step;volume;A_0;B_0;C;L;p;Compl;Aext;Bext;A_ingresso;A_uscita;B_ingresso;B_uscita;A_netto;B_netto;Avicino;Amedio;Alontano
0;4.18816e-15;365;380;97;10000;1;3;981;1000;500;132;506;141;368;365;1000;2;0
1;4.18816e-15;355;390;97;10000;1;3;1104;1176;491;146;465;126;345;339;944;0;0
2;4.18816e-15;503;576;94;10000;1;6;1148;1250;552;216;623;217;336;406;913;6;0
3;4.18816e-15;551;595;92;10000;1;8;1209;1320;554;288;612;293;266;319;883;8;0
4;4.18816e-15;572;636;89;10001;1;11;1233;1388;647;284;692;303;363;389;856;9;0
5;4.18879e-15;632;666;88;10001;1;12;1270;1452;646;290;708;330;356;378;832;8;0
6;4.18879e-15;592;668;84;10001;1;16;1312;1514;605;317;725;350;288;375;808;8;0
7;4.18879e-15;585;712;81;10002;1;20;1349;1574;635;321;732;323;314;409;785;8;0
8;4.18942e-15;620;778;81;10002;1;23;1400;1631;633;344;776;371;289;405;765;7;0
9;4.18942e-15;680;811;85;10004;1;22;1408;1686;748;314;790;396;434;394;744;7;0
10;4.19068e-15;689;862;89;10004;1;21;1436;1739;666;340;841;410;326;431;723;7;0
11;4.19068e-15;716;811;90;10004;1;22;1460;1789;709;362;896;426;347;470;704;6;0
12;4.19068e-15;728;880;85;10005;1;28;1500;1838;753;349;860;428;404;432;685;6;0
13;4.19131e-15;753;904;84;10006;1;31;1518;1884;763;359;914;454;404;460;664;6;0
14;4.19195e-15;744;903;81;10007;1;35;1524;1929;707;349;950;454;358;496;649;6;0
15;4.19258e-15;770;971;86;10007;1;35;1559;1972;816;342;889;454;474;435;632;6;0
16;4.19258e-15;738;982;88;10007;1;36;1559;2014;769;393;1048;495;376;553;616;6;0
17;4.19258e-15;777;1029;96;10007;1;34;1577;2054;728;369;996;500;359;496;602;6;0
18;4.19258e-15;797;1047;99;10007;1;33;1595;2092;768;423;1102;490;345;612;586;6;0
19;4.19258e-15;796;1038;102;10007;1;34;1630;2129;828;412;991;502;416;489;570;6;0
20;4.19258e-15;856;1104;106;10007;1;35;1644;2165;837;398;1081;554;439;527;556;6;0
21;4.19258e-15;851;1098;110;10007;1;36;1659;2199;812;443;1085;557;369;528;542;6;0
22;4.19258e-15;830;1092;107;10007;1;40;1552;2132;830;421;1096;574;409;522;536;6;0
23;4.19258e-15;802;1052;115;10007;1;38;1687;2264;745;395;1056;531;350;525;514;6;0
24;4.19258e-15;824;1031;118;10007;1;39;1670;2294;898;412;1135;535;486;600;503;6;0
25;4.19258e-15;880;1131;126;10007;1;36;1680;2324;843;423;1152;522;420;630;492;6;0
26;4.19258e-15;902;1146;135;10008;1;35;1588;2252;848;417;1168;555;431;613;487;6;0
27;4.19321e-15;848;1137;148;10008;1;31;1600;2280;800;434;1103;556;366;547;474;6;0
28;4.19321e-15;797;1122;149;10009;1;35;1613;2306;756;402;1139;566;354;573;463;7;0
29;4.19384e-15;756;1136;154;10009;1;35;1745;2432;791;417;1134;569;374;565;448;7;0
30;4.19384e-15;794;1174;154;10009;1;37;1749;2456;869;393;1222;585;476;637;439;7;0
31;4.19384e-15;839;1253;145;10010;1;46;1656;2380;836;439;1237;531;397;706;435;7;0
32;4.19447e-15;841;1243;145;10010;1;50;1736;2503;842;397;1228;622;445;606;421;8;0
33;4.19447e-15;857;1226;157;10010;1;48;1765;2525;840;431;1265;613;409;652;411;8;0
34;4.19447e-15;849;1179;159;10010;1;51;1768;2547;886;425;1250;668;461;582;403;8;0
35;4.19447e-15;865;1163;159;10011;1;55;1773;2567;888;454;1286;567;434;719;395;9;0
36;4.1951e-15;869;1264;173;10012;1;53;1753;2587;867;457;1267;631;410;636;389;9;0
37;4.19574e-15;841;1306;177;10014;1;55;1783;2607;847;455;1311;663;392;648;381;10;0
38;4.197e-15;850;1278;180;10015;1;61;1764;2626;917;457;1339;702;460;637;373;10;0
39;4.19763e-15;822;1292;194;10016;1;59;1789;2644;873;418;1325;661;455;664;367;11;0
40;4.19826e-15;852;1291;210;10017;1;55;1795;2661;913;458;1326;666;455;660;360;11;0
41;4.1989e-15;893;1308;213;10019;1;61;1774;2678;904;441;1391;667;463;724;353;12;0
42;4.20016e-15;869;1305;220;10021;1;63;1779;2695;919;459;1392;634;460;758;347;12;0
43;4.20142e-15;861;1333;231;10023;1;67;1804;2711;897;444;1262;621;453;641;341;12;0
44;4.20269e-15;909;1312;229;10024;1;77;1776;2726;977;426;1332;666;551;666;335;13;0
45;4.20332e-15;958;1338;244;10025;1;73;1799;2741;911;424;1271;633;487;638;327;14;0
46;4.20395e-15;897;1295;252;10025;1;75;1803;2755;866;453;1416;667;413;749;321;14;0
47;4.20395e-15;867;1317;256;10027;1;82;1811;2769;838;467;1361;693;371;668;314;15;0
48;4.20522e-15;867;1293;265;10029;1;82;1790;2783;889;439;1388;668;450;720;309;15;0
49;4.20648e-15;877;1318;275;10032;1;82;1795;2796;876;456;1412;699;420;713;304;16;0
50;4.20838e-15;896;1317;286;10035;1;84;1798;2809;909;453;1368;674;456;694;301;17;0
51;4.21028e-15;901;1406;297;10036;1;86;1800;2821;910;481;1351;660;429;691;296;17;0
52;4.21091e-15;963;1379;310;10038;1;87;1801;2833;889;418;1463;689;471;774;291;18;0
53;4.21217e-15;966;1360;327;10039;1;87;1805;2845;915;470;1402;706;445;696;286;19;0
54;4.21281e-15;888;1336;345;10040;1;85;1809;2856;824;441;1427;705;383;722;282;19;0
55;4.21344e-15;932;1375;350;10042;1;92;1809;2868;944;444;1433;671;500;762;278;20;0
56;4.21471e-15;961;1326;362;10042;1;98;1808;2878;935;449;1420;726;486;694;274;20;0
57;4.21471e-15;973;1405;375;10043;1;101;1811;2889;899;474;1414;700;425;714;270;21;0
58;4.21534e-15;869;1422;393;10049;1;103;1813;2899;927;480;1429;729;447;700;265;21;0
59;4.21914e-15;869;1474;421;10052;1;96;1835;2909;917;409;1429;708;508;721;260;21;0
60;4.22103e-15;871;1469;428;10054;1;106;1814;2918;906;426;1479;700;480;779;256;21;0
61;4.2223e-15;902;1450;437;10057;1;115;1814;2928;915;423;1478;687;492;791;252;22;0
62;4.2242e-15;862;1420;453;10059;1;120;1815;2937;882;447;1433;710;435;723;249;22;0
63;4.22547e-15;835;1387;481;10063;1;120;1812;2945;933;443;1493;743;490;750;245;23;0
64;4.228e-15;883;1372;509;10067;1;117;1813;2954;865;428;1467;717;437;750;243;24;0
65;4.23053e-15;954;1380;530;10070;1;118;1832;2962;952;391;1422;707;561;715;239;24;0
66;4.23244e-15;916;1427;535;10075;1;129;1806;2971;918;437;1504;681;481;823;235;25;0
67;4.2356e-15;877;1451;539;10076;1;142;1808;2979;902;437;1548;728;465;820;232;25;0
68;4.23624e-15;874;1467;542;10079;1;161;1831;2986;910;418;1531;668;492;863;229;26;0
69;4.23814e-15;852;1487;564;10085;1;164;1804;2994;923;456;1460;744;467;716;225;26;0
70;4.24194e-15;887;1485;595;10089;1;158;1802;3001;921;428;1582;750;493;832;222;26;0
71;4.24448e-15;807;1442;630;10092;1;154;1806;3008;823;446;1469;716;377;753;220;27;0
72;4.24638e-15;833;1470;666;10098;1;149;1808;3015;898;451;1539;759;447;780;217;28;0
73;4.25019e-15;850;1497;697;10100;1;150;1831;3022;917;425;1514;730;492;784;215;28;0
74;4.25146e-15;907;1516;728;10106;1;150;1832;3029;871;434;1532;741;437;791;214;29;0
75;4.25527e-15;879;1511;742;10113;1;164;1832;3035;916;461;1535;726;455;809;212;30;0
76;4.25971e-15;841;1471;751;10118;1;183;1836;3042;904;457;1533;756;447;777;207;30;0
77;4.26289e-15;840;1542;795;10122;1;176;1833;3048;945;461;1435;720;484;715;205;31;0
78;4.26543e-15;819;1509;812;10125;1;193;1831;3054;933;460;1485;733;473;752;203;31;0
79;4.26733e-15;840;1475;834;10128;1;204;1803;3060;939;416;1585;692;523;893;201;32;0
80;4.26924e-15;892;1463;863;10135;1;215;1827;3066;870;412;1542;737;458;805;199;33;0
81;4.27369e-15;880;1469;881;10140;1;232;1825;3071;1004;457;1578;748;547;830;198;33;0
82;4.27687e-15;882;1513;923;10143;1;226;1827;3077;891;463;1495;720;428;775;195;33;0
83;4.27878e-15;910;1518;970;10149;1;227;1829;3082;901;434;1509;743;467;766;194;34;0
84;4.28259e-15;899;1515;976;10156;1;251;1832;3088;903;473;1515;755;430;760;193;34;0
85;4.28705e-15;880;1465;1028;10162;1;248;1834;3093;903;457;1579;777;446;802;192;35;0
86;4.29087e-15;831;1509;1058;10167;1;260;1809;3098;956;452;1516;736;504;780;189;35;0
87;4.29405e-15;854;1517;1123;10170;1;251;1808;3103;882;416;1632;731;466;901;187;36;0
88;4.29596e-15;886;1549;1173;10178;1;249;1811;3108;904;479;1562;751;425;811;186;37;0
89;4.30106e-15;831;1469;1217;10183;1;252;1836;3112;927;484;1611;811;443;800;184;38;0
90;4.30424e-15;826;1540;1256;10189;1;266;1810;3117;880;461;1566;708;419;858;183;38;0
91;4.30807e-15;837;1518;1274;10193;1;291;1811;3122;898;404;1507;791;494;716;182;40;0
92;4.31062e-15;835;1568;1306;10201;1;309;1833;3126;902;405;1613;722;497;891;181;40;0
93;4.31572e-15;829;1490;1353;10207;1;316;1831;3130;955;426;1555;786;529;769;180;40;0
94;4.31954e-15;839;1512;1405;10210;1;319;1806;3135;927;408;1512;743;519;769;179;40;0
95;4.32146e-15;833;1528;1459;10218;1;326;1799;3139;958;434;1595;777;524;818;177;41;0
96;4.32656e-15;803;1476;1492;10233;1;345;1825;3143;850;407;1584;778;443;806;175;41;0
97;4.33614e-15;855;1499;1531;10245;1;361;1820;3147;908;371;1520;750;537;770;175;42;0
98;4.34381e-15;882;1490;1584;10258;1;378;1818;3151;965;432;1609;738;533;871;173;43;0
99;4.35212e-15;792;1491;1643;10266;1;388;1820;3155;882;438;1578;763;444;815;172;44;0
100;4.35724e-15;771;1457;1669;10274;1;414;1819;3159;934;405;1549;769;529;780;171;44;0
101;4.36236e-15;784;1492;1749;10282;1;408;1797;3162;912;391;1593;724;521;869;169;44;0
102;4.36748e-15;818;1571;1801;10300;1;429;1796;3166;856;385;1571;729;471;842;167;45;0
103;4.37901e-15;838;1561;1871;10309;1;443;1793;3170;969;421;1593;771;548;822;165;46;0
104;4.38478e-15;834;1495;1928;10313;1;456;1816;3173;895;396;1521;797;499;724;164;46;0
105;4.38735e-15;840;1570;1980;10328;1;474;1816;3177;908;429;1602;764;479;838;163;47;0
106;4.39697e-15;820;1503;2085;10343;1;480;1789;3180;954;407;1612;756;547;856;162;47;0
107;4.4066e-15;785;1496;2121;10360;1;513;1812;3184;909;411;1668;761;498;907;160;48;0
108;4.41753e-15;764;1576;2207;10368;1;515;1811;3187;920;411;1609;792;509;817;159;49;0
109;4.42267e-15;835;1534;2292;10380;1;522;1681;3090;934;404;1628;795;530;833;160;49;0
110;4.43039e-15;725;1461;2375;10395;1;532;1787;3193;811;405;1534;744;406;790;157;49;0
111;4.44004e-15;780;1477;2475;10403;1;527;1808;3196;936;383;1574;742;553;832;157;50;0
112;4.4452e-15;817;1546;2545;10416;1;547;1803;3199;920;361;1600;757;559;843;155;51;0
113;4.45357e-15;788;1496;2601;10432;1;578;1802;3203;887;415;1533;741;472;792;154;52;0
114;4.46389e-15;766;1538;2650;10448;1;613;1806;3206;874;423;1531;783;451;748;153;52;0
115;4.47422e-15;766;1549;2761;10462;1;609;1804;3208;868;381;1603;769;487;834;152;52;0
116;4.48326e-15;747;1551;2841;10482;1;614;1782;3211;857;396;1615;757;461;858;151;53;0
117;4.49618e-15;753;1539;2922;10495;1;633;1805;3214;877;385;1599;740;492;859;150;53;0
118;4.50459e-15;792;1519;3047;10508;1;627;1775;3217;920;384;1590;754;536;836;149;54;0
119;4.51301e-15;817;1538;3137;10523;1;645;1776;3220;843;395;1609;711;448;898;148;55;0
120;4.52272e-15;785;1482;3224;10542;1;688;1801;3222;850;374;1486;728;476;758;148;56;0
121;4.53504e-15;735;1575;3334;10559;1;705;1673;3125;907;379;1613;706;528;907;149;56;0
122;4.54607e-15;728;1424;3412;10575;1;737;1800;3228;791;359;1575;789;432;786;146;57;0
123;4.55645e-15;746;1495;3496;10594;1;773;1773;3230;871;318;1638;708;553;930;145;57;0
124;4.5688e-15;765;1498;3599;10607;1;800;1770;3233;811;376;1663;766;435;897;144;57;0
125;4.57725e-15;746;1492;3739;10630;1;807;1764;3235;939;379;1628;737;560;891;143;58;0
126;4.59222e-15;734;1500;3832;10652;1;843;1758;3238;902;350;1579;772;552;807;144;58;0
127;4.60656e-15;746;1442;3937;10668;1;877;1755;3240;920;364;1654;770;556;884;143;58;0
128;4.61699e-15;694;1463;4082;10699;1;879;1757;3243;840;374;1684;685;466;999;143;59;0
129;4.63723e-15;693;1536;4199;10721;1;892;1757;3245;858;350;1660;708;508;952;141;60;0
130;4.65161e-15;726;1470;4308;10745;1;922;1781;3248;872;354;1631;792;518;839;140;60;0
131;4.66732e-15;705;1488;4453;10767;1;935;1749;3250;887;358;1579;680;529;899;140;60;0
132;4.68173e-15;691;1460;4573;10795;1;960;1648;3152;858;345;1629;759;513;870;141;60;0
133;4.70009e-15;675;1369;4711;10810;1;983;1749;3254;778;328;1583;741;450;842;138;60;0
134;4.70994e-15;657;1453;4852;10838;1;1000;1743;3257;910;354;1675;712;556;963;139;61;0
135;4.72834e-15;723;1473;4982;10859;1;1019;1743;3259;835;347;1660;703;488;957;139;61;0
136;4.74216e-15;663;1518;5160;10885;1;1022;1742;3261;891;344;1683;718;547;965;138;62;0
137;4.75929e-15;694;1500;5253;10904;1;1068;1763;3263;896;311;1595;755;585;840;138;63;0
138;4.77181e-15;661;1558;5375;10933;1;1099;1760;3265;875;364;1624;739;511;885;137;63;0
139;4.79096e-15;689;1472;5592;10964;1;1069;1755;3267;925;351;1675;799;574;876;136;63;0
140;4.81145e-15;687;1480;5724;10993;1;1105;1726;3269;876;335;1647;717;541;930;136;63;0
141;4.83064e-15;623;1474;5837;11029;1;1145;1751;3271;868;353;1627;744;515;883;135;63;0
142;4.85451e-15;677;1458;6001;11060;1;1161;1747;3273;852;313;1622;732;539;890;134;64;0
143;4.87509e-15;681;1456;6136;11095;1;1198;1715;3275;882;330;1696;717;552;979;134;64;0
144;4.89836e-15;596;1501;6313;11127;1;1216;1743;3277;826;354;1623;711;472;912;134;64;0
145;4.91967e-15;657;1520;6453;11154;1;1245;1736;3279;904;281;1653;738;623;915;134;65;0
146;4.93767e-15;657;1440;6560;11186;1;1302;1603;3181;843;318;1598;723;525;875;135;65;0
147;4.95904e-15;608;1406;6748;11210;1;1322;1731;3283;796;317;1538;683;479;855;133;66;0
148;4.97509e-15;649;1436;6887;11242;1;1352;1731;3285;869;346;1663;682;523;981;133;66;0
149;4.99651e-15;643;1503;7063;11278;1;1379;1698;3287;892;339;1737;724;553;1013;132;66;0
150;5.02064e-15;610;1489;7271;11314;1;1383;1724;3289;822;315;1580;667;507;913;132;68;0
151;5.04482e-15;624;1480;7429;11341;1;1415;1701;3291;842;330;1704;725;512;979;132;68;0
152;5.06297e-15;610;1429;7583;11382;1;1452;1701;3292;854;356;1616;747;498;869;130;68;0
153;5.09058e-15;587;1396;7763;11415;1;1472;1698;3294;857;308;1709;706;549;1003;129;69;0
154;5.11285e-15;648;1376;7876;11454;1;1535;1697;3296;801;287;1537;738;514;799;129;69;0
155;5.1392e-15;625;1447;8017;11485;1;1588;1722;3298;862;333;1655;703;529;952;129;70;0
156;5.16017e-15;626;1413;8237;11520;1;1606;1692;3299;885;312;1621;726;573;895;130;70;0
157;5.18389e-15;625;1406;8399;11559;1;1664;1692;3301;790;329;1622;687;461;935;129;71;0
158;5.21036e-15;603;1406;8606;11597;1;1686;1716;3303;845;301;1628;695;544;933;129;72;0
159;5.2362e-15;608;1429;8821;11650;1;1703;1713;3304;831;300;1720;709;531;1011;129;72;0
160;5.27231e-15;544;1425;8979;11684;1;1760;1712;3306;837;305;1704;706;532;998;128;73;0
161;5.29551e-15;608;1416;9237;11726;1;1752;1679;3308;887;289;1690;680;598;1010;129;73;0
162;5.32423e-15;532;1433;9439;11782;1;1789;1676;3309;844;300;1617;741;544;876;129;74;0
163;5.36259e-15;570;1444;9614;11824;1;1830;1668;3311;840;278;1661;723;562;938;129;73;0
164;5.39143e-15;578;1397;9912;11878;1;1804;1694;3312;858;307;1678;682;551;996;129;73;0
165;5.42858e-15;572;1420;10148;11921;1;1826;1694;3314;853;305;1675;664;548;1011;128;74;0
166;5.45822e-15;546;1426;10368;11976;1;1861;1689;3315;883;294;1639;721;589;918;129;74;0
167;5.49622e-15;558;1429;10609;12029;1;1874;1656;3317;913;300;1681;724;613;957;128;74;0
168;5.53291e-15;535;1383;10882;12078;1;1870;1682;3318;826;291;1602;718;535;884;128;75;0
169;5.56691e-15;555;1377;11111;12131;1;1899;1681;3320;862;294;1660;705;568;955;128;76;0
170;5.60377e-15;572;1364;11315;12180;1;1928;1653;3321;864;291;1669;665;573;1004;127;75;0
171;5.63791e-15;533;1386;11516;12225;1;1959;1674;3323;897;250;1643;706;647;937;127;76;0
172;5.66933e-15;567;1372;11657;12267;1;2033;1641;3324;827;238;1637;736;589;901;126;76;0
173;5.6987e-15;549;1421;11857;12313;1;2071;1670;3326;790;297;1571;716;493;855;127;76;0
174;5.73094e-15;534;1461;12059;12376;1;2118;1669;3327;839;270;1652;706;569;946;126;76;0
175;5.77518e-15;527;1462;12260;12430;1;2170;1643;3329;804;286;1633;688;518;945;126;76;0
176;5.81319e-15;567;1346;12524;12481;1;2176;1669;3330;802;254;1604;739;548;865;126;77;0
177;5.84917e-15;552;1402;12683;12545;1;2245;1667;3331;872;302;1611;688;570;923;125;77;0
178;5.89442e-15;551;1340;12905;12586;1;2275;1635;3333;837;261;1598;719;576;879;125;77;0
179;5.92348e-15;496;1389;13146;12634;1;2299;1661;3334;838;285;1645;660;553;985;126;78;0
180;5.95755e-15;534;1443;13435;12682;1;2299;1632;3336;840;264;1644;673;576;971;126;79;0
181;5.99169e-15;495;1374;13704;12745;1;2322;1630;3337;800;267;1643;746;533;897;126;79;0
182;6.03659e-15;499;1395;13994;12805;1;2312;1651;3338;907;257;1646;719;650;927;126;80;0
183;6.07946e-15;494;1404;14243;12874;1;2324;1649;3340;836;245;1656;720;591;936;126;81;0
184;6.12889e-15;556;1378;14462;12933;1;2370;1645;3341;856;269;1649;695;587;954;127;79;0
185;6.17126e-15;515;1397;14710;12998;1;2398;1640;3342;884;261;1649;719;623;930;126;79;0
186;6.21805e-15;522;1453;14963;13054;1;2424;1637;3343;852;240;1622;719;612;903;125;79;0
187;6.25846e-15;534;1366;15228;13112;1;2453;1634;3345;828;241;1721;654;587;1067;125;79;0
188;6.3004e-15;512;1331;15435;13176;1;2510;1606;3346;785;240;1767;718;545;1049;125;79;0
189;6.34679e-15;482;1376;15691;13258;1;2538;1635;3347;782;251;1640;648;531;992;124;79;0
190;6.4064e-15;511;1408;15947;13339;1;2565;1607;3349;859;251;1701;657;608;1044;124;79;0
191;6.46546e-15;489;1454;16169;13391;1;2617;1635;3350;775;255;1712;687;520;1025;124;80;0
192;6.50347e-15;470;1403;16410;13453;1;2650;1603;3351;861;244;1632;733;617;899;124;80;0
193;6.54889e-15;481;1396;16695;13516;1;2640;1601;3352;781;256;1685;687;525;998;124;80;0
194;6.59515e-15;537;1443;16936;13593;1;2682;1599;3353;794;246;1693;683;548;1010;124;80;0
195;6.65183e-15;511;1404;17179;13664;1;2720;1598;3355;801;274;1622;689;527;933;125;81;0
196;6.70424e-15;460;1397;17372;13725;1;2784;1595;3356;825;270;1558;690;555;868;124;81;0
197;6.74939e-15;501;1409;17647;13788;1;2801;1520;3257;832;226;1582;706;606;876;125;81;0
198;6.79611e-15;472;1342;17890;13854;1;2826;1622;3358;762;250;1676;672;512;1004;123;82;0
199;6.84518e-15;484;1427;18162;13927;1;2834;1627;3359;752;252;1673;699;500;974;123;82;0
200;6.89959e-15;504;1339;18398;13987;1;2882;1625;3360;837;249;1686;668;588;1018;124;82;0
201;6.94442e-15;494;1381;18657;14054;1;2915;1621;3362;810;226;1630;693;584;937;122;83;0
202;6.99459e-15;467;1398;18903;14111;1;2966;1620;3363;769;236;1639;707;533;932;123;83;0
203;7.03737e-15;480;1374;19154;14185;1;2997;1623;3364;766;252;1652;713;514;939;123;83;0
204;7.09304e-15;450;1421;19428;14256;1;3021;1589;3365;855;230;1663;688;625;975;122;84;0
205;7.14659e-15;468;1400;19741;14326;1;3010;1587;3366;806;246;1677;687;560;990;122;83;0
206;7.19951e-15;499;1376;20021;14402;1;3022;1613;3367;813;237;1726;710;576;1016;122;85;0
207;7.25712e-15;484;1406;20307;14475;1;3052;1585;3368;798;249;1628;710;549;918;122;83;0
208;7.3126e-15;499;1385;20591;14539;1;3081;1585;3369;778;232;1628;682;546;946;122;82;0
209;7.36136e-15;509;1417;20818;14621;1;3133;1613;3370;805;243;1650;728;562;922;122;82;0
210;7.42399e-15;494;1438;21097;14688;1;3163;1612;3371;813;255;1647;710;558;937;122;82;0
211;7.47529e-15;469;1316;21364;14767;1;3210;1487;3273;801;254;1720;724;547;996;123;82;0
212;7.53594e-15;460;1313;21647;14839;1;3230;1588;3374;745;214;1574;703;531;871;122;83;0
213;7.59135e-15;416;1383;21843;14915;1;3316;1596;3375;722;269;1685;672;453;1013;121;83;0
214;7.64999e-15;444;1379;22105;15002;1;3340;1623;3376;793;228;1697;701;565;996;121;83;0
215;7.7173e-15;502;1324;22309;15069;1;3409;1594;3377;816;240;1732;733;576;999;121;84;0
216;7.76928e-15;490;1402;22569;15132;1;3448;1593;3378;767;253;1720;673;514;1047;120;83;0
217;7.81825e-15;473;1411;22864;15199;1;3470;1618;3379;843;241;1762;700;602;1062;120;84;0
218;7.87045e-15;479;1353;23150;15273;1;3487;1586;3380;796;238;1716;679;558;1037;120;84;0
219;7.92824e-15;480;1323;23385;15329;1;3530;1587;3381;768;244;1734;748;524;986;120;84;0
220;7.97206e-15;450;1402;23655;15408;1;3569;1587;3382;767;250;1701;644;517;1057;121;84;0
221;8.03402e-15;434;1366;23978;15487;1;3576;1613;3383;815;236;1618;735;579;883;121;85;0
222;8.09614e-15;461;1398;24237;15540;1;3617;1611;3384;790;228;1670;688;562;982;120;86;0
223;8.13791e-15;470;1414;24459;15599;1;3686;1582;3385;774;213;1677;705;561;972;120;87;0
224;8.18449e-15;430;1427;24721;15674;1;3725;1611;3386;767;246;1665;714;521;951;121;88;0
225;8.24383e-15;464;1334;24997;15756;1;3765;1581;3387;786;199;1682;753;587;929;121;88;0
226;8.30887e-15;447;1363;25275;15828;1;3795;1579;3388;797;247;1743;668;550;1075;121;89;0
227;8.36612e-15;453;1390;25585;15890;1;3796;1581;3389;740;235;1670;646;505;1024;121;89;0
228;8.41552e-15;464;1369;25798;15969;1;3868;1609;3390;761;221;1667;704;540;963;121;89;0
229;8.47861e-15;502;1465;26099;16031;1;3894;1580;3390;812;235;1697;687;577;1010;121;89;0
230;8.52823e-15;479;1394;26374;16113;1;3932;1607;3391;827;254;1711;743;573;968;121;89;0
231;8.59402e-15;437;1423;26669;16181;1;3965;1577;3392;820;233;1775;676;587;1099;121;90;0
232;8.64869e-15;430;1390;26979;16265;1;3981;1574;3393;779;212;1701;705;567;996;121;90;0
233;8.7164e-15;429;1359;27215;16346;1;4037;1572;3394;784;202;1758;693;582;1065;121;89;0
234;8.78185e-15;429;1346;27508;16425;1;4073;1600;3395;796;231;1648;702;565;946;121;89;0
235;8.84585e-15;412;1399;27829;16501;1;4081;1599;3396;778;224;1646;728;554;918;121;89;0
236;8.90756e-15;436;1427;28094;16584;1;4128;1568;3397;839;204;1639;708;635;931;120;89;0
237;8.97512e-15;419;1472;28390;16669;1;4156;1596;3398;796;241;1729;681;555;1048;120;89;0
238;9.04448e-15;463;1433;28749;16752;1;4143;1594;3399;849;200;1619;738;649;881;120;89;0
239;9.11238e-15;448;1431;29066;16823;1;4166;1568;3400;755;213;1667;714;542;953;121;89;0
240;9.1706e-15;461;1351;29388;16882;1;4176;1568;3400;755;221;1756;675;534;1081;121;89;0
241;9.21908e-15;445;1432;29620;16948;1;4250;1567;3401;796;220;1666;649;576;1017;121;90;0
242;9.27341e-15;440;1438;29999;17011;1;4224;1595;3402;783;214;1744;677;569;1067;120;91;0
243;9.32536e-15;420;1362;30291;17093;1;4251;1592;3403;826;224;1707;728;602;979;120;91;0
244;9.39314e-15;437;1436;30519;17190;1;4316;1592;3404;779;238;1717;719;541;998;120;91;0
245;9.47352e-15;439;1403;30864;17262;1;4315;1587;3405;853;208;1655;701;645;954;119;92;0
246;9.53333e-15;450;1382;31141;17332;1;4341;1586;3406;821;221;1753;702;600;1051;119;92;0
247;9.5916e-15;457;1405;31414;17419;1;4382;1582;3407;831;204;1655;677;627;978;119;93;0
248;9.66419e-15;426;1396;31651;17501;1;4454;1555;3407;747;214;1784;667;533;1117;119;92;0
249;9.73278e-15;444;1371;31947;17585;1;4476;1556;3408;789;210;1733;676;579;1057;118;93;0
250;9.8032e-15;430;1313;32205;17665;1;4527;1582;3409;801;198;1624;720;603;904;118;93;0
251;9.87043e-15;437;1402;32424;17735;1;4601;1559;3410;771;224;1717;683;547;1034;117;93;0
252;9.92939e-15;422;1364;32683;17828;1;4649;1559;3411;783;223;1665;700;560;965;116;93;0
253;1.00079e-14;413;1369;33011;17908;1;4647;1587;3411;771;220;1728;710;551;1018;116;92;0
254;1.00756e-14;420;1374;33322;17978;1;4675;1560;3412;784;216;1717;704;568;1013;115;92;0
255;1.01349e-14;457;1364;33582;18063;1;4732;1557;3413;818;220;1743;690;598;1053;115;92;0
256;1.02072e-14;404;1358;33858;18130;1;4768;1588;3414;732;239;1626;720;493;906;115;91;0
257;1.02642e-14;418;1335;34107;18211;1;4815;1588;3415;756;210;1662;706;546;956;115;92;0
258;1.03334e-14;451;1346;34367;18306;1;4871;1558;3415;786;197;1776;661;589;1115;116;93;0
259;1.04146e-14;464;1370;34725;18386;1;4859;1560;3416;767;228;1783;694;539;1089;116;92;0
260;1.04832e-14;456;1404;34977;18460;1;4930;1561;3417;746;233;1751;697;513;1054;116;93;0
261;1.05468e-14;432;1368;35274;18539;1;4958;1559;3418;764;196;1727;706;568;1021;116;93;0
262;1.06149e-14;463;1364;35650;18610;1;4928;1586;3419;811;233;1740;655;578;1085;116;92;0
263;1.06761e-14;412;1349;35910;18682;1;4990;1558;3419;763;206;1752;668;557;1084;116;94;0
264;1.07384e-14;381;1407;36137;18749;1;5064;1558;3420;801;213;1752;695;588;1057;116;94;0
265;1.07964e-14;393;1398;36476;18834;1;5059;1558;3421;729;198;1680;700;531;980;116;94;0
266;1.08702e-14;383;1399;36776;18923;1;5096;1585;3422;780;194;1732;686;586;1046;116;94;0
267;1.09476e-14;441;1357;37020;19015;1;5162;1582;3422;789;196;1676;702;593;974;115;96;0
268;1.10278e-14;437;1431;37245;19100;1;5231;1550;3423;784;205;1789;687;579;1102;115;94;0
269;1.11021e-14;428;1411;37507;19190;1;5289;1579;3424;762;211;1695;739;551;956;115;95;0
270;1.1181e-14;414;1412;37793;19274;1;5327;1549;3425;784;215;1719;705;569;1014;115;95;0
271;1.12547e-14;392;1410;38067;19348;1;5357;1550;3425;773;225;1783;745;548;1038;115;94;1
272;1.13199e-14;412;1436;38318;19433;1;5418;1577;3426;788;198;1743;706;590;1037;116;95;1
273;1.13948e-14;400;1383;38649;19514;1;5416;1482;3327;708;211;1690;693;497;997;117;94;1
274;1.14664e-14;398;1316;38953;19584;1;5420;1581;3428;759;213;1686;684;546;1002;115;94;1
275;1.15284e-14;382;1342;39263;19675;1;5436;1553;3428;804;229;1718;694;575;1024;116;93;1
276;1.16091e-14;414;1356;39516;19770;1;5484;1529;3429;804;205;1652;680;599;972;115;93;1
277;1.16936e-14;412;1332;39852;19857;1;5488;1499;3430;777;224;1658;701;553;957;115;94;1
278;1.17711e-14;405;1383;40108;19954;1;5535;1529;3431;762;185;1756;730;577;1026;115;94;1
279;1.18578e-14;398;1370;40364;20046;1;5579;1476;3431;772;224;1762;720;548;1042;115;95;1
280;4.20269e-15;341;925;14974;10119;1;5350;1406;3432;732;129;1693;392;603;1301;116;94;1
281;4.26352e-15;366;1016;15941;10192;1;5026;1440;3433;733;182;1759;481;551;1278;116;94;1
282;4.30998e-15;355;1100;16852;10282;1;4740;1374;3433;695;168;1699;507;527;1192;115;95;1
283;4.36748e-15;345;1116;17723;10367;1;4469;1362;3434;699;196;1660;538;503;1122;116;95;1
284;4.42203e-15;349;1149;18491;10460;1;4260;1332;3435;654;155;1697;568;499;1129;117;96;1
285;4.48196e-15;343;1123;19190;10567;1;4096;1262;3435;621;157;1716;613;464;1103;118;96;1
286;4.55126e-15;332;1138;19825;10673;1;3939;1259;3436;631;171;1653;631;460;1022;118;97;1
287;4.62025e-15;298;1165;20476;10790;1;3785;1261;3437;606;143;1721;586;463;1135;118;97;1
288;4.69681e-15;291;1201;21152;10893;1;3611;1212;3438;641;175;1711;558;466;1153;118;97;1
289;4.76456e-15;316;1245;21747;11027;1;3471;1169;3438;654;132;1689;640;522;1049;118;97;1
290;4.85318e-15;237;1256;22332;11140;1;3339;1155;3439;559;149;1728;662;410;1066;117;97;1
291;4.92834e-15;297;1301;22890;11249;1;3206;1136;3440;592;115;1684;649;477;1035;118;97;1
292;5.0012e-15;265;1294;23359;11377;1;3120;1169;3440;524;149;1716;666;375;1050;118;97;1
293;5.08721e-15;280;1315;23880;11498;1;3016;1113;3441;546;137;1745;670;409;1075;118;97;1
294;5.16898e-15;272;1323;24331;11630;1;2962;1101;3442;575;121;1717;668;454;1049;118;97;1
295;5.25867e-15;258;1356;24836;11753;1;2855;1113;3442;557;154;1747;692;403;1055;118;97;1
296;5.34271e-15;244;1281;25183;11877;1;2842;1086;3443;547;128;1707;683;419;1024;117;97;1
297;5.42789e-15;259;1324;25610;11994;1;2774;1119;3444;560;134;1687;648;426;1039;117;97;1
298;5.50867e-15;247;1388;26010;12109;1;2714;1057;3444;549;138;1711;651;411;1060;118;97;1
299;5.58846e-15;228;1403;26305;12238;1;2710;1090;3445;571;132;1672;700;439;972;117;97;1
300;5.67842e-15;223;1441;26668;12338;1;2662;1082;3445;490;124;1672;706;366;966;117;98;1
301;5.74848e-15;264;1390;27108;12453;1;2574;1055;3446;529;118;1722;721;411;1001;117;97;1
302;5.82941e-15;240;1449;27445;12569;1;2554;1033;3447;552;123;1748;708;429;1040;116;97;1
303;5.91142e-15;253;1446;27783;12700;1;2529;1070;3447;483;119;1757;702;364;1055;117;97;1
304;6.00451e-15;230;1377;28117;12791;1;2505;1090;3448;494;151;1691;736;343;955;117;97;1
305;6.06945e-15;238;1392;28438;12910;1;2480;1031;3449;559;133;1695;736;426;959;116;96;1
306;6.15473e-15;245;1447;28739;13022;1;2470;1046;3449;503;106;1687;664;397;1023;116;97;1
307;6.23536e-15;255;1396;29035;13133;1;2473;1022;3450;518;115;1765;708;403;1057;115;96;1
308;6.31561e-15;260;1494;29316;13255;1;2470;1038;3451;529;127;1754;725;402;1029;115;97;1
309;6.40421e-15;266;1495;29592;13363;1;2472;1055;3451;525;146;1682;720;379;962;115;95;1
310;6.48299e-15;243;1501;29902;13494;1;2465;1027;3452;524;106;1687;746;418;941;115;95;1
311;6.57898e-15;240;1370;30246;13632;1;2424;1047;3452;513;123;1750;737;390;1013;115;96;1
312;6.68061e-15;237;1379;30518;13748;1;2430;1045;3453;514;102;1706;752;412;954;114;95;1
313;6.76643e-15;244;1519;30747;13865;1;2462;1064;3454;500;119;1736;710;381;1026;113;95;1
314;6.85337e-15;256;1469;31007;13992;1;2477;1018;3454;589;136;1720;765;453;955;113;95;1
315;6.94816e-15;241;1540;31236;14114;1;2513;998;3455;498;116;1707;703;382;1004;113;94;1
316;7.03962e-15;218;1443;31528;14229;1;2488;1036;3455;515;114;1736;786;401;950;113;94;1
317;7.12621e-15;231;1481;31842;14330;1;2463;1035;3456;497;123;1660;691;374;969;114;95;1
318;7.20254e-15;279;1459;32112;14441;1;2462;1031;3457;538;109;1731;755;429;976;114;95;1
319;7.28675e-15;251;1506;32358;14553;1;2481;1014;3457;538;117;1699;728;421;971;114;95;1
320;7.37204e-15;253;1479;32625;14659;1;2472;1050;3458;507;118;1739;739;389;1000;114;96;1
321;7.45307e-15;242;1513;32855;14775;1;2485;1048;3458;517;131;1719;722;386;997;114;95;1
322;7.54209e-15;270;1437;33022;14896;1;2544;1031;3459;484;130;1736;749;354;987;113;96;1
323;7.63532e-15;272;1424;33256;15004;1;2569;1011;3460;522;129;1710;713;393;997;112;96;1
324;7.71885e-15;245;1405;33508;15108;1;2587;1008;3460;549;119;1788;750;430;1038;112;96;1
325;7.79958e-15;260;1486;33730;15222;1;2610;1046;3461;473;134;1764;705;339;1059;111;96;1
326;7.88839e-15;243;1469;33988;15326;1;2617;989;3461;499;124;1713;741;375;972;111;95;1
327;7.96971e-15;276;1408;34241;15414;1;2616;987;3462;512;120;1749;723;392;1026;112;96;1
328;8.03873e-15;234;1438;34456;15524;1;2638;1027;3462;492;121;1729;707;371;1022;111;95;1
329;8.12529e-15;275;1474;34699;15641;1;2636;1025;3463;516;119;1734;745;397;989;112;95;1
330;8.2177e-15;261;1495;34867;15745;1;2685;1044;3464;516;129;1772;779;387;993;112;96;1
331;8.30013e-15;244;1495;35100;15852;1;2705;1026;3464;526;146;1649;747;380;902;112;95;1
332;8.38523e-15;250;1524;35304;15934;1;2732;1047;3465;496;114;1726;749;382;977;112;95;1
333;8.45064e-15;256;1507;35521;16050;1;2762;1045;3465;526;114;1710;734;412;976;111;96;1
334;8.54346e-15;255;1476;35775;16142;1;2760;994;3466;506;143;1726;806;363;920;110;96;2
335;8.61732e-15;242;1506;35976;16249;1;2789;1030;3466;508;131;1680;773;377;907;110;95;2
336;8.70349e-15;245;1540;36156;16353;1;2833;1007;3467;545;125;1684;734;420;950;110;95;2
337;8.78752e-15;247;1459;36350;16468;1;2871;1027;3467;515;127;1733;754;388;979;109;95;2
338;8.88074e-15;274;1398;36593;16548;1;2878;993;3468;495;133;1754;797;362;957;109;95;2
339;8.94579e-15;239;1454;36805;16647;1;2903;1030;3469;520;123;1780;728;397;1052;109;95;2
340;9.02651e-15;267;1517;37038;16748;1;2903;1046;3469;520;118;1735;751;402;984;109;96;2
341;9.10911e-15;263;1514;37286;16857;1;2911;1024;3470;508;120;1719;706;388;1013;109;95;2
342;9.19853e-15;283;1464;37509;16937;1;2925;987;3470;510;117;1804;738;393;1066;109;94;2
343;9.26434e-15;294;1491;37738;17032;1;2942;1043;3471;496;129;1705;719;367;986;108;94;2
344;9.3427e-15;239;1515;37888;17136;1;3006;1024;3471;483;133;1718;762;350;956;108;94;2
345;9.42874e-15;262;1552;38114;17252;1;3016;1044;3472;511;133;1758;755;378;1003;108;94;2
346;9.52502e-15;265;1508;38368;17362;1;3020;1008;3472;513;138;1758;744;375;1014;108;94;2
347;9.61661e-15;265;1450;38634;17440;1;3009;1007;3473;511;122;1784;797;389;987;108;94;2
348;9.68174e-15;286;1525;38801;17537;1;3059;1044;3473;512;116;1720;732;396;988;108;94;2
349;9.76294e-15;273;1487;39071;17619;1;3062;1038;3474;550;129;1806;728;421;1078;109;94;2
350;9.83176e-15;286;1496;39290;17730;1;3090;1004;3474;504;120;1740;705;384;1035;108;94;2
351;9.92517e-15;277;1523;39511;17813;1;3105;1045;3475;484;128;1686;764;356;922;108;94;2
352;9.99521e-15;276;1525;39719;17904;1;3131;1043;3475;560;147;1790;750;413;1040;107;94;2
353;1.00722e-14;251;1534;39848;18009;1;3211;1044;3476;538;133;1749;788;405;961;107;94;2
354;1.01613e-14;252;1515;40069;18111;1;3233;1044;3476;536;123;1708;757;413;951;106;93;2
355;1.0248e-14;249;1492;40312;18224;1;3233;1044;3477;508;149;1822;735;359;1087;106;93;2
356;1.03445e-14;273;1497;40463;18323;1;3286;1047;3477;478;130;1707;758;348;949;105;93;2
357;1.04292e-14;280;1451;40675;18423;1;3299;1009;3478;526;139;1674;762;387;912;105;94;2
358;1.0515e-14;279;1494;40918;18514;1;3294;983;3479;557;147;1733;747;410;986;105;93;2
359;1.05933e-14;258;1493;41069;18592;1;3352;1038;3479;494;112;1808;717;382;1091;106;92;2
360;1.06606e-14;260;1547;41288;18684;1;3368;993;3480;532;120;1668;757;412;911;105;92;2
361;1.07401e-14;244;1469;41574;18767;1;3348;973;3480;535;125;1707;742;410;965;104;92;2
362;1.0812e-14;244;1521;41840;18876;1;3337;1010;3481;469;119;1750;759;350;991;104;92;2
363;1.09067e-14;252;1516;42071;18967;1;3348;978;3481;495;150;1790;753;345;1037;103;92;2
364;1.09859e-14;239;1571;42261;19065;1;3365;1037;3482;450;136;1744;762;314;982;103;91;2
365;1.10715e-14;261;1523;42456;19157;1;3391;1033;3482;517;146;1740;753;371;987;103;92;2
366;1.1152e-14;275;1563;42702;19237;1;3387;1033;3482;519;127;1744;744;392;1000;103;92;2
367;1.12222e-14;245;1597;42974;19344;1;3371;1036;3483;493;133;1732;762;360;970;102;92;2
368;1.13163e-14;264;1479;43202;19457;1;3388;1001;3483;513;142;1728;777;371;951;102;92;2
369;1.1416e-14;293;1494;43431;19542;1;3401;1019;3484;489;137;1745;738;352;1007;102;93;2
370;1.14912e-14;266;1531;43609;19635;1;3445;981;3484;513;142;1843;743;371;1100;102;93;2
371;1.15736e-14;239;1502;43833;19722;1;3465;981;3485;489;131;1679;769;358;910;102;94;2
372;1.16509e-14;261;1515;44032;19813;1;3483;996;3485;518;119;1739;781;399;958;102;94;2
373;1.17319e-14;261;1502;44256;19910;1;3497;995;3486;502;136;1767;748;366;1019;102;95;2
374;1.18185e-14;277;1525;44438;20014;1;3528;928;3486;493;127;1799;797;366;1002;102;94;2
375;4.19258e-15;235;1094;16266;10100;1;3334;931;3487;455;94;1723;444;361;1279;101;95;2
376;4.25146e-15;224;1287;16921;10188;1;3107;905;3487;435;113;1720;616;322;1104;101;94;2
377;4.30743e-15;208;1343;17623;10293;1;2863;921;3488;438;118;1761;626;320;1135;100;95;2
378;4.37453e-15;214;1399;18244;10390;1;2663;833;3488;462;116;1739;675;346;1064;101;94;2
379;4.43683e-15;190;1343;18832;10488;1;2482;899;3489;391;101;1711;650;290;1061;101;95;2
380;4.50006e-15;230;1311;19334;10580;1;2343;834;3489;472;106;1733;665;366;1068;101;95;2
381;4.5597e-15;216;1316;19773;10685;1;2243;842;3490;396;100;1696;674;296;1022;101;94;2
382;4.62809e-15;197;1326;20191;10798;1;2150;832;3490;430;103;1795;701;327;1094;101;94;2
383;4.70206e-15;185;1423;20611;10912;1;2036;793;3491;394;105;1698;701;289;997;101;92;2
384;4.77709e-15;180;1364;20993;11008;1;1949;801;3491;396;92;1769;695;304;1074;101;92;2
385;4.84058e-15;215;1491;21330;11121;1;1880;796;3491;419;84;1769;701;335;1068;101;92;2
386;4.91567e-15;182;1452;21579;11234;1;1858;808;3492;364;130;1680;766;234;914;101;93;3
387;4.99115e-15;183;1484;21914;11351;1;1794;761;3492;399;92;1691;731;307;960;102;92;3
388;5.0697e-15;157;1504;22229;11450;1;1735;764;3493;415;104;1786;775;311;1011;102;92;3
389;5.13649e-15;158;1467;22486;11562;1;1712;790;3493;356;85;1811;770;271;1041;102;91;3
390;5.2124e-15;193;1460;22793;11670;1;1651;800;3494;412;98;1758;762;314;996;102;92;3
391;5.28595e-15;189;1468;23078;11780;1;1609;756;3494;370;112;1758;737;258;1021;101;92;3
392;5.36122e-15;186;1452;23349;11893;1;1567;737;3495;385;75;1739;753;310;986;101;90;3
393;5.43891e-15;187;1570;23598;11992;1;1541;747;3495;370;96;1725;713;274;1012;101;90;3
394;5.50729e-15;178;1572;23881;12087;1;1488;732;3496;389;96;1747;776;293;971;100;91;3
395;5.57316e-15;154;1556;24121;12188;1;1464;760;3496;385;83;1684;781;302;903;100;89;3
396;5.64349e-15;200;1578;24380;12292;1;1420;784;3496;392;95;1763;807;297;956;99;90;3
397;5.71621e-15;200;1511;24604;12395;1;1409;767;3497;408;85;1736;813;323;923;99;90;3
398;5.78854e-15;185;1581;24747;12490;1;1435;723;3497;413;93;1768;749;320;1019;99;89;3
399;5.85553e-15;181;1565;24928;12595;1;1437;720;3498;348;94;1740;789;254;951;98;90;3
400;5.92986e-15;173;1522;25132;12719;1;1432;763;3498;370;103;1749;772;267;977;98;90;3
401;6.01805e-15;184;1608;25283;12814;1;1464;741;3499;374;93;1690;743;281;947;98;90;3
402;6.0859e-15;149;1586;25468;12914;1;1466;718;3499;363;88;1793;822;275;971;98;88;3
403;6.1576e-15;186;1564;25684;13009;1;1444;707;3499;364;73;1748;810;291;938;98;89;3
404;6.22598e-15;164;1551;25855;13109;1;1441;694;3500;303;88;1723;813;215;910;98;90;3
405;6.29823e-15;171;1562;26011;13224;1;1457;689;3500;368;80;1716;802;288;914;98;90;3
406;6.38166e-15;173;1565;26171;13326;1;1464;680;3501;346;75;1694;782;271;912;98;91;3
407;6.45597e-15;180;1518;26405;13430;1;1433;658;3501;338;73;1736;785;265;951;97;91;3
408;6.53203e-15;153;1572;26578;13539;1;1423;617;3502;342;92;1761;798;250;963;97;91;3
409;6.61206e-15;147;1615;26793;13617;1;1397;599;3502;310;69;1724;763;241;961;97;89;3
410;6.66953e-15;149;1595;26983;13732;1;1383;596;3502;334;87;1769;846;247;923;96;89;3
411;6.75457e-15;142;1545;27165;13840;1;1373;565;3503;304;55;1761;772;249;989;95;90;3
412;6.83476e-15;139;1538;27300;13936;1;1377;498;3503;318;71;1739;769;247;970;95;88;3
413;6.90631e-15;144;1496;27496;14020;1;1340;550;3504;247;60;1668;797;187;871;94;89;3
414;6.96911e-15;135;1557;27620;14110;1;1347;542;3504;268;84;1791;740;184;1051;94;88;3
415;7.03662e-15;171;1613;27750;14199;1;1353;472;3505;227;72;1829;798;155;1031;94;88;3
416;7.10359e-15;126;1652;27886;14292;1;1357;546;3505;239;69;1790;825;170;965;94;89;3
417;7.17379e-15;130;1673;28090;14388;1;1327;549;3505;258;65;1752;778;193;974;94;89;3
418;7.2465e-15;121;1674;28258;14486;1;1314;545;3506;306;73;1709;797;233;912;94;87;3
419;7.32098e-15;147;1667;28361;14591;1;1337;563;3506;267;73;1782;812;194;970;94;88;3
420;7.40106e-15;153;1685;28541;14704;1;1318;500;3507;267;75;1764;865;192;899;93;87;3
421;7.48756e-15;133;1647;28682;14797;1;1316;545;3507;256;69;1782;834;187;948;94;87;3
422;7.55901e-15;139;1679;28834;14898;1;1300;531;3507;291;70;1774;760;221;1014;93;88;3
423;7.63686e-15;125;1668;28965;14986;1;1297;539;3508;249;66;1708;811;183;897;93;87;3
424;7.70491e-15;154;1658;29094;15094;1;1294;525;3508;266;60;1772;839;206;933;92;87;3
425;7.7887e-15;115;1657;29233;15188;1;1290;484;3509;271;65;1780;826;206;954;92;85;3
426;7.86187e-15;131;1667;29344;15275;1;1301;539;3509;254;51;1773;831;203;942;91;86;3
427;7.9298e-15;136;1701;29457;15373;1;1304;535;3509;275;67;1869;834;208;1035;91;86;3
428;8.00655e-15;161;1598;29603;15463;1;1291;465;3510;303;61;1736;818;242;918;91;84;3
429;8.07725e-15;137;1656;29751;15567;1;1291;539;3510;233;66;1687;784;167;903;90;85;3
430;8.15921e-15;158;1671;29887;15663;1;1284;515;3511;322;85;1781;824;237;957;90;84;3
431;8.23511e-15;145;1663;30005;15752;1;1296;518;3511;262;75;1791;818;187;973;91;84;3
432;8.30569e-15;145;1668;30149;15836;1;1292;526;3511;252;55;1757;825;197;932;91;83;3
433;8.37248e-15;145;1629;30302;15931;1;1282;526;3512;262;84;1752;838;178;914;91;84;3
434;8.44824e-15;141;1587;30446;16026;1;1273;534;3512;269;69;1731;846;200;885;91;84;3
435;8.52423e-15;133;1648;30552;16125;1;1284;525;3513;265;75;1790;817;190;973;90;83;4
436;8.60366e-15;132;1624;30660;16215;1;1285;536;3513;246;61;1774;808;185;966;89;82;4
437;8.67608e-15;158;1730;30762;16296;1;1290;528;3513;289;69;1744;768;220;976;89;82;4
438;8.74143e-15;145;1624;30886;16372;1;1286;478;3514;260;70;1726;819;190;907;90;82;4
439;8.8029e-15;135;1634;31035;16448;1;1274;486;3514;229;74;1778;815;155;963;89;82;4
440;8.86451e-15;118;1686;31131;16544;1;1282;519;3514;251;49;1707;845;202;862;90;83;4
441;8.94254e-15;121;1687;31216;16620;1;1305;516;3515;266;55;1777;804;211;973;90;83;4
442;9.00447e-15;123;1660;31317;16698;1;1316;511;3515;247;61;1803;820;186;983;90;83;4
443;9.06819e-15;138;1608;31421;16789;1;1324;496;3516;265;74;1856;842;191;1014;90;83;4
444;9.14271e-15;147;1637;31513;16876;1;1339;524;3516;248;86;1789;831;162;958;89;83;4
445;9.21414e-15;129;1603;31615;16972;1;1357;529;3516;307;77;1764;775;230;989;89;82;4
446;9.29319e-15;160;1613;31741;17047;1;1356;461;3517;268;65;1722;778;203;944;89;82;4
447;9.3551e-15;130;1647;31882;17111;1;1349;518;3517;221;73;1824;799;148;1025;88;82;4
448;9.40804e-15;128;1658;32009;17190;1;1335;504;3517;221;84;1730;805;137;925;89;81;4
449;9.47352e-15;125;1645;32150;17282;1;1323;512;3518;271;62;1753;819;209;934;88;81;4
450;9.54997e-15;153;1665;32282;17384;1;1307;530;3518;244;64;1806;810;180;996;87;82;4
451;9.63497e-15;145;1682;32375;17465;1;1329;527;3519;278;69;1744;836;209;908;87;79;4
452;9.70265e-15;122;1649;32472;17552;1;1341;532;3519;270;89;1820;824;181;996;86;80;4
453;9.77552e-15;129;1644;32593;17637;1;1339;541;3519;262;73;1700;790;189;910;85;80;4
454;9.84689e-15;161;1674;32679;17725;1;1350;542;3520;288;79;1793;817;209;976;85;80;4
455;9.92096e-15;146;1617;32776;17797;1;1366;557;3520;288;85;1762;862;203;900;85;80;4
456;9.9817e-15;157;1615;32865;17879;1;1380;552;3520;237;80;1772;795;157;977;85;80;4
457;1.0051e-14;150;1550;32969;17944;1;1386;563;3521;261;73;1778;821;188;957;86;80;4
458;1.01061e-14;146;1624;33038;18018;1;1419;532;3521;255;76;1752;818;179;934;86;79;4
459;1.01689e-14;144;1611;33138;18104;1;1430;538;3521;273;84;1800;808;189;992;84;80;4
460;1.02421e-14;133;1613;33256;18197;1;1430;542;3522;233;69;1742;806;164;936;83;80;4
461;1.03214e-14;140;1638;33341;18270;1;1450;475;3522;282;88;1770;806;194;964;83;79;4
462;1.03838e-14;161;1577;33486;18355;1;1429;509;3523;240;70;1763;804;170;959;83;80;4
463;1.04566e-14;140;1647;33601;18430;1;1429;539;3523;266;75;1884;793;191;1091;83;80;4
464;1.0521e-14;156;1667;33682;18511;1;1447;547;3523;277;81;1766;821;196;945;82;80;4
465;1.05907e-14;148;1640;33820;18586;1;1443;539;3524;298;62;1769;807;236;962;82;80;4
466;1.06554e-14;144;1630;33918;18669;1;1453;531;3524;294;66;1790;814;228;976;82;80;4
467;1.07271e-14;148;1641;34058;18753;1;1432;534;3524;265;66;1735;845;199;890;81;79;4
468;1.07999e-14;179;1580;34139;18832;1;1449;548;3525;262;74;1805;845;188;960;81;78;4
469;1.08684e-14;179;1624;34202;18896;1;1480;531;3525;284;93;1840;755;191;1085;82;78;4
470;1.09241e-14;167;1647;34313;18972;1;1491;533;3525;253;92;1780;814;161;966;82;78;4
471;1.09903e-14;140;1616;34405;19052;1;1510;535;3526;264;83;1697;800;181;897;82;78;4
472;1.10602e-14;158;1612;34521;19132;1;1519;541;3526;267;72;1741;825;195;916;81;78;4
473;1.11301e-14;151;1606;34624;19211;1;1521;530;3526;260;65;1805;798;195;1007;81;78;4
474;1.11994e-14;150;1593;34707;19282;1;1536;487;3527;261;86;1718;868;175;850;82;77;4
475;1.12618e-14;159;1643;34829;19385;1;1532;494;3527;239;61;1831;856;178;975;81;78;4
476;1.13525e-14;132;1683;34914;19478;1;1551;537;3527;276;81;1798;788;195;1010;81;78;4
477;1.14346e-14;150;1666;35005;19539;1;1557;460;3528;257;73;1717;847;184;870;81;77;4
478;1.14885e-14;111;1634;35150;19605;1;1537;471;3528;228;68;1764;831;160;933;81;77;4
479;1.1547e-14;118;1652;35249;19686;1;1539;524;3528;211;58;1795;795;153;1000;81;77;4
480;1.16189e-14;133;1611;35375;19759;1;1526;526;3529;242;60;1787;815;182;972;81;77;4
481;1.16838e-14;146;1675;35487;19843;1;1522;504;3529;272;78;1831;791;194;1040;81;77;4
482;1.17587e-14;134;1696;35613;19931;1;1511;498;3529;247;70;1793;804;177;989;80;77;4
483;1.18372e-14;147;1691;35736;19999;1;1495;502;3530;234;73;1855;832;161;1023;80;76;4
484;1.18981e-14;145;1634;35830;20081;1;1502;501;3530;269;66;1792;854;203;938;80;77;5
485;4.21407e-15;122;1141;12936;10129.5;1;1404;462;3530;245;46;1816;505;199;1311;79;76;5
486;4.27051e-15;119;1388;13283;10201.5;1;1273;496;3531;231;72;1747;629;159;1118;79;75;5
487;4.31635e-15;133;1445;13557;10272.5;1;1185;441;3531;272;64;1763;767;208;996;79;75;5
488;4.36172e-15;114;1508;13826;10366.5;1;1096;488;3531;192;66;1789;708;126;1081;80;75;5
489;4.42203e-15;127;1547;14117;10431.5;1;994;436;3532;240;69;1773;777;171;996;79;74;5
490;4.46389e-15;112;1522;14389;10504.5;1;900;481;3532;262;66;1779;778;196;1001;79;74;5
491;4.51106e-15;137;1594;14562;10581.5;1;859;481;3532;223;58;1734;799;165;935;79;74;5
492;4.561e-15;104;1641;14781;10669.5;1;804;470;3533;234;70;1718;843;164;875;78;74;5
493;4.6183e-15;142;1592;14978;10754.5;1;759;463;3533;235;63;1743;775;172;968;78;73;5
494;4.67387e-15;156;1576;15111;10835.5;1;741;407;3533;236;71;1773;807;165;966;78;73;5
495;4.72703e-15;119;1633;15253;10913.5;1;722;468;3534;240;55;1785;778;185;1007;78;73;5
496;4.77841e-15;154;1628;15426;10987.5;1;681;406;3534;221;57;1798;799;164;999;78;73;5
497;4.82733e-15;137;1647;15539;11065.5;1;677;442;3534;195;60;1770;821;135;949;78;72;5
498;4.87907e-15;132;1613;15682;11137.5;1;659;463;3535;187;60;1770;795;127;975;77;72;5
499;4.927e-15;137;1657;15806;11222.5;1;648;469;3535;246;63;1793;812;183;981;77;72;5
500;4.98378e-15;123;1702;15910;11298.5;1;654;462;3535;228;62;1803;807;166;996;77;72;5
501;5.03474e-15;121;1691;16025;11382.5;1;641;465;3536;247;57;1790;840;190;950;76;73;5
502;5.09126e-15;124;1630;16149;11458.5;1;629;419;3536;245;59;1854;801;186;1053;76;72;5
503;5.14258e-15;123;1665;16249;11530.5;1;627;427;3536;215;64;1783;832;151;951;75;72;5
504;5.19135e-15;125;1686;16355;11604.5;1;614;476;3537;225;49;1773;834;176;939;75;72;5
505;5.24165e-15;149;1652;16432;11682.5;1;625;413;3537;221;54;1756;825;167;931;75;72;5
506;5.29483e-15;108;1690;16549;11771.5;1;618;484;3537;183;69;1851;821;114;1030;74;73;5
507;5.35574e-15;133;1696;16658;11845.5;1;603;437;3537;222;64;1773;824;158;949;75;71;5
508;5.40655e-15;132;1593;16762;11904.5;1;600;482;3538;203;62;1845;863;141;982;75;72;5
509;5.44719e-15;137;1684;16857;11976.5;1;595;447;3538;292;72;1767;790;220;977;74;71;5
510;5.49691e-15;142;1667;16934;12046.5;1;602;387;3538;218;56;1846;865;162;981;74;71;5
511;5.54539e-15;119;1687;17011;12126.5;1;610;446;3539;215;58;1822;785;157;1037;73;71;5
512;5.60098e-15;130;1677;17101;12215.5;1;616;434;3539;212;72;1752;859;140;893;72;71;5
513;5.66304e-15;135;1663;17192;12291.5;1;617;452;3539;218;83;1827;829;135;998;72;71;5
514;5.71621e-15;120;1703;17273;12379.5;1;631;411;3540;232;71;1856;810;161;1046;72;70;5
515;5.77799e-15;116;1672;17394;12446.5;1;609;390;3540;204;52;1784;860;152;924;72;71;5
516;5.82518e-15;121;1701;17499;12510.5;1;597;385;3540;192;55;1752;808;137;944;72;70;5
517;5.87037e-15;136;1706;17568;12573.5;1;613;394;3541;197;57;1794;856;140;938;73;71;5
518;5.91497e-15;112;1660;17669;12642.5;1;607;379;3541;191;68;1792;875;123;917;72;70;5
519;5.96394e-15;84;1697;17750;12703.5;1;611;391;3541;168;54;1755;909;114;846;71;70;5
520;6.00735e-15;120;1653;17828;12787.5;1;611;382;3541;178;55;1701;895;123;806;72;70;5
521;6.06731e-15;114;1683;17905;12887.5;1;614;384;3542;180;59;1730;840;121;890;71;69;5
522;6.13893e-15;116;1713;17985;12958.5;1;613;387;3542;196;60;1754;858;136;896;71;70;5
523;6.18996e-15;116;1734;18101;13033.5;1;602;393;3542;207;60;1782;846;147;936;70;69;5
524;6.24402e-15;148;1699;18205;13105.5;1;593;382;3543;181;53;1736;825;128;911;70;69;5
525;6.29606e-15;108;1640;18308;13186.5;1;585;398;3543;194;61;1806;839;133;967;70;69;5
526;6.35478e-15;125;1724;18382;13273.5;1;593;387;3543;183;62;1842;850;121;992;70;69;5
527;6.41805e-15;107;1701;18457;13361.5;1;603;393;3544;203;49;1756;808;154;948;69;68;5
528;6.48226e-15;124;1764;18539;13429.5;1;600;386;3544;217;51;1817;840;166;977;70;68;5
529;6.53203e-15;117;1741;18621;13495.5;1;603;377;3544;201;54;1713;899;147;814;70;67;5
530;6.58045e-15;105;1733;18667;13558.5;1;628;371;3544;189;51;1826;831;138;995;70;68;5
531;6.62678e-15;103;1723;18767;13631.5;1;612;366;3545;189;62;1758;814;127;944;70;68;5
532;6.68061e-15;125;1782;18831;13692.5;1;614;377;3545;186;56;1787;880;130;907;70;68;5
533;6.72569e-15;130;1785;18920;13768.5;1;601;296;3545;212;66;1850;893;146;957;69;68;5
534;6.78201e-15;87;1798;18970;13844.5;1;619;343;3546;135;49;1748;893;86;855;69;69;5
535;6.83848e-15;88;1746;19056;13919.5;1;613;335;3546;181;44;1786;873;137;913;69;69;5
536;6.89437e-15;97;1721;19160;13969.5;1;588;346;3546;159;37;1773;875;122;898;69;68;5
537;6.93171e-15;110;1653;19267;14024.5;1;566;348;3546;156;50;1764;883;106;881;68;68;5
538;6.97286e-15;101;1663;19344;14098.5;1;565;341;3547;193;51;1705;874;142;831;68;68;5
539;7.02836e-15;119;1722;19395;14176.5;1;570;341;3547;164;45;1773;800;119;973;68;67;6
540;7.08701e-15;116;1718;19445;14244.5;1;590;346;3547;182;45;1736;804;137;932;68;68;6
541;7.13828e-15;121;1740;19534;14325.5;1;579;345;3548;175;58;1756;857;117;899;68;66;6
542;7.19951e-15;95;1689;19607;14409.5;1;566;344;3548;178;73;1728;890;105;838;68;67;6
543;7.2632e-15;116;1713;19668;14465.5;1;568;302;3548;167;48;1743;827;119;916;68;67;6
544;7.30576e-15;97;1702;19747;14528.5;1;566;296;3548;141;60;1770;827;81;943;67;67;6
545;7.35374e-15;108;1710;19805;14597.5;1;570;262;3549;144;46;1759;837;98;922;68;67;6
546;7.40641e-15;71;1743;19872;14672.5;1;572;316;3549;132;48;1756;904;84;852;68;67;6
547;7.4638e-15;80;1654;19946;14723.5;1;564;327;3549;142;44;1770;869;98;901;68;66;6
548;7.50291e-15;89;1660;20013;14795.5;1;562;317;3550;174;45;1698;849;129;849;67;66;6
549;7.55824e-15;99;1695;20079;14855.5;1;564;276;3550;179;48;1854;841;131;1013;67;66;6
550;7.60446e-15;98;1714;20137;14918.5;1;563;302;3550;149;45;1765;836;104;929;67;66;6
551;7.65308e-15;77;1676;20195;14991.5;1;564;291;3550;155;39;1762;839;116;923;67;66;6
552;7.70956e-15;88;1770;20257;15054.5;1;559;334;3551;153;43;1731;850;110;881;67;66;6
553;7.75841e-15;93;1711;20355;15123.5;1;538;336;3551;165;56;1816;875;109;941;66;65;6
554;7.81203e-15;112;1644;20453;15198.5;1;519;322;3551;159;64;1710;913;95;797;66;65;6
555;7.87045e-15;104;1696;20492;15269.5;1;533;290;3551;120;48;1750;833;72;917;66;65;6
556;7.92589e-15;99;1715;20514;15337.5;1;554;281;3552;147;50;1746;826;97;920;66;65;6
557;7.97911e-15;82;1721;20555;15406.5;1;567;319;3552;143;48;1821;880;95;941;66;65;6
558;8.03324e-15;93;1781;20616;15469.5;1;569;316;3552;160;46;1810;828;114;982;66;65;6
559;8.08276e-15;115;1740;20692;15528.5;1;558;272;3553;159;53;1781;863;106;918;66;64;6
560;8.12923e-15;89;1666;20761;15596.5;1;555;274;3553;149;57;1728;817;92;911;65;64;6
561;8.18291e-15;87;1661;20840;15655.5;1;538;293;3553;123;44;1824;849;79;975;65;64;6
562;8.22957e-15;95;1653;20890;15719.5;1;537;334;3553;154;51;1688;844;103;844;65;64;6
563;8.28029e-15;96;1644;20937;15786.5;1;547;278;3554;183;38;1679;852;145;827;64;63;6
564;8.3335e-15;72;1735;21008;15840.5;1;534;1.07374e+08;-2.14748e+09;154;59;1748;813;95;935;64;63;6
565;8.37647e-15;72;1733;21008;15840.5;1;534;1.032e+08;-2.06399e+09;1;0;-1;0;1;-1;64;63;6
566;8.37647e-15;72;1733;21008;15840.5;1;534;3.09788e+08;-1.98428e+09;0;0;-1;0;0;-1;64;63;6
567;8.37647e-15;72;1731;21008;15840.5;1;534;2.97823e+08;-1.90817e+09;0;0;-1;0;0;-1;239;238;6
568;8.37647e-15;72;1731;21008;15840.5;1;534;4.96971e+08;-1.83548e+09;0;0;-1;0;0;-1;913;913;6
569;8.37647e-15;72;1728;21008;15840.5;1;534;5.85273e+08;-1.76604e+09;3;0;-1;0;3;-1;2534;2533;6
570;8.37647e-15;72;1728;21008;15840.5;1;534;5.62884e+08;-1.69969e+09;0;0;-1;0;0;-1;5648;5647;6
571;8.37647e-15;72;1726;21008;15840.5;1;534;6.44698e+08;-1.63627e+09;0;0;-1;0;0;-1;10888;10887;6
572;8.37647e-15;72;1725;21008;15840.5;1;534;7.2348e+08;-1.57565e+09;4;0;-1;0;4;-1;18951;18950;6
573;8.37647e-15;72;1724;21008;15840.5;1;534;9.06739e+08;-1.51768e+09;0;0;-1;0;0;-1;30582;30581;6
574;8.37647e-15;72;1724;21008;15840.5;1;534;8.72477e+08;-1.46224e+09;1;0;-1;0;1;-1;46565;46564;6
575;8.37647e-15;72;1724;21008;15840.5;1;534;1.05031e+09;-1.40921e+09;0;0;-1;0;0;-1;67707;67706;6
576;8.37647e-15;75;1719;21008;15840.5;1;534;1.11824e+09;-1.35846e+09;1;0;-1;0;1;-1;94830;94828;6
577;8.37647e-15;79;1714;21008;15840.5;1;534;1.07636e+09;-1.30989e+09;3;0;-1;0;3;-1;128760;128758;6
578;8.37647e-15;80;1712;21008;15840.5;1;534;1.2469e+09;-1.2634e+09;1;0;-1;0;1;-1;170321;170319;6
579;8.37647e-15;80;1711;21008;15840.5;1;534;1.20047e+09;-1.21888e+09;1;0;-1;0;1;-1;220327;220326;6
580;8.37647e-15;81;1710;21008;15840.5;1;534;1.25928e+09;-1.17625e+09;1;0;-1;0;1;-1;279577;279575;6
581;8.37647e-15;82;1706;21008;15840.5;1;534;1.31605e+09;-1.13541e+09;1;0;-1;0;1;-1;348848;348846;6
582;8.37647e-15;87;1702;21008;15840.5;1;534;1.37087e+09;-1.09627e+09;6;0;-1;0;6;-1;428893;428891;6
583;8.37647e-15;87;1701;21008;15840.5;1;534;1.53118e+09;-1.05877e+09;0;0;-1;0;0;-1;520437;520436;6
584;8.37647e-15;88;1700;21008;15840.5;1;534;1.47495e+09;-1.02281e+09;2;0;-1;0;2;-1;624174;624173;6
585;8.37647e-15;89;1699;21008;15840.5;1;534;1.52436e+09;-9.88342e+08;4;0;-1;0;4;-1;740763;740762;6
586;8.37647e-15;91;1696;21008;15840.5;1;534;1.6795e+09;-9.5528e+08;0;0;-1;0;0;-1;870830;870828;6
587;8.37647e-15;94;1696;21008;15840.5;1;534;1.61831e+09;-9.23566e+08;3;0;-1;0;3;-1;1014962;1014960;6
588;8.37647e-15;94;1695;21008;15840.5;1;534;1.66296e+09;-8.93136e+08;1;0;-1;0;1;-1;1173709;1173707;6
589;8.37647e-15;95;1695;21008;15840.5;1;534;1.70616e+09;-8.63933e+08;1;0;-1;0;1;-1;1347583;1347581;6
590;8.37647e-15;95;1695;21008;15840.5;1;534;1.74796e+09;-8.359e+08;0;0;-1;0;0;-1;1537058;1537056;6
591;8.37647e-15;98;1695;21008;15840.5;1;534;1.89578e+09;-8.08984e+08;0;0;-1;0;0;-1;1742568;1742566;6
592;8.37647e-15;99;1692;21008;15840.5;1;534;1.82756e+09;-7.83135e+08;4;0;-1;0;4;-1;1964509;1964508;6
593;8.37647e-15;99;1691;21008;15840.5;1;534;1.97285e+09;-7.58305e+08;3;0;-1;0;3;-1;2203240;2203238;6
594;8.37647e-15;102;1691;21008;15840.5;1;534;1.9022e+09;-7.34449e+08;2;0;-1;0;2;-1;2459079;2459077;6
595;8.37647e-15;102;1691;21008;15840.5;1;534;1.93778e+09;-7.11523e+08;1;0;-1;0;1;-1;2732311;2732309;6
596;8.37647e-15;104;1691;21008;15840.5;1;534;2.07963e+09;-6.89486e+08;3;0;-1;0;3;-1;3023183;3023181;7
597;8.37647e-15;120;1687;21008;15840.5;1;534;2.00567e+09;-6.68298e+08;12;0;-1;0;12;-1;3331907;3331905;7
598;8.37647e-15;120;1686;21008;15840.5;1;534;2.14544e+09;-6.47923e+08;1;0;-1;0;1;-1;3658661;3658659;7
599;8.37647e-15;120;1686;21008;15840.5;1;534;2.06948e+09;-6.28325e+08;0;0;-1;0;0;-1;4003589;4003587;7
600;8.37647e-15;123;1685;21008;15840.5;1;534;-2.14748e+09;-6.0947e+08;0;0;-1;0;0;-1;4366806;4366804;7
601;8.37647e-15;123;1685;21008;15840.5;1;534;-2.14748e+09;-5.91326e+08;0;0;-1;0;0;-1;4748392;4748390;7
602;8.37647e-15;122;1685;21008;15840.5;1;534;-2.14748e+09;-5.73862e+08;-1;0;0;0;-1;0;5148402;5148400;7
603;8.37647e-15;120;1684;21008;15840.5;1;534;-2.14748e+09;-5.57049e+08;0;0;-1;0;0;-1;5566860;5566858;8
604;8.37647e-15;119;1684;21008;15840.5;1;534;-2.14748e+09;-5.40859e+08;0;0;-1;0;0;-1;6003764;6003762;8
605;8.37647e-15;119;1684;21008;15840.5;1;534;-2.14748e+09;-5.25265e+08;-1;0;0;0;-1;0;6459086;6459085;8
606;8.37647e-15;117;1684;21008;15840.5;1;534;-2.14748e+09;-5.10244e+08;-1;0;0;0;-1;0;6932775;6932773;9
607;8.37647e-15;116;1684;21008;15840.5;1;534;-2.14748e+09;-4.95769e+08;0;0;-1;0;0;-1;7424755;7424753;9
608;8.37647e-15;116;1683;21008;15840.5;1;534;-2.14748e+09;-4.81819e+08;-1;0;0;0;-1;0;7934928;7934927;10
609;8.37647e-15;114;1683;21008;15840.5;1;534;-2.14748e+09;-4.68371e+08;-1;0;0;0;-1;0;8463179;8463177;11
610;8.37647e-15;113;1683;21008;15840.5;1;534;-2.14748e+09;-4.55404e+08;-1;0;0;0;-1;0;9009369;9009367;12
611;8.37647e-15;113;1683;21008;15840.5;1;534;-2.14748e+09;-4.429e+08;-1;0;0;0;-1;0;9573344;9573342;13
612;8.37647e-15;112;1682;21008;15840.5;1;534;-2.14748e+09;-4.30837e+08;-1;0;0;0;-1;0;10154931;10154930;14
613;8.37647e-15;112;1682;21008;15840.5;1;534;-2.14748e+09;-4.192e+08;-1;0;0;0;-1;0;10753944;10753942;16
614;8.37647e-15;112;1682;21008;15840.5;1;534;-2.14748e+09;-4.07969e+08;-1;0;0;0;-1;0;11370178;11370177;18
615;8.37647e-15;110;1682;21008;15840.5;1;534;-2.14748e+09;-3.97129e+08;-1;0;0;0;-1;0;12003419;12003418;20
616;8.37647e-15;110;1682;21008;15840.5;1;534;-2.14748e+09;-3.86664e+08;-1;0;0;0;-1;0;12653436;12653435;23
617;8.37647e-15;110;1682;21008;15840.5;1;534;-2.14748e+09;-3.76558e+08;-1;0;0;0;-1;0;13319990;13319989;26
618;8.37647e-15;109;1682;21008;15840.5;1;534;-2.14748e+09;-3.66798e+08;-1;0;0;0;-1;0;14002829;14002828;29
619;8.37647e-15;108;1682;21008;15840.5;1;534;-2.14748e+09;-3.57369e+08;-1;0;0;0;-1;0;14701692;14701692;33
620;8.37647e-15;108;1682;21008;15840.5;1;534;-2.14748e+09;-3.48258e+08;-1;0;0;0;-1;0;15416310;15416309;38
621;8.37647e-15;107;1682;21008;15840.5;1;534;-2.14748e+09;-3.39454e+08;-1;0;0;0;-1;0;16146404;16146404;43
622;8.37647e-15;105;1682;21008;15840.5;1;534;-2.14748e+09;-3.30943e+08;-1;0;0;0;-1;0;16891690;16891690;49
623;8.37647e-15;105;1682;21008;15840.5;1;534;-2.14748e+09;-3.22714e+08;-1;0;0;0;-1;0;17651876;17651876;56
624;8.37647e-15;105;1682;21008;15840.5;1;534;-2.14748e+09;-3.14757e+08;-1;0;0;0;-1;0;18426665;18426666;64
625;8.37647e-15;104;1682;21008;15840.5;1;534;-2.14748e+09;-3.07061e+08;-1;0;0;0;-1;0;19215756;19215757;72
626;8.37647e-15;102;1682;21008;15840.5;1;534;-2.14748e+09;-2.99615e+08;0;0;-1;0;0;-1;20018843;20018844;82
627;8.37647e-15;100;1682;21008;15840.5;1;534;-2.14748e+09;-2.92411e+08;-1;0;0;0;-1;0;20835615;20835617;93
628;8.37647e-15;93;1680;21008;15840.5;1;534;-2.14748e+09;-2.85438e+08;-1;0;0;0;-1;0;21665760;21665763;106
629;8.37647e-15;93;1680;21008;15840.5;1;534;-2.14748e+09;-2.78689e+08;-1;0;0;0;-1;0;22508964;22508967;120
630;8.37647e-15;93;1680;21008;15840.5;1;534;-2.14748e+09;-2.72154e+08;-1;0;0;0;-1;0;23364909;23364913;136
631;8.37647e-15;92;1680;21008;15840.5;1;534;-2.14748e+09;-2.65826e+08;-1;0;0;0;-1;0;24233278;24233283;153
632;8.37647e-15;91;1680;21008;15840.5;1;534;-2.14748e+09;-2.59696e+08;0;0;-1;0;0;-1;25113751;25113756;172
633;8.37647e-15;91;1680;21008;15840.5;1;534;-2.14748e+09;-2.53759e+08;-1;0;0;0;-1;0;26006008;26006015;194
634;8.37647e-15;91;1680;21008;15840.5;1;534;-2.14748e+09;-2.48005e+08;-1;0;0;0;-1;0;26909732;26909740;218
635;8.37647e-15;89;1680;21008;15840.5;1;534;-2.14748e+09;-2.42429e+08;-1;0;0;0;-1;0;27824602;27824611;244
636;8.37647e-15;89;1680;21008;15840.5;1;534;-2.14748e+09;-2.37024e+08;-1;0;0;0;-1;0;28750301;28750312;273
637;8.37647e-15;89;1680;21008;15840.5;1;534;-2.14748e+09;-2.31784e+08;-1;0;0;0;-1;0;29686513;29686525;305
638;8.37647e-15;84;1680;21008;15840.5;1;534;-2.14748e+09;-2.26703e+08;-1;0;0;0;-1;0;30632922;30632935;340
639;8.37647e-15;84;1680;21008;15840.5;1;534;-2.14748e+09;-2.21775e+08;0;0;-1;0;0;-1;31589215;31589230;379
640;8.37647e-15;84;1680;21008;15840.5;1;534;-2.14748e+09;-2.16994e+08;-1;0;0;0;-1;0;32555080;32555098;421
641;8.37647e-15;84;1680;21008;15840.5;1;534;-2.14748e+09;-2.12356e+08;-1;0;0;0;-1;0;33530210;33530230;467
642;8.37647e-15;84;1680;21008;15840.5;1;534;-2.14748e+09;-2.07855e+08;-1;0;0;0;-1;0;34514298;34514320;517
643;8.37647e-15;84;1680;21008;15840.5;1;534;-2.14748e+09;-2.03486e+08;-1;0;0;0;-1;0;35507041;35507065;572
644;8.37647e-15;84;1680;21008;15840.5;1;534;-2.14748e+09;-1.99245e+08;-1;0;0;0;-1;0;36508138;36508166;632
645;8.37647e-15;84;1680;21008;15840.5;1;534;-2.14748e+09;-1.95127e+08;-1;0;0;0;-1;0;37517293;37517324;697
646;8.37647e-15;84;1680;21008;15840.5;1;534;-2.14748e+09;-1.91128e+08;-1;0;0;0;-1;0;38534214;38534248;767
647;8.37647e-15;83;1680;21008;15840.5;1;534;-2.14748e+09;-1.87243e+08;-1;0;0;0;-1;0;39558609;39558647;843
648;8.37647e-15;83;1680;21008;15840.5;1;534;-2.14748e+09;-1.83469e+08;-1;0;0;0;-1;0;40590194;40590236;926
649;8.37647e-15;82;1680;21008;15840.5;1;534;-2.14748e+09;-1.79803e+08;-1;0;0;0;-1;0;41628686;41628732;1015
650;8.37647e-15;82;1680;21008;15840.5;1;534;-2.14748e+09;-1.76239e+08;-1;0;0;0;-1;0;42673808;42673858;1111
651;8.37647e-15;82;1680;21008;15840.5;1;534;-2.14748e+09;-1.72776e+08;-1;0;0;0;-1;0;43725285;43725340;1214
652;8.37647e-15;79;1679;21008;15840.5;1;534;-2.14748e+09;-1.69408e+08;-1;0;0;0;-1;0;44782848;44782909;1326
653;8.37647e-15;76;1678;21008;15840.5;1;534;-2.14748e+09;-1.66134e+08;-1;0;0;0;-1;0;45846232;45846298;1445
654;8.37647e-15;75;1678;21008;15840.5;1;534;-2.14748e+09;-1.6295e+08;-1;0;0;0;-1;0;46915175;46915248;1574
655;8.37647e-15;73;1678;21008;15840.5;1;534;-2.14748e+09;-1.59852e+08;-1;0;0;0;-1;0;47989423;47989502;1712
656;8.37647e-15;73;1678;21008;15840.5;1;534;-2.14748e+09;-1.56839e+08;0;0;-1;0;0;-1;49068721;49068807;1860
657;8.37647e-15;72;1678;21008;15840.5;1;534;-2.14748e+09;-1.53907e+08;-1;0;0;0;-1;0;50152824;50152917;2018
658;8.37647e-15;72;1678;21008;15840.5;1;534;-2.14748e+09;-1.51054e+08;-1;0;0;0;-1;0;51241487;51241589;2186
659;8.37647e-15;72;1678;21008;15840.5;1;534;-2.14748e+09;-1.48277e+08;-1;0;0;0;-1;0;52334473;52334584;2367
660;8.37647e-15;69;1678;21008;15840.5;1;534;-2.14748e+09;-1.45573e+08;-1;0;0;0;-1;0;53431548;53431668;2559
661;8.37647e-15;69;1678;21008;15840.5;1;534;-2.14748e+09;-1.42941e+08;-1;0;0;0;-1;0;54532483;54532613;2764
662;8.37647e-15;67;1678;21008;15840.5;1;534;-2.14748e+09;-1.40378e+08;-1;0;0;0;-1;0;55637054;55637194;2982
663;8.37647e-15;67;1678;21008;15840.5;1;534;-2.14748e+09;-1.37881e+08;-1;0;0;0;-1;0;56745040;56745192;3214
664;8.37647e-15;67;1678;21008;15840.5;1;534;-2.14748e+09;-1.35448e+08;-1;0;0;0;-1;0;57856226;57856390;3461
665;8.37647e-15;67;1678;21008;15840.5;1;534;-2.14748e+09;-1.33079e+08;-1;0;0;0;-1;0;58970402;58970579;3722
666;8.37647e-15;67;1678;21008;15840.5;1;534;-2.14748e+09;-1.30769e+08;-1;0;0;0;-1;0;60087362;60087552;4000
667;8.37647e-15;67;1678;21008;15840.5;1;534;-2.14748e+09;-1.28518e+08;-1;0;0;0;-1;0;61206903;61207107;4294
668;8.37647e-15;65;1678;21008;15840.5;1;534;-2.14748e+09;-1.26325e+08;-1;0;0;0;-1;0;62328829;62329048;4605
669;8.37647e-15;62;1678;21008;15840.5;1;534;-2.14748e+09;-1.24186e+08;-1;0;0;0;-1;0;63452947;63453183;4935
670;8.37647e-15;62;1678;21008;15840.5;1;534;-2.14748e+09;-1.221e+08;0;0;-1;0;0;-1;64579069;64579322;5283
671;8.37647e-15;62;1678;21008;15840.5;1;534;-2.14748e+09;-1.20066e+08;-1;0;0;0;-1;0;65707012;65707284;5651
672;8.37647e-15;62;1678;21008;15840.5;1;534;-2.14748e+09;-1.18082e+08;-1;0;0;0;-1;0;66836596;66836887;6039
673;8.37647e-15;61;1678;21008;15840.5;1;534;-2.14748e+09;-1.16147e+08;-1;0;0;0;-1;0;67967647;67967958;6448
674;8.37647e-15;60;1678;21008;15840.5;1;534;-2.14748e+09;-1.14258e+08;-1;0;0;0;-1;0;69099992;69100325;6879
675;8.37647e-15;59;1678;21008;15840.5;1;534;-2.14748e+09;-1.12415e+08;-1;0;0;0;-1;0;70233467;70233822;7333
676;8.37647e-15;58;1678;21008;15840.5;1;534;-2.14748e+09;-1.10617e+08;-1;0;0;0;-1;0;71367907;71368288;7811
677;8.37647e-15;58;1677;21008;15840.5;1;534;-2.14748e+09;-1.08861e+08;-1;0;0;0;-1;0;72503157;72503563;8313
678;8.37647e-15;53;1677;21008;15840.5;1;534;-2.14748e+09;-1.07148e+08;-1;0;0;0;-1;0;73639061;73639493;8841
679;8.37647e-15;49;1677;21008;15840.5;1;534;-2.14748e+09;-1.05474e+08;-1;0;0;0;-1;0;74775469;74775930;9395
680;8.37647e-15;49;1677;21008;15840.5;1;534;-2.14748e+09;-1.0384e+08;-1;0;0;0;-1;0;75912236;75912726;9976
681;8.37647e-15;48;1677;21008;15840.5;1;534;-2.14748e+09;-1.02244e+08;-1;0;0;0;-1;0;77049218;77049740;10585
682;8.37647e-15;45;1677;21008;15840.5;1;534;-2.14748e+09;-1.00684e+08;-1;0;0;0;-1;0;78186278;78186832;11224
683;8.37647e-15;45;1676;21008;15840.5;1;534;-2.14748e+09;-9.9161e+07;-1;0;0;0;-1;0;79323281;79323869;11893
684;8.37647e-15;43;1676;21008;15840.5;1;534;-2.14748e+09;-9.76725e+07;-1;0;0;0;-1;0;80460095;80460720;12593
685;8.37647e-15;42;1676;21008;15840.5;1;534;-2.14748e+09;-9.62178e+07;-1;0;0;0;-1;0;81596595;81597258;13325
686;8.37647e-15;40;1676;21008;15840.5;1;534;-2.14748e+09;-9.4796e+07;-1;0;0;0;-1;0;82732656;82733358;14091
687;8.37647e-15;39;1676;21008;15840.5;1;534;-2.14748e+09;-9.34062e+07;-1;0;0;0;-1;0;83868157;83868901;14890
688;8.37647e-15;38;1676;21008;15840.5;1;534;-2.14748e+09;-9.20473e+07;-1;0;0;0;-1;0;85002983;85003771;15725
689;8.37647e-15;38;1676;21008;15840.5;1;534;-2.14748e+09;-9.07186e+07;-1;0;0;0;-1;0;86137020;86137853;16596
690;8.37647e-15;35;1675;21008;15840.5;1;534;-2.14748e+09;-8.94192e+07;-1;0;0;0;-1;0;87270158;87271039;17505
691;8.37647e-15;34;1675;21008;15840.5;1;534;-2.14748e+09;-8.81483e+07;-1;0;0;0;-1;0;88402290;88403222;18452
692;8.37647e-15;28;1675;21008;15840.5;1;534;-2.14748e+09;-8.69051e+07;-1;0;0;0;-1;0;89533314;89534297;19438
693;8.37647e-15;25;1675;21008;15840.5;1;534;-2.14748e+09;-8.56888e+07;-1;0;0;0;-1;0;90663128;90664166;20466
694;8.37647e-15;21;1675;21008;15840.5;1;534;-2.14748e+09;-8.44987e+07;-1;0;0;0;-1;0;91791635;91792731;21535
695;8.37647e-15;21;1675;21008;15840.5;1;534;-2.14748e+09;-8.33341e+07;-1;0;0;0;-1;0;92918742;92919898;22647
696;8.37647e-15;21;1675;21008;15840.5;1;534;-2.14748e+09;-8.21942e+07;-1;0;0;0;-1;0;94044357;94045575;23804
697;8.37647e-15;21;1675;21008;15840.5;1;534;-2.14748e+09;-8.10785e+07;-1;0;0;0;-1;0;95168392;95169675;25005
698;8.37647e-15;21;1675;21008;15840.5;1;534;-2.14748e+09;-7.99862e+07;-1;0;0;0;-1;0;96290761;96292112;26253
699;8.37647e-15;21;1675;21008;15840.5;1;534;-2.14748e+09;-7.89167e+07;-1;0;0;0;-1;0;97411382;97412803;27549
700;8.37647e-15;18;1675;21008;15840.5;1;534;-2.14748e+09;-7.78694e+07;0;0;-1;0;0;-1;98530174;98531668;28894
701;8.37647e-15;18;1675;21008;15840.5;1;534;-2.14748e+09;-7.68437e+07;0;0;-1;0;0;-1;99647061;99648631;30288
702;8.37647e-15;17;1675;21008;15840.5;1;534;-2.14748e+09;-7.58391e+07;-1;0;0;0;-1;0;100761967;100763617;31734
703;8.37647e-15;14;1674;21008;15840.5;1;534;-2.14748e+09;-7.4855e+07;-1;0;0;0;-1;0;101874821;101876553;33233
704;8.37647e-15;12;1674;21008;15840.5;1;534;-2.14748e+09;-7.38908e+07;-1;0;0;0;-1;0;102985552;102987370;34785
705;8.37647e-15;12;1674;21008;15840.5;1;534;-2.14748e+09;-7.2946e+07;-1;0;0;0;-1;0;104094094;104096000;36392
706;8.37647e-15;9;1674;21008;15840.5;1;534;-2.14748e+09;-7.20202e+07;-1;0;0;0;-1;0;105200381;105202380;38055
707;8.37647e-15;9;1674;21008;15840.5;1;534;-2.14748e+09;-7.11128e+07;-1;0;0;0;-1;0;106304350;106306446;39776
708;8.37647e-15;9;1674;21008;15840.5;1;534;-2.14748e+09;-7.02234e+07;-1;0;0;0;-1;0;107405942;107408137;41555
709;8.37647e-15;8;1674;21008;15840.5;1;534;-2.14748e+09;-6.93515e+07;-1;0;0;0;-1;0;108505098;108507397;43394
710;8.37647e-15;8;1674;21008;15840.5;1;534;-2.14748e+09;-6.84966e+07;-1;0;0;0;-1;0;109601763;109604169;45295
711;8.37647e-15;8;1674;21008;15840.5;1;534;-2.14748e+09;-6.76584e+07;0;0;-1;0;0;-1;110695882;110698399;47258
712;8.37647e-15;6;1674;21008;15840.5;1;534;-2.14748e+09;-6.68363e+07;-1;0;0;0;-1;0;111787404;111790036;49285
713;8.37647e-15;6;1674;21008;15840.5;1;534;-2.14748e+09;-6.60301e+07;0;0;-1;0;0;-1;112876279;112879029;51377
714;8.37647e-15;3;1674;21008;15840.5;1;534;-2.14748e+09;-6.52393e+07;-1;0;0;0;-1;0;113962459;113965331;53535
715;8.37647e-15;3;1674;21008;15840.5;1;534;-2.14748e+09;-6.44635e+07;-1;0;0;0;-1;0;115045897;115048897;55762
716;8.37647e-15;3;1674;21008;15840.5;1;534;-2.14748e+09;-6.37023e+07;-1;0;0;0;-1;0;116126550;116129683;58057
717;8.37647e-15;3;1674;21008;15840.5;1;534;-2.14748e+09;-6.29555e+07;-1;0;0;0;-1;0;117204375;117207645;60422
718;8.37647e-15;2;1674;21008;15840.5;1;534;-2.14748e+09;-6.22226e+07;-1;0;0;0;-1;0;118279333;118282744;62859
719;8.37647e-15;2;1674;21008;15840.5;1;534;-2.14748e+09;-6.15032e+07;-1;0;0;0;-1;0;119351383;119354940;65369
720;8.37647e-15;-1;1674;21008;15840.5;1;534;-2.14748e+09;-6.07972e+07;0;0;0;0;0;0;120420489;120424197;67953
721;8.37647e-15;-2;1674;21008;15840.5;1;534;-2.14748e+09;-6.01041e+07;0;0;0;0;0;0;121486616;121490479;70612
722;8.37647e-15;-2;1674;21008;15840.5;1;534;-2.14748e+09;-5.94236e+07;-1;0;0;0;-1;0;122549729;122553753;73348
723;8.37647e-15;-2;1674;21008;15840.5;1;534;-2.14748e+09;-5.87555e+07;-1;0;0;0;-1;0;123609795;123613985;76163
724;8.37647e-15;-3;1674;21008;15840.5;1;534;-2.14748e+09;-5.80994e+07;0;0;0;0;0;0;124666785;124671146;79057
725;8.37647e-15;-3;1673;21008;15840.5;1;534;-2.14748e+09;-5.74551e+07;0;0;0;0;0;0;125720668;125725205;82031
726;8.37647e-15;-3;1673;21008;15840.5;1;534;-2.14748e+09;-5.68223e+07;-1;0;0;0;-1;0;126771416;126776136;85088
727;8.37647e-15;-3;1673;21008;15840.5;1;534;-2.14748e+09;-5.62006e+07;-1;0;0;0;-1;0;127819003;127823911;88228
728;8.37647e-15;-3;1673;21008;15840.5;1;534;-2.14748e+09;-5.559e+07;-1;0;0;0;-1;0;128863404;128868505;91453
729;8.37647e-15;-3;1673;21008;15840.5;1;534;-2.14748e+09;-5.499e+07;-1;0;0;0;-1;0;129904594;129909895;94763
730;8.37647e-15;-3;1673;21008;15840.5;1;534;-2.14748e+09;-5.44004e+07;-1;0;0;0;-1;0;130942550;130948056;98161
731;8.37647e-15;-4;1673;21008;15840.5;1;534;-2.14748e+09;-5.38211e+07;0;0;0;0;0;0;131977251;131982970;101648
732;8.37647e-15;-5;1673;21008;15840.5;1;534;-2.14748e+09;-5.32517e+07;0;0;0;0;0;0;133008677;133014614;105224
733;8.37647e-15;-5;1673;21008;15840.5;1;534;-2.14748e+09;-5.26921e+07;-1;0;0;0;-1;0;134036809;134042970;108892
734;8.37647e-15;-6;1673;21008;15840.5;1;534;-2.14748e+09;-5.2142e+07;0;0;0;0;0;0;135061629;135068021;112652
735;8.37647e-15;-7;1673;21008;15840.5;1;534;-2.14748e+09;-5.16013e+07;0;0;0;0;0;0;136083119;136089749;116505
736;8.37647e-15;-7;1673;21008;15840.5;1;534;-2.14748e+09;-5.10696e+07;-1;0;0;0;-1;0;137101264;137108138;120454
737;8.37647e-15;-8;1673;21008;15840.5;1;534;-2.14748e+09;-5.05468e+07;0;0;0;0;0;0;138116049;138123175;124499
738;8.37647e-15;-9;1673;21008;15840.5;1;534;-2.14748e+09;-5.00327e+07;0;0;0;0;0;0;139127460;139134845;128642
739;8.37647e-15;-9;1673;21008;15840.5;1;534;-2.14748e+09;-4.95272e+07;-1;0;0;0;-1;0;140135485;140143135;132884
740;8.37647e-15;-10;1673;21008;15840.5;1;534;-2.14748e+09;-4.90299e+07;0;0;0;0;0;0;141140112;141148035;137225
741;8.37647e-15;-10;1673;21008;15840.5;1;534;-2.14748e+09;-4.85408e+07;-1;0;0;0;-1;0;142141329;142149532;141668
742;8.37647e-15;-11;1673;21008;15840.5;1;534;-2.14748e+09;-4.80597e+07;0;0;0;0;0;0;143139127;143147618;146214
743;8.37647e-15;-11;1673;21008;15840.5;1;534;-2.14748e+09;-4.75863e+07;-1;0;0;0;-1;0;144133496;144142284;150864
744;8.37647e-15;-11;1673;21008;15840.5;1;534;-2.14748e+09;-4.71205e+07;-1;0;0;0;-1;0;145124429;145133520;155618
745;8.37647e-15;-11;1673;21008;15840.5;1;534;-2.14748e+09;-4.66622e+07;-1;0;0;0;-1;0;146111917;146121319;160479
746;8.37647e-15;-11;1673;21008;15840.5;1;534;-2.14748e+09;-4.62112e+07;-1;0;0;0;-1;0;147095954;147105676;165448
747;8.37647e-15;-12;1673;21008;15840.5;1;534;-2.14748e+09;-4.57674e+07;0;0;0;0;0;0;148076534;148086584;170525
748;8.37647e-15;-13;1673;21008;15840.5;1;534;-2.14748e+09;-4.53305e+07;0;0;0;0;0;0;149053653;149064038;175712
749;8.37647e-15;-13;1673;21008;15840.5;1;534;-2.14748e+09;-4.49004e+07;-1;0;0;0;-1;0;150027304;150038035;181010
750;8.37647e-15;-14;1673;21008;15840.5;1;534;-2.14748e+09;-4.44771e+07;0;0;0;0;0;0;150997485;151008569;186421
751;8.37647e-15;-14;1673;21008;15840.5;1;534;-2.14748e+09;-4.40603e+07;-1;0;0;0;-1;0;151964192;151975638;191945
752;8.37647e-15;-14;1673;21008;15840.5;1;534;-2.14748e+09;-4.36499e+07;-1;0;0;0;-1;0;152927424;152939241;197584
753;8.37647e-15;-15;1673;21008;15840.5;1;534;-2.14748e+09;-4.32458e+07;0;0;0;0;0;0;153887177;153899375;203339
754;8.37647e-15;-15;1673;21008;15840.5;1;534;-2.14748e+09;-4.28479e+07;-1;0;0;0;-1;0;154843452;154856039;209211
755;8.37647e-15;-16;1673;21008;15840.5;1;534;-2.14748e+09;-4.2456e+07;0;0;0;0;0;0;155796247;155809233;215201
756;8.37647e-15;-16;1673;21008;15840.5;1;534;-2.14748e+09;-4.207e+07;-1;0;0;0;-1;0;156745562;156758957;221310
757;8.37647e-15;-17;1673;21008;15840.5;1;534;-2.14748e+09;-4.16897e+07;0;0;0;0;0;0;157691398;157705212;227539
758;8.37647e-15;-18;1673;21008;15840.5;1;534;-2.14748e+09;-4.13152e+07;0;0;0;0;0;0;158633756;158647998;233890
759;8.37647e-15;-19;1673;21008;15840.5;1;534;-2.14748e+09;-4.09462e+07;0;0;0;0;0;0;159572638;159587318;240364
760;8.37647e-15;-20;1673;21008;15840.5;1;534;-2.14748e+09;-4.05826e+07;0;0;0;0;0;0;160508045;160523174;246961
761;8.37647e-15;-20;1673;21008;15840.5;1;534;-2.14748e+09;-4.02244e+07;-1;0;0;0;-1;0;161439981;161455567;253684
762;8.37647e-15;-20;1673;21008;15840.5;1;534;-2.14748e+09;-3.98714e+07;-1;0;0;0;-1;0;162368447;162384503;260532
763;8.37647e-15;-21;1673;21008;15840.5;1;534;-2.14748e+09;-3.95235e+07;0;0;0;0;0;0;163293449;163309984;267506
764;8.37647e-15;-22;1673;21008;15840.5;1;534;-2.14748e+09;-3.91807e+07;0;0;0;0;0;0;164214989;164232014;274609
765;8.37647e-15;-23;1673;21008;15840.5;1;534;-2.14748e+09;-3.88428e+07;0;0;0;0;0;0;165133072;165150598;281841
766;8.37647e-15;-24;1673;21008;15840.5;1;534;-2.14748e+09;-3.85097e+07;0;0;0;0;0;0;166047702;166065741;289202
767;8.37647e-15;-25;1673;21008;15840.5;1;534;-2.14748e+09;-3.81813e+07;0;0;0;0;0;0;166958886;166977448;296695
768;8.37647e-15;-26;1673;21008;15840.5;1;534;-2.14748e+09;-3.78576e+07;0;0;0;0;0;0;167866628;167885724;304320
769;8.37647e-15;-27;1673;21008;15840.5;1;534;-2.14748e+09;-3.75384e+07;0;0;0;0;0;0;168770934;168790577;312077
770;8.37647e-15;-27;1673;21008;15840.5;1;534;-2.14748e+09;-3.72237e+07;-1;0;0;0;-1;0;169671811;169692012;319969
771;8.37647e-15;-28;1673;21008;15840.5;1;534;-2.14748e+09;-3.69134e+07;0;0;0;0;0;0;170569266;170590035;327995
772;8.37647e-15;-28;1673;21008;15840.5;1;534;-2.14748e+09;-3.66073e+07;-1;0;0;0;-1;0;171463304;171484655;336157
773;8.37647e-15;-29;1673;21008;15840.5;1;534;-2.14748e+09;-3.63055e+07;0;0;0;0;0;0;172353933;172375878;344456
774;8.37647e-15;-30;1673;21008;15840.5;1;534;-2.14748e+09;-3.60078e+07;0;0;0;0;0;0;173241162;173263712;352892
775;8.37647e-15;-31;1673;21008;15840.5;1;534;-2.14748e+09;-3.57142e+07;0;0;0;0;0;0;174124997;174148165;361467
776;8.37647e-15;-32;1673;21008;15840.5;1;534;-2.14748e+09;-3.54246e+07;0;0;0;0;0;0;175005447;175029246;370182
777;8.37647e-15;-32;1673;21008;15840.5;1;534;-2.14748e+09;-3.51389e+07;-1;0;0;0;-1;0;175882520;175906962;379036
778;8.37647e-15;-32;1673;21008;15840.5;1;534;-2.14748e+09;-3.4857e+07;-1;0;0;0;-1;0;176756225;176781323;388032
779;8.37647e-15;-33;1673;21008;15840.5;1;534;-2.14748e+09;-3.45788e+07;0;0;0;0;0;0;177626570;177652338;397170
780;8.37647e-15;-33;1673;21008;15840.5;1;534;-2.14748e+09;-3.43044e+07;-1;0;0;0;-1;0;178493566;178520015;406451
781;8.37647e-15;-34;1673;21008;15840.5;1;534;-2.14748e+09;-3.40336e+07;0;0;0;0;0;0;179357220;179384365;415876
782;8.37647e-15;-34;1673;21008;15840.5;1;534;-2.14748e+09;-3.37664e+07;-1;0;0;0;-1;0;180217543;180245398;425445
783;8.37647e-15;-34;1673;21008;15840.5;1;534;-2.14748e+09;-3.35026e+07;-1;0;0;0;-1;0;181074545;181103122;435159
784;8.37647e-15;-35;1673;21008;15840.5;1;534;-2.14748e+09;-3.32423e+07;0;0;0;0;0;0;181928235;181957549;445019
785;8.37647e-15;-35;1673;21008;15840.5;1;534;-2.14748e+09;-3.29854e+07;-1;0;0;0;-1;0;182778623;182808688;455026
786;8.37647e-15;-35;1673;21008;15840.5;1;534;-2.14748e+09;-3.27317e+07;-1;0;0;0;-1;0;183625721;183656550;465181
787;8.37647e-15;-35;1672;21008;15840.5;1;534;-2.14748e+09;-3.24814e+07;0;0;0;0;0;0;184469538;184501146;475484
788;8.37647e-15;-35;1672;21008;15840.5;1;534;-2.14748e+09;-3.22342e+07;-1;0;0;0;-1;0;185310085;185342486;485936
789;8.37647e-15;-36;1672;21008;15840.5;1;534;-2.14748e+09;-3.19902e+07;0;0;0;0;0;0;186147373;186180582;496537
790;8.37647e-15;-36;1671;21008;15840.5;1;534;-2.14748e+09;-3.17492e+07;0;0;0;0;0;0;186981414;187015445;507289
791;8.37647e-15;-37;1671;21008;15840.5;1;534;-2.14748e+09;-3.15113e+07;0;0;0;0;0;0;187812217;187847086;518192
792;8.37647e-15;-37;1671;21008;15840.5;1;534;-2.14748e+09;-3.12764e+07;-1;0;0;0;-1;0;188639795;188675517;529247
793;8.37647e-15;-37;1671;21008;15840.5;1;534;-2.14748e+09;-3.10444e+07;-1;0;0;0;-1;0;189464159;189500748;540455
794;8.37647e-15;-38;1671;21008;15840.5;1;534;-2.14748e+09;-3.08153e+07;0;0;0;0;0;0;190285320;190322793;551815
795;8.37647e-15;-39;1671;21008;15840.5;1;534;-2.14748e+09;-3.0589e+07;0;0;0;0;0;0;191103291;191141662;563329
796;8.37647e-15;-40;1671;21008;15840.5;1;534;-2.14748e+09;-3.03654e+07;0;0;0;0;0;0;191918082;191957367;574997
797;8.37647e-15;-41;1671;21008;15840.5;1;534;-2.14748e+09;-3.01446e+07;0;0;0;0;0;0;192729706;192769921;586820
798;8.37647e-15;-42;1671;21008;15840.5;1;534;-2.14748e+09;-2.99265e+07;0;0;0;0;0;0;193538174;193579336;598799
799;8.37647e-15;-42;1670;21008;15840.5;1;534;-2.14748e+09;-2.97111e+07;0;0;0;0;0;0;194343500;194385624;610933
800;8.37647e-15;-42;1670;21008;15840.5;1;534;-2.14748e+09;-2.94982e+07;-1;0;0;0;-1;0;195145695;195188797;623224
801;8.37647e-15;-43;1670;21008;15840.5;1;534;-2.14748e+09;-2.92879e+07;0;0;0;0;0;0;195944770;195988868;635672
802;8.37647e-15;-43;1670;21008;15840.5;1;534;-2.14748e+09;-2.90801e+07;-1;0;0;0;-1;0;196740740;196785849;648278
803;8.37647e-15;-44;1670;21008;15840.5;1;534;-2.14748e+09;-2.88747e+07;0;0;0;0;0;0;197533615;197579753;661042
804;8.37647e-15;-44;1670;21008;15840.5;1;534;-2.14748e+09;-2.86718e+07;-1;0;0;0;-1;0;198323408;198370592;673964
805;8.37647e-15;-45;1670;21008;15840.5;1;534;-2.14748e+09;-2.84713e+07;0;0;0;0;0;0;199110133;199158379;687046
806;8.37647e-15;-45;1670;21008;15840.5;1;534;-2.14748e+09;-2.82731e+07;-1;0;0;0;-1;0;199893801;199943127;700287
807;8.37647e-15;-45;1670;21008;15840.5;1;534;-2.14748e+09;-2.80773e+07;-1;0;0;0;-1;0;200674426;200724848;713688
808;8.37647e-15;-45;1670;21008;15840.5;1;534;-2.14748e+09;-2.78837e+07;-1;0;0;0;-1;0;201452019;201503556;727249
809;8.37647e-15;-45;1670;21008;15840.5;1;534;-2.14748e+09;-2.76923e+07;-1;0;0;0;-1;0;202226593;202279263;740971
810;8.37647e-15;-46;1670;21008;15840.5;1;534;-2.14748e+09;-2.75032e+07;0;0;0;0;0;0;202998163;203051983;754854
811;8.37647e-15;-47;1670;21008;15840.5;1;534;-2.14748e+09;-2.73162e+07;0;0;0;0;0;0;203766739;203821727;768899
812;8.37647e-15;-47;1670;21008;15840.5;1;534;-2.14748e+09;-2.71313e+07;-1;0;0;0;-1;0;204532335;204588510;783106
813;8.37647e-15;-48;1670;21008;15840.5;1;534;-2.14748e+09;-2.69485e+07;0;0;0;0;0;0;205294965;205352345;797476
814;8.37647e-15;-49;1670;21008;15840.5;1;534;-2.14748e+09;-2.67678e+07;0;0;0;0;0;0;206054640;206113243;812008
815;8.37647e-15;-50;1670;21008;15840.5;1;534;-2.14748e+09;-2.65892e+07;0;0;0;0;0;0;206811374;206871219;826703
816;8.37647e-15;-51;1670;21008;15840.5;1;534;-2.14748e+09;-2.64125e+07;0;0;0;0;0;0;207565180;207626286;841561
817;8.37647e-15;-52;1670;21008;15840.5;1;534;-2.14748e+09;-2.62378e+07;0;0;0;0;0;0;208316071;208378456;856583
818;8.37647e-15;-53;1670;21008;15840.5;1;534;-2.14748e+09;-2.6065e+07;0;0;0;0;0;0;209064059;209127744;871769
819;8.37647e-15;-53;1670;21008;15840.5;1;534;-2.14748e+09;-2.58941e+07;-1;0;0;0;-1;0;209809158;209874161;887120
820;8.37647e-15;-53;1670;21008;15840.5;1;534;-2.14748e+09;-2.57251e+07;-1;0;0;0;-1;0;210551381;210617721;902634
821;8.37647e-15;-53;1670;21008;15840.5;1;534;-2.14748e+09;-2.5558e+07;-1;0;0;0;-1;0;211290741;211358438;918314
822;8.37647e-15;-53;1670;21008;15840.5;1;534;-2.14748e+09;-2.53927e+07;-1;0;0;0;-1;0;212027250;212096324;934158
823;8.37647e-15;-54;1670;21008;15840.5;1;534;-2.14748e+09;-2.52292e+07;0;0;0;0;0;0;212760922;212831393;950168
824;8.37647e-15;-54;1670;21008;15840.5;1;534;-2.14748e+09;-2.50674e+07;-1;0;0;0;-1;0;213491770;213563658;966343
825;8.37647e-15;-55;1670;21008;15840.5;1;534;-2.14748e+09;-2.49074e+07;0;0;0;0;0;0;214219807;214293132;982684
826;8.37647e-15;-55;1670;21008;15840.5;1;534;-2.14748e+09;-2.47491e+07;-1;0;0;0;-1;0;214945046;215019828;999191
827;8.37647e-15;-55;1670;21008;15840.5;1;534;-2.14748e+09;-2.45924e+07;-1;0;0;0;-1;0;215667500;215743759;1015864
828;8.37647e-15;-55;1670;21008;15840.5;1;534;-2.14748e+09;-2.44375e+07;-1;0;0;0;-1;0;216387181;216464939;1032703
829;8.37647e-15;-56;1670;21008;15840.5;1;534;-2.14748e+09;-2.42841e+07;0;0;0;0;0;0;217104103;217183380;1049708
830;8.37647e-15;-57;1670;21008;15840.5;1;534;-2.14748e+09;-2.41324e+07;0;0;0;0;0;0;217818279;217899096;1066879
831;8.37647e-15;-58;1670;21008;15840.5;1;534;-2.14748e+09;-2.39823e+07;0;0;0;0;0;0;218529722;218612100;1084217
832;8.37647e-15;-59;1670;21008;15840.5;1;534;-2.14748e+09;-2.38337e+07;0;0;0;0;0;0;219238444;219322404;1101722
833;8.37647e-15;-59;1670;21008;15840.5;1;534;-2.14748e+09;-2.36867e+07;-1;0;0;0;-1;0;219944459;220030023;1119394
834;8.37647e-15;-60;1670;21008;15840.5;1;534;-2.14748e+09;-2.35412e+07;0;0;0;0;0;0;220647779;220734968;1137232
835;8.37647e-15;-60;1670;21008;15840.5;1;534;-2.14748e+09;-2.33972e+07;-1;0;0;0;-1;0;221348418;221437254;1155238
836;8.37647e-15;-61;1670;21008;15840.5;1;534;-2.14748e+09;-2.32547e+07;0;0;0;0;0;0;222046388;222136892;1173410
837;8.37647e-15;-61;1670;21008;15840.5;1;534;-2.14748e+09;-2.31136e+07;-1;0;0;0;-1;0;222741701;222833896;1191750
838;8.37647e-15;-61;1670;21008;15840.5;1;534;-2.14748e+09;-2.29739e+07;-1;0;0;0;-1;0;223434371;223528279;1210256
839;8.37647e-15;-61;1670;21008;15840.5;1;534;-2.14748e+09;-2.28357e+07;-1;0;0;0;-1;0;224124411;224220053;1228930
840;8.37647e-15;-61;1670;21008;15840.5;1;534;-2.14748e+09;-2.26989e+07;-1;0;0;0;-1;0;224811832;224909232;1247771
841;8.37647e-15;-62;1670;21008;15840.5;1;534;-2.14748e+09;-2.25634e+07;0;0;0;0;0;0;225496649;225595828;1266779
842;8.37647e-15;-63;1670;21008;15840.5;1;534;-2.14748e+09;-2.24293e+07;0;0;0;0;0;0;226178873;226279854;1285954
843;8.37647e-15;-64;1670;21008;15840.5;1;534;-2.14748e+09;-2.22965e+07;0;0;0;0;0;0;226858517;226961324;1305296
844;8.37647e-15;-64;1670;21008;15840.5;1;534;-2.14748e+09;-2.21651e+07;0;0;-1;0;0;-1;227535593;227640248;1324805
845;8.37647e-15;-65;1670;21008;15840.5;1;534;-2.14748e+09;-2.20349e+07;0;0;0;0;0;0;228210115;228316641;1344482
846;8.37647e-15;-65;1670;21008;15840.5;1;534;-2.14748e+09;-2.1906e+07;-1;0;0;0;-1;0;228882094;228990515;1364325
847;8.37647e-15;-65;1670;21008;15840.5;1;534;-2.14748e+09;-2.17784e+07;-1;0;0;0;-1;0;229551544;229661882;1384335
848;8.37647e-15;-66;1670;21008;15840.5;1;534;-2.14748e+09;-2.16521e+07;0;0;0;0;0;0;230218475;230330755;1404512
849;8.37647e-15;-66;1670;21008;15840.5;1;534;-2.14748e+09;-2.15269e+07;-1;0;0;0;-1;0;230882902;230997147;1424856
850;8.37647e-15;-67;1670;21008;15840.5;1;534;-2.14748e+09;-2.1403e+07;0;0;0;0;0;0;231544836;231661069;1445366
851;8.37647e-15;-68;1670;21008;15840.5;1;534;-2.14748e+09;-2.12802e+07;0;0;0;0;0;0;232204289;232322535;1466043
852;8.37647e-15;-68;1670;21008;15840.5;1;534;-2.14748e+09;-2.11587e+07;-1;0;0;0;-1;0;232861274;232981557;1486886
853;8.37647e-15;-69;1670;21008;15840.5;1;534;-2.14748e+09;-2.10383e+07;0;0;0;0;0;0;233515803;233638146;1507896
854;8.37647e-15;-70;1670;21008;15840.5;1;534;-2.14748e+09;-2.0919e+07;0;0;0;0;0;0;234167888;234292317;1529072
855;8.37647e-15;-71;1670;21008;15840.5;1;534;-2.14748e+09;-2.08009e+07;0;0;0;0;0;0;234817541;234944079;1550414
856;8.37647e-15;-72;1670;21008;15840.5;1;534;-2.14748e+09;-2.06839e+07;0;0;0;0;0;0;235464775;235593447;1571921
857;8.37647e-15;-73;1670;21008;15840.5;1;534;-2.14748e+09;-2.05679e+07;0;0;0;0;0;0;236109600;236240431;1593595
858;8.37647e-15;-74;1670;21008;15840.5;1;534;-2.14748e+09;-2.04531e+07;0;0;0;0;0;0;236752030;236885044;1615433
859;8.37647e-15;-74;1670;21008;15840.5;1;534;-2.14748e+09;-2.03394e+07;-1;0;0;0;-1;0;237392075;237527299;1637437
860;8.37647e-15;-74;1670;21008;15840.5;1;534;-2.14748e+09;-2.02267e+07;-1;0;0;0;-1;0;238029749;238167206;1659607
861;8.37647e-15;-74;1670;21008;15840.5;1;534;-2.14748e+09;-2.0115e+07;-1;0;0;0;-1;0;238665062;238804778;1681941
862;8.37647e-15;-75;1670;21008;15840.5;1;534;-2.14748e+09;-2.00044e+07;0;0;0;0;0;0;239298027;239440027;1704440
863;8.37647e-15;-76;1670;21008;15840.5;1;534;-2.14748e+09;-1.98948e+07;0;0;0;0;0;0;239928655;240072965;1727103
864;8.37647e-15;-77;1670;21008;15840.5;1;534;-2.14748e+09;-1.97862e+07;0;0;0;0;0;0;240556958;240703603;1749930
865;8.37647e-15;-78;1670;21008;15840.5;1;534;-2.14748e+09;-1.96786e+07;0;0;0;0;0;0;241182947;241331953;1772922
866;8.37647e-15;-78;1670;21008;15840.5;1;534;-2.14748e+09;-1.95719e+07;-1;0;0;0;-1;0;241806634;241958027;1796077
867;8.37647e-15;-78;1670;21008;15840.5;1;534;-2.14748e+09;-1.94663e+07;-1;0;0;0;-1;0;242428031;242581837;1819396
868;8.37647e-15;-78;1670;21008;15840.5;1;534;-2.14748e+09;-1.93615e+07;-1;0;0;0;-1;0;243047148;243203394;1842878
869;8.37647e-15;-79;1670;21008;15840.5;1;534;-2.14748e+09;-1.92578e+07;0;0;0;0;0;0;243663998;243822709;1866523
870;8.37647e-15;-80;1670;21008;15840.5;1;534;-2.14748e+09;-1.91549e+07;0;0;0;0;0;0;244278591;244439794;1890330
871;8.37647e-15;-80;1670;21008;15840.5;1;534;-2.14748e+09;-1.9053e+07;-1;0;0;0;-1;0;244890940;245054660;1914300
872;8.37647e-15;-80;1670;21008;15840.5;1;534;-2.14748e+09;-1.89519e+07;-1;0;0;0;-1;0;245501054;245667319;1938432
873;8.37647e-15;-81;1670;21008;15840.5;1;534;-2.14748e+09;-1.88518e+07;0;0;0;0;0;0;246108946;246277782;1962725
874;8.37647e-15;-81;1670;21008;15840.5;1;534;-2.14748e+09;-1.87526e+07;-1;0;0;0;-1;0;246714626;246886061;1987180
875;8.37647e-15;-82;1670;21008;15840.5;1;534;-2.14748e+09;-1.86542e+07;0;0;0;0;0;0;247318106;247492166;2011796
876;8.37647e-15;-82;1670;21008;15840.5;1;534;-2.14748e+09;-1.85566e+07;-1;0;0;0;-1;0;247919396;248096108;2036573
877;8.37647e-15;-83;1670;21008;15840.5;1;534;-2.14748e+09;-1.846e+07;0;0;0;0;0;0;248518508;248697899;2061510
878;8.37647e-15;-84;1670;21008;15840.5;1;534;-2.14748e+09;-1.83641e+07;0;0;0;0;0;0;249115452;249297549;2086608
879;8.37647e-15;-84;1670;21008;15840.5;1;534;-2.14748e+09;-1.82691e+07;-1;0;0;0;-1;0;249710239;249895070;2111865
880;8.37647e-15;-85;1670;21008;15840.5;1;534;-2.14748e+09;-1.8175e+07;0;0;0;0;0;0;250302880;250490473;2137281
881;8.37647e-15;-85;1670;21008;15840.5;1;534;-2.14748e+09;-1.80816e+07;-1;0;0;0;-1;0;250893386;251083768;2162856
882;8.37647e-15;-86;1670;21008;15840.5;1;534;-2.14748e+09;-1.7989e+07;0;0;0;0;0;0;251481767;251674966;2188590
883;8.37647e-15;-87;1670;21008;15840.5;1;534;-2.14748e+09;-1.78972e+07;0;0;0;0;0;0;252068034;252264077;2214482
884;8.37647e-15;-88;1670;21008;15840.5;1;534;-2.14748e+09;-1.78062e+07;0;0;0;0;0;0;252652197;252851113;2240532
885;8.37647e-15;-89;1670;21008;15840.5;1;534;-2.14748e+09;-1.7716e+07;0;0;0;0;0;0;253234268;253436085;2266739
886;8.37647e-15;-89;1670;21008;15840.5;1;534;-2.14748e+09;-1.76265e+07;-1;0;0;0;-1;0;253814256;254019002;2293103
887;8.37647e-15;-90;1670;21008;15840.5;1;534;-2.14748e+09;-1.75378e+07;0;0;0;0;0;0;254392172;254599875;2319624
888;8.37647e-15;-91;1670;21008;15840.5;1;534;-2.14748e+09;-1.74498e+07;0;0;0;0;0;0;254968026;255178714;2346301
889;8.37647e-15;-91;1670;21008;15840.5;1;534;-2.14748e+09;-1.73625e+07;-1;0;0;0;-1;0;255541829;255755531;2373134
890;8.37647e-15;-91;1670;21008;15840.5;1;534;-2.14748e+09;-1.7276e+07;-1;0;0;0;-1;0;256113590;256330335;2400122
891;8.37647e-15;-91;1670;21008;15840.5;1;534;-2.14748e+09;-1.71902e+07;-1;0;0;0;-1;0;256683320;256903136;2427265
892;8.37647e-15;-92;1670;21008;15840.5;1;534;-2.14748e+09;-1.71051e+07;0;0;0;0;0;0;257251030;257473946;2454562
893;8.37647e-15;-92;1670;21008;15840.5;1;534;-2.14748e+09;-1.70207e+07;-1;0;0;0;-1;0;257816728;258042773;2482013
894;8.37647e-15;-93;1670;21008;15840.5;1;534;-2.14748e+09;-1.6937e+07;0;0;0;0;0;0;258380425;258609628;2509618
895;8.37647e-15;-93;1670;21008;15840.5;1;534;-2.14748e+09;-1.6854e+07;-1;0;0;0;-1;0;258942132;259174521;2537376
896;8.37647e-15;-94;1670;21008;15840.5;1;534;-2.14748e+09;-1.67716e+07;0;0;0;0;0;0;259501857;259737463;2565286
897;8.37647e-15;-94;1670;21008;15840.5;1;534;-2.14748e+09;-1.66899e+07;-1;0;0;0;-1;0;260059611;260298462;2593349
898;8.37647e-15;-94;1670;21008;15840.5;1;534;-2.14748e+09;-1.66089e+07;-1;0;0;0;-1;0;260615404;260857530;2621563
899;8.37647e-15;-95;1670;21008;15840.5;1;534;-2.14748e+09;-1.65285e+07;0;0;0;0;0;0;261169244;261414675;2649928
900;8.37647e-15;-96;1670;21008;15840.5;1;534;-2.14748e+09;-1.64488e+07;0;0;0;0;0;0;261721143;261969907;2678444
901;8.37647e-15;-97;1670;21008;15840.5;1;534;-2.14748e+09;-1.63697e+07;0;0;0;0;0;0;262271109;262523237;2707110
902;8.37647e-15;-98;1670;21008;15840.5;1;534;-2.14748e+09;-1.62913e+07;0;0;0;0;0;0;262819153;263074673;2735926
903;8.37647e-15;-98;1670;21008;15840.5;1;534;-2.14748e+09;-1.62134e+07;-1;0;0;0;-1;0;263365283;263624226;2764891
904;8.37647e-15;-99;1670;21008;15840.5;1;534;-2.14748e+09;-1.61362e+07;0;0;0;0;0;0;263909509;264171905;2794005
905;8.37647e-15;-99;1670;21008;15840.5;1;534;-2.14748e+09;-1.60596e+07;-1;0;0;0;-1;0;264451840;264717720;2823266
906;8.37647e-15;-100;1670;21008;15840.5;1;534;-2.14748e+09;-1.59836e+07;0;0;0;0;0;0;264992286;265261679;2852676
907;8.37647e-15;-101;1670;21008;15840.5;1;534;-2.14748e+09;-1.59082e+07;0;0;0;0;0;0;265530857;265803793;2882232
908;8.37647e-15;-101;1670;21008;15840.5;1;534;-2.14748e+09;-1.58334e+07;-1;0;0;0;-1;0;266067560;266344070;2911936
909;8.37647e-15;-101;1670;21008;15840.5;1;534;-2.14748e+09;-1.57592e+07;-1;0;0;0;-1;0;266602406;266882520;2941785
910;8.37647e-15;-101;1670;21008;15840.5;1;534;-2.14748e+09;-1.56855e+07;-1;0;0;0;-1;0;267135404;267419152;2971779
911;8.37647e-15;-101;1670;21008;15840.5;1;534;-2.14748e+09;-1.56124e+07;-1;0;0;0;-1;0;267666563;267953975;3001919
912;8.37647e-15;-102;1670;21008;15840.5;1;534;-2.14748e+09;-1.55399e+07;0;0;0;0;0;0;268195891;268486999;3032203
913;8.37647e-15;-103;1670;21008;15840.5;1;534;-2.14748e+09;-1.54679e+07;0;0;0;0;0;0;268723398;269018232;3062631
914;8.37647e-15;-104;1670;21008;15840.5;1;534;-2.14748e+09;-1.53965e+07;0;0;0;0;0;0;269249092;269547683;3093202
915;8.37647e-15;-104;1670;21008;15840.5;1;534;-2.14748e+09;-1.53256e+07;-1;0;0;0;-1;0;269772983;270075362;3123916
916;8.37647e-15;-105;1670;21008;15840.5;1;534;-2.14748e+09;-1.52553e+07;0;0;0;0;0;0;270295079;270601277;3154773
917;8.37647e-15;-105;1670;21008;15840.5;1;534;-2.14748e+09;-1.51855e+07;-1;0;0;0;-1;0;270815390;271125437;3185771
918;8.37647e-15;-105;1670;21008;15840.5;1;534;-2.14748e+09;-1.51162e+07;-1;0;0;0;-1;0;271333923;271647851;3216910
919;8.37647e-15;-106;1670;21008;15840.5;1;534;-2.14748e+09;-1.50475e+07;0;0;0;0;0;0;271850687;272168527;3248189
920;8.37647e-15;-107;1670;21008;15840.5;1;534;-2.14748e+09;-1.49792e+07;0;0;0;0;0;0;272365692;272687474;3279608
921;8.37647e-15;-107;1670;21008;15840.5;1;534;-2.14748e+09;-1.49115e+07;-1;0;0;0;-1;0;272878945;273204702;3311167
922;8.37647e-15;-108;1670;21008;15840.5;1;534;-2.14748e+09;-1.48443e+07;0;0;0;0;0;0;273390455;273720218;3342865
923;8.37647e-15;-108;1670;21008;15840.5;1;534;-2.14748e+09;-1.47776e+07;-1;0;0;0;-1;0;273900230;274234031;3374701
924;8.37647e-15;-108;1670;21008;15840.5;1;534;-2.14748e+09;-1.47113e+07;-1;0;0;0;-1;0;274408280;274746149;3406674
925;8.37647e-15;-108;1670;21008;15840.5;1;534;-2.14748e+09;-1.46456e+07;-1;0;0;0;-1;0;274914612;275256581;3438784
926;8.37647e-15;-109;1670;21008;15840.5;1;534;-2.14748e+09;-1.45803e+07;0;0;0;0;0;0;275419234;275765336;3471031
927;8.37647e-15;-110;1670;21008;15840.5;1;534;-2.14748e+09;-1.45156e+07;0;0;0;0;0;0;275922155;276272421;3503414
928;8.37647e-15;-110;1670;21008;15840.5;1;534;-2.14748e+09;-1.44513e+07;-1;0;0;0;-1;0;276423384;276777845;3535932
929;8.37647e-15;-111;1670;21008;15840.5;1;534;-2.14748e+09;-1.43874e+07;0;0;0;0;0;0;276922927;277281615;3568584
930;8.37647e-15;-112;1670;21008;15840.5;1;534;-2.14748e+09;-1.43241e+07;0;0;0;0;0;0;277420794;277783741;3601371
931;8.37647e-15;-113;1670;21008;15840.5;1;534;-2.14748e+09;-1.42612e+07;0;0;0;0;0;0;277916992;278284231;3634291
932;8.37647e-15;-114;1670;21008;15840.5;1;534;-2.14748e+09;-1.41987e+07;0;0;0;0;0;0;278411530;278783091;3667344
933;8.37647e-15;-115;1670;21008;15840.5;1;534;-2.14748e+09;-1.41367e+07;0;0;0;0;0;0;278904415;279280332;3700529
934;8.37647e-15;-115;1670;21008;15840.5;1;534;-2.14748e+09;-1.40752e+07;-1;0;0;0;-1;0;279395655;279775959;3733845
935;8.37647e-15;-115;1670;21008;15840.5;1;534;-2.14748e+09;-1.4014e+07;-1;0;0;0;-1;0;279885258;280269982;3767293
936;8.37647e-15;-115;1670;21008;15840.5;1;534;-2.14748e+09;-1.39534e+07;-1;0;0;0;-1;0;280373232;280762408;3800871
937;8.37647e-15;-116;1670;21008;15840.5;1;534;-2.14748e+09;-1.38931e+07;0;0;0;0;0;0;280859584;281253245;3834578
938;8.37647e-15;-116;1670;21008;15840.5;1;534;-2.14748e+09;-1.38333e+07;-1;0;0;0;-1;0;281344324;281742501;3868415
939;8.37647e-15;-117;1670;21008;15840.5;1;534;-2.14748e+09;-1.37739e+07;0;0;0;0;0;0;281827457;282230183;3902380
940;8.37647e-15;-118;1670;21008;15840.5;1;534;-2.14748e+09;-1.37149e+07;0;0;0;0;0;0;282308992;282716300;3936473
941;8.37647e-15;-119;1670;21008;15840.5;1;534;-2.14748e+09;-1.36564e+07;0;0;0;0;0;0;282788936;283200858;3970693
942;8.37647e-15;-119;1670;21008;15840.5;1;534;-2.14748e+09;-1.35982e+07;-1;0;0;0;-1;0;283267297;283683866;4005040
943;8.37647e-15;-120;1670;21008;15840.5;1;534;-2.14748e+09;-1.35405e+07;0;0;0;0;0;0;283744082;284165331;4039513
944;8.37647e-15;-121;1670;21008;15840.5;1;534;-2.14748e+09;-1.34831e+07;0;0;0;0;0;0;284219299;284645260;4074111
945;8.37647e-15;-121;1670;21008;15840.5;1;534;-2.14748e+09;-1.34262e+07;-1;0;0;0;-1;0;284692955;285123661;4108834
946;8.37647e-15;-122;1670;21008;15840.5;1;534;-2.14748e+09;-1.33696e+07;0;0;0;0;0;0;285165058;285600541;4143681
947;8.37647e-15;-123;1670;21008;15840.5;1;534;-2.14748e+09;-1.33134e+07;0;0;0;0;0;0;285635615;286075909;4178652
948;8.37647e-15;-124;1670;21008;15840.5;1;534;-2.14748e+09;-1.32577e+07;0;0;0;0;0;0;286104632;286549770;4213745
949;8.37647e-15;-125;1670;21008;15840.5;1;534;-2.14748e+09;-1.32023e+07;0;0;0;0;0;0;286572118;287022132;4248960
950;8.37647e-15;-126;1670;21008;15840.5;1;534;-2.14748e+09;-1.31473e+07;0;0;0;0;0;0;287038080;287493003;4284297
951;8.37647e-15;-127;1670;21008;15840.5;1;534;-2.14748e+09;-1.30926e+07;0;0;0;0;0;0;287502524;287962389;4319755
952;8.37647e-15;-127;1670;21008;15840.5;1;534;-2.14748e+09;-1.30384e+07;-1;0;0;0;-1;0;287965458;288430298;4355333
953;8.37647e-15;-128;1670;21008;15840.5;1;534;-2.14748e+09;-1.29845e+07;0;0;0;0;0;0;288426888;288896737;4391030
954;8.37647e-15;-129;1670;21008;15840.5;1;534;-2.14748e+09;-1.29309e+07;0;0;0;0;0;0;288886823;289361713;4426846
955;8.37647e-15;-129;1670;21008;15840.5;1;534;-2.14748e+09;-1.28777e+07;-1;0;0;0;-1;0;289345268;289825233;4462781
956;8.37647e-15;-130;1670;21008;15840.5;1;534;-2.14748e+09;-1.28249e+07;0;0;0;0;0;0;289802231;290287304;4498833
957;8.37647e-15;-130;1670;21008;15840.5;1;534;-2.14748e+09;-1.27725e+07;-1;0;0;0;-1;0;290257718;290747933;4535003
958;8.37647e-15;-131;1670;21008;15840.5;1;534;-2.14748e+09;-1.27203e+07;0;0;0;0;0;0;290711737;291207126;4571288
959;8.37647e-15;-132;1670;21008;15840.5;1;534;-2.14748e+09;-1.26686e+07;0;0;0;0;0;0;291164294;291664891;4607689
960;8.37647e-15;-133;1670;21008;15840.5;1;534;-2.14748e+09;-1.26172e+07;0;0;0;0;0;0;291615395;292121234;4644206
961;8.37647e-15;-134;1670;21008;15840.5;1;534;-2.14748e+09;-1.25661e+07;0;0;0;0;0;0;292065049;292576162;4680836
962;8.37647e-15;-134;1670;21008;15840.5;1;534;-2.14748e+09;-1.25153e+07;-1;0;0;0;-1;0;292513260;293029682;4717581
963;8.37647e-15;-134;1670;21008;15840.5;1;534;-2.14748e+09;-1.24649e+07;-1;0;0;0;-1;0;292960037;293481800;4754438
964;8.37647e-15;-135;1670;21008;15840.5;1;534;-2.14748e+09;-1.24148e+07;0;0;0;0;0;0;293405385;293932523;4791408
965;8.37647e-15;-135;1670;21008;15840.5;1;534;-2.14748e+09;-1.23651e+07;-1;0;0;0;-1;0;293849312;294381858;4828489
966;8.37647e-15;-136;1670;21008;15840.5;1;534;-2.14748e+09;-1.23157e+07;0;0;0;0;0;0;294291823;294829811;4865682
967;8.37647e-15;-136;1670;21008;15840.5;1;534;-2.14748e+09;-1.22665e+07;-1;0;0;0;-1;0;294732925;295276388;4902985
968;8.37647e-15;-136;1670;21008;15840.5;1;534;-2.14748e+09;-1.22178e+07;-1;0;0;0;-1;0;295172624;295721597;4940398
969;8.37647e-15;-137;1670;21008;15840.5;1;534;-2.14748e+09;-1.21693e+07;0;0;0;0;0;0;295610927;296165443;4977920
970;8.37647e-15;-138;1670;21008;15840.5;1;534;-2.14748e+09;-1.21211e+07;0;0;0;0;0;0;296047841;296607934;5015550
971;8.37647e-15;-138;1670;21008;15840.5;1;534;-2.14748e+09;-1.20733e+07;-1;0;0;0;-1;0;296483371;297049074;5053288
972;8.37647e-15;-138;1670;21008;15840.5;1;534;-2.14748e+09;-1.20257e+07;-1;0;0;0;-1;0;296917524;297488871;5091134
973;8.37647e-15;-138;1670;21008;15840.5;1;534;-2.14748e+09;-1.19785e+07;-1;0;0;0;-1;0;297350307;297927331;5129086
974;8.37647e-15;-139;1670;21008;15840.5;1;534;-2.14748e+09;-1.19316e+07;0;0;0;0;0;0;297781724;298364459;5167143
975;8.37647e-15;-139;1670;21008;15840.5;1;534;-2.14748e+09;-1.18849e+07;-1;0;0;0;-1;0;298211783;298800263;5205306
976;8.37647e-15;-140;1670;21008;15840.5;1;534;-2.14748e+09;-1.18386e+07;0;0;0;0;0;0;298640490;299234749;5243574
977;8.37647e-15;-141;1670;21008;15840.5;1;534;-2.14748e+09;-1.17925e+07;0;0;0;0;0;0;299067850;299667922;5281945
978;8.37647e-15;-142;1670;21008;15840.5;1;534;-2.14748e+09;-1.17468e+07;0;0;0;0;0;0;299493870;300099788;5320419
979;8.37647e-15;-143;1670;21008;15840.5;1;534;-2.14748e+09;-1.17013e+07;0;0;0;0;0;0;299918556;300530354;5358996
980;8.37647e-15;-143;1670;21008;15840.5;1;534;-2.14748e+09;-1.16561e+07;-1;0;0;0;-1;0;300341913;300959626;5397675
981;8.37647e-15;-143;1670;21008;15840.5;1;534;-2.14748e+09;-1.16112e+07;-1;0;0;0;-1;0;300763949;301387609;5436455
982;8.37647e-15;-144;1670;21008;15840.5;1;534;-2.14748e+09;-1.15666e+07;0;0;0;0;0;0;301184668;301814310;5475336
983;8.37647e-15;-144;1670;21008;15840.5;1;534;-2.14748e+09;-1.15223e+07;-1;0;0;0;-1;0;301604076;302239734;5514317
984;8.37647e-15;-145;1670;21008;15840.5;1;534;-2.14748e+09;-1.14782e+07;0;0;0;0;0;0;302022180;302663887;5553396
985;8.37647e-15;-145;1670;21008;15840.5;1;534;-2.14748e+09;-1.14344e+07;-1;0;0;0;-1;0;302438984;303086775;5592575
986;8.37647e-15;-146;1670;21008;15840.5;1;534;-2.14748e+09;-1.13909e+07;0;0;0;0;0;0;302854496;303508405;5631851
987;8.37647e-15;-146;1670;21008;15840.5;1;534;-2.14748e+09;-1.13476e+07;-1;0;0;0;-1;0;303268721;303928780;5671225
988;8.37647e-15;-147;1670;21008;15840.5;1;534;-2.14748e+09;-1.13046e+07;0;0;0;0;0;0;303681663;304347908;5710695
989;8.37647e-15;-148;1670;21008;15840.5;1;534;-2.14748e+09;-1.12619e+07;0;0;0;0;0;0;304093330;304765794;5750262
990;8.37647e-15;-149;1670;21008;15840.5;1;534;-2.14748e+09;-1.12194e+07;0;0;0;0;0;0;304503727;305182444;5789923
991;8.37647e-15;-149;1670;21008;15840.5;1;534;-2.14748e+09;-1.11772e+07;-1;0;0;0;-1;0;304912858;305597862;5829680
992;8.37647e-15;-150;1670;21008;15840.5;1;534;-2.14748e+09;-1.11352e+07;0;0;0;0;0;0;305320731;306012056;5869530
993;8.37647e-15;-150;1670;21008;15840.5;1;534;-2.14748e+09;-1.10935e+07;-1;0;0;0;-1;0;305727349;306425029;5909474
994;8.37647e-15;-151;1670;21008;15840.5;1;534;-2.14748e+09;-1.10521e+07;0;0;0;0;0;0;306132720;306836789;5949510
995;8.37647e-15;-151;1670;21008;15840.5;1;534;-2.14748e+09;-1.10109e+07;-1;0;0;0;-1;0;306536848;307247340;5989639
996;8.37647e-15;-151;1670;21008;15840.5;1;534;-2.14748e+09;-1.09699e+07;-1;0;0;0;-1;0;306939739;307656687;6029859
997;8.37647e-15;-152;1670;21008;15840.5;1;534;-2.14748e+09;-1.09292e+07;0;0;0;0;0;0;307341398;308064837;6070169
998;8.37647e-15;-152;1670;21008;15840.5;1;534;-2.14748e+09;-1.08888e+07;-1;0;0;0;-1;0;307741830;308471794;6110570
999;8.37647e-15;-152;1670;21008;15840.5;1;534;-2.14748e+09;-1.08486e+07;-1;0;0;0;-1;0;308141042;308877564;6151060
1000;8.37647e-15;-153;1670;21008;15840.5;1;534;-2.14748e+09;-1.08086e+07;0;0;0;0;0;0;308539037;309282152;6191639
1001;8.37647e-15;-154;1670;21008;15840.5;1;534;-2.14748e+09;-1.07688e+07;0;0;0;0;0;0;308935822;309685563;6232307
1002;8.37647e-15;-154;1670;21008;15840.5;1;534;-2.14748e+09;-1.07293e+07;-1;0;0;0;-1;0;309331402;310087803;6273061
1003;8.37647e-15;-154;1670;21008;15840.5;1;534;-2.14748e+09;-1.069e+07;-1;0;0;0;-1;0;309725781;310488877;6313903
1004;8.37647e-15;-154;1670;21008;15840.5;1;534;-2.14748e+09;-1.0651e+07;-1;0;0;0;-1;0;310118966;310888790;6354831
1005;8.37647e-15;-155;1670;21008;15840.5;1;534;-2.14748e+09;-1.06122e+07;0;0;0;0;0;0;310510961;311287548;6395845
1006;8.37647e-15;-155;1670;21008;15840.5;1;534;-2.14748e+09;-1.05736e+07;-1;0;0;0;-1;0;310901771;311685154;6436943
1007;8.37647e-15;-156;1670;21008;15840.5;1;534;-2.14748e+09;-1.05352e+07;0;0;0;0;0;0;311291402;312081615;6478126
1008;8.37647e-15;-157;1670;21008;15840.5;1;534;-2.14748e+09;-1.04971e+07;0;0;0;0;0;0;311679858;312476935;6519392
1009;8.37647e-15;-157;1670;21008;15840.5;1;534;-2.14748e+09;-1.04592e+07;-1;0;0;0;-1;0;312067145;312871120;6560742
1010;8.37647e-15;-158;1670;21008;15840.5;1;534;-2.14748e+09;-1.04215e+07;0;0;0;0;0;0;312453268;313264174;6602174
1011;8.37647e-15;-159;1670;21008;15840.5;1;534;-2.14748e+09;-1.0384e+07;0;0;0;0;0;0;312838231;313656102;6643688
1012;8.37647e-15;-159;1670;21008;15840.5;1;534;-2.14748e+09;-1.03467e+07;-1;0;0;0;-1;0;313222039;314046910;6685282
1013;8.37647e-15;-159;1670;21008;15840.5;1;534;-2.14748e+09;-1.03096e+07;-1;0;0;0;-1;0;313604698;314436602;6726958
1014;8.37647e-15;-160;1670;21008;15840.5;1;534;-2.14748e+09;-1.02728e+07;0;0;0;0;0;0;313986212;314825184;6768713
1015;8.37647e-15;-160;1670;21008;15840.5;1;534;-2.14748e+09;-1.02362e+07;-1;0;0;0;-1;0;314366586;315212659;6810547
1016;8.37647e-15;-161;1670;21008;15840.5;1;534;-2.14748e+09;-1.01998e+07;0;0;0;0;0;0;314745826;315599033;6852460
1017;8.37647e-15;-162;1670;21008;15840.5;1;534;-2.14748e+09;-1.01635e+07;0;0;0;0;0;0;315123935;315984310;6894451
1018;8.37647e-15;-163;1670;21008;15840.5;1;534;-2.14748e+09;-1.01275e+07;0;0;0;0;0;0;315500919;316368496;6936520
1019;8.37647e-15;-163;1670;21008;15840.5;1;534;-2.14748e+09;-1.00917e+07;-1;0;0;0;-1;0;315876782;316751595;6978665
1020;8.37647e-15;-163;1670;21008;15840.5;1;534;-2.14748e+09;-1.00561e+07;-1;0;0;0;-1;0;316251529;317133611;7020886
1021;8.37647e-15;-163;1670;21008;15840.5;1;534;-2.14748e+09;-1.00207e+07;-1;0;0;0;-1;0;316625164;317514550;7063183
1022;8.37647e-15;-164;1670;21008;15840.5;1;534;-2.14748e+09;-9.98552e+06;0;0;0;0;0;0;316997693;317894416;7105554
1023;8.37647e-15;-165;1670;21008;15840.5;1;534;-2.14748e+09;-9.95051e+06;0;0;0;0;0;0;317369120;318273214;7148000
1024;8.37647e-15;-165;1670;21008;15840.5;1;534;-2.14748e+09;-9.9157e+06;-1;0;0;0;-1;0;317739450;318650948;7190519
1025;8.37647e-15;-165;1670;21008;15840.5;1;534;-2.14748e+09;-9.88108e+06;-1;0;0;0;-1;0;318108687;319027623;7233112
1026;8.37647e-15;-165;1670;21008;15840.5;1;534;-2.14748e+09;-9.84666e+06;-1;0;0;0;-1;0;318476836;319403243;7275777
1027;8.37647e-15;-165;1670;21008;15840.5;1;534;-2.14748e+09;-9.81242e+06;-1;0;0;0;-1;0;318843901;319777813;7318513
1028;8.37647e-15;-166;1670;21008;15840.5;1;534;-2.14748e+09;-9.77838e+06;0;0;0;0;0;0;319209887;320151337;7361321
1029;8.37647e-15;-166;1670;21008;15840.5;1;534;-2.14748e+09;-9.74452e+06;-1;0;0;0;-1;0;319574798;320523820;7404199
1030;8.37647e-15;-167;1670;21008;15840.5;1;534;-2.14748e+09;-9.71085e+06;0;0;0;0;0;0;319938639;320895267;7447147
1031;8.37647e-15;-168;1670;21008;15840.5;1;534;-2.14748e+09;-9.67736e+06;0;0;0;0;0;0;320301414;321265681;7490164
1032;8.37647e-15;-169;1670;21008;15840.5;1;534;-2.14748e+09;-9.64406e+06;0;0;0;0;0;0;320663127;321635067;7533251
1033;8.37647e-15;-169;1670;21008;15840.5;1;534;-2.14748e+09;-9.61094e+06;-1;0;0;0;-1;0;321023784;322003429;7576405
1034;8.37647e-15;-169;1670;21008;15840.5;1;534;-2.14748e+09;-9.578e+06;-1;0;0;0;-1;0;321383388;322370772;7619627
1035;8.37647e-15;-170;1670;21008;15840.5;1;534;-2.14748e+09;-9.54524e+06;0;0;0;0;0;0;321741944;322737100;7662915
1036;8.37647e-15;-171;1670;21008;15840.5;1;534;-2.14748e+09;-9.51266e+06;0;0;0;0;0;0;322099455;323102417;7706270
1037;8.37647e-15;-172;1670;21008;15840.5;1;534;-2.14748e+09;-9.48025e+06;0;0;0;0;0;0;322455927;323466728;7749691
1038;8.37647e-15;-173;1670;21008;15840.5;1;534;-2.14748e+09;-9.44802e+06;0;0;0;0;0;0;322811363;323830036;7793176
1039;8.37647e-15;-173;1670;21008;15840.5;1;534;-2.14748e+09;-9.41596e+06;-1;0;0;0;-1;0;323165768;324192347;7836727
1040;8.37647e-15;-174;1670;21008;15840.5;1;534;-2.14748e+09;-9.38407e+06;0;0;0;0;0;0;323519146;324553663;7880341
1041;8.37647e-15;-174;1670;21008;15840.5;1;534;-2.14748e+09;-9.35236e+06;-1;0;0;0;-1;0;323871501;324913990;7924018
1042;8.37647e-15;-174;1670;21008;15840.5;1;534;-2.14748e+09;-9.32081e+06;-1;0;0;0;-1;0;324222837;325273331;7967758
1043;8.37647e-15;-175;1670;21008;15840.5;1;534;-2.14748e+09;-9.28943e+06;0;0;0;0;0;0;324573159;325631690;8011560
1044;8.37647e-15;-175;1670;21008;15840.5;1;534;-2.14748e+09;-9.25822e+06;-1;0;0;0;-1;0;324922470;325989072;8055424
1045;8.37647e-15;-175;1670;21008;15840.5;1;534;-2.14748e+09;-9.22718e+06;-1;0;0;0;-1;0;325270774;326345481;8099349
1046;8.37647e-15;-176;1670;21008;15840.5;1;534;-2.14748e+09;-9.1963e+06;0;0;0;0;0;0;325618077;326700920;8143334
1047;8.37647e-15;-176;1670;21008;15840.5;1;534;-2.14748e+09;-9.16558e+06;-1;0;0;0;-1;0;325964381;327055394;8187379
1048;8.37647e-15;-176;1670;21008;15840.5;1;534;-2.14748e+09;-9.13502e+06;-1;0;0;0;-1;0;326309691;327408906;8231483
1049;8.37647e-15;-176;1670;21008;15840.5;1;534;-2.14748e+09;-9.10463e+06;-1;0;0;0;-1;0;326654010;327761462;8275646
1050;8.37647e-15;-177;1670;21008;15840.5;1;534;-2.14748e+09;-9.07439e+06;0;0;0;0;0;0;326997343;328113063;8319866
1051;8.37647e-15;-178;1670;21008;15840.5;1;534;-2.14748e+09;-9.04431e+06;0;0;0;0;0;0;327339694;328463715;8364145
1052;8.37647e-15;-178;1670;21008;15840.5;1;534;-2.14748e+09;-9.01439e+06;-1;0;0;0;-1;0;327681067;328813421;8408480
1053;8.37647e-15;-178;1670;21008;15840.5;1;534;-2.14748e+09;-8.98462e+06;-1;0;0;0;-1;0;328021465;329162185;8452871
1054;8.37647e-15;-179;1670;21008;15840.5;1;534;-2.14748e+09;-8.95501e+06;0;0;0;0;0;0;328360892;329510012;8497318
1055;8.37647e-15;-180;1670;21008;15840.5;1;534;-2.14748e+09;-8.92556e+06;0;0;0;0;0;0;328699352;329856904;8541821
1056;8.37647e-15;-181;1670;21008;15840.5;1;534;-2.14748e+09;-8.89625e+06;0;0;0;0;0;0;329036850;330202866;8586378
1057;8.37647e-15;-182;1670;21008;15840.5;1;534;-2.14748e+09;-8.8671e+06;0;0;0;0;0;0;329373389;330547901;8630989
1058;8.37647e-15;-183;1670;21008;15840.5;1;534;-2.14748e+09;-8.83809e+06;0;0;0;0;0;0;329708972;330892014;8675653
1059;8.37647e-15;-183;1670;21008;15840.5;1;534;-2.14748e+09;-8.80924e+06;-1;0;0;0;-1;0;330043604;331235207;8720370
1060;8.37647e-15;-184;1670;21008;15840.5;1;534;-2.14748e+09;-8.78053e+06;0;0;0;0;0;0;330377288;331577485;8765140
1061;8.37647e-15;-185;1670;21008;15840.5;1;534;-2.14748e+09;-8.75197e+06;0;0;0;0;0;0;330710029;331918851;8809962
1062;8.37647e-15;-185;1670;21008;15840.5;1;534;-2.14748e+09;-8.72355e+06;-1;0;0;0;-1;0;331041828;332259309;8854835
1063;8.37647e-15;-185;1670;21008;15840.5;1;534;-2.14748e+09;-8.69528e+06;-1;0;0;0;-1;0;331372692;332598863;8899758
1064;8.37647e-15;-186;1670;21008;15840.5;1;534;-2.14748e+09;-8.66715e+06;0;0;0;0;0;0;331702622;332937516;8944732
1065;8.37647e-15;-186;1670;21008;15840.5;1;534;-2.14748e+09;-8.63917e+06;-1;0;0;0;-1;0;332031624;333275272;8989755
1066;8.37647e-15;-186;1670;21008;15840.5;1;534;-2.14748e+09;-8.61132e+06;-1;0;0;0;-1;0;332359699;333612135;9034827
1067;8.37647e-15;-187;1670;21008;15840.5;1;534;-2.14748e+09;-8.58362e+06;0;0;0;0;0;0;332686853;333948107;9079948
1068;8.37647e-15;-187;1670;21008;15840.5;1;534;-2.14748e+09;-8.55606e+06;-1;0;0;0;-1;0;333013088;334283193;9125117
1069;8.37647e-15;-187;1670;21008;15840.5;1;534;-2.14748e+09;-8.52863e+06;-1;0;0;0;-1;0;333338409;334617397;9170333
1070;8.37647e-15;-187;1670;21008;15840.5;1;534;-2.14748e+09;-8.50134e+06;-1;0;0;0;-1;0;333662818;334950720;9215596
1071;8.37647e-15;-188;1670;21008;15840.5;1;534;-2.14748e+09;-8.47419e+06;0;0;0;0;0;0;333986320;335283168;9260905
1072;8.37647e-15;-189;1670;21008;15840.5;1;534;-2.14748e+09;-8.44717e+06;0;0;0;0;0;0;334308917;335614744;9306260
1073;8.37647e-15;-190;1670;21008;15840.5;1;534;-2.14748e+09;-8.42028e+06;0;0;0;0;0;0;334630614;335945450;9351661
1074;8.37647e-15;-191;1670;21008;15840.5;1;534;-2.14748e+09;-8.39354e+06;0;0;0;0;0;0;334951413;336275291;9397106
1075;8.37647e-15;-191;1670;21008;15840.5;1;534;-2.14748e+09;-8.36692e+06;-1;0;0;0;-1;0;335271319;336604270;9442595
1076;8.37647e-15;-191;1670;21008;15840.5;1;534;-2.14748e+09;-8.34043e+06;-1;0;0;0;-1;0;335590335;336932390;9488128
1077;8.37647e-15;-191;1670;21008;15840.5;1;534;-2.14748e+09;-8.31407e+06;-1;0;0;0;-1;0;335908463;337259654;9533704
1078;8.37647e-15;-192;1670;21008;15840.5;1;534;-2.14748e+09;-8.28785e+06;0;0;0;0;0;0;336225709;337586067;9579323
1079;8.37647e-15;-192;1670;21008;15840.5;1;534;-2.14748e+09;-8.26175e+06;-1;0;0;0;-1;0;336542074;337911631;9624983
1080;8.37647e-15;-193;1670;21008;15840.5;1;534;-2.14748e+09;-8.23578e+06;0;0;0;0;0;0;336857563;338236349;9670686
1081;8.37647e-15;-194;1670;21008;15840.5;1;534;-2.14748e+09;-8.20994e+06;0;0;0;0;0;0;337172178;338560226;9716429
1082;8.37647e-15;-195;1670;21008;15840.5;1;534;-2.14748e+09;-8.18422e+06;0;0;0;0;0;0;337485923;338883263;9762213
1083;8.37647e-15;-196;1670;21008;15840.5;1;534;-2.14748e+09;-8.15862e+06;0;0;0;0;0;0;337798802;339205465;9808037
1084;8.37647e-15;-196;1670;21008;15840.5;1;534;-2.14748e+09;-8.13316e+06;-1;0;0;0;-1;0;338110817;339526835;9853900
1085;8.37647e-15;-196;1670;21008;15840.5;1;534;-2.14748e+09;-8.10781e+06;-1;0;0;0;-1;0;338421972;339847375;9899802
1086;8.37647e-15;-196;1670;21008;15840.5;1;534;-2.14748e+09;-8.08258e+06;-1;0;0;0;-1;0;338732271;340167090;9945743
1087;8.37647e-15;-197;1670;21008;15840.5;1;534;-2.14748e+09;-8.05748e+06;0;0;0;0;0;0;339041716;340485982;9991722
1088;8.37647e-15;-198;1670;21008;15840.5;1;534;-2.14748e+09;-8.0325e+06;0;0;0;0;0;0;339350310;340804054;10037738
1089;8.37647e-15;-199;1670;21008;15840.5;1;534;-2.14748e+09;-8.00764e+06;0;0;0;0;0;0;339658057;341121310;10083791
1090;8.37647e-15;-199;1670;21008;15840.5;1;534;-2.14748e+09;-7.9829e+06;-1;0;0;0;-1;0;339964961;341437753;10129881
1091;8.37647e-15;-200;1670;21008;15840.5;1;534;-2.14748e+09;-7.95827e+06;0;0;0;0;0;0;340271024;341753386;10176006
1092;8.37647e-15;-201;1670;21008;15840.5;1;534;-2.14748e+09;-7.93376e+06;0;0;0;0;0;0;340576249;342068211;10222167
1093;8.37647e-15;-202;1670;21008;15840.5;1;534;-2.14748e+09;-7.90937e+06;0;0;0;0;0;0;340880640;342382233;10268363
1094;8.37647e-15;-202;1670;21008;15840.5;1;534;-2.14748e+09;-7.8851e+06;-1;0;0;0;-1;0;341184199;342695454;10314594
1095;8.37647e-15;-202;1670;21008;15840.5;1;534;-2.14748e+09;-7.86094e+06;-1;0;0;0;-1;0;341486930;343007877;10360858
1096;8.37647e-15;-202;1670;21008;15840.5;1;534;-2.14748e+09;-7.83689e+06;-1;0;0;0;-1;0;341788837;343319505;10407156
1097;8.37647e-15;-202;1670;21008;15840.5;1;534;-2.14748e+09;-7.81296e+06;-1;0;0;0;-1;0;342089921;343630341;10453487
1098;8.37647e-15;-202;1670;21008;15840.5;1;534;-2.14748e+09;-7.78914e+06;-1;0;0;0;-1;0;342390186;343940389;10499850
1099;8.37647e-15;-203;1670;21008;15840.5;1;534;-2.14748e+09;-7.76543e+06;0;0;0;0;0;0;342689636;344249650;10546245
1100;8.37647e-15;-203;1670;21008;15840.5;1;534;-2.14748e+09;-7.74183e+06;-1;0;0;0;-1;0;342988272;344558129;10592672
1101;8.37647e-15;-204;1670;21008;15840.5;1;534;-2.14748e+09;-7.71834e+06;0;0;0;0;0;0;343286099;344865828;10639130
1102;8.37647e-15;-205;1670;21008;15840.5;1;534;-2.14748e+09;-7.69496e+06;0;0;0;0;0;0;343583119;345172750;10685619
1103;8.37647e-15;-205;1670;21008;15840.5;1;534;-2.14748e+09;-7.67169e+06;-1;0;0;0;-1;0;343879335;345478898;10732137
1104;8.37647e-15;-205;1670;21008;15840.5;1;534;-2.14748e+09;-7.64853e+06;-1;0;0;0;-1;0;344174750;345784275;10778685
1105;8.37647e-15;-206;1670;21008;15840.5;1;534;-2.14748e+09;-7.62547e+06;0;0;0;0;0;0;344469367;346088884;10825263
1106;8.37647e-15;-206;1670;21008;15840.5;1;534;-2.14748e+09;-7.60252e+06;-1;0;0;0;-1;0;344763189;346392727;10871869
1107;8.37647e-15;-207;1670;21008;15840.5;1;534;-2.14748e+09;-7.57968e+06;0;0;0;0;0;0;345056220;346695807;10918503
1108;8.37647e-15;-207;1670;21008;15840.5;1;534;-2.14748e+09;-7.55694e+06;-1;0;0;0;-1;0;345348461;346998128;10965165
1109;8.37647e-15;-208;1670;21008;15840.5;1;534;-2.14748e+09;-7.53431e+06;0;0;0;0;0;0;345639916;347299692;11011854
1110;8.37647e-15;-208;1670;21008;15840.5;1;534;-2.14748e+09;-7.51178e+06;-1;0;0;0;-1;0;345930587;347600502;11058571
1111;8.37647e-15;-209;1670;21008;15840.5;1;534;-2.14748e+09;-7.48936e+06;0;0;0;0;0;0;346220478;347900561;11105313
1112;8.37647e-15;-210;1670;21008;15840.5;1;534;-2.14748e+09;-7.46703e+06;0;0;0;0;0;0;346509591;348199871;11152081
1113;8.37647e-15;-211;1670;21008;15840.5;1;534;-2.14748e+09;-7.44481e+06;0;0;0;0;0;0;346797930;348498436;11198875
1114;8.37647e-15;-211;1670;21008;15840.5;1;534;-2.14748e+09;-7.42268e+06;-1;0;0;0;-1;0;347085496;348796257;11245694
1115;8.37647e-15;-212;1670;21008;15840.5;1;534;-2.14748e+09;-7.40066e+06;0;0;0;0;0;0;347372294;349093338;11292537
1116;8.37647e-15;-212;1670;21008;15840.5;1;534;-2.14748e+09;-7.37874e+06;-1;0;0;0;-1;0;347658325;349389682;11339405
1117;8.37647e-15;-212;1670;21008;15840.5;1;534;-2.14748e+09;-7.35692e+06;-1;0;0;0;-1;0;347943592;349685291;11386296
1118;8.37647e-15;-213;1670;21008;15840.5;1;534;-2.14748e+09;-7.33519e+06;0;0;0;0;0;0;348228099;349980168;11433210
1119;8.37647e-15;-213;1670;21008;15840.5;1;534;-2.14748e+09;-7.31357e+06;-1;0;0;0;-1;0;348511847;350274315;11480147
1120;8.37647e-15;-214;1670;21008;15840.5;1;534;-2.14748e+09;-7.29204e+06;0;0;0;0;0;0;348794840;350567736;11527107
1121;8.37647e-15;-214;1670;21008;15840.5;1;534;-2.14748e+09;-7.2706e+06;-1;0;0;0;-1;0;349077081;350860432;11574088
1122;8.37647e-15;-214;1670;21008;15840.5;1;534;-2.14748e+09;-7.24926e+06;-1;0;0;0;-1;0;349358571;351152407;11621091
1123;8.37647e-15;-214;1670;21008;15840.5;1;534;-2.14748e+09;-7.22802e+06;-1;0;0;0;-1;0;349639315;351443663;11668114
1124;8.37647e-15;-215;1670;21008;15840.5;1;534;-2.14748e+09;-7.20687e+06;0;0;0;0;0;0;349919313;351734202;11715158
1125;8.37647e-15;-215;1670;21008;15840.5;1;534;-2.14748e+09;-7.18582e+06;-1;0;0;0;-1;0;350198570;352024028;11762223
1126;8.37647e-15;-216;1670;21008;15840.5;1;534;-2.14748e+09;-7.16485e+06;0;0;0;0;0;0;350477088;352313143;11809307
1127;8.37647e-15;-216;1670;21008;15840.5;1;534;-2.14748e+09;-7.14398e+06;-1;0;0;0;-1;0;350754869;352601549;11856410
1128;8.37647e-15;-216;1670;21008;15840.5;1;534;-2.14748e+09;-7.12321e+06;-1;0;0;0;-1;0;351031916;352889249;11903532
1129;8.37647e-15;-217;1670;21008;15840.5;1;534;-2.14748e+09;-7.10252e+06;0;0;0;0;0;0;351308232;353176246;11950673
1130;8.37647e-15;-218;1670;21008;15840.5;1;534;-2.14748e+09;-7.08193e+06;0;0;0;0;0;0;351583819;353462542;11997831
1131;8.37647e-15;-219;1670;21008;15840.5;1;534;-2.14748e+09;-7.06142e+06;0;0;0;0;0;0;351858680;353748139;12045007
1132;8.37647e-15;-219;1670;21008;15840.5;1;534;-2.14748e+09;-7.04101e+06;-1;0;0;0;-1;0;352132818;354033040;12092200
1133;8.37647e-15;-219;1670;21008;15840.5;1;534;-2.14748e+09;-7.02068e+06;-1;0;0;0;-1;0;352406234;354317248;12139410
1134;8.37647e-15;-220;1670;21008;15840.5;1;534;-2.14748e+09;-7.00044e+06;0;0;0;0;0;0;352678932;354600765;12186637
1135;8.37647e-15;-220;1670;21008;15840.5;1;534;-2.14748e+09;-6.98029e+06;-1;0;0;0;-1;0;352950915;354883593;12233879
1136;8.37647e-15;-220;1670;21008;15840.5;1;534;-2.14748e+09;-6.96023e+06;-1;0;0;0;-1;0;353222183;355165736;12281136
1137;8.37647e-15;-221;1670;21008;15840.5;1;534;-2.14748e+09;-6.94026e+06;0;0;0;0;0;0;353492741;355447194;12328409
1138;8.37647e-15;-221;1670;21008;15840.5;1;534;-2.14748e+09;-6.92037e+06;-1;0;0;0;-1;0;353762591;355727971;12375697
1139;8.37647e-15;-222;1670;21008;15840.5;1;534;-2.14748e+09;-6.90056e+06;0;0;0;0;0;0;354031735;356008070;12422998
1140;8.37647e-15;-223;1670;21008;15840.5;1;534;-2.14748e+09;-6.88085e+06;0;0;0;0;0;0;354300175;356287492;12470314
1141;8.37647e-15;-223;1670;21008;15840.5;1;534;-2.14748e+09;-6.86121e+06;-1;0;0;0;-1;0;354567914;356566240;12517643
1142;8.37647e-15;-223;1670;21008;15840.5;1;534;-2.14748e+09;-6.84166e+06;-1;0;0;0;-1;0;354834955;356844316;12564985
1143;8.37647e-15;-223;1670;21008;15840.5;1;534;-2.14748e+09;-6.8222e+06;-1;0;0;0;-1;0;355101300;357121723;12612340
1144;8.37647e-15;-223;1670;21008;15840.5;1;534;-2.14748e+09;-6.80282e+06;-1;0;0;0;-1;0;355366951;357398463;12659707
1145;8.37647e-15;-223;1670;21008;15840.5;1;534;-2.14748e+09;-6.78352e+06;-1;0;0;0;-1;0;355631911;357674539;12707086
1146;8.37647e-15;-223;1670;21008;15840.5;1;534;-2.14748e+09;-6.7643e+06;-1;0;0;0;-1;0;355896183;357949952;12754476
1147;8.37647e-15;-224;1670;21008;15840.5;1;534;-2.14748e+09;-6.74516e+06;0;0;0;0;0;0;356159768;358224705;12801877
1148;8.37647e-15;-225;1670;21008;15840.5;1;534;-2.14748e+09;-6.72611e+06;0;0;0;0;0;0;356422668;358498800;12849290
1149;8.37647e-15;-226;1670;21008;15840.5;1;534;-2.14748e+09;-6.70713e+06;0;0;0;0;0;0;356684888;358772240;12896712
1150;8.37647e-15;-227;1670;21008;15840.5;1;534;-2.14748e+09;-6.68824e+06;0;0;0;0;0;0;356946428;359045027;12944145
1151;8.37647e-15;-227;1670;21008;15840.5;1;534;-2.14748e+09;-6.66942e+06;-1;0;0;0;-1;0;357207291;359317163;12991587
1152;8.37647e-15;-227;1670;21008;15840.5;1;534;-2.14748e+09;-6.65069e+06;-1;0;0;0;-1;0;357467479;359588650;13039038
1153;8.37647e-15;-227;1670;21008;15840.5;1;534;-2.14748e+09;-6.63203e+06;-1;0;0;0;-1;0;357726996;359859490;13086498
1154;8.37647e-15;-227;1670;21008;15840.5;1;534;-2.14748e+09;-6.61345e+06;-1;0;0;0;-1;0;357985842;360129687;13133966
1155;8.37647e-15;-228;1670;21008;15840.5;1;534;-2.14748e+09;-6.59495e+06;0;0;0;0;0;0;358244021;360399242;13181442
1156;8.37647e-15;-229;1670;21008;15840.5;1;534;-2.14748e+09;-6.57652e+06;0;0;0;0;0;0;358501534;360668156;13228927
1157;8.37647e-15;-230;1670;21008;15840.5;1;534;-2.14748e+09;-6.55817e+06;0;0;0;0;0;0;358758384;360936434;13276418
1158;8.37647e-15;-231;1670;21008;15840.5;1;534;-2.14748e+09;-6.5399e+06;0;0;0;0;0;0;359014574;361204076;13323916
1159;8.37647e-15;-231;1670;21008;15840.5;1;534;-2.14748e+09;-6.52171e+06;-1;0;0;0;-1;0;359270105;361471084;13371421
1160;8.37647e-15;-232;1670;21008;15840.5;1;534;-2.14748e+09;-6.50359e+06;0;0;0;0;0;0;359524979;361737462;13418932
1161;8.37647e-15;-233;1670;21008;15840.5;1;534;-2.14748e+09;-6.48554e+06;0;0;0;0;0;0;359779200;362003211;13466449
1162;8.37647e-15;-234;1670;21008;15840.5;1;534;-2.14748e+09;-6.46757e+06;0;0;0;0;0;0;360032769;362268333;13513972
1163;8.37647e-15;-234;1670;21008;15840.5;1;534;-2.14748e+09;-6.44967e+06;-1;0;0;0;-1;0;360285688;362532830;13561499
1164;8.37647e-15;-234;1670;21008;15840.5;1;534;-2.14748e+09;-6.43184e+06;-1;0;0;0;-1;0;360537959;362796705;13609031
1165;8.37647e-15;-235;1670;21008;15840.5;1;534;-2.14748e+09;-6.41409e+06;0;0;0;0;0;0;360789586;363059959;13656568
1166;8.37647e-15;-236;1670;21008;15840.5;1;534;-2.14748e+09;-6.39642e+06;0;0;0;0;0;0;361040569;363322595;13704109
1167;8.37647e-15;-236;1670;21008;15840.5;1;534;-2.14748e+09;-6.37881e+06;-1;0;0;0;-1;0;361290912;363584615;13751653
1168;8.37647e-15;-236;1670;21008;15840.5;1;534;-2.14748e+09;-6.36127e+06;-1;0;0;0;-1;0;361540616;363846021;13799201
1169;8.37647e-15;-236;1670;21008;15840.5;1;534;-2.14748e+09;-6.34381e+06;-1;0;0;0;-1;0;361789684;364106814;13846751
1170;8.37647e-15;-236;1670;21008;15840.5;1;534;-2.14748e+09;-6.32642e+06;-1;0;0;0;-1;0;362038117;364366998;13894305
1171;8.37647e-15;-237;1670;21008;15840.5;1;534;-2.14748e+09;-6.30909e+06;0;0;0;0;0;0;362285918;364626574;13941860
1172;8.37647e-15;-237;1670;21008;15840.5;1;534;-2.14748e+09;-6.29184e+06;-1;0;0;0;-1;0;362533088;364885543;13989418
1173;8.37647e-15;-238;1670;21008;15840.5;1;534;-2.14748e+09;-6.27466e+06;0;0;0;0;0;0;362779631;365143909;14036977
1174;8.37647e-15;-239;1670;21008;15840.5;1;534;-2.14748e+09;-6.25754e+06;0;0;0;0;0;0;363025548;365401673;14084537
1175;8.37647e-15;-239;1670;21008;15840.5;1;534;-2.14748e+09;-6.2405e+06;-1;0;0;0;-1;0;363270841;365658837;14132099
1176;8.37647e-15;-239;1670;21008;15840.5;1;534;-2.14748e+09;-6.22352e+06;-1;0;0;0;-1;0;363515512;365915403;14179661
1177;8.37647e-15;-240;1670;21008;15840.5;1;534;-2.14748e+09;-6.20661e+06;0;0;0;0;0;0;363759564;366171373;14227223
1178;8.37647e-15;-241;1670;21008;15840.5;1;534;-2.14748e+09;-6.18977e+06;0;0;0;0;0;0;364002998;366426749;14274785
1179;8.37647e-15;-242;1670;21008;15840.5;1;534;-2.14748e+09;-6.173e+06;0;0;0;0;0;0;364245816;366681533;14322347
1180;8.37647e-15;-242;1670;21008;15840.5;1;534;-2.14748e+09;-6.15629e+06;-1;0;0;0;-1;0;364488022;366935727;14369908
1181;8.37647e-15;-243;1670;21008;15840.5;1;534;-2.14748e+09;-6.13965e+06;0;0;0;0;0;0;364729615;367189333;14417467
1182;8.37647e-15;-244;1670;21008;15840.5;1;534;-2.14748e+09;-6.12307e+06;0;0;0;0;0;0;364970599;367442353;14465026
1183;8.37647e-15;-245;1670;21008;15840.5;1;534;-2.14748e+09;-6.10656e+06;0;0;0;0;0;0;365210976;367694789;14512583
1184;8.37647e-15;-246;1670;21008;15840.5;1;534;-2.14748e+09;-6.09012e+06;0;0;0;0;0;0;365450748;367946642;14560138
1185;8.37647e-15;-247;1670;21008;15840.5;1;534;-2.14748e+09;-6.07374e+06;0;0;0;0;0;0;365689916;368197915;14607690
1186;8.37647e-15;-247;1670;21008;15840.5;1;534;-2.14748e+09;-6.05743e+06;-1;0;0;0;-1;0;365928482;368448610;14655240
1187;8.37647e-15;-248;1670;21008;15840.5;1;534;-2.14748e+09;-6.04118e+06;0;0;0;0;0;0;366166450;368698728;14702786
1188;8.37647e-15;-249;1670;21008;15840.5;1;534;-2.14748e+09;-6.02499e+06;0;0;0;0;0;0;366403820;368948271;14750330
1189;8.37647e-15;-249;1670;21008;15840.5;1;534;-2.14748e+09;-6.00886e+06;-1;0;0;0;-1;0;366640594;369197241;14797870
1190;8.37647e-15;-250;1670;21008;15840.5;1;534;-2.14748e+09;-5.9928e+06;0;0;0;0;0;0;366876775;369445641;14845405
1191;8.37647e-15;-251;1670;21008;15840.5;1;534;-2.14748e+09;-5.97681e+06;0;0;0;0;0;0;367112364;369693471;14892937
1192;8.37647e-15;-251;1670;21008;15840.5;1;534;-2.14748e+09;-5.96087e+06;-1;0;0;0;-1;0;367347364;369940734;14940464
1193;8.37647e-15;-251;1670;21008;15840.5;1;534;-2.14748e+09;-5.945e+06;-1;0;0;0;-1;0;367581776;370187431;14987986
1194;8.37647e-15;-251;1670;21008;15840.5;1;534;-2.14748e+09;-5.92918e+06;-1;0;0;0;-1;0;367815602;370433565;15035503
1195;8.37647e-15;-252;1670;21008;15840.5;1;534;-2.14748e+09;-5.91343e+06;0;0;0;0;0;0;368048844;370679137;15083015
1196;8.37647e-15;-253;1670;21008;15840.5;1;534;-2.14748e+09;-5.89774e+06;0;0;0;0;0;0;368281505;370924149;15130520
1197;8.37647e-15;-254;1670;21008;15840.5;1;534;-2.14748e+09;-5.88211e+06;0;0;0;0;0;0;368513585;371168602;15178020
1198;8.37647e-15;-255;1670;21008;15840.5;1;534;-2.14748e+09;-5.86654e+06;0;0;0;0;0;0;368745087;371412500;15225513
1199;8.37647e-15;-255;1670;21008;15840.5;1;534;-2.14748e+09;-5.85103e+06;-1;0;0;0;-1;0;368976013;371655843;15273000
1200;8.37647e-15;-256;1670;21008;15840.5;1;534;-2.14748e+09;-5.83558e+06;0;0;0;0;0;0;369206364;371898632;15320479
1201;8.37647e-15;-256;1670;21008;15840.5;1;534;-2.14748e+09;-5.82019e+06;-1;0;0;0;-1;0;369436143;372140871;15367952
1202;8.37647e-15;-257;1670;21008;15840.5;1;534;-2.14748e+09;-5.80486e+06;0;0;0;0;0;0;369665351;372382561;15415416
1203;8.37647e-15;-258;1670;21008;15840.5;1;534;-2.14748e+09;-5.78958e+06;0;0;0;0;0;0;369893990;372623702;15462873
1204;8.37647e-15;-259;1670;21008;15840.5;1;534;-2.14748e+09;-5.77437e+06;0;0;0;0;0;0;370122062;372864299;15510322
1205;8.37647e-15;-259;1670;21008;15840.5;1;534;-2.14748e+09;-5.75921e+06;-1;0;0;0;-1;0;370349569;373104350;15557762
1206;8.37647e-15;-259;1670;21008;15840.5;1;534;-2.14748e+09;-5.74411e+06;-1;0;0;0;-1;0;370576513;373343860;15605194
1207;8.37647e-15;-260;1670;21008;15840.5;1;534;-2.14748e+09;-5.72907e+06;0;0;0;0;0;0;370802895;373582829;15652617
1208;8.37647e-15;-260;1670;21008;15840.5;1;534;-2.14748e+09;-5.71408e+06;-1;0;0;0;-1;0;371028717;373821259;15700030
1209;8.37647e-15;-261;1670;21008;15840.5;1;534;-2.14748e+09;-5.69915e+06;0;0;0;0;0;0;371253981;374059151;15747434
1210;8.37647e-15;-261;1670;21008;15840.5;1;534;-2.14748e+09;-5.68428e+06;-1;0;0;0;-1;0;371478689;374296508;15794828
1211;8.37647e-15;-262;1670;21008;15840.5;1;534;-2.14748e+09;-5.66946e+06;0;0;0;0;0;0;371702842;374533332;15842212
1212;8.37647e-15;-263;1670;21008;15840.5;1;534;-2.14748e+09;-5.6547e+06;0;0;0;0;0;0;371926443;374769623;15889585
1213;8.37647e-15;-263;1670;21008;15840.5;1;534;-2.14748e+09;-5.63999e+06;-1;0;0;0;-1;0;372149493;375005383;15936948
1214;8.37647e-15;-263;1670;21008;15840.5;1;534;-2.14748e+09;-5.62534e+06;-1;0;0;0;-1;0;372371994;375240615;15984300
1215;8.37647e-15;-263;1670;21008;15840.5;1;534;-2.14748e+09;-5.61074e+06;-1;0;0;0;-1;0;372593947;375475319;16031640
1216;8.37647e-15;-263;1670;21008;15840.5;1;534;-2.14748e+09;-5.5962e+06;-1;0;0;0;-1;0;372815355;375709498;16078969
1217;8.37647e-15;-264;1670;21008;15840.5;1;534;-2.14748e+09;-5.58171e+06;0;0;0;0;0;0;373036219;375943153;16126287
1218;8.37647e-15;-265;1670;21008;15840.5;1;534;-2.14748e+09;-5.56728e+06;0;0;0;0;0;0;373256540;376176285;16173592
1219;8.37647e-15;-266;1670;21008;15840.5;1;534;-2.14748e+09;-5.5529e+06;0;0;0;0;0;0;373476321;376408897;16220885
1220;8.37647e-15;-267;1670;21008;15840.5;1;534;-2.14748e+09;-5.53857e+06;0;0;0;0;0;0;373695564;376640990;16268166
1221;8.37647e-15;-267;1669;21008;15840.5;1;534;-2.14748e+09;-5.5243e+06;0;0;0;0;0;0;373914269;376872565;16315434
1222;8.37647e-15;-267;1669;21008;15840.5;1;534;-2.14748e+09;-5.51007e+06;-1;0;0;0;-1;0;374132439;377103625;16362688
1223;8.37647e-15;-268;1669;21008;15840.5;1;534;-2.14748e+09;-5.4959e+06;0;0;0;0;0;0;374350075;377334170;16409929
1224;8.37647e-15;-269;1669;21008;15840.5;1;534;-2.14748e+09;-5.48179e+06;0;0;0;0;0;0;374567180;377564203;16457157
1225;8.37647e-15;-269;1669;21008;15840.5;1;534;-2.14748e+09;-5.46772e+06;-1;0;0;0;-1;0;374783754;377793724;16504371
1226;8.37647e-15;-269;1669;21008;15840.5;1;534;-2.14748e+09;-5.45371e+06;-1;0;0;0;-1;0;374999799;378022736;16551571
1227;8.37647e-15;-270;1669;21008;15840.5;1;534;-2.14748e+09;-5.43974e+06;0;0;0;0;0;0;375215317;378251240;16598756
1228;8.37647e-15;-270;1669;21008;15840.5;1;534;-2.14748e+09;-5.42583e+06;-1;0;0;0;-1;0;375430310;378479237;16645927
1229;8.37647e-15;-270;1669;21008;15840.5;1;534;-2.14748e+09;-5.41197e+06;-1;0;0;0;-1;0;375644779;378706730;16693083
1230;8.37647e-15;-271;1669;21008;15840.5;1;534;-2.14748e+09;-5.39816e+06;0;0;0;0;0;0;375858727;378933719;16740224
1231;8.37647e-15;-272;1669;21008;15840.5;1;534;-2.14748e+09;-5.3844e+06;0;0;0;0;0;0;376072153;379160207;16787349
1232;8.37647e-15;-272;1669;21008;15840.5;1;534;-2.14748e+09;-5.37069e+06;-1;0;0;0;-1;0;376285061;379386194;16834459
1233;8.37647e-15;-272;1669;21008;15840.5;1;534;-2.14748e+09;-5.35702e+06;-1;0;0;0;-1;0;376497452;379611683;16881553
1234;8.37647e-15;-273;1669;21008;15840.5;1;534;-2.14748e+09;-5.34341e+06;0;0;0;0;0;0;376709327;379836674;16928631
1235;8.37647e-15;-273;1669;21008;15840.5;1;534;-2.14748e+09;-5.32985e+06;-1;0;0;0;-1;0;376920689;380061170;16975693
1236;8.37647e-15;-274;1669;21008;15840.5;1;534;-2.14748e+09;-5.31634e+06;0;0;0;0;0;0;377131537;380285171;17022738
1237;8.37647e-15;-274;1669;21008;15840.5;1;534;-2.14748e+09;-5.30287e+06;-1;0;0;0;-1;0;377341875;380508680;17069767
1238;8.37647e-15;-275;1669;21008;15840.5;1;534;-2.14748e+09;-5.28945e+06;0;0;0;0;0;0;377551704;380731697;17116778
1239;8.37647e-15;-275;1669;21008;15840.5;1;534;-2.14748e+09;-5.27608e+06;-1;0;0;0;-1;0;377761025;380954225;17163772
1240;8.37647e-15;-276;1669;21008;15840.5;1;534;-2.14748e+09;-5.26276e+06;0;0;0;0;0;0;377969841;381176264;17210748
1241;8.37647e-15;-277;1669;21008;15840.5;1;534;-2.14748e+09;-5.24949e+06;0;0;0;0;0;0;378178151;381397817;17257707
1242;8.37647e-15;-277;1669;21008;15840.5;1;534;-2.14748e+09;-5.23626e+06;-1;0;0;0;-1;0;378385959;381618884;17304648
1243;8.37647e-15;-278;1669;21008;15840.5;1;534;-2.14748e+09;-5.22308e+06;0;0;0;0;0;0;378593265;381839467;17351570
1244;8.37647e-15;-279;1669;21008;15840.5;1;534;-2.14748e+09;-5.20995e+06;0;0;0;0;0;0;378800072;382059568;17398474
1245;8.37647e-15;-280;1669;21008;15840.5;1;534;-2.14748e+09;-5.19686e+06;0;0;0;0;0;0;379006380;382279188;17445360
1246;8.37647e-15;-280;1669;21008;15840.5;1;534;-2.14748e+09;-5.18382e+06;-1;0;0;0;-1;0;379212191;382498328;17492226
1247;8.37647e-15;-281;1669;21008;15840.5;1;534;-2.14748e+09;-5.17083e+06;0;0;0;0;0;0;379417507;382716991;17539074
1248;8.37647e-15;-281;1669;21008;15840.5;1;534;-2.14748e+09;-5.15788e+06;-1;0;0;0;-1;0;379622330;382935176;17585902
1249;8.37647e-15;-282;1669;21008;15840.5;1;534;-2.14748e+09;-5.14498e+06;0;0;0;0;0;0;379826660;383152886;17632711
1250;8.37647e-15;-283;1669;21008;15840.5;1;534;-2.14748e+09;-5.13213e+06;0;0;0;0;0;0;380030499;383370122;17679500
1251;8.37647e-15;-284;1669;21008;15840.5;1;534;-2.14748e+09;-5.11931e+06;0;0;0;0;0;0;380233849;383586886;17726268
1252;8.37647e-15;-284;1669;21008;15840.5;1;534;-2.14748e+09;-5.10655e+06;-1;0;0;0;-1;0;380436712;383803179;17773017
1253;8.37647e-15;-284;1669;21008;15840.5;1;534;-2.14748e+09;-5.09382e+06;-1;0;0;0;-1;0;380639088;384019002;17819745
1254;8.37647e-15;-285;1669;21008;15840.5;1;534;-2.14748e+09;-5.08115e+06;0;0;0;0;0;0;380840979;384234356;17866453
1255;8.37647e-15;-285;1669;21008;15840.5;1;534;-2.14748e+09;-5.06851e+06;-1;0;0;0;-1;0;381042388;384449244;17913139
1256;8.37647e-15;-286;1669;21008;15840.5;1;534;-2.14748e+09;-5.05592e+06;0;0;0;0;0;0;381243314;384663666;17959805
1257;8.37647e-15;-287;1669;21008;15840.5;1;534;-2.14748e+09;-5.04338e+06;0;0;0;0;0;0;381443760;384877624;18006449
1258;8.37647e-15;-287;1669;21008;15840.5;1;534;-2.14748e+09;-5.03088e+06;-1;0;0;0;-1;0;381643727;385091119;18053072
1259;8.37647e-15;-288;1669;21008;15840.5;1;534;-2.14748e+09;-5.01842e+06;0;0;0;0;0;0;381843216;385304152;18099674
1260;8.37647e-15;-289;1669;21008;15840.5;1;534;-2.14748e+09;-5.006e+06;0;0;0;0;0;0;382042230;385516726;18146253
1261;8.37647e-15;-289;1669;21008;15840.5;1;534;-2.14748e+09;-4.99363e+06;-1;0;0;0;-1;0;382240769;385728840;18192810
1262;8.37647e-15;-290;1669;21008;15840.5;1;534;-2.14748e+09;-4.9813e+06;0;0;0;0;0;0;382438834;385940497;18239345
1263;8.37647e-15;-290;1669;21008;15840.5;1;534;-2.14748e+09;-4.96901e+06;-1;0;0;0;-1;0;382636428;386151698;18285857
1264;8.37647e-15;-290;1669;21008;15840.5;1;534;-2.14748e+09;-4.95677e+06;-1;0;0;0;-1;0;382833552;386362445;18332347
1265;8.37647e-15;-290;1669;21008;15840.5;1;534;-2.14748e+09;-4.94456e+06;-1;0;0;0;-1;0;383030207;386572737;18378814
1266;8.37647e-15;-291;1669;21008;15840.5;1;534;-2.14748e+09;-4.9324e+06;0;0;0;0;0;0;383226394;386782578;18425257
1267;8.37647e-15;-291;1669;21008;15840.5;1;534;-2.14748e+09;-4.92028e+06;-1;0;0;0;-1;0;383422116;386991967;18471678
1268;8.37647e-15;-291;1669;21008;15840.5;1;534;-2.14748e+09;-4.9082e+06;-1;0;0;0;-1;0;383617372;387200908;18518074
1269;8.37647e-15;-291;1669;21008;15840.5;1;534;-2.14748e+09;-4.89617e+06;-1;0;0;0;-1;0;383812166;387409399;18564448
1270;8.37647e-15;-291;1669;21008;15840.5;1;534;-2.14748e+09;-4.88417e+06;-1;0;0;0;-1;0;384006497;387617444;18610797
1271;8.37647e-15;-291;1669;21008;15840.5;1;534;-2.14748e+09;-4.87222e+06;-1;0;0;0;-1;0;384200368;387825043;18657122
1272;8.37647e-15;-291;1669;21008;15840.5;1;534;-2.14748e+09;-4.8603e+06;-1;0;0;0;-1;0;384393780;388032198;18703423
1273;8.37647e-15;-291;1669;21008;15840.5;1;534;-2.14748e+09;-4.84843e+06;-1;0;0;0;-1;0;384586734;388238910;18749699
1274;8.37647e-15;-291;1669;21008;15840.5;1;534;-2.14748e+09;-4.83659e+06;-1;0;0;0;-1;0;384779231;388445179;18795951
1275;8.37647e-15;-292;1669;21008;15840.5;1;534;-2.14748e+09;-4.8248e+06;0;0;0;0;0;0;384971273;388651008;18842178
1276;8.37647e-15;-292;1669;21008;15840.5;1;534;-2.14748e+09;-4.81304e+06;-1;0;0;0;-1;0;385162862;388856398;18888380
1277;8.37647e-15;-292;1669;21008;15840.5;1;534;-2.14748e+09;-4.80133e+06;-1;0;0;0;-1;0;385353998;389061350;18934557
1278;8.37647e-15;-293;1669;21008;15840.5;1;534;-2.14748e+09;-4.78965e+06;0;0;0;0;0;0;385544684;389265865;18980708
1279;8.37647e-15;-294;1669;21008;15840.5;1;534;-2.14748e+09;-4.77802e+06;0;0;0;0;0;0;385734919;389469944;19026834
1280;8.37647e-15;-294;1669;21008;15840.5;1;534;-2.14748e+09;-4.76642e+06;-1;0;0;0;-1;0;385924707;389673589;19072933
1281;8.37647e-15;-295;1669;21008;15840.5;1;534;-2.14748e+09;-4.75486e+06;0;0;0;0;0;0;386114047;389876800;19119007
1282;8.37647e-15;-295;1669;21008;15840.5;1;534;-2.14748e+09;-4.74334e+06;-1;0;0;0;-1;0;386302942;390079580;19165055
1283;8.37647e-15;-296;1669;21008;15840.5;1;534;-2.14748e+09;-4.73186e+06;0;0;0;0;0;0;386491392;390281929;19211077
1284;8.37647e-15;-296;1669;21008;15840.5;1;534;-2.14748e+09;-4.72042e+06;-1;0;0;0;-1;0;386679399;390483849;19257072
1285;8.37647e-15;-297;1669;21008;15840.5;1;534;-2.14748e+09;-4.70901e+06;0;0;0;0;0;0;386866964;390685340;19303041
1286;8.37647e-15;-297;1669;21008;15840.5;1;534;-2.14748e+09;-4.69764e+06;-1;0;0;0;-1;0;387054089;390886405;19348982
1287;8.37647e-15;-297;1669;21008;15840.5;1;534;-2.14748e+09;-4.68631e+06;-1;0;0;0;-1;0;387240775;391087043;19394897
1288;8.37647e-15;-297;1669;21008;15840.5;1;534;-2.14748e+09;-4.67502e+06;-1;0;0;0;-1;0;387427022;391287257;19440784
1289;8.37647e-15;-297;1669;21008;15840.5;1;534;-2.14748e+09;-4.66377e+06;-1;0;0;0;-1;0;387612833;391487047;19486644
1290;8.37647e-15;-298;1669;21008;15840.5;1;534;-2.14748e+09;-4.65255e+06;0;0;0;0;0;0;387798209;391686415;19532477
1291;8.37647e-15;-298;1669;21008;15840.5;1;534;-2.14748e+09;-4.64137e+06;-1;0;0;0;-1;0;387983151;391885362;19578282
1292;8.37647e-15;-298;1669;21008;15840.5;1;534;-2.14748e+09;-4.63022e+06;-1;0;0;0;-1;0;388167660;392083889;19624059
1293;8.37647e-15;-298;1669;21008;15840.5;1;534;-2.14748e+09;-4.61912e+06;-1;0;0;0;-1;0;388351737;392281997;19669808
1294;8.37647e-15;-299;1669;21008;15840.5;1;534;-2.14748e+09;-4.60805e+06;0;0;0;0;0;0;388535384;392479688;19715529
1295;8.37647e-15;-299;1669;21008;15840.5;1;534;-2.14748e+09;-4.59701e+06;-1;0;0;0;-1;0;388718602;392676962;19761222
1296;8.37647e-15;-300;1669;21008;15840.5;1;534;-2.14748e+09;-4.58601e+06;0;0;0;0;0;0;388901393;392873821;19806886
1297;8.37647e-15;-301;1669;21008;15840.5;1;534;-2.14748e+09;-4.57505e+06;0;0;0;0;0;0;389083757;393070266;19852521
1298;8.37647e-15;-301;1669;21008;15840.5;1;534;-2.14748e+09;-4.56412e+06;-1;0;0;0;-1;0;389265695;393266298;19898128
1299;8.37647e-15;-302;1669;21008;15840.5;1;534;-2.14748e+09;-4.55323e+06;0;0;0;0;0;0;389447210;393461918;19943706
1300;8.37647e-15;-302;1669;21008;15840.5;1;534;-2.14748e+09;-4.54238e+06;-1;0;0;0;-1;0;389628301;393657127;19989254
1301;8.37647e-15;-302;1669;21008;15840.5;1;534;-2.14748e+09;-4.53156e+06;-1;0;0;0;-1;0;389808971;393851927;20034774
1302;8.37647e-15;-303;1669;21008;15840.5;1;534;-2.14748e+09;-4.52077e+06;0;0;0;0;0;0;389989221;394046318;20080263
1303;8.37647e-15;-304;1669;21008;15840.5;1;534;-2.14748e+09;-4.51002e+06;0;0;0;0;0;0;390169052;394240303;20125724
1304;8.37647e-15;-305;1669;21008;15840.5;1;534;-2.14748e+09;-4.4993e+06;0;0;0;0;0;0;390348464;394433880;20171154
1305;8.37647e-15;-306;1669;21008;15840.5;1;534;-2.14748e+09;-4.48862e+06;0;0;0;0;0;0;390527460;394627053;20216554
1306;8.37647e-15;-307;1669;21008;15840.5;1;534;-2.14748e+09;-4.47798e+06;0;0;0;0;0;0;390706040;394819822;20261925
1307;8.37647e-15;-308;1669;21008;15840.5;1;534;-2.14748e+09;-4.46736e+06;0;0;0;0;0;0;390884206;395012188;20307265
1308;8.37647e-15;-309;1669;21008;15840.5;1;534;-2.14748e+09;-4.45678e+06;0;0;0;0;0;0;391061959;395204152;20352575
1309;8.37647e-15;-309;1669;21008;15840.5;1;534;-2.14748e+09;-4.44624e+06;-1;0;0;0;-1;0;391239300;395395716;20397855
1310;8.37647e-15;-309;1669;21008;15840.5;1;534;-2.14748e+09;-4.43573e+06;-1;0;0;0;-1;0;391416230;395586880;20443103
1311;8.37647e-15;-310;1669;21008;15840.5;1;534;-2.14748e+09;-4.42525e+06;0;0;0;0;0;0;391592750;395777646;20488321
1312;8.37647e-15;-311;1669;21008;15840.5;1;534;-2.14748e+09;-4.41481e+06;0;0;0;0;0;0;391768862;395968014;20533508
1313;8.37647e-15;-311;1669;21008;15840.5;1;534;-2.14748e+09;-4.4044e+06;-1;0;0;0;-1;0;391944567;396157985;20578664
1314;8.37647e-15;-312;1669;21008;15840.5;1;534;-2.14748e+09;-4.39402e+06;0;0;0;0;0;0;392119866;396347562;20623789
1315;8.37647e-15;-313;1669;21008;15840.5;1;534;-2.14748e+09;-4.38368e+06;0;0;0;0;0;0;392294759;396536744;20668882
1316;8.37647e-15;-313;1669;21008;15840.5;1;534;-2.14748e+09;-4.37336e+06;-1;0;0;0;-1;0;392469249;396725534;20713944
1317;8.37647e-15;-314;1669;21008;15840.5;1;534;-2.14748e+09;-4.36308e+06;0;0;0;0;0;0;392643337;396913931;20758974
1318;8.37647e-15;-314;1669;21008;15840.5;1;534;-2.14748e+09;-4.35284e+06;-1;0;0;0;-1;0;392817023;397101937;20803972
1319;8.37647e-15;-314;1669;21008;15840.5;1;534;-2.14748e+09;-4.34262e+06;-1;0;0;0;-1;0;392990308;397289553;20848939
1320;8.37647e-15;-315;1669;21008;15840.5;1;534;-2.14748e+09;-4.33244e+06;0;0;0;0;0;0;393163194;397476781;20893873
1321;8.37647e-15;-315;1669;21008;15840.5;1;534;-2.14748e+09;-4.32229e+06;-1;0;0;0;-1;0;393335683;397663620;20938775
1322;8.37647e-15;-315;1669;21008;15840.5;1;534;-2.14748e+09;-4.31218e+06;-1;0;0;0;-1;0;393507774;397850073;20983645
1323;8.37647e-15;-315;1669;21008;15840.5;1;534;-2.14748e+09;-4.30209e+06;-1;0;0;0;-1;0;393679469;398036140;21028482
1324;8.37647e-15;-316;1669;21008;15840.5;1;534;-2.14748e+09;-4.29204e+06;0;0;0;0;0;0;393850770;398221823;21073287
1325;8.37647e-15;-317;1669;21008;15840.5;1;534;-2.14748e+09;-4.28201e+06;0;0;0;0;0;0;394021677;398407121;21118059
1326;8.37647e-15;-318;1669;21008;15840.5;1;534;-2.14748e+09;-4.27202e+06;0;0;0;0;0;0;394192192;398592037;21162798
1327;8.37647e-15;-319;1669;21008;15840.5;1;534;-2.14748e+09;-4.26206e+06;0;0;0;0;0;0;394362315;398776571;21207504
1328;8.37647e-15;-319;1669;21008;15840.5;1;534;-2.14748e+09;-4.25213e+06;-1;0;0;0;-1;0;394532048;398960725;21252178
1329;8.37647e-15;-319;1669;21008;15840.5;1;534;-2.14748e+09;-4.24224e+06;-1;0;0;0;-1;0;394701392;399144499;21296817
1330;8.37647e-15;-319;1669;21008;15840.5;1;534;-2.14748e+09;-4.23237e+06;-1;0;0;0;-1;0;394870348;399327894;21341424
1331;8.37647e-15;-319;1669;21008;15840.5;1;534;-2.14748e+09;-4.22253e+06;-1;0;0;0;-1;0;395038917;399510912;21385997
1332;8.37647e-15;-319;1669;21008;15840.5;1;534;-2.14748e+09;-4.21272e+06;-1;0;0;0;-1;0;395207100;399693553;21430536
1333;8.37647e-15;-320;1669;21008;15840.5;1;534;-2.14748e+09;-4.20295e+06;0;0;0;0;0;0;395374899;399875819;21475041
1334;8.37647e-15;-320;1669;21008;15840.5;1;534;-2.14748e+09;-4.1932e+06;-1;0;0;0;-1;0;395542313;400057709;21519513
1335;8.37647e-15;-320;1669;21008;15840.5;1;534;-2.14748e+09;-4.18349e+06;-1;0;0;0;-1;0;395709345;400239227;21563951
1336;8.37647e-15;-321;1669;21008;15840.5;1;534;-2.14748e+09;-4.1738e+06;0;0;0;0;0;0;395875996;400420371;21608354
1337;8.37647e-15;-321;1669;21008;15840.5;1;534;-2.14748e+09;-4.16415e+06;-1;0;0;0;-1;0;396042265;400601144;21652724
1338;8.37647e-15;-322;1669;21008;15840.5;1;534;-2.14748e+09;-4.15452e+06;0;0;0;0;0;0;396208156;400781546;21697059
1339;8.37647e-15;-323;1669;21008;15840.5;1;534;-2.14748e+09;-4.14492e+06;0;0;0;0;0;0;396373668;400961579;21741359
1340;8.37647e-15;-324;1669;21008;15840.5;1;534;-2.14748e+09;-4.13536e+06;0;0;0;0;0;0;396538803;401141242;21785625
1341;8.37647e-15;-325;1669;21008;15840.5;1;534;-2.14748e+09;-4.12582e+06;0;0;0;0;0;0;396703561;401320538;21829856
1342;8.37647e-15;-325;1669;21008;15840.5;1;534;-2.14748e+09;-4.11631e+06;-1;0;0;0;-1;0;396867944;401499467;21874053
1343;8.37647e-15;-326;1669;21008;15840.5;1;534;-2.14748e+09;-4.10683e+06;0;0;0;0;0;0;397031954;401678030;21918214
1344;8.37647e-15;-326;1669;21008;15840.5;1;534;-2.14748e+09;-4.09738e+06;-1;0;0;0;-1;0;397195590;401856229;21962340
1345;8.37647e-15;-327;1669;21008;15840.5;1;534;-2.14748e+09;-4.08796e+06;0;0;0;0;0;0;397358853;402034063;22006432
1346;8.37647e-15;-328;1669;21008;15840.5;1;534;-2.14748e+09;-4.07857e+06;0;0;0;0;0;0;397521746;402211534;22050488
1347;8.37647e-15;-329;1669;21008;15840.5;1;534;-2.14748e+09;-4.0692e+06;0;0;0;0;0;0;397684269;402388643;22094508
1348;8.37647e-15;-329;1669;21008;15840.5;1;534;-2.14748e+09;-4.05987e+06;-1;0;0;0;-1;0;397846423;402565391;22138493
1349;8.37647e-15;-330;1669;21008;15840.5;1;534;-2.14748e+09;-4.05056e+06;0;0;0;0;0;0;398008209;402741779;22182443
1350;8.37647e-15;-331;1669;21008;15840.5;1;534;-2.14748e+09;-4.04128e+06;0;0;0;0;0;0;398169628;402917808;22226356
1351;8.37647e-15;-331;1669;21008;15840.5;1;534;-2.14748e+09;-4.03203e+06;-1;0;0;0;-1;0;398330681;403093478;22270234
1352;8.37647e-15;-332;1669;21008;15840.5;1;534;-2.14748e+09;-4.02281e+06;0;0;0;0;0;0;398491369;403268791;22314076
1353;8.37647e-15;-332;1669;21008;15840.5;1;534;-2.14748e+09;-4.01361e+06;-1;0;0;0;-1;0;398651693;403443747;22357882
1354;8.37647e-15;-332;1669;21008;15840.5;1;534;-2.14748e+09;-4.00444e+06;-1;0;0;0;-1;0;398811654;403618348;22401652
1355;8.37647e-15;-333;1669;21008;15840.5;1;534;-2.14748e+09;-3.9953e+06;0;0;0;0;0;0;398971253;403792594;22445386
1356;8.37647e-15;-334;1669;21008;15840.5;1;534;-2.14748e+09;-3.98619e+06;0;0;0;0;0;0;399130491;403966486;22489083
1357;8.37647e-15;-334;1669;21008;15840.5;1;534;-2.14748e+09;-3.9771e+06;-1;0;0;0;-1;0;399289370;404140026;22532744
1358;8.37647e-15;-335;1669;21008;15840.5;1;534;-2.14748e+09;-3.96805e+06;0;0;0;0;0;0;399447889;404313214;22576368
1359;8.37647e-15;-336;1669;21008;15840.5;1;534;-2.14748e+09;-3.95902e+06;0;0;0;0;0;0;399606050;404486050;22619956
1360;8.37647e-15;-336;1669;21008;15840.5;1;534;-2.14748e+09;-3.95001e+06;-1;0;0;0;-1;0;399763855;404658537;22663507
1361;8.37647e-15;-336;1669;21008;15840.5;1;534;-2.14748e+09;-3.94103e+06;-1;0;0;0;-1;0;399921303;404830674;22707021
1362;8.37647e-15;-336;1669;21008;15840.5;1;534;-2.14748e+09;-3.93208e+06;-1;0;0;0;-1;0;400078397;405002463;22750498
1363;8.37647e-15;-336;1669;21008;15840.5;1;534;-2.14748e+09;-3.92316e+06;-1;0;0;0;-1;0;400235136;405173904;22793938
1364;8.37647e-15;-336;1669;21008;15840.5;1;534;-2.14748e+09;-3.91426e+06;-1;0;0;0;-1;0;400391522;405344999;22837341
1365;8.37647e-15;-337;1669;21008;15840.5;1;534;-2.14748e+09;-3.90539e+06;0;0;0;0;0;0;400547556;405515748;22880707
1366;8.37647e-15;-337;1669;21008;15840.5;1;534;-2.14748e+09;-3.89655e+06;-1;0;0;0;-1;0;400703239;405686152;22924036
1367;8.37647e-15;-337;1669;21008;15840.5;1;534;-2.14748e+09;-3.88773e+06;-1;0;0;0;-1;0;400858572;405856213;22967327
1368;8.37647e-15;-337;1669;21008;15840.5;1;534;-2.14748e+09;-3.87893e+06;-1;0;0;0;-1;0;401013555;406025930;23010580
1369;8.37647e-15;-338;1669;21008;15840.5;1;534;-2.14748e+09;-3.87017e+06;0;0;0;0;0;0;401168190;406195305;23053796
1370;8.37647e-15;-339;1669;21008;15840.5;1;534;-2.14748e+09;-3.86143e+06;0;0;0;0;0;0;401322478;406364339;23096974
1371;8.37647e-15;-339;1669;21008;15840.5;1;534;-2.14748e+09;-3.85271e+06;-1;0;0;0;-1;0;401476419;406533032;23140115
1372;8.37647e-15;-339;1669;21008;15840.5;1;534;-2.14748e+09;-3.84402e+06;-1;0;0;0;-1;0;401630015;406701386;23183217
1373;8.37647e-15;-340;1669;21008;15840.5;1;534;-2.14748e+09;-3.83536e+06;0;0;0;0;0;0;401783267;406869401;23226282
1374;8.37647e-15;-340;1669;21008;15840.5;1;534;-2.14748e+09;-3.82672e+06;-1;0;0;0;-1;0;401936174;407037078;23269309
1375;8.37647e-15;-340;1669;21008;15840.5;1;534;-2.14748e+09;-3.81811e+06;-1;0;0;0;-1;0;402088739;407204418;23312297
1376;8.37647e-15;-340;1669;21008;15840.5;1;534;-2.14748e+09;-3.80952e+06;-1;0;0;0;-1;0;402240963;407371421;23355247
1377;8.37647e-15;-340;1669;21008;15840.5;1;534;-2.14748e+09;-3.80096e+06;-1;0;0;0;-1;0;402392845;407538090;23398159
1378;8.37647e-15;-341;1669;21008;15840.5;1;534;-2.14748e+09;-3.79242e+06;0;0;0;0;0;0;402544388;407704424;23441033
1379;8.37647e-15;-342;1669;21008;15840.5;1;534;-2.14748e+09;-3.7839e+06;0;0;0;0;0;0;402695591;407870424;23483868
1380;8.37647e-15;-343;1669;21008;15840.5;1;534;-2.14748e+09;-3.77542e+06;0;0;0;0;0;0;402846457;408036091;23526664
1381;8.37647e-15;-344;1669;21008;15840.5;1;534;-2.14748e+09;-3.76695e+06;0;0;0;0;0;0;402996985;408201426;23569422
1382;8.37647e-15;-345;1669;21008;15840.5;1;534;-2.14748e+09;-3.75851e+06;0;0;0;0;0;0;403147177;408366431;23612141
1383;8.37647e-15;-345;1669;21008;15840.5;1;534;-2.14748e+09;-3.7501e+06;-1;0;0;0;-1;0;403297034;408531104;23654822
1384;8.37647e-15;-346;1669;21008;15840.5;1;534;-2.14748e+09;-3.74171e+06;0;0;0;0;0;0;403446556;408695448;23697463
1385;8.37647e-15;-346;1669;21008;15840.5;1;534;-2.14748e+09;-3.73334e+06;-1;0;0;0;-1;0;403595745;408859464;23740065
1386;8.37647e-15;-347;1669;21008;15840.5;1;534;-2.14748e+09;-3.725e+06;0;0;0;0;0;0;403744601;409023151;23782629
1387;8.37647e-15;-347;1669;21008;15840.5;1;534;-2.14748e+09;-3.71668e+06;-1;0;0;0;-1;0;403893125;409186512;23825153
1388;8.37647e-15;-347;1669;21008;15840.5;1;534;-2.14748e+09;-3.70839e+06;-1;0;0;0;-1;0;404041318;409349546;23867638
1389;8.37647e-15;-347;1669;21008;15840.5;1;534;-2.14748e+09;-3.70012e+06;-1;0;0;0;-1;0;404189181;409512255;23910084
1390;8.37647e-15;-347;1669;21008;15840.5;1;534;-2.14748e+09;-3.69187e+06;-1;0;0;0;-1;0;404336716;409674639;23952491
1391;8.37647e-15;-347;1669;21008;15840.5;1;534;-2.14748e+09;-3.68365e+06;-1;0;0;0;-1;0;404483922;409836699;23994858
1392;8.37647e-15;-347;1669;21008;15840.5;1;534;-2.14748e+09;-3.67545e+06;-1;0;0;0;-1;0;404630800;409998436;24037185
1393;8.37647e-15;-348;1669;21008;15840.5;1;534;-2.14748e+09;-3.66728e+06;0;0;0;0;0;0;404777352;410159850;24079473
1394;8.37647e-15;-349;1669;21008;15840.5;1;534;-2.14748e+09;-3.65912e+06;0;0;0;0;0;0;404923579;410320944;24121722
1395;8.37647e-15;-349;1669;21008;15840.5;1;534;-2.14748e+09;-3.651e+06;-1;0;0;0;-1;0;405069481;410481716;24163930
1396;8.37647e-15;-349;1669;21008;15840.5;1;534;-2.14748e+09;-3.64289e+06;-1;0;0;0;-1;0;405215059;410642169;24206099
1397;8.37647e-15;-349;1669;21008;15840.5;1;534;-2.14748e+09;-3.63481e+06;-1;0;0;0;-1;0;405360313;410802302;24248228
1398;8.37647e-15;-350;1669;21008;15840.5;1;534;-2.14748e+09;-3.62675e+06;0;0;0;0;0;0;405505246;410962117;24290317
1399;8.37647e-15;-351;1669;21008;15840.5;1;534;-2.14748e+09;-3.61871e+06;0;0;0;0;0;0;405649858;411121615;24332366
1400;8.37647e-15;-352;1669;21008;15840.5;1;534;-2.14748e+09;-3.6107e+06;0;0;0;0;0;0;405794149;411280795;24374376
1401;8.37647e-15;-352;1669;21008;15840.5;1;534;-2.14748e+09;-3.60271e+06;-1;0;0;0;-1;0;405938120;411439660;24416344
1402;8.37647e-15;-352;1669;21008;15840.5;1;534;-2.14748e+09;-3.59474e+06;-1;0;0;0;-1;0;406081772;411598210;24458273
1403;8.37647e-15;-352;1669;21008;15840.5;1;534;-2.14748e+09;-3.58679e+06;-1;0;0;0;-1;0;406225107;411756444;24500161
1404;8.37647e-15;-352;1669;21008;15840.5;1;534;-2.14748e+09;-3.57887e+06;-1;0;0;0;-1;0;406368125;411914366;24542010
1405;8.37647e-15;-352;1669;21008;15840.5;1;534;-2.14748e+09;-3.57097e+06;-1;0;0;0;-1;0;406510826;412071974;24583817
1406;8.37647e-15;-353;1669;21008;15840.5;1;534;-2.14748e+09;-3.56309e+06;0;0;0;0;0;0;406653212;412229270;24625584
1407;8.37647e-15;-353;1669;21008;15840.5;1;534;-2.14748e+09;-3.55523e+06;-1;0;0;0;-1;0;406795283;412386255;24667311
1408;8.37647e-15;-353;1669;21008;15840.5;1;534;-2.14748e+09;-3.5474e+06;-1;0;0;0;-1;0;406937041;412542929;24708997
1409;8.37647e-15;-354;1669;21008;15840.5;1;534;-2.14748e+09;-3.53959e+06;0;0;0;0;0;0;407078485;412699293;24750643
1410;8.37647e-15;-355;1669;21008;15840.5;1;534;-2.14748e+09;-3.5318e+06;0;0;0;0;0;0;407219618;412855348;24792247
1411;8.37647e-15;-356;1669;21008;15840.5;1;534;-2.14748e+09;-3.52403e+06;0;0;0;0;0;0;407360439;413011094;24833811
1412;8.37647e-15;-357;1669;21008;15840.5;1;534;-2.14748e+09;-3.51628e+06;0;0;0;0;0;0;407500950;413166533;24875334
1413;8.37647e-15;-358;1669;21008;15840.5;1;534;-2.14748e+09;-3.50856e+06;0;0;0;0;0;0;407641151;413321665;24916816
1414;8.37647e-15;-358;1669;21008;15840.5;1;534;-2.14748e+09;-3.50085e+06;-1;0;0;0;-1;0;407781044;413476490;24958258
1415;8.37647e-15;-358;1669;21008;15840.5;1;534;-2.14748e+09;-3.49317e+06;-1;0;0;0;-1;0;407920628;413631010;24999658
1416;8.37647e-15;-358;1669;21008;15840.5;1;534;-2.14748e+09;-3.48551e+06;-1;0;0;0;-1;0;408059905;413785226;25041017
1417;8.37647e-15;-358;1669;21008;15840.5;1;534;-2.14748e+09;-3.47787e+06;-1;0;0;0;-1;0;408198876;413939137;25082335
1418;8.37647e-15;-358;1669;21008;15840.5;1;534;-2.14748e+09;-3.47025e+06;-1;0;0;0;-1;0;408337541;414092745;25123612
1419;8.37647e-15;-359;1669;21008;15840.5;1;534;-2.14748e+09;-3.46265e+06;0;0;0;0;0;0;408475901;414246050;25164847
1420;8.37647e-15;-359;1669;21008;15840.5;1;534;-2.14748e+09;-3.45508e+06;-1;0;0;0;-1;0;408613957;414399054;25206042
1421;8.37647e-15;-359;1669;21008;15840.5;1;534;-2.14748e+09;-3.44752e+06;-1;0;0;0;-1;0;408751711;414551757;25247195
1422;8.37647e-15;-359;1669;21008;15840.5;1;534;-2.14748e+09;-3.43999e+06;-1;0;0;0;-1;0;408889161;414704159;25288306
1423;8.37647e-15;-359;1669;21008;15840.5;1;534;-2.14748e+09;-3.43248e+06;-1;0;0;0;-1;0;409026310;414856261;25329376
1424;8.37647e-15;-359;1669;21008;15840.5;1;534;-2.14748e+09;-3.42498e+06;-1;0;0;0;-1;0;409163158;415008065;25370405
1425;8.37647e-15;-359;1669;21008;15840.5;1;534;-2.14748e+09;-3.41751e+06;-1;0;0;0;-1;0;409299706;415159570;25411392
1426;8.37647e-15;-360;1669;21008;15840.5;1;534;-2.14748e+09;-3.41006e+06;0;0;0;0;0;0;409435955;415310778;25452337
1427;8.37647e-15;-361;1669;21008;15840.5;1;534;-2.14748e+09;-3.40263e+06;0;0;0;0;0;0;409571905;415461689;25493241
1428;8.37647e-15;-361;1669;21008;15840.5;1;534;-2.14748e+09;-3.39522e+06;-1;0;0;0;-1;0;409707558;415612303;25534103
1429;8.37647e-15;-362;1669;21008;15840.5;1;534;-2.14748e+09;-3.38783e+06;0;0;0;0;0;0;409842913;415762623;25574923
1430;8.37647e-15;-362;1669;21008;15840.5;1;534;-2.14748e+09;-3.38046e+06;-1;0;0;0;-1;0;409977973;415912647;25615701
1431;8.37647e-15;-362;1669;21008;15840.5;1;534;-2.14748e+09;-3.37311e+06;-1;0;0;0;-1;0;410112737;416062378;25656437
1432;8.37647e-15;-362;1669;21008;15840.5;1;534;-2.14748e+09;-3.36578e+06;-1;0;0;0;-1;0;410247206;416211815;25697132
1433;8.37647e-15;-363;1669;21008;15840.5;1;534;-2.14748e+09;-3.35847e+06;0;0;0;0;0;0;410381381;416360960;25737785
1434;8.37647e-15;-364;1669;21008;15840.5;1;534;-2.14748e+09;-3.35118e+06;0;0;0;0;0;0;410515263;416509812;25778395
1435;8.37647e-15;-364;1669;21008;15840.5;1;534;-2.14748e+09;-3.34391e+06;-1;0;0;0;-1;0;410648853;416658373;25818964
1436;8.37647e-15;-365;1669;21008;15840.5;1;534;-2.14748e+09;-3.33666e+06;0;0;0;0;0;0;410782151;416806644;25859490
1437;8.37647e-15;-366;1669;21008;15840.5;1;534;-2.14748e+09;-3.32943e+06;0;0;0;0;0;0;410915159;416954625;25899974
1438;8.37647e-15;-366;1669;21008;15840.5;1;534;-2.14748e+09;-3.32222e+06;-1;0;0;0;-1;0;411047876;417102317;25940416
1439;8.37647e-15;-366;1669;21008;15840.5;1;534;-2.14748e+09;-3.31503e+06;-1;0;0;0;-1;0;411180304;417249720;25980816
1440;8.37647e-15;-367;1669;21008;15840.5;1;534;-2.14748e+09;-3.30786e+06;0;0;0;0;0;0;411312443;417396835;26021174
1441;8.37647e-15;-367;1669;21008;15840.5;1;534;-2.14748e+09;-3.3007e+06;-1;0;0;0;-1;0;411444294;417543663;26061489
1442;8.37647e-15;-367;1669;21008;15840.5;1;534;-2.14748e+09;-3.29357e+06;-1;0;0;0;-1;0;411575858;417690204;26101762
1443;8.37647e-15;-368;1669;21008;15840.5;1;534;-2.14748e+09;-3.28646e+06;0;0;0;0;0;0;411707136;417836460;26141992
1444;8.37647e-15;-369;1669;21008;15840.5;1;534;-2.14748e+09;-3.27936e+06;0;0;0;0;0;0;411838128;417982431;26182180
1445;8.37647e-15;-369;1669;21008;15840.5;1;534;-2.14748e+09;-3.27229e+06;-1;0;0;0;-1;0;411968835;418128116;26222325
1446;8.37647e-15;-370;1669;21008;15840.5;1;534;-2.14748e+09;-3.26523e+06;0;0;0;0;0;0;412099258;418273519;26262428
1447;8.37647e-15;-370;1669;21008;15840.5;1;534;-2.14748e+09;-3.2582e+06;-1;0;0;0;-1;0;412229397;418418638;26302488
1448;8.37647e-15;-371;1669;21008;15840.5;1;534;-2.14748e+09;-3.25118e+06;0;0;0;0;0;0;412359254;418563474;26342506
1449;8.37647e-15;-371;1669;21008;15840.5;1;534;-2.14748e+09;-3.24418e+06;-1;0;0;0;-1;0;412488828;418708028;26382481
1450;8.37647e-15;-372;1669;21008;15840.5;1;534;-2.14748e+09;-3.2372e+06;0;0;0;0;0;0;412618121;418852302;26422414
1451;8.37647e-15;-372;1669;21008;15840.5;1;534;-2.14748e+09;-3.23024e+06;-1;0;0;0;-1;0;412747134;418996294;26462303
1452;8.37647e-15;-372;1669;21008;15840.5;1;534;-2.14748e+09;-3.22329e+06;-1;0;0;0;-1;0;412875867;419140007;26502150
1453;8.37647e-15;-373;1669;21008;15840.5;1;534;-2.14748e+09;-3.21637e+06;0;0;0;0;0;0;413004320;419283441;26541954
1454;8.37647e-15;-373;1669;21008;15840.5;1;534;-2.14748e+09;-3.20946e+06;-1;0;0;0;-1;0;413132495;419426595;26581715
1455;8.37647e-15;-373;1669;21008;15840.5;1;534;-2.14748e+09;-3.20257e+06;-1;0;0;0;-1;0;413260392;419569472;26621434
1456;8.37647e-15;-374;1669;21008;15840.5;1;534;-2.14748e+09;-3.1957e+06;0;0;0;0;0;0;413388013;419712072;26661109
1457;8.37647e-15;-375;1669;21008;15840.5;1;534;-2.14748e+09;-3.18885e+06;0;0;0;0;0;0;413515357;419854395;26700742
1458;8.37647e-15;-375;1669;21008;15840.5;1;534;-2.14748e+09;-3.18202e+06;-1;0;0;0;-1;0;413642425;419996442;26740331
1459;8.37647e-15;-376;1669;21008;15840.5;1;534;-2.14748e+09;-3.1752e+06;0;0;0;0;0;0;413769218;420138213;26779878
1460;8.37647e-15;-377;1669;21008;15840.5;1;534;-2.14748e+09;-3.16841e+06;0;0;0;0;0;0;413895737;420279709;26819381
1461;8.37647e-15;-378;1669;21008;15840.5;1;534;-2.14748e+09;-3.16163e+06;0;0;0;0;0;0;414021983;420420932;26858841
1462;8.37647e-15;-378;1669;21008;15840.5;1;534;-2.14748e+09;-3.15487e+06;-1;0;0;0;-1;0;414147955;420561880;26898259
1463;8.37647e-15;-379;1669;21008;15840.5;1;534;-2.14748e+09;-3.14813e+06;0;0;0;0;0;0;414273656;420702556;26937633
1464;8.37647e-15;-380;1669;21008;15840.5;1;534;-2.14748e+09;-3.1414e+06;0;0;0;0;0;0;414399085;420842960;26976964
1465;8.37647e-15;-380;1669;21008;15840.5;1;534;-2.14748e+09;-3.13469e+06;-1;0;0;0;-1;0;414524243;420983092;27016252
1466;8.37647e-15;-381;1669;21008;15840.5;1;534;-2.14748e+09;-3.128e+06;0;0;0;0;0;0;414649131;421122953;27055496
1467;8.37647e-15;-382;1669;21008;15840.5;1;534;-2.14748e+09;-3.12133e+06;0;0;0;0;0;0;414773750;421262544;27094697
1468;8.37647e-15;-383;1669;21008;15840.5;1;534;-2.14748e+09;-3.11468e+06;0;0;0;0;0;0;414898099;421401864;27133855
1469;8.37647e-15;-383;1669;21008;15840.5;1;534;-2.14748e+09;-3.10804e+06;-1;0;0;0;-1;0;415022181;421540916;27172970
1470;8.37647e-15;-384;1669;21008;15840.5;1;534;-2.14748e+09;-3.10142e+06;0;0;0;0;0;0;415145996;421679699;27212041
1471;8.37647e-15;-384;1669;21008;15840.5;1;534;-2.14748e+09;-3.09482e+06;-1;0;0;0;-1;0;415269543;421818214;27251069
1472;8.37647e-15;-385;1669;21008;15840.5;1;534;-2.14748e+09;-3.08823e+06;0;0;0;0;0;0;415392825;421956461;27290054
1473;8.37647e-15;-385;1669;21008;15840.5;1;534;-2.14748e+09;-3.08166e+06;-1;0;0;0;-1;0;415515841;422094442;27328995
1474;8.37647e-15;-385;1669;21008;15840.5;1;534;-2.14748e+09;-3.07511e+06;-1;0;0;0;-1;0;415638593;422232157;27367892
1475;8.37647e-15;-386;1669;21008;15840.5;1;534;-2.14748e+09;-3.06858e+06;0;0;0;0;0;0;415761080;422369606;27406746
1476;8.37647e-15;-387;1669;21008;15840.5;1;534;-2.14748e+09;-3.06206e+06;0;0;0;0;0;0;415883305;422506790;27445557
1477;8.37647e-15;-388;1669;21008;15840.5;1;534;-2.14748e+09;-3.05556e+06;0;0;0;0;0;0;416005266;422643710;27484324
1478;8.37647e-15;-389;1669;21008;15840.5;1;534;-2.14748e+09;-3.04908e+06;0;0;0;0;0;0;416126965;422780366;27523048
1479;8.37647e-15;-389;1669;21008;15840.5;1;534;-2.14748e+09;-3.04262e+06;-1;0;0;0;-1;0;416248403;422916759;27561728
1480;8.37647e-15;-389;1669;21008;15840.5;1;534;-2.14748e+09;-3.03617e+06;-1;0;0;0;-1;0;416369581;423052890;27600364
1481;8.37647e-15;-390;1669;21008;15840.5;1;534;-2.14748e+09;-3.02974e+06;0;0;0;0;0;0;416490498;423188758;27638957
1482;8.37647e-15;-391;1669;21008;15840.5;1;534;-2.14748e+09;-3.02332e+06;0;0;0;0;0;0;416611155;423324366;27677506
1483;8.37647e-15;-391;1669;21008;15840.5;1;534;-2.14748e+09;-3.01692e+06;-1;0;0;0;-1;0;416731554;423459712;27716011
1484;8.37647e-15;-391;1669;21008;15840.5;1;534;-2.14748e+09;-3.01054e+06;-1;0;0;0;-1;0;416851695;423594798;27754473
1485;8.37647e-15;-392;1669;21008;15840.5;1;534;-2.14748e+09;-3.00417e+06;0;0;0;0;0;0;416971578;423729625;27792891
1486;8.37647e-15;-393;1669;21008;15840.5;1;534;-2.14748e+09;-2.99782e+06;0;0;0;0;0;0;417091204;423864192;27831265
1487;8.37647e-15;-394;1669;21008;15840.5;1;534;-2.14748e+09;-2.99149e+06;0;0;0;0;0;0;417210574;423998501;27869596
1488;8.37647e-15;-395;1669;21008;15840.5;1;534;-2.14748e+09;-2.98518e+06;0;0;0;0;0;0;417329689;424132552;27907882
1489;8.37647e-15;-395;1669;21008;15840.5;1;534;-2.14748e+09;-2.97888e+06;-1;0;0;0;-1;0;417448548;424266346;27946125
1490;8.37647e-15;-396;1669;21008;15840.5;1;534;-2.14748e+09;-2.97259e+06;0;0;0;0;0;0;417567153;424399884;27984324
1491;8.37647e-15;-396;1669;21008;15840.5;1;534;-2.14748e+09;-2.96632e+06;-1;0;0;0;-1;0;417685505;424533165;28022480
1492;8.37647e-15;-396;1669;21008;15840.5;1;534;-2.14748e+09;-2.96007e+06;-1;0;0;0;-1;0;417803603;424666190;28060591
1493;8.37647e-15;-397;1669;21008;15840.5;1;534;-2.14748e+09;-2.95384e+06;0;0;0;0;0;0;417921449;424798961;28098659
1494;8.37647e-15;-397;1669;21008;15840.5;1;534;-2.14748e+09;-2.94762e+06;-1;0;0;0;-1;0;418039043;424931477;28136682
1495;8.37647e-15;-397;1669;21008;15840.5;1;534;-2.14748e+09;-2.94141e+06;-1;0;0;0;-1;0;418156386;425063739;28174662
1496;8.37647e-15;-398;1669;21008;15840.5;1;534;-2.14748e+09;-2.93522e+06;0;0;0;0;0;0;418273479;425195748;28212598
1497;8.37647e-15;-398;1669;21008;15840.5;1;534;-2.14748e+09;-2.92905e+06;-1;0;0;0;-1;0;418390321;425327505;28250490
1498;8.37647e-15;-399;1669;21008;15840.5;1;534;-2.14748e+09;-2.9229e+06;0;0;0;0;0;0;418506914;425459009;28288338
1499;8.37647e-15;-400;1669;21008;15840.5;1;534;-2.14748e+09;-2.91676e+06;0;0;0;0;0;0;418623259;425590261;28326142
1500;8.37647e-15;-400;1669;21008;15840.5;1;534;-2.14748e+09;-2.91063e+06;-1;0;0;0;-1;0;418739355;425721262;28363902
1501;8.37647e-15;-400;1669;21008;15840.5;1;534;-2.14748e+09;-2.90452e+06;-1;0;0;0;-1;0;418855204;425852013;28401618
1502;8.37647e-15;-401;1669;21008;15840.5;1;534;-2.14748e+09;-2.89843e+06;0;0;0;0;0;0;418970806;425982514;28439290
1503;8.37647e-15;-401;1669;21008;15840.5;1;534;-2.14748e+09;-2.89235e+06;-1;0;0;0;-1;0;419086162;426112766;28476918
1504;8.37647e-15;-401;1669;21008;15840.5;1;534;-2.14748e+09;-2.88629e+06;-1;0;0;0;-1;0;419201272;426242769;28514502
1505;8.37647e-15;-401;1669;21008;15840.5;1;534;-2.14748e+09;-2.88024e+06;-1;0;0;0;-1;0;419316137;426372523;28552042
1506;8.37647e-15;-402;1669;21008;15840.5;1;534;-2.14748e+09;-2.87421e+06;0;0;0;0;0;0;419430758;426502030;28589538
1507;8.37647e-15;-402;1669;21008;15840.5;1;534;-2.14748e+09;-2.86819e+06;-1;0;0;0;-1;0;419545134;426631290;28626989
1508;8.37647e-15;-402;1669;21008;15840.5;1;534;-2.14748e+09;-2.86219e+06;-1;0;0;0;-1;0;419659268;426760303;28664397
1509;8.37647e-15;-403;1669;21008;15840.5;1;534;-2.14748e+09;-2.8562e+06;0;0;0;0;0;0;419773159;426889069;28701761
1510;8.37647e-15;-403;1669;21008;15840.5;1;534;-2.14748e+09;-2.85023e+06;-1;0;0;0;-1;0;419886808;427017591;28739080
1511;8.37647e-15;-403;1669;21008;15840.5;1;534;-2.14748e+09;-2.84427e+06;-1;0;0;0;-1;0;420000215;427145867;28776355
1512;8.37647e-15;-404;1669;21008;15840.5;1;534;-2.14748e+09;-2.83833e+06;0;0;0;0;0;0;420113382;427273899;28813587
1513;8.37647e-15;-404;1669;21008;15840.5;1;534;-2.14748e+09;-2.8324e+06;-1;0;0;0;-1;0;420226308;427401687;28850774
1514;8.37647e-15;-405;1669;21008;15840.5;1;534;-2.14748e+09;-2.82649e+06;0;0;0;0;0;0;420338994;427529231;28887917
1515;8.37647e-15;-406;1669;21008;15840.5;1;534;-2.14748e+09;-2.8206e+06;0;0;0;0;0;0;420451442;427656533;28925015
1516;8.37647e-15;-406;1669;21008;15840.5;1;534;-2.14748e+09;-2.81472e+06;-1;0;0;0;-1;0;420563651;427783592;28962070
1517;8.37647e-15;-407;1669;21008;15840.5;1;534;-2.14748e+09;-2.80885e+06;0;0;0;0;0;0;420675622;427910409;28999081
1518;8.37647e-15;-408;1669;21008;15840.5;1;534;-2.14748e+09;-2.803e+06;0;0;0;0;0;0;420787355;428036985;29036047
1519;8.37647e-15;-409;1669;21008;15840.5;1;534;-2.14748e+09;-2.79716e+06;0;0;0;0;0;0;420898852;428163321;29072969
1520;8.37647e-15;-410;1669;21008;15840.5;1;534;-2.14748e+09;-2.79134e+06;0;0;0;0;0;0;421010113;428289416;29109847
1521;8.37647e-15;-411;1669;21008;15840.5;1;534;-2.14748e+09;-2.78553e+06;0;0;0;0;0;0;421121138;428415271;29146680
1522;8.37647e-15;-412;1669;21008;15840.5;1;534;-2.14748e+09;-2.77973e+06;0;0;0;0;0;0;421231928;428540887;29183470
1523;8.37647e-15;-412;1669;21008;15840.5;1;534;-2.14748e+09;-2.77395e+06;-1;0;0;0;-1;0;421342484;428666265;29220215
1524;8.37647e-15;-413;1669;21008;15840.5;1;534;-2.14748e+09;-2.76819e+06;0;0;0;0;0;0;421452805;428791404;29256916
1525;8.37647e-15;-414;1669;21008;15840.5;1;534;-2.14748e+09;-2.76244e+06;0;0;0;0;0;0;421562894;428916306;29293573
1526;8.37647e-15;-414;1669;21008;15840.5;1;534;-2.14748e+09;-2.7567e+06;-1;0;0;0;-1;0;421672750;429040971;29330186
1527;8.37647e-15;-415;1669;21008;15840.5;1;534;-2.14748e+09;-2.75098e+06;0;0;0;0;0;0;421782373;429165399;29366754
1528;8.37647e-15;-416;1669;21008;15840.5;1;534;-2.14748e+09;-2.74527e+06;0;0;0;0;0;0;421891765;429289591;29403278
1529;8.37647e-15;-416;1669;21008;15840.5;1;534;-2.14748e+09;-2.73958e+06;-1;0;0;0;-1;0;422000926;429413548;29439758
1530;8.37647e-15;-417;1669;21008;15840.5;1;534;-2.14748e+09;-2.7339e+06;0;0;0;0;0;0;422109856;429537269;29476193
1531;8.37647e-15;-418;1669;21008;15840.5;1;534;-2.14748e+09;-2.72823e+06;0;0;0;0;0;0;422218556;429660756;29512585
1532;8.37647e-15;-418;1669;21008;15840.5;1;534;-2.14748e+09;-2.72258e+06;-1;0;0;0;-1;0;422327027;429784009;29548932
1533;8.37647e-15;-419;1669;21008;15840.5;1;534;-2.14748e+09;-2.71694e+06;0;0;0;0;0;0;422435269;429907028;29585235
1534;8.37647e-15;-420;1669;21008;15840.5;1;534;-2.14748e+09;-2.71132e+06;0;0;0;0;0;0;422543283;430029814;29621493
1535;8.37647e-15;-421;1669;21008;15840.5;1;534;-2.14748e+09;-2.70571e+06;0;0;0;0;0;0;422651069;430152368;29657707
1536;8.37647e-15;-422;1669;21008;15840.5;1;534;-2.14748e+09;-2.70011e+06;0;0;0;0;0;0;422758628;430274690;29693877
1537;8.37647e-15;-422;1669;21008;15840.5;1;534;-2.14748e+09;-2.69453e+06;-1;0;0;0;-1;0;422865960;430396780;29730003
1538;8.37647e-15;-423;1669;21008;15840.5;1;534;-2.14748e+09;-2.68896e+06;0;0;0;0;0;0;422973066;430518639;29766085
1539;8.37647e-15;-424;1669;21008;15840.5;1;534;-2.14748e+09;-2.68341e+06;0;0;0;0;0;0;423079947;430640268;29802122
1540;8.37647e-15;-425;1669;21008;15840.5;1;534;-2.14748e+09;-2.67786e+06;0;0;0;0;0;0;423186602;430761666;29838115
1541;8.37647e-15;-426;1669;21008;15840.5;1;534;-2.14748e+09;-2.67234e+06;0;0;0;0;0;0;423293034;430882835;29874064
1542;8.37647e-15;-426;1669;21008;15840.5;1;534;-2.14748e+09;-2.66682e+06;-1;0;0;0;-1;0;423399241;431003776;29909968
1543;8.37647e-15;-426;1669;21008;15840.5;1;534;-2.14748e+09;-2.66132e+06;-1;0;0;0;-1;0;423505225;431124487;29945828
1544;8.37647e-15;-426;1669;21008;15840.5;1;534;-2.14748e+09;-2.65584e+06;-1;0;0;0;-1;0;423610986;431244970;29981644
1545;8.37647e-15;-427;1669;21008;15840.5;1;534;-2.14748e+09;-2.65036e+06;0;0;0;0;0;0;423716525;431365226;30017416
1546;8.37647e-15;-427;1669;21008;15840.5;1;534;-2.14748e+09;-2.6449e+06;-1;0;0;0;-1;0;423821842;431485255;30053143
1547;8.37647e-15;-428;1669;21008;15840.5;1;534;-2.14748e+09;-2.63946e+06;0;0;0;0;0;0;423926938;431605057;30088826
1548;8.37647e-15;-429;1669;21008;15840.5;1;534;-2.14748e+09;-2.63402e+06;0;0;0;0;0;0;424031813;431724633;30124465
1549;8.37647e-15;-430;1669;21008;15840.5;1;534;-2.14748e+09;-2.6286e+06;0;0;0;0;0;0;424136468;431843983;30160060
1550;8.37647e-15;-430;1669;21008;15840.5;1;534;-2.14748e+09;-2.62319e+06;-1;0;0;0;-1;0;424240903;431963109;30195610
1551;8.37647e-15;-430;1669;21008;15840.5;1;534;-2.14748e+09;-2.6178e+06;-1;0;0;0;-1;0;424345119;432082009;30231116
1552;8.37647e-15;-430;1669;21008;15840.5;1;534;-2.14748e+09;-2.61242e+06;-1;0;0;0;-1;0;424449117;432200685;30266578
1553;8.37647e-15;-430;1669;21008;15840.5;1;534;-2.14748e+09;-2.60705e+06;-1;0;0;0;-1;0;424552897;432319138;30301995
1554;8.37647e-15;-431;1669;21008;15840.5;1;534;-2.14748e+09;-2.6017e+06;0;0;0;0;0;0;424656459;432437367;30337369
1555;8.37647e-15;-432;1669;21008;15840.5;1;534;-2.14748e+09;-2.59636e+06;0;0;0;0;0;0;424759804;432555374;30372698
1556;8.37647e-15;-433;1669;21008;15840.5;1;534;-2.14748e+09;-2.59103e+06;0;0;0;0;0;0;424862932;432673158;30407983
1557;8.37647e-15;-434;1669;21008;15840.5;1;534;-2.14748e+09;-2.58571e+06;0;0;0;0;0;0;424965845;432790721;30443223
1558;8.37647e-15;-434;1669;21008;15840.5;1;534;-2.14748e+09;-2.58041e+06;-1;0;0;0;-1;0;425068542;432908062;30478420
1559;8.37647e-15;-435;1669;21008;15840.5;1;534;-2.14748e+09;-2.57512e+06;0;0;0;0;0;0;425171024;433025182;30513572
1560;8.37647e-15;-436;1669;21008;15840.5;1;534;-2.14748e+09;-2.56984e+06;0;0;0;0;0;0;425273291;433142082;30548680
1561;8.37647e-15;-436;1669;21008;15840.5;1;534;-2.14748e+09;-2.56458e+06;-1;0;0;0;-1;0;425375345;433258762;30583744
1562;8.37647e-15;-437;1669;21008;15840.5;1;534;-2.14748e+09;-2.55932e+06;0;0;0;0;0;0;425477185;433375222;30618763
1563;8.37647e-15;-438;1669;21008;15840.5;1;534;-2.14748e+09;-2.55408e+06;0;0;0;0;0;0;425578813;433491464;30653739
1564;8.37647e-15;-438;1669;21008;15840.5;1;534;-2.14748e+09;-2.54886e+06;-1;0;0;0;-1;0;425680228;433607487;30688670
1565;8.37647e-15;-439;1669;21008;15840.5;1;534;-2.14748e+09;-2.54364e+06;0;0;0;0;0;0;425781431;433723292;30723557
1566;8.37647e-15;-440;1669;21008;15840.5;1;534;-2.14748e+09;-2.53844e+06;0;0;0;0;0;0;425882423;433838879;30758400
1567;8.37647e-15;-440;1669;21008;15840.5;1;534;-2.14748e+09;-2.53325e+06;-1;0;0;0;-1;0;425983204;433954249;30793199
1568;8.37647e-15;-441;1669;21008;15840.5;1;534;-2.14748e+09;-2.52808e+06;0;0;0;0;0;0;426083774;434069402;30827953
1569;8.37647e-15;-441;1669;21008;15840.5;1;534;-2.14748e+09;-2.52291e+06;-1;0;0;0;-1;0;426184134;434184339;30862664
1570;8.37647e-15;-441;1669;21008;15840.5;1;534;-2.14748e+09;-2.51776e+06;-1;0;0;0;-1;0;426284286;434299060;30897330
1571;8.37647e-15;-442;1669;21008;15840.5;1;534;-2.14748e+09;-2.51262e+06;0;0;0;0;0;0;426384228;434413566;30931952
1572;8.37647e-15;-443;1669;21008;15840.5;1;534;-2.14748e+09;-2.5075e+06;0;0;0;0;0;0;426483962;434527857;30966530
1573;8.37647e-15;-443;1669;21008;15840.5;1;534;-2.14748e+09;-2.50238e+06;-1;0;0;0;-1;0;426583488;434641934;31001064
1574;8.37647e-15;-444;1669;21008;15840.5;1;534;-2.14748e+09;-2.49728e+06;0;0;0;0;0;0;426682806;434755796;31035554
1575;8.37647e-15;-444;1669;21008;15840.5;1;534;-2.14748e+09;-2.49219e+06;-1;0;0;0;-1;0;426781918;434869445;31070000
1576;8.37647e-15;-445;1669;21008;15840.5;1;534;-2.14748e+09;-2.48711e+06;0;0;0;0;0;0;426880823;434982881;31104401
1577;8.37647e-15;-446;1669;21008;15840.5;1;534;-2.14748e+09;-2.48204e+06;0;0;0;0;0;0;426979522;435096104;31138759
1578;8.37647e-15;-446;1669;21008;15840.5;1;534;-2.14748e+09;-2.47699e+06;-1;0;0;0;-1;0;427078016;435209115;31173072
1579;8.37647e-15;-446;1669;21008;15840.5;1;534;-2.14748e+09;-2.47195e+06;-1;0;0;0;-1;0;427176305;435321915;31207342
1580;8.37647e-15;-446;1669;21008;15840.5;1;534;-2.14748e+09;-2.46692e+06;-1;0;0;0;-1;0;427274389;435434503;31241567
1581;8.37647e-15;-446;1669;21008;15840.5;1;534;-2.14748e+09;-2.4619e+06;-1;0;0;0;-1;0;427372269;435546880;31275748
1582;8.37647e-15;-446;1669;21008;15840.5;1;534;-2.14748e+09;-2.45689e+06;-1;0;0;0;-1;0;427469946;435659046;31309886
1583;8.37647e-15;-447;1669;21008;15840.5;1;534;-2.14748e+09;-2.4519e+06;0;0;0;0;0;0;427567419;435771003;31343979
1584;8.37647e-15;-448;1669;21008;15840.5;1;534;-2.14748e+09;-2.44692e+06;0;0;0;0;0;0;427664690;435882750;31378029
1585;8.37647e-15;-449;1669;21008;15840.5;1;534;-2.14748e+09;-2.44194e+06;0;0;0;0;0;0;427761759;435994288;31412034
1586;8.37647e-15;-450;1669;21008;15840.5;1;534;-2.14748e+09;-2.43699e+06;0;0;0;0;0;0;427858627;436105618;31445995
1587;8.37647e-15;-451;1669;21008;15840.5;1;534;-2.14748e+09;-2.43204e+06;0;0;0;0;0;0;427955293;436216739;31479913
1588;8.37647e-15;-451;1669;21008;15840.5;1;534;-2.14748e+09;-2.4271e+06;-1;0;0;0;-1;0;428051759;436327652;31513786
1589;8.37647e-15;-452;1669;21008;15840.5;1;534;-2.14748e+09;-2.42218e+06;0;0;0;0;0;0;428148024;436438358;31547616
1590;8.37647e-15;-453;1669;21008;15840.5;1;534;-2.14748e+09;-2.41727e+06;0;0;0;0;0;0;428244090;436548857;31581402
1591;8.37647e-15;-453;1669;21008;15840.5;1;534;-2.14748e+09;-2.41237e+06;-1;0;0;0;-1;0;428339956;436659149;31615143
1592;8.37647e-15;-454;1669;21008;15840.5;1;534;-2.14748e+09;-2.40748e+06;0;0;0;0;0;0;428435623;436769235;31648841
1593;8.37647e-15;-454;1669;21008;15840.5;1;534;-2.14748e+09;-2.4026e+06;-1;0;0;0;-1;0;428531093;436879116;31682495
1594;8.37647e-15;-455;1669;21008;15840.5;1;534;-2.14748e+09;-2.39774e+06;0;0;0;0;0;0;428626364;436988791;31716105
1595;8.37647e-15;-456;1669;21008;15840.5;1;534;-2.14748e+09;-2.39288e+06;0;0;0;0;0;0;428721438;437098262;31749672
1596;8.37647e-15;-456;1669;21008;15840.5;1;534;-2.14748e+09;-2.38804e+06;-1;0;0;0;-1;0;428816315;437207528;31783194
1597;8.37647e-15;-457;1669;21008;15840.5;1;534;-2.14748e+09;-2.38321e+06;0;0;0;0;0;0;428910995;437316590;31816673
1598;8.37647e-15;-458;1669;21008;15840.5;1;534;-2.14748e+09;-2.37838e+06;0;0;0;0;0;0;429005480;437425449;31850108
1599;8.37647e-15;-458;1669;21008;15840.5;1;534;-2.14748e+09;-2.37358e+06;-1;0;0;0;-1;0;429099769;437534105;31883499
1600;8.37647e-15;-459;1669;21008;15840.5;1;534;-2.14748e+09;-2.36878e+06;0;0;0;0;0;0;429193863;437642557;31916846
1601;8.37647e-15;-460;1669;21008;15840.5;1;534;-2.14748e+09;-2.36399e+06;0;0;0;0;0;0;429287762;437750808;31950150
1602;8.37647e-15;-460;1669;21008;15840.5;1;534;-2.14748e+09;-2.35922e+06;-1;0;0;0;-1;0;429381467;437858857;31983409
1603;8.37647e-15;-460;1669;21008;15840.5;1;534;-2.14748e+09;-2.35445e+06;-1;0;0;0;-1;0;429474978;437966704;32016626
1604;8.37647e-15;-460;1669;21008;15840.5;1;534;-2.14748e+09;-2.3497e+06;-1;0;0;0;-1;0;429568296;438074350;32049798
1605;8.37647e-15;-461;1669;21008;15840.5;1;534;-2.14748e+09;-2.34496e+06;0;0;0;0;0;0;429661421;438181796;32082927
1606;8.37647e-15;-462;1669;21008;15840.5;1;534;-2.14748e+09;-2.34023e+06;0;0;0;0;0;0;429754354;438289041;32116012
1607;8.37647e-15;-463;1669;21008;15840.5;1;534;-2.14748e+09;-2.33551e+06;0;0;0;0;0;0;429847095;438396087;32149053
1608;8.37647e-15;-464;1669;21008;15840.5;1;534;-2.14748e+09;-2.3308e+06;0;0;0;0;0;0;429939644;438502933;32182051
1609;8.37647e-15;-465;1669;21008;15840.5;1;534;-2.14748e+09;-2.3261e+06;0;0;0;0;0;0;430032002;438609580;32215005
1610;8.37647e-15;-466;1669;21008;15840.5;1;534;-2.14748e+09;-2.32141e+06;0;0;0;0;0;0;430124170;438716028;32247916
1611;8.37647e-15;-467;1669;21008;15840.5;1;534;-2.14748e+09;-2.31674e+06;0;0;0;0;0;0;430216148;438822279;32280783
1612;8.37647e-15;-468;1669;21008;15840.5;1;534;-2.14748e+09;-2.31207e+06;0;0;0;0;0;0;430307935;438928332;32313606
1613;8.37647e-15;-469;1669;21008;15840.5;1;534;-2.14748e+09;-2.30742e+06;0;0;0;0;0;0;430399534;439034187;32346386
1614;8.37647e-15;-469;1669;21008;15840.5;1;534;-2.14748e+09;-2.30277e+06;-1;0;0;0;-1;0;430490943;439139845;32379122
1615;8.37647e-15;-470;1669;21008;15840.5;1;534;-2.14748e+09;-2.29814e+06;0;0;0;0;0;0;430582165;439245307;32411815
1616;8.37647e-15;-471;1669;21008;15840.5;1;534;-2.14748e+09;-2.29352e+06;0;0;0;0;0;0;430673198;439350573;32444464
1617;8.37647e-15;-472;1669;21008;15840.5;1;534;-2.14748e+09;-2.28891e+06;0;0;0;0;0;0;430764044;439455643;32477070
1618;8.37647e-15;-473;1669;21008;15840.5;1;534;-2.14748e+09;-2.28431e+06;0;0;0;0;0;0;430854702;439560517;32509633
1619;8.37647e-15;-474;1669;21008;15840.5;1;534;-2.14748e+09;-2.27972e+06;0;0;0;0;0;0;430945174;439665197;32542152
1620;8.37647e-15;-475;1669;21008;15840.5;1;534;-2.14748e+09;-2.27514e+06;0;0;0;0;0;0;431035460;439769682;32574627
1621;8.37647e-15;-476;1669;21008;15840.5;1;534;-2.14748e+09;-2.27057e+06;0;0;0;0;0;0;431125560;439873973;32607059
1622;8.37647e-15;-476;1669;21008;15840.5;1;534;-2.14748e+09;-2.26601e+06;-1;0;0;0;-1;0;431215475;439978071;32639448
1623;8.37647e-15;-477;1669;21008;15840.5;1;534;-2.14748e+09;-2.26146e+06;0;0;0;0;0;0;431305204;440081974;32671794
1624;8.37647e-15;-477;1669;21008;15840.5;1;534;-2.14748e+09;-2.25692e+06;-1;0;0;0;-1;0;431394749;440185685;32704096
1625;8.37647e-15;-478;1669;21008;15840.5;1;534;-2.14748e+09;-2.2524e+06;0;0;0;0;0;0;431484110;440289204;32736355
1626;8.37647e-15;-478;1669;21008;15840.5;1;534;-2.14748e+09;-2.24788e+06;-1;0;0;0;-1;0;431573288;440392530;32768570
1627;8.37647e-15;-479;1669;21008;15840.5;1;534;-2.14748e+09;-2.24337e+06;0;0;0;0;0;0;431662282;440495664;32800743
1628;8.37647e-15;-479;1669;21008;15840.5;1;534;-2.14748e+09;-2.23888e+06;-1;0;0;0;-1;0;431751093;440598607;32832872
1629;8.37647e-15;-479;1669;21008;15840.5;1;534;-2.14748e+09;-2.23439e+06;-1;0;0;0;-1;0;431839722;440701359;32864958
1630;8.37647e-15;-480;1669;21008;15840.5;1;534;-2.14748e+09;-2.22992e+06;0;0;0;0;0;0;431928169;440803921;32897000
1631;8.37647e-15;-480;1669;21008;15840.5;1;534;-2.14748e+09;-2.22545e+06;-1;0;0;0;-1;0;432016434;440906292;32929000
1632;8.37647e-15;-480;1669;21008;15840.5;1;534;-2.14748e+09;-2.221e+06;-1;0;0;0;-1;0;432104518;441008473;32960956
1633;8.37647e-15;-480;1669;21008;15840.5;1;534;-2.14748e+09;-2.21655e+06;-1;0;0;0;-1;0;432192422;441110465;32992869
1634;8.37647e-15;-480;1669;21008;15840.5;1;534;-2.14748e+09;-2.21212e+06;-1;0;0;0;-1;0;432280145;441212268;33024740
1635;8.37647e-15;-481;1669;21008;15840.5;1;534;-2.14748e+09;-2.2077e+06;0;0;0;0;0;0;432367688;441313882;33056567
1636;8.37647e-15;-482;1669;21008;15840.5;1;534;-2.14748e+09;-2.20328e+06;0;0;0;0;0;0;432455052;441415307;33088351
1637;8.37647e-15;-482;1669;21008;15840.5;1;534;-2.14748e+09;-2.19888e+06;-1;0;0;0;-1;0;432542236;441516545;33120091
1638;8.37647e-15;-482;1669;21008;15840.5;1;534;-2.14748e+09;-2.19448e+06;-1;0;0;0;-1;0;432629242;441617595;33151789
1639;8.37647e-15;-482;1669;21008;15840.5;1;534;-2.14748e+09;-2.1901e+06;-1;0;0;0;-1;0;432716070;441718458;33183444
1640;8.37647e-15;-483;1669;21008;15840.5;1;534;-2.14748e+09;-2.18572e+06;0;0;0;0;0;0;432802720;441819135;33215056
1641;8.37647e-15;-484;1669;21008;15840.5;1;534;-2.14748e+09;-2.18136e+06;0;0;0;0;0;0;432889192;441919625;33246625
1642;8.37647e-15;-485;1669;21008;15840.5;1;534;-2.14748e+09;-2.17701e+06;0;0;0;0;0;0;432975488;442019928;33278151
1643;8.37647e-15;-486;1669;21008;15840.5;1;534;-2.14748e+09;-2.17266e+06;0;0;0;0;0;0;433061607;442120047;33309634
1644;8.37647e-15;-486;1669;21008;15840.5;1;534;-2.14748e+09;-2.16833e+06;-1;0;0;0;-1;0;433147549;442219979;33341075
1645;8.37647e-15;-487;1669;21008;15840.5;1;534;-2.14748e+09;-2.164e+06;0;0;0;0;0;0;433233316;442319727;33372472
1646;8.37647e-15;-487;1669;21008;15840.5;1;534;-2.14748e+09;-2.15969e+06;-1;0;0;0;-1;0;433318907;442419291;33403827
1647;8.37647e-15;-487;1669;21008;15840.5;1;534;-2.14748e+09;-2.15538e+06;-1;0;0;0;-1;0;433404324;442518670;33435139
1648;8.37647e-15;-487;1669;21008;15840.5;1;534;-2.14748e+09;-2.15109e+06;-1;0;0;0;-1;0;433489565;442617865;33466408
1649;8.37647e-15;-488;1669;21008;15840.5;1;534;-2.14748e+09;-2.1468e+06;0;0;0;0;0;0;433574633;442716877;33497634
1650;8.37647e-15;-489;1669;21008;15840.5;1;534;-2.14748e+09;-2.14253e+06;0;0;0;0;0;0;433659527;442815706;33528818
1651;8.37647e-15;-490;1669;21008;15840.5;1;534;-2.14748e+09;-2.13826e+06;0;0;0;0;0;0;433744247;442914352;33559959
1652;8.37647e-15;-491;1669;21008;15840.5;1;534;-2.14748e+09;-2.13401e+06;0;0;0;0;0;0;433828794;443012816;33591057
1653;8.37647e-15;-491;1669;21008;15840.5;1;534;-2.14748e+09;-2.12976e+06;-1;0;0;0;-1;0;433913168;443111098;33622112
1654;8.37647e-15;-491;1669;21008;15840.5;1;534;-2.14748e+09;-2.12552e+06;-1;0;0;0;-1;0;433997371;443209198;33653125
1655;8.37647e-15;-491;1669;21008;15840.5;1;534;-2.14748e+09;-2.1213e+06;-1;0;0;0;-1;0;434081401;443307117;33684096
1656;8.37647e-15;-492;1669;21008;15840.5;1;534;-2.14748e+09;-2.11708e+06;0;0;0;0;0;0;434165260;443404855;33715023
1657;8.37647e-15;-493;1669;21008;15840.5;1;534;-2.14748e+09;-2.11287e+06;0;0;0;0;0;0;434248948;443502413;33745909
1658;8.37647e-15;-494;1669;21008;15840.5;1;534;-2.14748e+09;-2.10867e+06;0;0;0;0;0;0;434332466;443599791;33776751
1659;8.37647e-15;-494;1669;21008;15840.5;1;534;-2.14748e+09;-2.10448e+06;-1;0;0;0;-1;0;434415813;443696988;33807552
1660;8.37647e-15;-494;1669;21008;15840.5;1;534;-2.14748e+09;-2.1003e+06;-1;0;0;0;-1;0;434498990;443794007;33838309
1661;8.37647e-15;-495;1669;21008;15840.5;1;534;-2.14748e+09;-2.09613e+06;0;0;0;0;0;0;434581997;443890846;33869025
1662;8.37647e-15;-495;1669;21008;15840.5;1;534;-2.14748e+09;-2.09197e+06;-1;0;0;0;-1;0;434664835;443987506;33899698
1663;8.37647e-15;-496;1669;21008;15840.5;1;534;-2.14748e+09;-2.08782e+06;0;0;0;0;0;0;434747505;444083988;33930328
1664;8.37647e-15;-497;1669;21008;15840.5;1;534;-2.14748e+09;-2.08367e+06;0;0;0;0;0;0;434830006;444180292;33960916
1665;8.37647e-15;-497;1669;21008;15840.5;1;534;-2.14748e+09;-2.07954e+06;-1;0;0;0;-1;0;434912340;444276419;33991462
1666;8.37647e-15;-497;1669;21008;15840.5;1;534;-2.14748e+09;-2.07542e+06;-1;0;0;0;-1;0;434994505;444372368;34021966
1667;8.37647e-15;-498;1669;21008;15840.5;1;534;-2.14748e+09;-2.0713e+06;0;0;0;0;0;0;435076504;444468140;34052427
1668;8.37647e-15;-499;1669;21008;15840.5;1;534;-2.14748e+09;-2.0672e+06;0;0;0;0;0;0;435158335;444563736;34082846
1669;8.37647e-15;-500;1669;21008;15840.5;1;534;-2.14748e+09;-2.0631e+06;0;0;0;0;0;0;435240000;444659155;34113223
1670;8.37647e-15;-501;1669;21008;15840.5;1;534;-2.14748e+09;-2.05901e+06;0;0;0;0;0;0;435321499;444754399;34143558
1671;8.37647e-15;-501;1669;21008;15840.5;1;534;-2.14748e+09;-2.05493e+06;-1;0;0;0;-1;0;435402833;444849467;34173850
1672;8.37647e-15;-501;1669;21008;15840.5;1;534;-2.14748e+09;-2.05086e+06;-1;0;0;0;-1;0;435484001;444944359;34204101
1673;8.37647e-15;-502;1669;21008;15840.5;1;534;-2.14748e+09;-2.0468e+06;0;0;0;0;0;0;435565004;445039077;34234309
1674;8.37647e-15;-502;1669;21008;15840.5;1;534;-2.14748e+09;-2.04275e+06;-1;0;0;0;-1;0;435645842;445133621;34264475
1675;8.37647e-15;-503;1669;21008;15840.5;1;534;-2.14748e+09;-2.03871e+06;0;0;0;0;0;0;435726516;445227990;34294599
1676;8.37647e-15;-504;1669;21008;15840.5;1;534;-2.14748e+09;-2.03468e+06;0;0;0;0;0;0;435807027;445322185;34324681
1677;8.37647e-15;-504;1669;21008;15840.5;1;534;-2.14748e+09;-2.03066e+06;-1;0;0;0;-1;0;435887373;445416207;34354721
1678;8.37647e-15;-505;1669;21008;15840.5;1;534;-2.14748e+09;-2.02664e+06;0;0;0;0;0;0;435967557;445510056;34384720
1679;8.37647e-15;-506;1669;21008;15840.5;1;534;-2.14748e+09;-2.02263e+06;0;0;0;0;0;0;436047578;445603732;34414676
1680;8.37647e-15;-506;1669;21008;15840.5;1;534;-2.14748e+09;-2.01864e+06;-1;0;0;0;-1;0;436127436;445697236;34444590
1681;8.37647e-15;-507;1669;21008;15840.5;1;534;-2.14748e+09;-2.01465e+06;0;0;0;0;0;0;436207133;445790568;34474463
1682;8.37647e-15;-507;1669;21008;15840.5;1;534;-2.14748e+09;-2.01067e+06;-1;0;0;0;-1;0;436286668;445883728;34504293
1683;8.37647e-15;-508;1669;21008;15840.5;1;534;-2.14748e+09;-2.0067e+06;0;0;0;0;0;0;436366041;445976716;34534082
1684;8.37647e-15;-509;1669;21008;15840.5;1;534;-2.14748e+09;-2.00274e+06;0;0;0;0;0;0;436445254;446069533;34563829
1685;8.37647e-15;-510;1669;21008;15840.5;1;534;-2.14748e+09;-1.99878e+06;0;0;0;0;0;0;436524306;446162180;34593535
1686;8.37647e-15;-510;1669;21008;15840.5;1;534;-2.14748e+09;-1.99484e+06;-1;0;0;0;-1;0;436603198;446254656;34623198
1687;8.37647e-15;-510;1669;21008;15840.5;1;534;-2.14748e+09;-1.99091e+06;-1;0;0;0;-1;0;436681930;446346962;34652820
1688;8.37647e-15;-510;1669;21008;15840.5;1;534;-2.14748e+09;-1.98698e+06;-1;0;0;0;-1;0;436760502;446439099;34682400
1689;8.37647e-15;-510;1669;21008;15840.5;1;534;-2.14748e+09;-1.98306e+06;-1;0;0;0;-1;0;436838916;446531066;34711939
1690;8.37647e-15;-510;1669;21008;15840.5;1;534;-2.14748e+09;-1.97915e+06;-1;0;0;0;-1;0;436917170;446622864;34741436
1691;8.37647e-15;-511;1669;21008;15840.5;1;534;-2.14748e+09;-1.97525e+06;0;0;0;0;0;0;436995267;446714493;34770892
1692;8.37647e-15;-512;1669;21008;15840.5;1;534;-2.14748e+09;-1.97136e+06;0;0;0;0;0;0;437073205;446805954;34800305
1693;8.37647e-15;-512;1669;21008;15840.5;1;534;-2.14748e+09;-1.96747e+06;-1;0;0;0;-1;0;437150985;446897247;34829678
1694;8.37647e-15;-513;1669;21008;15840.5;1;534;-2.14748e+09;-1.9636e+06;0;0;0;0;0;0;437228608;446988372;34859009
1695;8.37647e-15;-513;1669;21008;15840.5;1;534;-2.14748e+09;-1.95973e+06;-1;0;0;0;-1;0;437306074;447079330;34888298
1696;8.37647e-15;-514;1669;21008;15840.5;1;534;-2.14748e+09;-1.95587e+06;0;0;0;0;0;0;437383383;447170120;34917547
1697;8.37647e-15;-514;1669;21008;15840.5;1;534;-2.14748e+09;-1.95203e+06;-1;0;0;0;-1;0;437460536;447260744;34946753
1698;8.37647e-15;-514;1669;21008;15840.5;1;534;-2.14748e+09;-1.94818e+06;-1;0;0;0;-1;0;437537534;447351202;34975919
1699;8.37647e-15;-515;1669;21008;15840.5;1;534;-2.14748e+09;-1.94435e+06;0;0;0;0;0;0;437614375;447441493;35005043
1700;8.37647e-15;-515;1669;21008;15840.5;1;534;-2.14748e+09;-1.94053e+06;-1;0;0;0;-1;0;437691061;447531619;35034126
1701;8.37647e-15;-516;1669;21008;15840.5;1;534;-2.14748e+09;-1.93671e+06;0;0;0;0;0;0;437767593;447621579;35063167
1702;8.37647e-15;-517;1669;21008;15840.5;1;534;-2.14748e+09;-1.93291e+06;0;0;0;0;0;0;437843969;447711374;35092167
1703;8.37647e-15;-518;1669;21008;15840.5;1;534;-2.14748e+09;-1.92911e+06;0;0;0;0;0;0;437920192;447801005;35121127
1704;8.37647e-15;-518;1669;21008;15840.5;1;534;-2.14748e+09;-1.92532e+06;-1;0;0;0;-1;0;437996261;447890470;35150045
1705;8.37647e-15;-518;1669;21008;15840.5;1;534;-2.14748e+09;-1.92153e+06;-1;0;0;0;-1;0;438072176;447979772;35178921
1706;8.37647e-15;-519;1669;21008;15840.5;1;534;-2.14748e+09;-1.91776e+06;0;0;0;0;0;0;438147938;448068910;35207757
1707;8.37647e-15;-520;1669;21008;15840.5;1;534;-2.14748e+09;-1.91399e+06;0;0;0;0;0;0;438223547;448157884;35236552
1708;8.37647e-15;-520;1669;21008;15840.5;1;534;-2.14748e+09;-1.91024e+06;-1;0;0;0;-1;0;438299003;448246696;35265306
1709;8.37647e-15;-520;1669;21008;15840.5;1;534;-2.14748e+09;-1.90649e+06;-1;0;0;0;-1;0;438374308;448335344;35294018
1710;8.37647e-15;-521;1669;21008;15840.5;1;534;-2.14748e+09;-1.90274e+06;0;0;0;0;0;0;438449460;448423830;35322690
1711;8.37647e-15;-522;1669;21008;15840.5;1;534;-2.14748e+09;-1.89901e+06;0;0;0;0;0;0;438524461;448512153;35351321
1712;8.37647e-15;-523;1669;21008;15840.5;1;534;-2.14748e+09;-1.89529e+06;0;0;0;0;0;0;438599311;448600315;35379911
1713;8.37647e-15;-524;1669;21008;15840.5;1;534;-2.14748e+09;-1.89157e+06;0;0;0;0;0;0;438674010;448688315;35408460
1714;8.37647e-15;-525;1669;21008;15840.5;1;534;-2.14748e+09;-1.88786e+06;0;0;0;0;0;0;438748559;448776154;35436968
1715;8.37647e-15;-526;1669;21008;15840.5;1;534;-2.14748e+09;-1.88416e+06;0;0;0;0;0;0;438822957;448863832;35465436
1716;8.37647e-15;-526;1669;21008;15840.5;1;534;-2.14748e+09;-1.88047e+06;-1;0;0;0;-1;0;438897206;448951349;35493863
1717;8.37647e-15;-526;1669;21008;15840.5;1;534;-2.14748e+09;-1.87678e+06;-1;0;0;0;-1;0;438971305;449038706;35522249
1718;8.37647e-15;-527;1669;21008;15840.5;1;534;-2.14748e+09;-1.87311e+06;0;0;0;0;0;0;439045255;449125903;35550594
1719;8.37647e-15;-527;1669;21008;15840.5;1;534;-2.14748e+09;-1.86944e+06;-1;0;0;0;-1;0;439119056;449212940;35578899
1720;8.37647e-15;-527;1669;21008;15840.5;1;534;-2.14748e+09;-1.86578e+06;-1;0;0;0;-1;0;439192709;449299818;35607163
1721;8.37647e-15;-528;1669;21008;15840.5;1;534;-2.14748e+09;-1.86213e+06;0;0;0;0;0;0;439266213;449386536;35635386
1722;8.37647e-15;-528;1669;21008;15840.5;1;534;-2.14748e+09;-1.85848e+06;-1;0;0;0;-1;0;439339570;449473096;35663569
1723;8.37647e-15;-528;1669;21008;15840.5;1;534;-2.14748e+09;-1.85485e+06;-1;0;0;0;-1;0;439412779;449559498;35691711
1724;8.37647e-15;-529;1669;21008;15840.5;1;534;-2.14748e+09;-1.85122e+06;0;0;0;0;0;0;439485841;449645741;35719813
1725;8.37647e-15;-529;1669;21008;15840.5;1;534;-2.14748e+09;-1.8476e+06;-1;0;0;0;-1;0;439558756;449731826;35747875
1726;8.37647e-15;-529;1669;21008;15840.5;1;534;-2.14748e+09;-1.84398e+06;-1;0;0;0;-1;0;439631524;449817754;35775896
1727;8.37647e-15;-530;1669;21008;15840.5;1;534;-2.14748e+09;-1.84038e+06;0;0;0;0;0;0;439704146;449903525;35803876
1728;8.37647e-15;-531;1669;21008;15840.5;1;534;-2.14748e+09;-1.83678e+06;0;0;0;0;0;0;439776623;449989138;35831817
1729;8.37647e-15;-532;1669;21008;15840.5;1;534;-2.14748e+09;-1.83319e+06;0;0;0;0;0;0;439848954;450074595;35859717
1730;8.37647e-15;-532;1669;21008;15840.5;1;534;-2.14748e+09;-1.82961e+06;-1;0;0;0;-1;0;439921139;450159896;35887576
1731;8.37647e-15;-533;1669;21008;15840.5;1;534;-2.14748e+09;-1.82604e+06;0;0;0;0;0;0;439993180;450245041;35915396
1732;8.37647e-15;-533;1669;21008;15840.5;1;534;-2.14748e+09;-1.82247e+06;-1;0;0;0;-1;0;440065076;450330030;35943175
1733;8.37647e-15;-533;1669;21008;15840.5;1;534;-2.14748e+09;-1.81891e+06;-1;0;0;0;-1;0;440136828;450414863;35970914
1734;8.37647e-15;-534;1669;21008;15840.5;1;534;-2.14748e+09;-1.81536e+06;0;0;0;0;0;0;440208435;450499542;35998613
1735;8.37647e-15;-534;1669;21008;15840.5;1;534;-2.14748e+09;-1.81182e+06;-1;0;0;0;-1;0;440279899;450584065;36026272
1736;8.37647e-15;-534;1669;21008;15840.5;1;534;-2.14748e+09;-1.80828e+06;-1;0;0;0;-1;0;440351220;450668434;36053891
1737;8.37647e-15;-535;1669;21008;15840.5;1;534;-2.14748e+09;-1.80476e+06;0;0;0;0;0;0;440422398;450752649;36081469
1738;8.37647e-15;-535;1669;21008;15840.5;1;534;-2.14748e+09;-1.80123e+06;-1;0;0;0;-1;0;440493433;450836710;36109008
1739;8.37647e-15;-535;1669;21008;15840.5;1;534;-2.14748e+09;-1.79772e+06;-1;0;0;0;-1;0;440564326;450920617;36136507
1740;8.37647e-15;-535;1669;21008;15840.5;1;534;-2.14748e+09;-1.79422e+06;-1;0;0;0;-1;0;440635076;451004371;36163966
1741;8.37647e-15;-536;1669;21008;15840.5;1;534;-2.14748e+09;-1.79072e+06;0;0;0;0;0;0;440705685;451087972;36191385
1742;8.37647e-15;-537;1669;21008;15840.5;1;534;-2.14748e+09;-1.78723e+06;0;0;0;0;0;0;440776152;451171421;36218764
1743;8.37647e-15;-537;1669;21008;15840.5;1;534;-2.14748e+09;-1.78375e+06;-1;0;0;0;-1;0;440846479;451254716;36246103
1744;8.37647e-15;-538;1669;21008;15840.5;1;534;-2.14748e+09;-1.78027e+06;0;0;0;0;0;0;440916664;451337860;36273402
1745;8.37647e-15;-538;1669;21008;15840.5;1;534;-2.14748e+09;-1.7768e+06;-1;0;0;0;-1;0;440986709;451420852;36300662
1746;8.37647e-15;-538;1669;21008;15840.5;1;534;-2.14748e+09;-1.77334e+06;-1;0;0;0;-1;0;441056613;451503692;36327882
1747;8.37647e-15;-539;1669;21008;15840.5;1;534;-2.14748e+09;-1.76989e+06;0;0;0;0;0;0;441126378;451586381;36355063
1748;8.37647e-15;-540;1669;21008;15840.5;1;534;-2.14748e+09;-1.76644e+06;0;0;0;0;0;0;441196003;451668919;36382203
1749;8.37647e-15;-541;1669;21008;15840.5;1;534;-2.14748e+09;-1.76301e+06;0;0;0;0;0;0;441265489;451751306;36409304
1750;8.37647e-15;-541;1669;21008;15840.5;1;534;-2.14748e+09;-1.75958e+06;-1;0;0;0;-1;0;441334836;451833543;36436366
1751;8.37647e-15;-542;1669;21008;15840.5;1;534;-2.14748e+09;-1.75615e+06;0;0;0;0;0;0;441404044;451915629;36463388
1752;8.37647e-15;-542;1669;21008;15840.5;1;534;-2.14748e+09;-1.75274e+06;-1;0;0;0;-1;0;441473114;451997566;36490371
1753;8.37647e-15;-543;1669;21008;15840.5;1;534;-2.14748e+09;-1.74933e+06;0;0;0;0;0;0;441542045;452079354;36517314
1754;8.37647e-15;-544;1669;21008;15840.5;1;534;-2.14748e+09;-1.74593e+06;0;0;0;0;0;0;441610839;452160992;36544217
1755;8.37647e-15;-545;1669;21008;15840.5;1;534;-2.14748e+09;-1.74253e+06;0;0;0;0;0;0;441679496;452242481;36571082
1756;8.37647e-15;-546;1669;21008;15840.5;1;534;-2.14748e+09;-1.73914e+06;0;0;0;0;0;0;441748015;452323821;36597907
1757;8.37647e-15;-547;1669;21008;15840.5;1;534;-2.14748e+09;-1.73577e+06;0;0;0;0;0;0;441816397;452405014;36624692
1758;8.37647e-15;-547;1669;21008;15840.5;1;534;-2.14748e+09;-1.73239e+06;-1;0;0;0;-1;0;441884643;452486058;36651439
1759;8.37647e-15;-547;1669;21008;15840.5;1;534;-2.14748e+09;-1.72903e+06;-1;0;0;0;-1;0;441952752;452566954;36678146
1760;8.37647e-15;-547;1669;21008;15840.5;1;534;-2.14748e+09;-1.72567e+06;-1;0;0;0;-1;0;442020726;452647702;36704814
1761;8.37647e-15;-548;1669;21008;15840.5;1;534;-2.14748e+09;-1.72232e+06;0;0;0;0;0;0;442088564;452728304;36731442
1762;8.37647e-15;-548;1669;21008;15840.5;1;534;-2.14748e+09;-1.71897e+06;-1;0;0;0;-1;0;442156266;452808758;36758032
1763;8.37647e-15;-549;1669;21008;15840.5;1;534;-2.14748e+09;-1.71564e+06;0;0;0;0;0;0;442223833;452889066;36784583
1764;8.37647e-15;-550;1669;21008;15840.5;1;534;-2.14748e+09;-1.71231e+06;0;0;0;0;0;0;442291266;452969227;36811094
1765;8.37647e-15;-551;1669;21008;15840.5;1;534;-2.14748e+09;-1.70899e+06;0;0;0;0;0;0;442358564;453049243;36837567
1766;8.37647e-15;-551;1669;21008;15840.5;1;534;-2.14748e+09;-1.70567e+06;-1;0;0;0;-1;0;442425728;453129112;36864000
1767;8.37647e-15;-552;1669;21008;15840.5;1;534;-2.14748e+09;-1.70236e+06;0;0;0;0;0;0;442492758;453208836;36890395
1768;8.37647e-15;-552;1669;21008;15840.5;1;534;-2.14748e+09;-1.69906e+06;-1;0;0;0;-1;0;442559654;453288414;36916750
1769;8.37647e-15;-552;1669;21008;15840.5;1;534;-2.14748e+09;-1.69577e+06;-1;0;0;0;-1;0;442626417;453367848;36943067
1770;8.37647e-15;-552;1669;21008;15840.5;1;534;-2.14748e+09;-1.69248e+06;-1;0;0;0;-1;0;442693046;453447137;36969345
1771;8.37647e-15;-552;1669;21008;15840.5;1;534;-2.14748e+09;-1.6892e+06;-1;0;0;0;-1;0;442759543;453526281;36995584
1772;8.37647e-15;-552;1669;21008;15840.5;1;534;-2.14748e+09;-1.68592e+06;-1;0;0;0;-1;0;442825908;453605281;37021785
1773;8.37647e-15;-552;1669;21008;15840.5;1;534;-2.14748e+09;-1.68266e+06;-1;0;0;0;-1;0;442892140;453684138;37047947
1774;8.37647e-15;-552;1669;21008;15840.5;1;534;-2.14748e+09;-1.6794e+06;-1;0;0;0;-1;0;442958241;453762850;37074070
1775;8.37647e-15;-553;1669;21008;15840.5;1;534;-2.14748e+09;-1.67615e+06;0;0;0;0;0;0;443024210;453841420;37100154
1776;8.37647e-15;-554;1669;21008;15840.5;1;534;-2.14748e+09;-1.6729e+06;0;0;0;0;0;0;443090047;453919846;37126200
1777;8.37647e-15;-554;1669;21008;15840.5;1;534;-2.14748e+09;-1.66966e+06;-1;0;0;0;-1;0;443155754;453998129;37152207
1778;8.37647e-15;-555;1669;21008;15840.5;1;534;-2.14748e+09;-1.66643e+06;0;0;0;0;0;0;443221330;454076270;37178176
1779;8.37647e-15;-556;1669;21008;15840.5;1;534;-2.14748e+09;-1.6632e+06;0;0;0;0;0;0;443286775;454154269;37204106
1780;8.37647e-15;-556;1669;21008;15840.5;1;534;-2.14748e+09;-1.65999e+06;-1;0;0;0;-1;0;443352090;454232125;37229998
1781;8.37647e-15;-557;1669;21008;15840.5;1;534;-2.14748e+09;-1.65677e+06;0;0;0;0;0;0;443417275;454309840;37255851
1782;8.37647e-15;-557;1669;21008;15840.5;1;534;-2.14748e+09;-1.65357e+06;-1;0;0;0;-1;0;443482331;454387414;37281666
1783;8.37647e-15;-557;1669;21008;15840.5;1;534;-2.14748e+09;-1.65037e+06;-1;0;0;0;-1;0;443547257;454464846;37307443
1784;8.37647e-15;-558;1669;21008;15840.5;1;534;-2.14748e+09;-1.64718e+06;0;0;0;0;0;0;443612054;454542137;37333182
1785;8.37647e-15;-559;1669;21008;15840.5;1;534;-2.14748e+09;-1.644e+06;0;0;0;0;0;0;443676723;454619288;37358882
1786;8.37647e-15;-559;1669;21008;15840.5;1;534;-2.14748e+09;-1.64082e+06;-1;0;0;0;-1;0;443741263;454696298;37384544
1787;8.37647e-15;-559;1669;21008;15840.5;1;534;-2.14748e+09;-1.63765e+06;-1;0;0;0;-1;0;443805674;454773168;37410167
1788;8.37647e-15;-560;1669;21008;15840.5;1;534;-2.14748e+09;-1.63448e+06;0;0;0;0;0;0;443869958;454849899;37435753
1789;8.37647e-15;-560;1669;21008;15840.5;1;534;-2.14748e+09;-1.63132e+06;-1;0;0;0;-1;0;443934114;454926490;37461301
1790;8.37647e-15;-561;1669;21008;15840.5;1;534;-2.14748e+09;-1.62817e+06;0;0;0;0;0;0;443998142;455002941;37486810
1791;8.37647e-15;-561;1669;21008;15840.5;1;534;-2.14748e+09;-1.62503e+06;-1;0;0;0;-1;0;444062044;455079253;37512282
1792;8.37647e-15;-562;1669;21008;15840.5;1;534;-2.14748e+09;-1.62189e+06;0;0;0;0;0;0;444125819;455155427;37537715
1793;8.37647e-15;-562;1669;21008;15840.5;1;534;-2.14748e+09;-1.61876e+06;-1;0;0;0;-1;0;444189467;455231462;37563111
1794;8.37647e-15;-563;1669;21008;15840.5;1;534;-2.14748e+09;-1.61563e+06;0;0;0;0;0;0;444252988;455307359;37588468
1795;8.37647e-15;-564;1669;21008;15840.5;1;534;-2.14748e+09;-1.61252e+06;0;0;0;0;0;0;444316384;455383118;37613788
1796;8.37647e-15;-565;1669;21008;15840.5;1;534;-2.14748e+09;-1.6094e+06;0;0;0;0;0;0;444379654;455458739;37639070
1797;8.37647e-15;-565;1669;21008;15840.5;1;534;-2.14748e+09;-1.6063e+06;-1;0;0;0;-1;0;444442799;455534223;37664314
1798;8.37647e-15;-565;1669;21008;15840.5;1;534;-2.14748e+09;-1.6032e+06;-1;0;0;0;-1;0;444505818;455609569;37689520
1799;8.37647e-15;-566;1669;21008;15840.5;1;534;-2.14748e+09;-1.60011e+06;0;0;0;0;0;0;444568712;455684779;37714689
1800;8.37647e-15;-567;1669;21008;15840.5;1;534;-2.14748e+09;-1.59702e+06;0;0;0;0;0;0;444631482;455759852;37739820
1801;8.37647e-15;-567;1669;21008;15840.5;1;534;-2.14748e+09;-1.59394e+06;-1;0;0;0;-1;0;444694127;455834788;37764913
1802;8.37647e-15;-567;1669;21008;15840.5;1;534;-2.14748e+09;-1.59087e+06;-1;0;0;0;-1;0;444756648;455909588;37789969
1803;8.37647e-15;-568;1669;21008;15840.5;1;534;-2.14748e+09;-1.5878e+06;0;0;0;0;0;0;444819045;455984253;37814987
1804;8.37647e-15;-569;1669;21008;15840.5;1;534;-2.14748e+09;-1.58474e+06;0;0;0;0;0;0;444881319;456058781;37839968
1805;8.37647e-15;-570;1669;21008;15840.5;1;534;-2.14748e+09;-1.58169e+06;0;0;0;0;0;0;444943469;456133175;37864911
1806;8.37647e-15;-570;1669;21008;15840.5;1;534;-2.14748e+09;-1.57864e+06;-1;0;0;0;-1;0;445005496;456207433;37889817
1807;8.37647e-15;-570;1669;21008;15840.5;1;534;-2.14748e+09;-1.5756e+06;-1;0;0;0;-1;0;445067400;456281556;37914685
1808;8.37647e-15;-571;1669;21008;15840.5;1;534;-2.14748e+09;-1.57257e+06;0;0;0;0;0;0;445129182;456355544;37939516
1809;8.37647e-15;-571;1669;21008;15840.5;1;534;-2.14748e+09;-1.56954e+06;-1;0;0;0;-1;0;445190842;456429399;37964310
1810;8.37647e-15;-572;1669;21008;15840.5;1;534;-2.14748e+09;-1.56652e+06;0;0;0;0;0;0;445252379;456503119;37989067
1811;8.37647e-15;-572;1669;21008;15840.5;1;534;-2.14748e+09;-1.5635e+06;-1;0;0;0;-1;0;445313795;456576705;38013786
1812;8.37647e-15;-573;1669;21008;15840.5;1;534;-2.14748e+09;-1.56049e+06;0;0;0;0;0;0;445375089;456650158;38038468
1813;8.37647e-15;-573;1669;21008;15840.5;1;534;-2.14748e+09;-1.55749e+06;-1;0;0;0;-1;0;445436262;456723477;38063113
1814;8.37647e-15;-573;1669;21008;15840.5;1;534;-2.14748e+09;-1.55449e+06;-1;0;0;0;-1;0;445497314;456796663;38087720
1815;8.37647e-15;-573;1669;21008;15840.5;1;534;-2.14748e+09;-1.5515e+06;-1;0;0;0;-1;0;445558245;456869716;38112291
1816;8.37647e-15;-573;1669;21008;15840.5;1;534;-2.14748e+09;-1.54852e+06;-1;0;0;0;-1;0;445619056;456942637;38136825
1817;8.37647e-15;-573;1669;21008;15840.5;1;534;-2.14748e+09;-1.54554e+06;-1;0;0;0;-1;0;445679747;457015425;38161321
1818;8.37647e-15;-574;1669;21008;15840.5;1;534;-2.14748e+09;-1.54257e+06;0;0;0;0;0;0;445740318;457088081;38185781
1819;8.37647e-15;-574;1669;21008;15840.5;1;534;-2.14748e+09;-1.5396e+06;-1;0;0;0;-1;0;445800768;457160605;38210203
1820;8.37647e-15;-575;1669;21008;15840.5;1;534;-2.14748e+09;-1.53664e+06;0;0;0;0;0;0;445861100;457232998;38234589
1821;8.37647e-15;-575;1669;21008;15840.5;1;534;-2.14748e+09;-1.53369e+06;-1;0;0;0;-1;0;445921312;457305259;38258938
1822;8.37647e-15;-576;1669;21008;15840.5;1;534;-2.14748e+09;-1.53074e+06;0;0;0;0;0;0;445981406;457377390;38283250
1823;8.37647e-15;-576;1669;21008;15840.5;1;534;-2.14748e+09;-1.5278e+06;-1;0;0;0;-1;0;446041381;457449389;38307526
1824;8.37647e-15;-576;1669;21008;15840.5;1;534;-2.14748e+09;-1.52487e+06;-1;0;0;0;-1;0;446101237;457521258;38331764
1825;8.37647e-15;-577;1669;21008;15840.5;1;534;-2.14748e+09;-1.52194e+06;0;0;0;0;0;0;446160975;457592996;38355966
1826;8.37647e-15;-578;1669;21008;15840.5;1;534;-2.14748e+09;-1.51902e+06;0;0;0;0;0;0;446220595;457664604;38380132
1827;8.37647e-15;-578;1669;21008;15840.5;1;534;-2.14748e+09;-1.5161e+06;-1;0;0;0;-1;0;446280098;457736082;38404261
1828;8.37647e-15;-578;1669;21008;15840.5;1;534;-2.14748e+09;-1.51319e+06;-1;0;0;0;-1;0;446339483;457807431;38428353
1829;8.37647e-15;-579;1669;21008;15840.5;1;534;-2.14748e+09;-1.51028e+06;0;0;0;0;0;0;446398751;457878650;38452408
1830;8.37647e-15;-579;1669;21008;15840.5;1;534;-2.14748e+09;-1.50738e+06;-1;0;0;0;-1;0;446457902;457949740;38476428
1831;8.37647e-15;-580;1669;21008;15840.5;1;534;-2.14748e+09;-1.50449e+06;0;0;0;0;0;0;446516937;458020702;38500410
1832;8.37647e-15;-580;1669;21008;15840.5;1;534;-2.14748e+09;-1.5016e+06;-1;0;0;0;-1;0;446575855;458091534;38524357
1833;8.37647e-15;-580;1669;21008;15840.5;1;534;-2.14748e+09;-1.49872e+06;-1;0;0;0;-1;0;446634657;458162238;38548267
1834;8.37647e-15;-581;1669;21008;15840.5;1;534;-2.14748e+09;-1.49585e+06;0;0;0;0;0;0;446693343;458232814;38572140
1835;8.37647e-15;-582;1669;21008;15840.5;1;534;-2.14748e+09;-1.49298e+06;0;0;0;0;0;0;446751913;458303262;38595978
1836;8.37647e-15;-582;1669;21008;15840.5;1;534;-2.14748e+09;-1.49012e+06;-1;0;0;0;-1;0;446810368;458373582;38619779
1837;8.37647e-15;-583;1669;21008;15840.5;1;534;-2.14748e+09;-1.48726e+06;0;0;0;0;0;0;446868708;458443775;38643544
1838;8.37647e-15;-583;1669;21008;15840.5;1;534;-2.14748e+09;-1.48441e+06;-1;0;0;0;-1;0;446926932;458513840;38667272
1839;8.37647e-15;-584;1669;21008;15840.5;1;534;-2.14748e+09;-1.48156e+06;0;0;0;0;0;0;446985042;458583779;38690965
1840;8.37647e-15;-585;1669;21008;15840.5;1;534;-2.14748e+09;-1.47872e+06;0;0;0;0;0;0;447043038;458653591;38714622
1841;8.37647e-15;-585;1669;21008;15840.5;1;534;-2.14748e+09;-1.47589e+06;-1;0;0;0;-1;0;447100919;458723276;38738242
1842;8.37647e-15;-586;1669;21008;15840.5;1;534;-2.14748e+09;-1.47306e+06;0;0;0;0;0;0;447158687;458792835;38761827
1843;8.37647e-15;-587;1669;21008;15840.5;1;534;-2.14748e+09;-1.47024e+06;0;0;0;0;0;0;447216341;458862268;38785375
1844;8.37647e-15;-588;1669;21008;15840.5;1;534;-2.14748e+09;-1.46742e+06;0;0;0;0;0;0;447273881;458931575;38808888
1845;8.37647e-15;-589;1669;21008;15840.5;1;534;-2.14748e+09;-1.46462e+06;0;0;0;0;0;0;447331308;459000756;38832365
1846;8.37647e-15;-589;1669;21008;15840.5;1;534;-2.14748e+09;-1.46181e+06;-1;0;0;0;-1;0;447388622;459069813;38855806
1847;8.37647e-15;-590;1669;21008;15840.5;1;534;-2.14748e+09;-1.45901e+06;0;0;0;0;0;0;447445823;459138744;38879211
1848;8.37647e-15;-591;1669;21008;15840.5;1;534;-2.14748e+09;-1.45622e+06;0;0;0;0;0;0;447502912;459207550;38902580
1849;8.37647e-15;-592;1669;21008;15840.5;1;534;-2.14748e+09;-1.45343e+06;0;0;0;0;0;0;447559889;459276232;38925914
1850;8.37647e-15;-593;1669;21008;15840.5;1;534;-2.14748e+09;-1.45065e+06;0;0;0;0;0;0;447616753;459344789;38949212
1851;8.37647e-15;-594;1669;21008;15840.5;1;534;-2.14748e+09;-1.44787e+06;0;0;0;0;0;0;447673506;459413222;38972474
1852;8.37647e-15;-594;1669;21008;15840.5;1;534;-2.14748e+09;-1.4451e+06;-1;0;0;0;-1;0;447730147;459481531;38995701
1853;8.37647e-15;-595;1669;21008;15840.5;1;534;-2.14748e+09;-1.44234e+06;0;0;0;0;0;0;447786677;459549716;39018892
1854;8.37647e-15;-595;1669;21008;15840.5;1;534;-2.14748e+09;-1.43958e+06;-1;0;0;0;-1;0;447843096;459617778;39042048
1855;8.37647e-15;-596;1669;21008;15840.5;1;534;-2.14748e+09;-1.43683e+06;0;0;0;0;0;0;447899404;459685717;39065168
1856;8.37647e-15;-596;1669;21008;15840.5;1;534;-2.14748e+09;-1.43408e+06;-1;0;0;0;-1;0;447955601;459753533;39088253
1857;8.37647e-15;-596;1669;21008;15840.5;1;534;-2.14748e+09;-1.43134e+06;-1;0;0;0;-1;0;448011688;459821226;39111302
1858;8.37647e-15;-596;1669;21008;15840.5;1;534;-2.14748e+09;-1.4286e+06;-1;0;0;0;-1;0;448067664;459888796;39134316
1859;8.37647e-15;-596;1669;21008;15840.5;1;534;-2.14748e+09;-1.42587e+06;-1;0;0;0;-1;0;448123531;459956244;39157295
1860;8.37647e-15;-597;1669;21008;15840.5;1;534;-2.14748e+09;-1.42315e+06;0;0;0;0;0;0;448179288;460023570;39180238
1861;8.37647e-15;-597;1669;21008;15840.5;1;534;-2.14748e+09;-1.42043e+06;-1;0;0;0;-1;0;448234936;460090774;39203146
1862;8.37647e-15;-598;1669;21008;15840.5;1;534;-2.14748e+09;-1.41771e+06;0;0;0;0;0;0;448290474;460157857;39226019
1863;8.37647e-15;-598;1669;21008;15840.5;1;534;-2.14748e+09;-1.41501e+06;-1;0;0;0;-1;0;448345904;460224818;39248857
1864;8.37647e-15;-598;1669;21008;15840.5;1;534;-2.14748e+09;-1.4123e+06;-1;0;0;0;-1;0;448401224;460291657;39271660
1865;8.37647e-15;-599;1669;21008;15840.5;1;534;-2.14748e+09;-1.40961e+06;0;0;0;0;0;0;448456437;460358376;39294428
1866;8.37647e-15;-599;1669;21008;15840.5;1;534;-2.14748e+09;-1.40691e+06;-1;0;0;0;-1;0;448511540;460424974;39317160
1867;8.37647e-15;-599;1669;21008;15840.5;1;534;-2.14748e+09;-1.40423e+06;-1;0;0;0;-1;0;448566536;460491452;39339858
1868;8.37647e-15;-599;1669;21008;15840.5;1;534;-2.14748e+09;-1.40155e+06;-1;0;0;0;-1;0;448621424;460557810;39362521
1869;8.37647e-15;-600;1669;21008;15840.5;1;534;-2.14748e+09;-1.39887e+06;0;0;0;0;0;0;448676204;460624047;39385149
1870;8.37647e-15;-600;1669;21008;15840.5;1;534;-2.14748e+09;-1.3962e+06;-1;0;0;0;-1;0;448730877;460690164;39407742
1871;8.37647e-15;-601;1669;21008;15840.5;1;534;-2.14748e+09;-1.39354e+06;0;0;0;0;0;0;448785443;460756162;39430300
1872;8.37647e-15;-601;1669;21008;15840.5;1;534;-2.14748e+09;-1.39088e+06;-1;0;0;0;-1;0;448839902;460822041;39452823
1873;8.37647e-15;-602;1669;21008;15840.5;1;534;-2.14748e+09;-1.38823e+06;0;0;0;0;0;0;448894254;460887800;39475312
1874;8.37647e-15;-603;1669;21008;15840.5;1;534;-2.14748e+09;-1.38558e+06;0;0;0;0;0;0;448948499;460953440;39497766
1875;8.37647e-15;-604;1669;21008;15840.5;1;534;-2.14748e+09;-1.38294e+06;0;0;0;0;0;0;449002638;461018962;39520185
1876;8.37647e-15;-605;1669;21008;15840.5;1;534;-2.14748e+09;-1.3803e+06;0;0;0;0;0;0;449056672;461084365;39542570
1877;8.37647e-15;-606;1669;21008;15840.5;1;534;-2.14748e+09;-1.37767e+06;0;0;0;0;0;0;449110599;461149650;39564920
1878;8.37647e-15;-607;1669;21008;15840.5;1;534;-2.14748e+09;-1.37504e+06;0;0;0;0;0;0;449164421;461214817;39587235
1879;8.37647e-15;-607;1669;21008;15840.5;1;534;-2.14748e+09;-1.37242e+06;-1;0;0;0;-1;0;449218137;461279866;39609516
1880;8.37647e-15;-608;1669;21008;15840.5;1;534;-2.14748e+09;-1.3698e+06;0;0;0;0;0;0;449271749;461344797;39631763
1881;8.37647e-15;-608;1669;21008;15840.5;1;534;-2.14748e+09;-1.36719e+06;-1;0;0;0;-1;0;449325255;461409611;39653975
1882;8.37647e-15;-609;1669;21008;15840.5;1;534;-2.14748e+09;-1.36459e+06;0;0;0;0;0;0;449378657;461474307;39676153
1883;8.37647e-15;-609;1669;21008;15840.5;1;534;-2.14748e+09;-1.36199e+06;-1;0;0;0;-1;0;449431954;461538887;39698296
1884;8.37647e-15;-609;1669;21008;15840.5;1;534;-2.14748e+09;-1.35939e+06;-1;0;0;0;-1;0;449485147;461603350;39720406
1885;8.37647e-15;-609;1669;21008;15840.5;1;534;-2.14748e+09;-1.3568e+06;-1;0;0;0;-1;0;449538236;461667697;39742481
1886;8.37647e-15;-610;1669;21008;15840.5;1;534;-2.14748e+09;-1.35422e+06;0;0;0;0;0;0;449591221;461731927;39764521
1887;8.37647e-15;-610;1669;21008;15840.5;1;534;-2.14748e+09;-1.35164e+06;-1;0;0;0;-1;0;449644102;461796041;39786528
1888;8.37647e-15;-610;1669;21008;15840.5;1;534;-2.14748e+09;-1.34907e+06;-1;0;0;0;-1;0;449696880;461860039;39808500
1889;8.37647e-15;-610;1669;21008;15840.5;1;534;-2.14748e+09;-1.3465e+06;-1;0;0;0;-1;0;449749555;461923921;39830439
1890;8.37647e-15;-610;1669;21008;15840.5;1;534;-2.14748e+09;-1.34393e+06;-1;0;0;0;-1;0;449802126;461987688;39852343
1891;8.37647e-15;-611;1669;21008;15840.5;1;534;-2.14748e+09;-1.34138e+06;0;0;0;0;0;0;449854596;462051340;39874213
1892;8.37647e-15;-612;1669;21008;15840.5;1;534;-2.14748e+09;-1.33882e+06;0;0;0;0;0;0;449906962;462114877;39896050
1893;8.37647e-15;-612;1669;21008;15840.5;1;534;-2.14748e+09;-1.33628e+06;-1;0;0;0;-1;0;449959226;462178299;39917852
1894;8.37647e-15;-613;1669;21008;15840.5;1;534;-2.14748e+09;-1.33373e+06;0;0;0;0;0;0;450011388;462241606;39939621
1895;8.37647e-15;-613;1669;21008;15840.5;1;534;-2.14748e+09;-1.3312e+06;-1;0;0;0;-1;0;450063449;462304799;39961355
1896;8.37647e-15;-614;1669;21008;15840.5;1;534;-2.14748e+09;-1.32866e+06;0;0;0;0;0;0;450115407;462367878;39983056
1897;8.37647e-15;-615;1669;21008;15840.5;1;534;-2.14748e+09;-1.32614e+06;0;0;0;0;0;0;450167264;462430843;40004723
1898;8.37647e-15;-615;1669;21008;15840.5;1;534;-2.14748e+09;-1.32361e+06;-1;0;0;0;-1;0;450219020;462493694;40026357
1899;8.37647e-15;-616;1669;21008;15840.5;1;534;-2.14748e+09;-1.3211e+06;0;0;0;0;0;0;450270675;462556431;40047957
1900;8.37647e-15;-616;1669;21008;15840.5;1;534;-2.14748e+09;-1.31858e+06;-1;0;0;0;-1;0;450322229;462619055;40069523
1901;8.37647e-15;-616;1669;21008;15840.5;1;534;-2.14748e+09;-1.31608e+06;-1;0;0;0;-1;0;450373682;462681566;40091055
1902;8.37647e-15;-616;1669;21008;15840.5;1;534;-2.14748e+09;-1.31358e+06;-1;0;0;0;-1;0;450425035;462743964;40112554
1903;8.37647e-15;-617;1669;21008;15840.5;1;534;-2.14748e+09;-1.31108e+06;0;0;0;0;0;0;450476288;462806250;40134020
1904;8.37647e-15;-617;1669;21008;15840.5;1;534;-2.14748e+09;-1.30859e+06;-1;0;0;0;-1;0;450527440;462868423;40155452
1905;8.37647e-15;-617;1669;21008;15840.5;1;534;-2.14748e+09;-1.3061e+06;-1;0;0;0;-1;0;450578493;462930483;40176850
1906;8.37647e-15;-618;1669;21008;15840.5;1;534;-2.14748e+09;-1.30362e+06;0;0;0;0;0;0;450629447;462992432;40198215
1907;8.37647e-15;-619;1669;21008;15840.5;1;534;-2.14748e+09;-1.30114e+06;0;0;0;0;0;0;450680300;463054269;40219547
1908;8.37647e-15;-620;1669;21008;15840.5;1;534;-2.14748e+09;-1.29867e+06;0;0;0;0;0;0;450731055;463115993;40240846
1909;8.37647e-15;-620;1669;21008;15840.5;1;534;-2.14748e+09;-1.2962e+06;-1;0;0;0;-1;0;450781711;463177607;40262111
1910;8.37647e-15;-620;1669;21008;15840.5;1;534;-2.14748e+09;-1.29374e+06;-1;0;0;0;-1;0;450832268;463239109;40283343
1911;8.37647e-15;-621;1669;21008;15840.5;1;534;-2.14748e+09;-1.29129e+06;0;0;0;0;0;0;450882727;463300501;40304542
1912;8.37647e-15;-621;1669;21008;15840.5;1;534;-2.14748e+09;-1.28884e+06;-1;0;0;0;-1;0;450933087;463361781;40325707
1913;8.37647e-15;-621;1669;21008;15840.5;1;534;-2.14748e+09;-1.28639e+06;-1;0;0;0;-1;0;450983349;463422951;40346840
1914;8.37647e-15;-622;1669;21008;15840.5;1;534;-2.14748e+09;-1.28395e+06;0;0;0;0;0;0;451033513;463484010;40367940
1915;8.37647e-15;-623;1669;21008;15840.5;1;534;-2.14748e+09;-1.28151e+06;0;0;0;0;0;0;451083580;463544959;40389006
1916;8.37647e-15;-624;1669;21008;15840.5;1;534;-2.14748e+09;-1.27908e+06;0;0;0;0;0;0;451133549;463605798;40410040
1917;8.37647e-15;-625;1669;21008;15840.5;1;534;-2.14748e+09;-1.27665e+06;0;0;0;0;0;0;451183420;463666527;40431040
1918;8.37647e-15;-625;1669;21008;15840.5;1;534;-2.14748e+09;-1.27423e+06;-1;0;0;0;-1;0;451233195;463727147;40452008
1919;8.37647e-15;-626;1669;21008;15840.5;1;534;-2.14748e+09;-1.27181e+06;0;0;0;0;0;0;451282873;463787657;40472943
1920;8.37647e-15;-626;1669;21008;15840.5;1;534;-2.14748e+09;-1.2694e+06;-1;0;0;0;-1;0;451332453;463848058;40493845
1921;8.37647e-15;-626;1669;21008;15840.5;1;534;-2.14748e+09;-1.26699e+06;-1;0;0;0;-1;0;451381938;463908350;40514714
1922;8.37647e-15;-627;1669;21008;15840.5;1;534;-2.14748e+09;-1.26459e+06;0;0;0;0;0;0;451431326;463968533;40535551
1923;8.37647e-15;-628;1669;21008;15840.5;1;534;-2.14748e+09;-1.26219e+06;0;0;0;0;0;0;451480618;464028608;40556354
1924;8.37647e-15;-629;1669;21008;15840.5;1;534;-2.14748e+09;-1.2598e+06;0;0;0;0;0;0;451529814;464088574;40577126
1925;8.37647e-15;-629;1669;21008;15840.5;1;534;-2.14748e+09;-1.25741e+06;-1;0;0;0;-1;0;451578914;464148432;40597864
1926;8.37647e-15;-630;1669;21008;15840.5;1;534;-2.14748e+09;-1.25502e+06;0;0;0;0;0;0;451627919;464208181;40618570
1927;8.37647e-15;-630;1669;21008;15840.5;1;534;-2.14748e+09;-1.25265e+06;-1;0;0;0;-1;0;451676829;464267823;40639244
1928;8.37647e-15;-631;1669;21008;15840.5;1;534;-2.14748e+09;-1.25027e+06;0;0;0;0;0;0;451725643;464327358;40659885
1929;8.37647e-15;-631;1669;21008;15840.5;1;534;-2.14748e+09;-1.2479e+06;-1;0;0;0;-1;0;451774362;464386785;40680493
1930;8.37647e-15;-632;1669;21008;15840.5;1;534;-2.14748e+09;-1.24554e+06;0;0;0;0;0;0;451822987;464446105;40701069
1931;8.37647e-15;-633;1669;21008;15840.5;1;534;-2.14748e+09;-1.24318e+06;0;0;0;0;0;0;451871517;464505317;40721613
1932;8.37647e-15;-634;1669;21008;15840.5;1;534;-2.14748e+09;-1.24082e+06;0;0;0;0;0;0;451919953;464564423;40742125
1933;8.37647e-15;-635;1669;21008;15840.5;1;534;-2.14748e+09;-1.23847e+06;0;0;0;0;0;0;451968295;464623423;40762604
1934;8.37647e-15;-636;1669;21008;15840.5;1;534;-2.14748e+09;-1.23613e+06;0;0;0;0;0;0;452016543;464682316;40783051
1935;8.37647e-15;-637;1669;21008;15840.5;1;534;-2.14748e+09;-1.23378e+06;0;0;0;0;0;0;452064697;464741102;40803465
1936;8.37647e-15;-638;1669;21008;15840.5;1;534;-2.14748e+09;-1.23145e+06;0;0;0;0;0;0;452112758;464799783;40823848
1937;8.37647e-15;-638;1669;21008;15840.5;1;534;-2.14748e+09;-1.22912e+06;-1;0;0;0;-1;0;452160725;464858358;40844198
1938;8.37647e-15;-639;1669;21008;15840.5;1;534;-2.14748e+09;-1.22679e+06;0;0;0;0;0;0;452208599;464916827;40864517
1939;8.37647e-15;-639;1669;21008;15840.5;1;534;-2.14748e+09;-1.22447e+06;-1;0;0;0;-1;0;452256380;464975190;40884803
1940;8.37647e-15;-640;1669;21008;15840.5;1;534;-2.14748e+09;-1.22215e+06;0;0;0;0;0;0;452304068;465033449;40905057
1941;8.37647e-15;-640;1669;21008;15840.5;1;534;-2.14748e+09;-1.21984e+06;-1;0;0;0;-1;0;452351664;465091602;40925280
1942;8.37647e-15;-640;1669;21008;15840.5;1;534;-2.14748e+09;-1.21753e+06;-1;0;0;0;-1;0;452399167;465149650;40945470
1943;8.37647e-15;-640;1669;21008;15840.5;1;534;-2.14748e+09;-1.21522e+06;-1;0;0;0;-1;0;452446578;465207594;40965629
1944;8.37647e-15;-640;1669;21008;15840.5;1;534;-2.14748e+09;-1.21293e+06;-1;0;0;0;-1;0;452493897;465265434;40985755
1945;8.37647e-15;-640;1669;21008;15840.5;1;534;-2.14748e+09;-1.21063e+06;-1;0;0;0;-1;0;452541125;465323168;41005850
1946;8.37647e-15;-641;1669;21008;15840.5;1;534;-2.14748e+09;-1.20834e+06;0;0;0;0;0;0;452588260;465380799;41025914
1947;8.37647e-15;-641;1669;21008;15840.5;1;534;-2.14748e+09;-1.20606e+06;-1;0;0;0;-1;0;452635305;465438326;41045945
1948;8.37647e-15;-642;1669;21008;15840.5;1;534;-2.14748e+09;-1.20377e+06;0;0;0;0;0;0;452682258;465495749;41065945
1949;8.37647e-15;-643;1669;21008;15840.5;1;534;-2.14748e+09;-1.2015e+06;0;0;0;0;0;0;452729119;465553069;41085913
1950;8.37647e-15;-644;1669;21008;15840.5;1;534;-2.14748e+09;-1.19923e+06;0;0;0;0;0;0;452775890;465610286;41105850
1951;8.37647e-15;-644;1669;21008;15840.5;1;534;-2.14748e+09;-1.19696e+06;-1;0;0;0;-1;0;452822571;465667399;41125755
1952;8.37647e-15;-644;1669;21008;15840.5;1;534;-2.14748e+09;-1.1947e+06;-1;0;0;0;-1;0;452869161;465724409;41145628
1953;8.37647e-15;-645;1669;21008;15840.5;1;534;-2.14748e+09;-1.19244e+06;0;0;0;0;0;0;452915660;465781316;41165470
1954;8.37647e-15;-646;1669;21008;15840.5;1;534;-2.14748e+09;-1.19018e+06;0;0;0;0;0;0;452962069;465838121;41185281
1955;8.37647e-15;-647;1669;21008;15840.5;1;534;-2.14748e+09;-1.18793e+06;0;0;0;0;0;0;453008389;465894824;41205060
1956;8.37647e-15;-647;1669;21008;15840.5;1;534;-2.14748e+09;-1.18569e+06;-1;0;0;0;-1;0;453054619;465951424;41224808
1957;8.37647e-15;-647;1669;21008;15840.5;1;534;-2.14748e+09;-1.18345e+06;-1;0;0;0;-1;0;453100759;466007922;41244525
1958;8.37647e-15;-647;1669;21008;15840.5;1;534;-2.14748e+09;-1.18121e+06;-1;0;0;0;-1;0;453146809;466064319;41264210
1959;8.37647e-15;-648;1669;21008;15840.5;1;534;-2.14748e+09;-1.17898e+06;0;0;0;0;0;0;453192771;466120613;41283864
1960;8.37647e-15;-648;1669;21008;15840.5;1;534;-2.14748e+09;-1.17675e+06;-1;0;0;0;-1;0;453238644;466176807;41303487
1961;8.37647e-15;-649;1669;21008;15840.5;1;534;-2.14748e+09;-1.17453e+06;0;0;0;0;0;0;453284427;466232899;41323079
1962;8.37647e-15;-650;1669;21008;15840.5;1;534;-2.14748e+09;-1.17231e+06;0;0;0;0;0;0;453330122;466288890;41342639
1963;8.37647e-15;-651;1669;21008;15840.5;1;534;-2.14748e+09;-1.1701e+06;0;0;0;0;0;0;453375729;466344779;41362169
1964;8.37647e-15;-651;1669;21008;15840.5;1;534;-2.14748e+09;-1.16789e+06;-1;0;0;0;-1;0;453421247;466400569;41381668
1965;8.37647e-15;-651;1669;21008;15840.5;1;534;-2.14748e+09;-1.16568e+06;-1;0;0;0;-1;0;453466677;466456258;41401135
1966;8.37647e-15;-651;1669;21008;15840.5;1;534;-2.14748e+09;-1.16348e+06;-1;0;0;0;-1;0;453512020;466511846;41420572
1967;8.37647e-15;-651;1669;21008;15840.5;1;534;-2.14748e+09;-1.16129e+06;-1;0;0;0;-1;0;453557274;466567334;41439978
1968;8.37647e-15;-651;1669;21008;15840.5;1;534;-2.14748e+09;-1.1591e+06;-1;0;0;0;-1;0;453602441;466622722;41459353
1969;8.37647e-15;-651;1669;21008;15840.5;1;534;-2.14748e+09;-1.15691e+06;-1;0;0;0;-1;0;453647521;466678011;41478697
1970;8.37647e-15;-652;1669;21008;15840.5;1;534;-2.14748e+09;-1.15472e+06;0;0;0;0;0;0;453692513;466733200;41498010
1971;8.37647e-15;-653;1669;21008;15840.5;1;534;-2.14748e+09;-1.15255e+06;0;0;0;0;0;0;453737418;466788289;41517292
1972;8.37647e-15;-653;1669;21008;15840.5;1;534;-2.14748e+09;-1.15037e+06;-1;0;0;0;-1;0;453782237;466843279;41536544
1973;8.37647e-15;-654;1669;21008;15840.5;1;534;-2.14748e+09;-1.1482e+06;0;0;0;0;0;0;453826968;466898170;41555766
1974;8.37647e-15;-654;1669;21008;15840.5;1;534;-2.14748e+09;-1.14604e+06;-1;0;0;0;-1;0;453871614;466952962;41574956
1975;8.37647e-15;-654;1669;21008;15840.5;1;534;-2.14748e+09;-1.14387e+06;-1;0;0;0;-1;0;453916173;467007656;41594116
1976;8.37647e-15;-655;1669;21008;15840.5;1;534;-2.14748e+09;-1.14172e+06;0;0;0;0;0;0;453960646;467062251;41613246
1977;8.37647e-15;-655;1669;21008;15840.5;1;534;-2.14748e+09;-1.13956e+06;-1;0;0;0;-1;0;454005033;467116747;41632345
1978;8.37647e-15;-655;1669;21008;15840.5;1;534;-2.14748e+09;-1.13741e+06;-1;0;0;0;-1;0;454049334;467171146;41651413
1979;8.37647e-15;-655;1669;21008;15840.5;1;534;-2.14748e+09;-1.13527e+06;-1;0;0;0;-1;0;454093549;467225446;41670451
1980;8.37647e-15;-656;1669;21008;15840.5;1;534;-2.14748e+09;-1.13313e+06;0;0;0;0;0;0;454137679;467279649;41689459
1981;8.37647e-15;-656;1669;21008;15840.5;1;534;-2.14748e+09;-1.13099e+06;-1;0;0;0;-1;0;454181724;467333754;41708436
1982;8.37647e-15;-656;1669;21008;15840.5;1;534;-2.14748e+09;-1.12886e+06;-1;0;0;0;-1;0;454225684;467387761;41727384
1983;8.37647e-15;-657;1669;21008;15840.5;1;534;-2.14748e+09;-1.12673e+06;0;0;0;0;0;0;454269559;467441672;41746300
1984;8.37647e-15;-658;1669;21008;15840.5;1;534;-2.14748e+09;-1.12461e+06;0;0;0;0;0;0;454313349;467495485;41765187
1985;8.37647e-15;-658;1669;21008;15840.5;1;534;-2.14748e+09;-1.12249e+06;-1;0;0;0;-1;0;454357054;467549201;41784044
1986;8.37647e-15;-658;1669;21008;15840.5;1;534;-2.14748e+09;-1.12037e+06;-1;0;0;0;-1;0;454400675;467602821;41802870
1987;8.37647e-15;-659;1669;21008;15840.5;1;534;-2.14748e+09;-1.11826e+06;0;0;0;0;0;0;454444212;467656343;41821666
1988;8.37647e-15;-659;1669;21008;15840.5;1;534;-2.14748e+09;-1.11616e+06;-1;0;0;0;-1;0;454487665;467709770;41840432
1989;8.37647e-15;-659;1669;21008;15840.5;1;534;-2.14748e+09;-1.11405e+06;-1;0;0;0;-1;0;454531034;467763100;41859169
1990;8.37647e-15;-660;1669;21008;15840.5;1;534;-2.14748e+09;-1.11196e+06;0;0;0;0;0;0;454574320;467816335;41877875
1991;8.37647e-15;-660;1669;21008;15840.5;1;534;-2.14748e+09;-1.10986e+06;-1;0;0;0;-1;0;454617521;467869473;41896551
1992;8.37647e-15;-660;1669;21008;15840.5;1;534;-2.14748e+09;-1.10777e+06;-1;0;0;0;-1;0;454660640;467922516;41915197
1993;8.37647e-15;-661;1669;21008;15840.5;1;534;-2.14748e+09;-1.10568e+06;0;0;0;0;0;0;454703675;467975463;41933814
1994;8.37647e-15;-662;1669;21008;15840.5;1;534;-2.14748e+09;-1.1036e+06;0;0;0;0;0;0;454746627;468028315;41952401
1995;8.37647e-15;-663;1669;21008;15840.5;1;534;-2.14748e+09;-1.10152e+06;0;0;0;0;0;0;454789497;468081072;41970957
1996;8.37647e-15;-663;1669;21008;15840.5;1;534;-2.14748e+09;-1.09945e+06;-1;0;0;0;-1;0;454832283;468133734;41989485
1997;8.37647e-15;-664;1669;21008;15840.5;1;534;-2.14748e+09;-1.09738e+06;0;0;0;0;0;0;454874988;468186301;42007982
1998;8.37647e-15;-665;1669;21008;15840.5;1;534;-2.14748e+09;-1.09532e+06;0;0;0;0;0;0;454917609;468238773;42026450
1999;8.37647e-15;-666;1669;21008;15840.5;1;534;-2.14748e+09;-1.09325e+06;0;0;0;0;0;0;454960149;468291151;42044888
