step;volume;A_0;B_0;C;L;p;Compl;Aext;Bext;A_ingresso;A_uscita;B_ingresso;B_uscita;A_netto;B_netto;Avicino;Amedio;Alontano
0;4.18816e-15;377;350;96;10001;1;4;659;1000;465;123;458;125;342;333;659;0;0
1;4.18816e-15;340;353;95;10000;1;5;279;980;498;125;448;110;373;338;279;0;0
2;4.18816e-15;236;435;95;10000;1;5;268;961;141;121;430;189;20;241;268;0;0
3;4.18816e-15;181;461;94;10001;1;6;227;943;124;75;435;210;49;225;227;0;0
4;4.18879e-15;127;463;93;10002;1;7;223;925;92;78;416;211;14;205;223;0;0
5;4.18942e-15;135;481;93;10002;1;7;193;907;95;55;438;189;40;249;193;0;0
6;4.18942e-15;117;430;93;10003;1;7;176;890;83;56;420;221;27;199;176;0;0
7;4.19005e-15;114;472;95;10004;1;6;147;873;83;42;415;204;41;211;147;0;0
8;4.19068e-15;82;437;95;10006;1;6;143;857;61;45;397;233;16;164;143;0;0
9;4.19195e-15;63;467;97;10007;1;5;114;841;74;35;377;178;39;199;114;0;0
10;4.19258e-15;64;450;96;10007;1;6;100;826;51;25;389;195;26;194;100;0;0
11;4.19258e-15;56;449;95;10007;1;7;105;811;35;28;365;210;7;155;105;0;0
12;4.19258e-15;60;429;95;10007;1;7;91;796;47;22;385;187;25;198;91;0;0
13;4.19258e-15;57;408;95;10007;1;7;82;782;44;24;376;186;20;190;82;0;0
14;4.19258e-15;48;384;95;10007;1;7;89;768;24;19;369;195;5;174;89;0;0
15;4.19258e-15;36;369;95;10007;1;7;78;755;45;23;359;151;22;208;78;0;0
16;4.19258e-15;31;368;93;10007;1;9;67;741;39;16;378;179;23;199;67;0;0
17;4.19258e-15;26;366;93;10007;1;9;62;728;35;19;347;168;16;179;62;1;0
18;4.19258e-15;33;366;93;10007;1;9;64;716;26;17;342;164;9;178;64;1;0
19;4.19258e-15;31;369;93;10008;1;9;68;704;27;20;330;165;7;165;68;1;0
20;4.19321e-15;33;337;93;10009;1;9;63;692;27;12;328;164;15;164;63;1;0
21;4.19384e-15;22;354;95;10010;1;8;65;680;26;17;328;152;9;176;65;1;0
22;4.19447e-15;29;333;99;10010;1;6;65;669;20;10;337;168;10;169;65;2;0
23;4.19447e-15;37;325;99;10011;1;6;54;658;37;17;292;141;20;151;54;2;0
24;4.1951e-15;28;337;99;10011;1;6;58;647;21;15;301;153;6;148;58;2;0
25;4.1951e-15;24;321;101;10011;1;5;54;636;25;11;286;145;14;141;54;3;0
26;4.1951e-15;22;322;105;10011;1;3;56;626;24;16;261;159;8;102;56;3;0
27;4.1951e-15;28;329;105;10012;1;3;47;616;24;6;289;157;18;132;47;4;0
28;4.19574e-15;19;316;105;10012;1;3;46;606;23;12;283;139;11;144;46;4;0
29;4.19574e-15;21;300;105;10012;1;3;44;596;19;7;249;144;12;105;44;4;0
30;4.19574e-15;17;328;105;10012;1;3;38;587;30;15;279;136;15;143;38;5;0
31;4.19574e-15;17;279;104;10012;1;4;37;578;16;6;266;146;10;120;37;5;0
32;4.19574e-15;10;286;104;10012;1;4;40;569;23;17;228;116;6;112;40;6;0
33;4.19574e-15;21;292;104;10012;1;4;33;560;20;4;266;130;16;136;33;6;0
34;4.19574e-15;22;277;103;10012;1;5;30;552;17;5;249;130;12;119;30;7;0
35;4.19574e-15;17;267;103;10013;1;5;39;544;11;11;285;125;0;160;39;8;0
36;4.19637e-15;22;244;103;10013;1;5;39;536;15;6;262;133;9;129;39;8;0
37;4.19637e-15;32;290;102;10015;1;6;41;528;15;9;264;110;6;154;41;9;0
38;4.19763e-15;24;289;102;10015;1;6;41;520;21;13;213;130;8;83;41;9;0
39;4.19763e-15;20;279;102;10015;1;6;44;513;17;11;259;118;6;141;44;10;0
40;4.19763e-15;19;275;102;10017;1;6;38;506;20;6;201;135;14;66;38;11;0
41;4.1989e-15;21;262;102;10017;1;6;45;499;12;11;228;122;1;106;45;12;0
42;4.1989e-15;20;231;101;10018;1;7;51;492;9;8;248;126;1;122;51;12;0
43;4.19953e-15;24;234;101;10018;1;7;41;485;25;8;245;100;17;145;41;13;0
44;4.19953e-15;25;239;103;10020;1;6;37;478;21;9;235;123;12;112;37;14;0
45;4.20079e-15;27;227;103;10023;1;6;43;472;8;7;232;114;1;118;43;15;0
46;4.20269e-15;16;268;103;10023;1;6;49;466;12;11;199;113;1;86;49;15;0
47;4.20269e-15;18;237;103;10023;1;6;47;460;19;10;236;116;9;120;47;16;0
48;4.20269e-15;20;245;105;10024;1;5;38;454;22;6;211;108;16;103;38;17;0
49;4.20332e-15;17;242;104;10025;1;6;39;448;14;8;209;114;6;95;39;18;0
50;4.20395e-15;17;235;104;10026;1;6;34;442;23;11;208;118;12;90;34;19;0
51;4.20458e-15;17;218;104;10026;1;6;37;437;13;9;207;107;4;100;37;20;0
52;4.20458e-15;16;207;104;10026;1;6;33;432;21;10;194;95;11;99;33;21;0
53;4.20458e-15;16;214;104;10028;1;6;36;426;13;9;197;89;4;108;36;22;0
54;4.20585e-15;20;210;104;10028;1;6;36;421;16;9;215;105;7;110;36;23;0
55;4.20585e-15;17;202;108;10028;1;4;31;416;18;6;184;110;12;74;31;24;0
56;4.20585e-15;18;179;108;10029;1;4;32;412;16;10;178;105;6;73;32;25;0
57;4.20648e-15;22;197;108;10029;1;4;33;407;14;8;201;87;6;114;33;26;0
58;4.20648e-15;17;211;108;10030;1;4;39;402;10;10;185;98;0;87;39;27;0
59;4.20711e-15;24;195;108;10030;1;4;46;398;13;13;207;79;0;128;46;28;0
60;4.20711e-15;25;186;108;10030;1;4;38;393;24;10;213;90;14;123;38;29;0
61;4.20711e-15;22;204;108;10031;1;4;38;389;19;13;164;84;6;80;38;30;0
62;4.20775e-15;21;192;108;10033;1;4;41;385;17;14;177;85;3;92;41;31;0
63;4.20901e-15;19;201;108;10033;1;4;33;381;24;10;163;80;14;83;33;32;0
64;4.20901e-15;15;188;108;10033;1;4;40;377;13;13;176;92;0;84;40;33;0
65;4.20901e-15;16;181;110;10033;1;3;42;373;12;8;163;95;4;68;42;34;0
66;4.20901e-15;22;200;110;10034;1;3;27;370;26;5;171;85;21;86;27;35;0
67;4.20964e-15;16;210;110;10035;1;3;29;366;15;11;177;88;4;89;29;36;0
68;4.21028e-15;18;195;110;10035;1;3;26;362;16;6;152;91;10;61;26;37;0
69;4.21028e-15;10;175;110;10036;1;3;24;359;16;8;180;95;8;85;24;38;0
70;4.21091e-15;4;183;110;10036;1;3;28;356;12;9;170;80;3;90;28;40;0
71;4.21091e-15;8;164;110;10036;1;3;22;352;19;7;163;86;12;77;22;41;0
72;4.21091e-15;6;173;109;10036;1;4;25;349;10;6;138;72;4;66;25;42;0
73;4.21091e-15;9;144;109;10037;1;4;24;346;14;6;180;93;8;87;24;43;0
74;4.21154e-15;10;161;108;10037;1;5;25;343;11;6;171;78;5;93;25;44;0
75;4.21154e-15;8;162;108;10038;1;5;22;340;14;4;164;68;10;96;22;45;0
76;4.21217e-15;6;168;108;10039;1;5;22;337;12;5;188;76;7;112;22;47;0
77;4.21281e-15;8;169;108;10041;1;5;17;335;11;0;166;80;11;86;17;48;0
78;4.21407e-15;12;159;108;10042;1;5;19;332;11;6;155;86;5;69;19;49;0
79;4.21471e-15;8;186;110;10042;1;4;17;329;14;6;160;61;8;99;17;50;0
80;4.21471e-15;7;157;110;10044;1;4;24;327;4;4;132;93;0;39;24;51;0
81;4.21597e-15;11;162;110;10044;1;4;23;324;8;1;175;77;7;98;23;53;0
82;4.21597e-15;10;166;110;10045;1;4;29;322;6;6;148;80;0;68;29;54;0
83;4.2166e-15;14;187;110;10046;1;4;29;319;12;6;126;74;6;52;29;55;0
84;4.21724e-15;13;143;110;10047;1;4;22;317;22;9;150;81;13;69;22;56;0
85;4.21787e-15;6;153;110;10048;1;4;19;315;12;3;168;68;9;100;19;57;0
86;4.2185e-15;4;150;110;10048;1;4;26;313;5;5;131;69;0;62;26;59;0
87;4.2185e-15;11;149;110;10049;1;4;24;311;14;6;138;75;8;63;24;60;0
88;4.21914e-15;16;164;110;10051;1;4;21;308;10;1;146;76;9;70;21;61;0
89;4.2204e-15;12;151;110;10052;1;4;22;306;10;5;133;76;5;57;22;62;0
90;4.22103e-15;17;149;110;10052;1;4;24;305;8;4;136;74;4;62;24;64;0
91;4.22103e-15;10;159;110;10052;1;4;29;303;6;5;136;73;1;63;29;65;0
92;4.22103e-15;13;168;110;10053;1;4;33;301;8;6;147;70;2;77;33;66;0
93;4.22167e-15;14;173;110;10053;1;4;26;299;15;2;149;61;13;88;26;67;0
94;4.22167e-15;12;150;109;10055;1;5;31;297;10;8;143;77;2;66;31;69;0
95;4.22293e-15;14;147;109;10056;1;5;28;296;16;8;152;70;8;82;28;70;0
96;4.22357e-15;15;133;109;10057;1;5;27;294;14;7;130;71;7;59;27;71;0
97;4.2242e-15;14;142;109;10058;1;5;32;292;12;11;139;61;1;78;32;72;0
98;4.22483e-15;18;148;111;10059;1;4;22;291;22;6;134;62;16;72;22;73;0
99;4.22547e-15;12;133;111;10060;1;4;28;289;8;8;152;65;0;87;28;75;0
100;4.2261e-15;16;126;111;10062;1;4;23;288;16;5;138;63;11;75;23;76;0
101;4.22737e-15;17;141;111;10062;1;4;17;286;14;2;136;60;12;76;17;77;0
102;4.22737e-15;13;150;111;10063;1;4;19;285;8;4;156;54;4;102;19;78;0
103;4.228e-15;8;140;110;10064;1;5;19;284;10;4;148;71;6;77;19;80;0
104;4.22863e-15;11;136;110;10065;1;5;21;282;9;5;159;58;4;101;21;81;0
105;4.22927e-15;9;161;110;10065;1;5;21;281;13;7;114;64;6;50;21;82;0
106;4.22927e-15;9;159;109;10065;1;6;20;280;11;3;117;64;8;53;20;83;0
107;4.22927e-15;12;163;109;10066;1;6;26;279;5;5;122;72;0;50;26;85;0
108;4.2299e-15;13;142;109;10066;1;6;29;278;11;8;130;70;3;60;29;86;0
109;4.2299e-15;9;117;109;10068;1;6;24;277;16;6;134;72;10;62;24;87;0
110;4.23117e-15;8;125;109;10069;1;6;24;275;11;5;127;52;6;75;24;88;0
111;4.2318e-15;12;108;111;10072;1;5;29;274;5;4;121;59;1;62;29;89;0
112;4.2337e-15;12;139;111;10075;1;5;32;273;7;4;135;55;3;80;32;91;0
113;4.2356e-15;12;134;111;10075;1;5;34;272;15;11;133;65;4;68;34;92;0
114;4.2356e-15;15;142;111;10076;1;5;35;272;12;7;117;62;5;55;35;93;0
115;4.23624e-15;22;135;110;10076;1;6;30;271;14;3;124;61;11;63;30;94;0
116;4.23624e-15;14;141;110;10076;1;6;42;270;4;10;130;51;-6;79;42;95;0
117;4.23624e-15;28;138;110;10076;1;6;45;269;13;10;114;55;3;59;45;97;0
118;4.23624e-15;35;146;110;10076;1;6;44;268;19;13;120;63;6;57;44;98;0
119;4.23624e-15;31;152;110;10077;1;6;32;267;24;6;106;59;18;47;32;99;0
120;4.23687e-15;26;119;110;10077;1;6;34;266;17;13;131;63;4;68;34;100;0
121;4.23687e-15;22;126;110;10078;1;6;37;266;12;9;123;53;3;70;37;101;0
122;4.23751e-15;21;146;110;10078;1;6;30;265;22;10;134;65;12;69;30;103;0
123;4.23751e-15;19;134;110;10079;1;6;34;264;11;9;96;64;2;32;34;104;0
124;4.23814e-15;18;148;110;10079;1;6;35;264;15;10;120;67;5;53;35;105;0
125;4.23814e-15;18;154;110;10080;1;6;31;263;16;7;133;51;9;82;31;106;0
126;4.23877e-15;22;144;110;10080;1;6;30;262;10;3;149;59;7;90;30;107;0
127;4.23877e-15;15;145;112;10082;1;5;36;262;15;16;139;57;-1;82;36;108;0
128;4.24004e-15;18;129;111;10083;1;6;34;261;13;6;121;67;7;54;34;110;0
129;4.24068e-15;18;129;111;10083;1;6;39;261;10;9;140;49;1;91;39;111;0
130;4.24068e-15;19;125;111;10083;1;6;27;260;26;8;116;59;18;57;27;112;0
131;4.24068e-15;13;142;111;10084;1;6;27;260;12;5;106;59;7;47;27;113;0
132;4.24131e-15;14;154;111;10084;1;6;21;259;15;3;138;61;12;77;21;114;0
133;4.24131e-15;13;137;110;10085;1;7;27;259;8;8;121;58;0;63;27;115;0
134;4.24194e-15;16;118;110;10086;1;7;31;258;13;11;120;54;2;66;31;116;0
135;4.24258e-15;11;130;110;10086;1;7;33;258;12;8;121;53;4;68;33;118;0
136;4.24258e-15;18;149;110;10088;1;7;15;257;25;2;115;62;23;53;15;119;0
137;4.24385e-15;9;123;112;10090;1;6;17;257;12;6;115;80;6;35;17;120;0
138;4.24511e-15;10;113;112;10090;1;6;22;257;7;6;132;61;1;71;22;121;0
139;4.24511e-15;6;124;112;10091;1;6;17;256;15;4;115;52;11;63;17;122;0
140;4.24575e-15;4;124;112;10091;1;6;19;256;8;3;118;66;5;52;19;123;0
141;4.24575e-15;6;136;112;10091;1;6;23;255;4;2;122;57;2;65;23;124;0
142;4.24575e-15;11;128;112;10091;1;6;20;255;14;4;132;73;10;59;20;125;0
143;4.24575e-15;10;110;111;10091;1;7;23;255;6;2;116;58;4;58;23;126;0
144;4.24575e-15;8;132;111;10092;1;7;17;255;17;5;118;53;12;65;17;128;0
145;4.24638e-15;7;144;111;10092;1;7;17;254;8;2;131;59;6;72;17;129;0
146;4.24638e-15;8;131;111;10093;1;7;21;254;7;4;118;68;3;50;21;130;0
147;4.24702e-15;11;116;111;10094;1;7;21;254;11;5;112;77;6;35;21;131;0
148;4.24765e-15;9;144;111;10096;1;7;25;254;7;5;138;63;2;75;25;132;0
149;4.24892e-15;12;127;111;10097;1;7;20;253;13;1;128;60;12;68;20;133;0
150;4.24956e-15;14;100;111;10097;1;7;22;253;10;6;127;54;4;73;22;134;0
151;4.24956e-15;12;118;111;10098;1;7;22;253;10;4;104;38;6;66;22;135;0
152;4.25019e-15;10;120;111;10098;1;7;23;253;12;6;128;52;6;76;23;136;0
153;4.25019e-15;15;112;111;10099;1;7;23;253;11;5;125;51;6;74;23;137;0
154;4.25082e-15;15;106;111;10100;1;7;18;253;17;6;101;55;11;46;18;138;0
155;4.25146e-15;9;103;111;10100;1;7;14;252;12;1;100;35;11;65;14;139;0
156;4.25146e-15;7;111;111;10100;1;7;12;252;11;3;122;59;8;63;12;140;0
157;4.25146e-15;6;117;111;10101;1;7;17;252;8;6;127;48;2;79;17;141;0
158;4.25209e-15;7;135;111;10101;1;7;15;252;13;4;102;43;9;59;15;142;0
159;4.25209e-15;9;129;111;10103;1;7;13;252;10;2;123;54;8;69;13;143;0
160;4.25336e-15;9;128;111;10103;1;7;18;252;5;3;101;62;2;39;18;144;0
161;4.25336e-15;4;128;111;10103;1;7;22;252;11;8;112;65;3;47;22;145;0
162;4.25336e-15;7;136;111;10105;1;7;21;252;9;2;106;48;7;58;21;146;0
163;4.25463e-15;8;114;111;10106;1;7;22;252;8;3;110;70;5;40;22;147;0
164;4.25527e-15;11;128;111;10106;1;7;21;252;10;2;141;55;8;86;21;148;0
165;4.25527e-15;8;120;111;10106;1;7;24;252;9;6;124;68;3;56;24;149;0
166;4.25527e-15;8;134;111;10107;1;7;29;252;9;7;112;66;2;46;29;150;0
167;4.2559e-15;14;150;111;10107;1;7;27;252;10;2;111;51;8;60;27;151;0
168;4.2559e-15;11;130;111;10107;1;7;25;252;14;6;121;58;8;63;25;152;0
169;4.2559e-15;7;138;110;10107;1;8;27;252;11;7;101;61;4;40;27;153;0
170;4.2559e-15;15;133;110;10108;1;8;20;252;15;1;112;67;14;45;20;154;0
171;4.25654e-15;11;120;110;10108;1;8;24;252;8;5;125;48;3;77;24;155;0
172;4.25654e-15;9;125;109;10109;1;9;27;252;10;6;126;52;4;74;27;156;0
173;4.25717e-15;12;128;109;10109;1;9;20;252;18;5;113;52;13;61;20;157;0
174;4.25717e-15;13;129;109;10109;1;9;30;252;3;6;116;55;-3;61;30;158;0
175;4.25717e-15;15;126;109;10109;1;9;34;252;6;4;124;56;2;68;34;159;0
176;4.25717e-15;10;97;109;10109;1;9;33;252;15;8;93;55;7;38;33;160;0
177;4.25717e-15;12;114;109;10110;1;9;21;252;20;2;134;49;18;85;21;161;0
178;4.25781e-15;12;114;109;10110;1;9;27;252;7;5;76;64;2;12;27;162;0
179;4.25781e-15;13;106;109;10111;1;9;25;252;12;4;114;59;8;55;25;163;0
180;4.25844e-15;12;130;109;10111;1;9;27;252;10;6;119;61;4;58;27;163;0
181;4.25844e-15;10;120;109;10113;1;9;28;252;12;6;127;56;6;71;28;164;0
182;4.25971e-15;12;125;109;10113;1;9;33;252;7;6;107;51;1;56;33;165;0
183;4.25971e-15;16;126;109;10113;1;9;28;252;16;5;114;56;11;58;28;166;0
184;4.25971e-15;9;120;109;10113;1;9;34;252;11;10;93;56;1;37;34;167;0
185;4.25971e-15;16;114;109;10113;1;9;31;253;17;8;127;50;9;77;31;168;0
186;4.25971e-15;20;109;109;10113;1;9;23;253;18;4;122;40;14;82;23;169;0
187;4.25971e-15;16;111;111;10113;1;8;21;253;21;12;133;56;9;77;21;170;0
188;4.25971e-15;15;111;111;10113;1;8;28;253;9;9;111;57;0;54;28;171;0
189;4.25971e-15;19;119;111;10115;1;8;26;253;13;5;117;52;8;65;26;172;0
190;4.26098e-15;14;136;110;10116;1;9;37;253;5;9;112;58;-4;54;37;172;0
191;4.26162e-15;14;109;110;10116;1;9;33;253;19;9;130;65;10;65;33;173;0
192;4.26162e-15;21;121;110;10116;1;9;25;254;17;3;120;45;14;75;25;174;0
193;4.26162e-15;12;101;110;10117;1;9;24;254;15;7;117;61;8;56;24;175;0
194;4.26225e-15;20;136;110;10118;1;9;24;254;10;4;106;56;6;50;24;176;0
195;4.26289e-15;17;125;110;10119;1;9;24;254;14;7;106;62;7;44;24;177;0
196;4.26352e-15;18;131;110;10119;1;9;28;254;9;6;110;49;3;61;28;178;0
197;4.26352e-15;19;108;110;10119;1;9;35;254;9;10;115;62;-1;53;35;178;0
198;4.26352e-15;27;126;110;10119;1;9;35;254;13;6;131;56;7;75;35;179;0
199;4.26352e-15;25;139;109;10120;1;10;41;255;13;13;113;46;0;67;41;180;0
200;4.26416e-15;28;141;109;10120;1;10;38;255;20;11;138;54;9;84;38;181;0
201;4.26416e-15;27;144;111;10121;1;9;40;255;16;12;113;47;4;66;40;182;0
202;4.26479e-15;23;131;111;10122;1;9;40;255;18;12;131;69;6;62;40;183;0
203;4.26543e-15;29;124;111;10123;1;9;41;255;16;9;115;68;7;47;41;183;0
204;4.26606e-15;22;138;112;10123;1;9;41;256;17;11;105;46;6;59;41;184;0
205;4.26606e-15;23;114;111;10123;1;10;36;256;20;9;124;61;11;63;36;185;0
206;4.26606e-15;15;123;111;10123;1;10;26;256;20;4;138;54;16;84;26;186;0
207;4.26606e-15;12;129;111;10123;1;10;26;256;11;4;120;52;7;68;26;187;0
208;4.26606e-15;15;142;111;10124;1;10;29;256;11;6;115;64;5;51;29;187;0
209;4.2667e-15;15;136;110;10124;1;11;34;257;11;9;133;66;2;67;34;188;0
210;4.2667e-15;15;142;110;10124;1;11;32;257;14;6;128;56;8;72;32;189;0
211;4.2667e-15;16;133;110;10125;1;11;32;257;14;7;120;59;7;61;32;190;0
212;4.26733e-15;12;119;110;10125;1;11;37;257;12;11;117;61;1;56;37;191;0
213;4.26733e-15;19;125;112;10125;1;10;37;258;15;8;92;59;7;33;37;191;0
214;4.26733e-15;15;138;112;10125;1;10;38;258;11;6;128;50;5;78;38;192;0
215;4.26733e-15;19;139;112;10125;1;10;39;258;16;11;123;49;5;74;39;193;0
216;4.26733e-15;16;127;111;10125;1;11;37;258;20;11;125;57;9;68;37;194;0
217;4.26733e-15;23;135;110;10125;1;12;29;258;19;5;92;72;14;20;29;194;0
218;4.26733e-15;17;136;110;10126;1;12;31;259;12;7;111;59;5;52;31;195;0
219;4.26797e-15;22;134;112;10126;1;11;36;259;12;10;109;65;2;44;36;196;0
220;4.26797e-15;19;124;112;10127;1;11;33;259;18;9;105;73;9;32;33;197;0
221;4.26861e-15;17;129;111;10128;1;12;32;259;12;4;120;58;8;62;32;197;0
222;4.26924e-15;16;134;111;10128;1;12;26;260;15;2;104;58;13;46;26;198;0
223;4.26924e-15;6;151;111;10128;1;12;37;260;5;9;128;51;-4;77;37;199;0
224;4.26924e-15;13;147;111;10128;1;12;36;260;14;7;127;53;7;74;36;200;0
225;4.26924e-15;18;126;111;10129;1;12;31;260;19;7;134;73;12;61;31;200;0
226;4.26988e-15;19;123;111;10129;1;12;29;261;15;6;106;50;9;56;29;201;0
227;4.26988e-15;21;138;111;10129;1;12;30;261;12;7;108;65;5;43;30;202;0
228;4.26988e-15;20;119;113;10129;1;11;32;261;16;11;108;77;5;31;32;203;0
229;4.26988e-15;9;120;113;10130;1;11;37;261;14;12;139;57;2;82;37;203;0
230;4.27051e-15;14;129;113;10132;1;11;32;262;18;6;107;48;12;59;32;204;0
231;4.27178e-15;11;137;113;10132;1;11;30;262;16;8;111;64;8;47;30;205;0
232;4.27178e-15;15;148;113;10132;1;11;24;262;17;4;123;60;13;63;24;205;0
233;4.27178e-15;15;142;113;10133;1;11;27;263;11;6;122;64;5;58;27;206;0
234;4.27242e-15;13;142;113;10134;1;11;22;263;19;7;112;54;12;58;22;207;0
235;4.27305e-15;9;119;113;10134;1;11;33;263;5;9;118;56;-4;62;33;208;0
236;4.27305e-15;14;119;113;10134;1;11;34;263;12;6;111;61;6;50;34;208;0
237;4.27305e-15;11;139;113;10135;1;11;32;264;12;4;111;43;8;68;32;209;0
238;4.27369e-15;26;131;113;10136;1;11;29;264;15;5;128;58;10;70;29;210;0
239;4.27433e-15;18;119;113;10136;1;11;36;264;10;10;132;69;0;63;36;210;0
240;4.27433e-15;12;132;113;10136;1;11;37;264;15;9;128;44;6;84;37;211;0
241;4.27433e-15;9;141;113;10136;1;11;29;265;21;6;106;59;15;47;29;212;0
242;4.27433e-15;15;113;113;10136;1;11;30;265;12;6;111;72;6;39;30;212;0
243;4.27433e-15;10;120;113;10137;1;11;32;265;13;8;130;57;5;73;32;213;0
244;4.27496e-15;15;121;113;10137;1;11;33;266;11;5;119;52;6;67;33;214;0
245;4.27496e-15;18;133;113;10137;1;11;29;266;18;7;113;59;11;54;29;214;0
246;4.27496e-15;11;142;113;10137;1;11;33;266;13;10;133;62;3;71;33;215;1
247;4.27496e-15;13;135;113;10138;1;11;31;266;16;7;128;71;9;57;31;216;1
248;4.2756e-15;16;139;113;10138;1;11;34;267;12;8;138;54;4;84;34;216;1
249;4.2756e-15;19;120;115;10140;1;10;33;267;16;8;121;64;8;57;33;217;1
250;4.27687e-15;19;124;115;10141;1;10;36;267;11;7;129;56;4;73;36;218;1
251;4.27751e-15;17;146;115;10142;1;10;30;268;17;4;129;49;13;80;30;218;1
252;4.27814e-15;15;127;115;10142;1;10;36;268;11;10;121;67;1;54;36;219;1
253;4.27814e-15;15;127;114;10144;1;11;36;268;18;11;143;69;7;74;36;220;1
254;4.27941e-15;19;147;114;10144;1;11;34;268;12;3;133;62;9;71;34;220;1
255;4.27941e-15;14;133;114;10144;1;11;29;269;19;7;124;68;12;56;29;221;1
256;4.27941e-15;21;138;113;10145;1;12;25;269;13;2;115;49;11;66;25;222;1
257;4.28005e-15;10;156;115;10145;1;11;31;269;15;14;125;86;1;39;31;222;1
258;4.28005e-15;14;137;115;10146;1;11;31;270;11;4;138;73;7;65;31;223;1
259;4.28069e-15;21;126;115;10147;1;11;20;270;23;5;116;55;18;61;20;223;1
260;4.28132e-15;9;133;115;10148;1;11;29;270;6;8;114;51;-2;63;29;224;1
261;4.28196e-15;8;134;117;10149;1;10;26;271;17;7;135;60;10;75;26;225;1
262;4.28259e-15;10;131;117;10152;1;10;23;271;16;5;116;65;11;51;23;225;1
263;4.2845e-15;8;135;116;10152;1;11;19;271;14;3;142;65;11;77;19;226;1
264;4.2845e-15;5;124;118;10154;1;10;24;271;6;3;155;61;3;94;24;226;1
265;4.28577e-15;11;133;118;10154;1;10;23;272;10;2;145;61;8;84;23;227;1
266;4.28577e-15;13;138;120;10154;1;9;21;272;13;3;117;52;10;65;21;228;1
267;4.28577e-15;15;119;120;10154;1;9;22;272;8;2;118;70;6;48;22;228;1
268;4.28577e-15;17;115;120;10155;1;9;25;273;12;6;128;55;6;73;25;229;1
269;4.28641e-15;16;122;120;10155;1;9;30;273;12;9;149;59;3;90;30;230;1
270;4.28641e-15;9;128;120;10155;1;9;30;273;20;12;112;59;8;53;30;230;1
271;4.28641e-15;16;138;120;10156;1;9;34;274;11;8;126;66;3;60;34;231;1
272;4.28705e-15;17;137;120;10156;1;9;24;274;25;8;133;69;17;64;24;231;1
273;4.28705e-15;12;147;119;10156;1;10;28;274;11;7;110;56;4;54;28;232;1
274;4.28705e-15;11;122;119;10156;1;10;29;274;10;4;132;68;6;64;29;232;1
275;4.28705e-15;17;127;119;10156;1;10;27;275;13;3;134;60;10;74;27;233;1
276;4.28705e-15;19;123;121;10157;1;9;31;275;10;6;131;58;4;73;31;234;1
277;4.28768e-15;18;151;121;10157;1;9;32;275;12;6;113;60;6;53;32;234;1
278;4.28768e-15;14;137;121;10157;1;9;31;276;17;9;123;62;8;61;31;235;1
279;4.28768e-15;14;146;121;10157;1;9;32;276;13;6;151;72;7;79;32;235;1
280;4.28768e-15;14;135;121;10157;1;9;30;276;14;5;124;63;9;61;30;236;1
281;4.28768e-15;13;159;121;10157;1;9;30;277;16;9;122;58;7;64;30;237;1
282;4.28768e-15;13;144;121;10158;1;9;31;277;12;5;144;66;7;78;31;237;1
283;4.28832e-15;17;133;123;10158;1;8;20;277;21;3;118;71;18;47;20;238;1
284;4.28832e-15;15;121;123;10159;1;8;27;277;11;10;115;59;1;56;27;238;1
285;4.28896e-15;12;114;123;10159;1;8;30;278;9;4;123;74;5;49;30;239;1
286;4.28896e-15;16;143;123;10162;1;8;24;278;17;4;126;56;13;70;24;239;1
287;4.29087e-15;14;132;123;10163;1;8;20;278;18;6;127;62;12;65;20;240;1
288;4.2915e-15;5;134;123;10164;1;8;25;279;11;8;120;51;3;69;25;240;1
289;4.29214e-15;9;130;123;10165;1;8;28;279;6;2;122;62;4;60;28;241;1
290;4.29278e-15;12;145;123;10166;1;8;30;279;10;4;116;54;6;62;30;242;1
291;4.29341e-15;17;149;123;10168;1;8;30;280;11;4;153;59;7;94;30;242;1
292;4.29469e-15;12;115;122;10168;1;9;31;280;14;7;135;59;7;76;31;243;2
293;4.29469e-15;7;115;122;10169;1;9;34;280;11;7;126;69;4;57;34;243;2
294;4.29532e-15;12;127;122;10170;1;9;32;281;12;2;144;57;10;87;32;244;2
295;4.29596e-15;13;129;122;10170;1;9;21;281;22;4;149;55;18;94;21;244;2
296;4.29596e-15;14;140;122;10170;1;9;25;281;7;3;125;57;4;68;25;245;2
297;4.29596e-15;14;137;122;10170;1;9;24;281;13;4;130;57;9;73;24;245;2
298;4.29596e-15;10;128;122;10170;1;9;23;282;11;3;123;65;8;58;23;246;2
299;4.29596e-15;12;148;122;10170;1;9;27;282;9;5;154;58;4;96;27;246;2
300;4.29596e-15;10;140;122;10171;1;9;28;282;10;3;139;73;7;66;28;247;2
301;4.2966e-15;12;119;124;10171;1;8;33;283;9;7;113;61;2;52;33;247;2
302;4.2966e-15;10;141;124;10173;1;8;42;283;11;12;139;58;-1;81;42;248;2
303;4.29787e-15;16;122;124;10173;1;8;38;283;19;8;126;62;11;64;38;248;2
304;4.29787e-15;24;145;124;10175;1;8;23;284;28;6;135;62;22;73;23;249;2
305;4.29914e-15;11;137;124;10177;1;8;27;284;15;10;109;79;5;30;27;250;2
306;4.30042e-15;12;149;126;10177;1;7;29;284;13;7;134;66;6;68;29;250;2
307;4.30042e-15;15;135;126;10178;1;7;24;285;23;10;122;72;13;50;24;251;2
308;4.30106e-15;16;137;126;10178;1;7;33;285;4;7;141;70;-3;71;33;251;2
309;4.30106e-15;13;138;126;10180;1;7;37;285;9;5;131;56;4;75;37;252;2
310;4.30233e-15;15;142;126;10182;1;7;31;285;19;6;124;58;13;66;31;252;2
311;4.3036e-15;16;148;126;10182;1;7;34;286;12;7;147;79;5;68;34;253;2
312;4.3036e-15;11;157;126;10183;1;7;38;286;13;9;118;79;4;39;38;253;2
313;4.30424e-15;18;142;126;10184;1;7;33;286;18;6;136;69;12;67;33;254;2
314;4.30488e-15;16;142;126;10184;1;7;23;287;23;6;133;77;17;56;23;254;2
315;4.30488e-15;14;121;126;10184;1;7;31;287;6;6;136;59;0;77;31;255;2
316;4.30488e-15;9;124;126;10185;1;7;24;287;18;3;127;59;15;68;24;255;2
317;4.30552e-15;9;128;126;10186;1;7;28;288;9;5;135;56;4;79;28;256;2
318;4.30615e-15;15;133;126;10187;1;7;31;288;9;4;117;52;5;65;31;256;2
319;4.30679e-15;9;122;126;10188;1;7;31;288;19;11;149;56;8;93;31;257;2
320;4.30743e-15;13;122;126;10189;1;7;26;288;15;3;147;46;12;101;26;257;2
321;4.30807e-15;16;125;126;10192;1;7;29;289;11;6;156;59;5;97;29;257;2
322;4.30998e-15;18;115;126;10194;1;7;29;289;16;8;118;66;8;52;29;258;2
323;4.31125e-15;16;122;125;10195;1;8;35;289;9;7;137;72;2;65;35;258;2
324;4.31189e-15;12;133;124;10197;1;9;33;290;16;7;120;58;9;62;33;259;2
325;4.31317e-15;12;134;124;10198;1;9;26;290;20;5;126;65;15;61;26;259;2
326;4.3138e-15;12;136;124;10198;1;9;31;290;7;4;134;67;3;67;31;260;2
327;4.3138e-15;11;126;123;10198;1;10;34;291;13;8;124;61;5;63;34;260;2
328;4.3138e-15;19;134;125;10198;1;9;37;291;11;7;141;69;4;72;37;261;3
329;4.3138e-15;15;145;125;10199;1;9;34;291;17;6;143;67;11;76;34;261;3
330;4.31444e-15;20;149;127;10199;1;8;38;291;12;8;139;69;4;70;38;262;3
331;4.31444e-15;19;150;127;10200;1;8;31;292;23;9;125;75;14;50;31;262;3
332;4.31508e-15;14;140;127;10202;1;8;32;292;13;6;138;72;7;66;32;263;3
333;4.31635e-15;18;135;127;10202;1;8;28;292;17;5;145;65;12;80;28;263;3
334;4.31635e-15;21;154;127;10204;1;8;26;293;14;4;159;63;10;96;26;264;3
335;4.31763e-15;27;158;127;10204;1;8;33;293;9;8;115;49;1;66;33;264;3
336;4.31763e-15;23;158;127;10204;1;8;30;293;19;8;132;59;11;73;30;265;3
337;4.31763e-15;16;131;127;10204;1;8;26;294;24;12;144;71;12;73;26;265;3
338;4.31763e-15;12;137;127;10204;1;8;31;294;11;8;136;53;3;83;31;265;3
339;4.31763e-15;7;150;127;10204;1;8;35;294;11;8;139;60;3;79;35;266;3
340;4.31763e-15;17;175;126;10204;1;9;42;294;5;4;129;59;1;70;42;266;3
341;4.31763e-15;24;167;125;10204;1;10;42;295;17;9;135;79;8;56;42;267;3
342;4.31763e-15;28;149;127;10204;1;9;37;295;18;6;132;76;12;56;37;267;3
343;4.31763e-15;17;152;127;10204;1;9;41;295;18;14;140;69;4;71;41;268;3
344;4.31763e-15;18;141;127;10207;1;9;38;296;17;7;134;69;10;65;38;268;3
345;4.31954e-15;20;145;127;10207;1;9;29;296;21;4;138;65;17;73;29;269;3
346;4.31954e-15;16;122;126;10208;1;10;31;296;16;10;136;71;6;65;31;269;3
347;4.32018e-15;14;139;126;10208;1;10;34;296;9;4;128;55;5;73;34;269;3
348;4.32018e-15;19;138;126;10208;1;10;30;297;17;5;126;61;12;65;30;270;3
349;4.32018e-15;14;157;126;10210;1;10;32;297;15;9;137;55;6;82;32;270;3
350;4.32146e-15;20;139;126;10212;1;10;33;297;13;6;135;75;7;60;33;271;3
351;4.32273e-15;11;137;126;10214;1;10;38;298;12;9;130;73;3;57;38;271;3
352;4.32401e-15;19;140;126;10214;1;10;30;298;22;7;123;63;15;60;30;272;3
353;4.32401e-15;15;128;126;10214;1;10;39;298;8;9;124;66;-1;58;39;272;3
354;4.32401e-15;11;156;126;10214;1;10;42;299;15;10;125;50;5;75;42;272;3
355;4.32401e-15;16;169;126;10215;1;10;34;299;24;8;107;62;16;45;34;273;3
356;4.32465e-15;10;167;126;10215;1;10;31;299;15;4;156;72;11;84;31;273;3
357;4.32465e-15;15;141;125;10217;1;11;26;299;20;6;148;70;14;78;26;274;3
358;4.32593e-15;12;152;127;10217;1;10;21;300;21;8;118;70;13;48;21;274;4
359;4.32593e-15;8;141;127;10217;1;10;26;300;9;6;131;80;3;51;26;275;4
360;4.32593e-15;12;175;127;10218;1;10;31;300;12;8;154;64;4;90;31;275;4
361;4.32656e-15;14;138;127;10218;1;10;32;301;12;5;137;84;7;53;32;275;4
362;4.32656e-15;12;142;131;10219;1;8;32;301;16;8;114;72;8;42;32;276;4
363;4.3272e-15;16;139;130;10219;1;9;34;301;12;6;129;55;6;74;34;276;4
364;4.3272e-15;17;143;130;10219;1;9;23;301;23;4;165;77;19;88;23;277;4
365;4.3272e-15;11;143;130;10219;1;9;30;302;9;8;138;62;1;76;30;277;4
366;4.3272e-15;13;143;130;10220;1;9;27;302;15;3;137;69;12;68;27;277;4
367;4.32784e-15;17;132;130;10220;1;9;35;302;9;8;136;91;1;45;35;278;4
368;4.32784e-15;20;136;130;10220;1;9;35;303;12;4;135;65;8;70;35;278;4
369;4.32784e-15;16;148;130;10220;1;9;43;303;6;7;126;62;-1;64;43;279;4
370;4.32784e-15;19;135;130;10221;1;9;34;303;21;5;136;68;16;68;34;279;4
371;4.32848e-15;20;139;132;10222;1;8;33;303;18;9;135;66;9;69;33;280;4
372;4.32912e-15;15;139;131;10222;1;9;39;304;12;10;124;61;2;63;39;280;4
373;4.32912e-15;17;147;130;10222;1;10;35;304;20;7;142;73;13;69;35;280;4
374;4.32912e-15;16;153;130;10223;1;10;33;304;18;8;151;61;10;90;33;281;4
375;4.32976e-15;20;161;130;10223;1;10;33;305;13;5;139;70;8;69;33;281;4
376;4.32976e-15;15;143;130;10223;1;10;44;305;11;14;132;92;-3;40;44;282;4
377;4.32976e-15;21;146;132;10223;1;9;41;305;18;7;131;69;11;62;41;282;4
378;4.32976e-15;21;181;132;10225;1;9;36;305;23;10;158;67;13;91;36;282;4
379;4.33103e-15;19;154;132;10226;1;9;29;306;23;8;143;90;15;53;29;283;4
380;4.33167e-15;7;154;132;10228;1;9;31;306;13;7;137;76;6;61;31;283;4
381;4.33295e-15;10;153;134;10228;1;8;33;306;14;7;120;84;7;36;33;283;4
382;4.33295e-15;9;165;134;10229;1;8;32;306;15;6;161;82;9;79;32;284;4
383;4.33359e-15;19;161;134;10229;1;8;33;307;14;6;170;71;8;99;33;284;4
384;4.33359e-15;17;170;134;10230;1;8;35;307;15;8;176;80;7;96;35;285;4
385;4.33423e-15;14;182;134;10234;1;8;38;307;15;9;145;70;6;75;38;285;4
386;4.33678e-15;19;148;134;10234;1;8;28;308;23;5;145;86;18;59;28;285;5
387;4.33678e-15;11;182;134;10237;1;8;38;308;10;12;135;59;-2;76;38;286;5
388;4.3387e-15;10;165;134;10238;1;8;36;308;21;11;134;75;10;59;36;286;5
389;4.33934e-15;24;148;134;10241;1;8;23;308;30;9;153;91;21;62;23;287;5
390;4.34125e-15;15;159;134;10241;1;8;33;309;10;11;140;68;-1;72;33;287;5
391;4.34125e-15;11;166;133;10242;1;9;33;309;15;7;150;61;8;89;33;287;5
392;4.34189e-15;18;165;135;10243;1;8;32;309;13;4;145;74;9;71;32;288;5
393;4.34253e-15;27;142;135;10245;1;8;34;309;13;6;134;89;7;45;34;288;5
394;4.34381e-15;19;142;135;10245;1;8;37;310;12;7;126;68;5;58;37;288;5
395;4.34381e-15;10;161;135;10245;1;8;42;310;13;10;139;64;3;75;42;289;5
396;4.34381e-15;20;147;135;10246;1;8;36;310;22;8;145;78;14;67;36;289;5
397;4.34445e-15;18;153;135;10247;1;8;37;311;17;10;122;74;7;48;37;290;5
398;4.34509e-15;20;161;135;10247;1;8;32;311;20;7;126;73;13;53;32;290;5
399;4.34509e-15;21;159;135;10248;1;8;31;311;16;7;155;59;9;96;31;290;5
400;4.34573e-15;10;168;135;10248;1;8;43;311;8;11;134;77;-3;57;43;291;5
401;4.34573e-15;24;162;135;10249;1;8;44;312;14;7;151;66;7;85;44;291;5
402;4.34637e-15;22;136;135;10249;1;8;43;312;26;16;131;78;10;53;43;291;5
403;4.34637e-15;21;157;134;10249;1;9;44;312;18;10;149;61;8;88;44;292;5
404;4.34637e-15;24;153;134;10249;1;9;47;312;15;10;129;77;5;52;47;292;5
405;4.34637e-15;36;140;134;10249;1;9;41;313;25;10;154;75;15;79;41;292;5
406;4.34637e-15;25;141;134;10250;1;9;32;313;27;10;161;58;17;103;32;293;5
407;4.34701e-15;22;154;134;10250;1;9;29;313;20;8;141;60;12;81;29;293;5
408;4.34701e-15;18;145;134;10251;1;9;27;314;17;7;141;82;10;59;27;294;5
409;4.34765e-15;15;147;134;10252;1;9;34;314;13;11;150;70;2;80;34;294;5
410;4.34829e-15;16;124;134;10253;1;9;35;314;11;4;123;83;7;40;35;294;5
411;4.34893e-15;18;147;134;10255;1;9;34;314;18;9;118;69;9;49;34;295;6
412;4.3502e-15;20;137;136;10255;1;8;27;315;23;7;143;83;16;60;27;295;6
413;4.3502e-15;15;163;138;10258;1;7;35;315;10;10;128;49;0;79;35;295;6
414;4.35212e-15;12;172;138;10258;1;7;29;315;21;6;142;72;15;70;29;296;6
415;4.35212e-15;11;179;138;10258;1;7;33;315;14;10;153;71;4;82;33;296;6
416;4.35212e-15;20;165;138;10258;1;7;29;316;14;1;152;83;13;69;29;296;6
417;4.35212e-15;13;137;138;10258;1;7;31;316;12;5;132;83;7;49;31;297;6
418;4.35212e-15;13;137;137;10258;1;8;33;316;15;8;161;71;7;90;33;297;6
419;4.35212e-15;10;174;137;10260;1;8;30;316;17;6;151;63;11;88;30;297;6
420;4.3534e-15;8;169;137;10261;1;8;29;317;16;6;142;67;10;75;29;298;6
421;4.35404e-15;12;167;137;10261;1;8;34;317;10;7;136;75;3;61;34;298;6
422;4.35404e-15;13;167;137;10261;1;8;38;317;12;7;144;88;5;56;38;298;6
423;4.35404e-15;18;165;139;10262;1;7;40;317;16;10;148;78;6;70;40;299;6
424;4.35468e-15;25;178;138;10262;1;8;36;318;17;5;155;83;12;72;36;299;6
425;4.35468e-15;12;172;138;10263;1;8;38;318;20;13;153;68;7;85;38;299;6
426;4.35532e-15;18;157;138;10265;1;8;39;318;15;7;148;77;8;71;39;300;6
427;4.3566e-15;17;161;138;10265;1;8;40;318;15;8;166;69;7;97;40;300;6
428;4.3566e-15;13;158;138;10265;1;8;32;319;23;7;138;75;16;63;32;300;6
429;4.3566e-15;15;169;138;10265;1;8;32;319;14;5;126;71;9;55;32;301;6
430;4.3566e-15;14;159;138;10266;1;8;36;319;15;11;132;76;4;56;36;301;6
431;4.35724e-15;18;168;138;10267;1;8;32;319;17;4;148;65;13;83;32;301;6
432;4.35788e-15;17;155;138;10267;1;8;33;320;13;6;153;85;7;68;33;302;6
433;4.35788e-15;12;154;138;10268;1;8;34;320;13;5;133;74;8;59;34;302;6
434;4.35852e-15;17;145;138;10268;1;8;31;320;17;6;167;73;11;94;31;302;6
435;4.35852e-15;16;145;138;10269;1;8;30;320;15;5;140;68;10;72;30;303;6
436;4.35916e-15;10;152;138;10270;1;8;33;321;15;9;146;73;6;73;33;303;7
437;4.3598e-15;21;157;138;10272;1;8;31;321;18;7;171;61;11;110;31;303;7
438;4.36108e-15;15;162;138;10272;1;8;35;321;13;8;145;80;5;65;35;304;7
439;4.36108e-15;15;141;138;10273;1;8;38;321;13;8;147;68;5;79;38;304;7
440;4.36172e-15;17;134;138;10275;1;8;42;322;17;13;140;77;4;63;42;304;7
441;4.363e-15;25;161;138;10275;1;8;37;322;21;7;161;75;14;86;37;305;7
442;4.363e-15;23;170;138;10277;1;8;34;322;17;6;148;88;11;60;34;305;7
443;4.36428e-15;18;159;137;10279;1;9;37;322;12;6;156;81;6;75;37;305;7
444;4.36556e-15;28;162;137;10280;1;9;30;323;24;9;154;71;15;83;30;306;7
445;4.3662e-15;22;166;136;10281;1;10;38;323;12;11;139;65;1;74;38;306;7
446;4.36684e-15;25;169;138;10284;1;9;43;323;10;7;141;75;3;66;43;306;7
447;4.36876e-15;24;156;138;10285;1;9;50;323;16;15;158;87;1;71;50;307;7
448;4.3694e-15;20;143;138;10285;1;9;42;324;27;11;154;73;16;81;42;307;7
449;4.3694e-15;26;145;138;10285;1;9;44;324;18;11;141;71;7;70;44;307;7
450;4.3694e-15;23;152;138;10286;1;9;30;324;29;7;146;72;22;74;30;307;7
451;4.37004e-15;17;166;137;10288;1;10;42;324;8;11;156;82;-3;74;42;308;7
452;4.37133e-15;19;173;137;10290;1;10;40;325;17;7;160;80;10;80;40;308;7
453;4.37261e-15;22;175;137;10290;1;10;42;325;13;7;149;73;6;76;42;308;7
454;4.37261e-15;19;169;136;10290;1;11;39;325;23;10;139;61;13;78;39;309;7
455;4.37261e-15;22;165;136;10290;1;11;41;325;13;7;136;70;6;66;41;309;7
456;4.37261e-15;18;166;135;10291;1;12;43;326;19;13;143;79;6;64;43;309;7
457;4.37325e-15;13;176;135;10291;1;12;36;326;20;4;139;81;16;58;36;310;7
458;4.37325e-15;10;186;137;10293;1;11;37;326;14;7;136;77;7;59;37;310;7
459;4.37453e-15;21;156;137;10294;1;11;34;326;16;4;161;88;12;73;34;310;8
460;4.37517e-15;23;149;137;10294;1;11;38;327;18;14;136;76;4;60;38;311;8
461;4.37517e-15;20;150;137;10294;1;12;44;327;16;13;148;75;3;73;44;311;8
462;4.37517e-15;19;169;137;10294;1;12;43;327;17;8;165;70;9;95;43;311;8
463;4.37517e-15;23;173;137;10295;1;12;47;327;15;10;148;71;5;77;47;311;8
464;4.37581e-15;21;163;137;10296;1;12;37;328;29;11;151;84;18;67;37;312;8
465;4.37645e-15;15;159;139;10298;1;11;47;328;12;14;164;89;-2;75;47;312;8
466;4.37773e-15;21;154;141;10298;1;10;46;328;16;7;174;63;9;111;46;312;8
467;4.37773e-15;18;180;141;10299;1;10;48;328;16;9;128;73;7;55;48;313;8
468;4.37837e-15;23;189;145;10301;1;8;53;328;19;16;170;73;3;97;53;313;8
469;4.37966e-15;21;199;145;10302;1;8;50;329;24;13;134;75;11;59;50;313;8
470;4.3803e-15;18;190;145;10302;1;8;41;329;28;11;156;77;17;79;41;314;8
471;4.3803e-15;13;180;145;10302;1;8;30;329;27;8;141;87;19;54;30;314;8
472;4.3803e-15;14;188;145;10304;1;8;29;329;17;7;170;74;10;96;29;314;8
473;4.38158e-15;15;195;145;10308;1;8;36;330;10;7;145;74;3;71;36;314;8
474;4.38414e-15;17;161;145;10310;1;8;38;330;16;9;132;108;7;24;38;315;8
475;4.38543e-15;11;162;145;10310;1;8;43;330;15;11;135;78;4;57;43;315;8
476;4.38543e-15;24;166;145;10310;1;8;37;330;19;5;131;65;14;66;37;315;8
477;4.38543e-15;26;149;145;10310;1;8;40;331;13;7;159;89;6;70;40;316;8
478;4.38543e-15;15;160;145;10310;1;8;35;331;23;10;150;71;13;79;35;316;8
479;4.38543e-15;11;167;144;10311;1;9;40;331;15;11;143;76;4;67;40;316;8
480;4.38607e-15;21;157;144;10312;1;9;44;331;13;8;156;75;5;81;44;316;8
481;4.38671e-15;33;166;143;10312;1;10;44;331;16;8;136;74;8;62;44;317;8
482;4.38671e-15;29;170;143;10312;1;10;44;332;19;11;147;71;8;76;44;317;9
483;4.38671e-15;26;183;143;10312;1;10;52;332;17;16;144;77;1;67;52;317;9
484;4.38671e-15;25;167;143;10313;1;10;55;332;22;17;157;88;5;69;55;318;9
485;4.38735e-15;31;171;147;10313;1;8;55;332;19;11;145;82;8;63;55;318;9
486;4.38735e-15;26;149;147;10314;1;8;51;333;23;11;163;75;12;88;51;318;9
487;4.38799e-15;29;162;147;10315;1;8;52;333;19;12;145;71;7;74;52;318;9
488;4.38863e-15;21;157;147;10316;1;8;53;333;17;10;150;76;7;74;53;319;9
489;4.38927e-15;25;182;147;10318;1;8;46;333;24;9;150;71;15;79;46;319;9
490;4.39056e-15;24;155;147;10318;1;8;44;333;23;11;151;97;12;54;44;319;9
491;4.39056e-15;26;176;146;10319;1;9;40;334;23;10;154;74;13;80;40;320;9
492;4.3912e-15;20;178;146;10320;1;9;42;334;16;9;131;87;7;44;42;320;9
493;4.39184e-15;16;174;145;10320;1;10;32;334;28;10;171;69;18;102;32;320;9
494;4.39184e-15;18;177;145;10320;1;10;23;334;21;3;146;68;18;78;23;320;9
495;4.39184e-15;19;174;145;10321;1;10;24;335;16;7;149;81;9;68;24;321;9
496;4.39248e-15;15;179;147;10321;1;9;33;335;10;10;165;75;0;90;33;321;9
497;4.39248e-15;12;181;149;10321;1;8;29;335;18;5;157;55;13;102;29;321;9
498;4.39248e-15;13;156;149;10323;1;8;29;335;15;6;159;77;9;82;29;321;9
499;4.39376e-15;8;164;149;10323;1;8;23;335;22;7;152;71;15;81;23;322;9
500;4.39376e-15;11;172;149;10323;1;8;24;336;14;5;165;69;9;96;24;322;9
501;4.39376e-15;13;186;149;10323;1;8;23;336;14;4;153;74;10;79;23;322;9
502;4.39376e-15;12;173;148;10323;1;9;27;336;14;9;153;81;5;72;27;323;9
503;4.39376e-15;15;158;146;10324;1;11;29;336;12;4;145;83;8;62;29;323;9
504;4.39441e-15;15;161;146;10324;1;11;33;337;17;12;149;81;5;68;33;323;10
505;4.39441e-15;16;131;146;10325;1;11;33;337;14;5;151;80;9;71;33;323;10
506;4.39505e-15;21;154;148;10325;1;10;33;337;14;5;155;66;9;89;33;324;10
507;4.39505e-15;16;161;147;10327;1;11;28;337;18;4;143;73;14;70;28;324;10
508;4.39633e-15;18;151;147;10327;1;11;30;337;10;3;180;56;7;124;30;324;10
509;4.39633e-15;18;152;146;10330;1;12;32;338;16;8;155;71;8;84;32;324;10
510;4.39826e-15;17;157;146;10330;1;12;36;338;14;9;167;79;5;88;36;325;10
511;4.39826e-15;20;175;146;10330;1;12;33;338;15;4;189;59;11;130;33;325;10
512;4.39826e-15;19;172;146;10332;1;12;34;338;14;6;151;88;8;63;34;325;10
513;4.39954e-15;19;166;146;10332;1;12;31;338;16;4;167;78;12;89;31;325;10
514;4.39954e-15;18;163;146;10332;1;12;27;339;17;4;157;83;13;74;27;326;10
515;4.39954e-15;17;156;148;10332;1;11;31;339;10;4;144;81;6;63;31;326;10
516;4.39954e-15;23;171;148;10334;1;11;35;339;12;7;147;88;5;59;35;326;10
517;4.40082e-15;20;165;147;10334;1;12;40;339;13;9;159;91;4;68;40;326;10
518;4.40082e-15;23;136;147;10335;1;12;42;340;14;8;137;76;6;61;42;327;10
519;4.40147e-15;17;161;147;10336;1;12;49;340;13;11;151;66;2;85;49;327;10
520;4.40211e-15;23;169;147;10336;1;12;40;340;30;12;172;75;18;97;40;327;10
521;4.40211e-15;24;170;147;10337;1;12;40;340;17;9;163;89;8;74;40;327;10
522;4.40275e-15;20;179;147;10338;1;12;42;340;21;14;138;77;7;61;42;328;10
523;4.40339e-15;22;169;149;10340;1;11;40;341;19;8;139;84;11;55;40;328;10
524;4.40468e-15;19;176;149;10341;1;11;34;341;21;6;169;71;15;98;34;328;10
525;4.40532e-15;15;205;149;10341;1;11;34;341;18;9;137;71;9;66;34;329;10
526;4.40532e-15;20;193;151;10342;1;10;29;341;18;4;155;93;14;62;29;329;11
527;4.40596e-15;16;191;151;10344;1;10;31;341;13;5;155;83;8;72;31;329;11
528;4.40725e-15;9;173;151;10344;1;10;33;342;15;8;142;89;7;53;33;329;11
529;4.40725e-15;11;190;150;10345;1;11;40;342;13;11;150;88;2;62;40;330;11
530;4.40789e-15;10;179;149;10346;1;12;43;342;13;7;163;87;6;76;43;330;11
531;4.40853e-15;18;168;148;10347;1;13;34;342;21;3;159;85;18;74;34;330;11
532;4.40917e-15;22;151;148;10348;1;13;40;342;13;9;166;79;4;87;40;330;11
533;4.40982e-15;23;166;148;10348;1;13;47;343;12;9;162;76;3;86;47;330;11
534;4.40982e-15;23;189;148;10349;1;13;36;343;26;7;155;72;19;83;36;331;11
535;4.41046e-15;18;185;147;10351;1;14;36;343;17;8;172;92;9;80;36;331;11
536;4.41174e-15;11;176;147;10351;1;14;37;343;19;10;154;68;9;86;37;331;11
537;4.41174e-15;17;158;146;10351;1;15;44;343;11;9;168;72;2;96;44;331;11
538;4.41174e-15;19;189;146;10351;1;15;49;344;17;13;175;69;4;106;49;332;11
539;4.41174e-15;18;181;146;10351;1;15;49;344;19;10;156;78;9;78;49;332;11
540;4.41174e-15;18;169;148;10351;1;14;40;344;26;8;165;96;18;69;40;332;11
541;4.41174e-15;17;156;150;10351;1;13;34;344;19;4;157;74;15;83;34;332;11
542;4.41174e-15;19;145;150;10352;1;13;36;344;11;4;163;57;7;106;36;333;11
543;4.41239e-15;13;146;152;10352;1;12;28;345;26;9;160;67;17;93;28;333;11
544;4.41239e-15;10;178;152;10352;1;12;26;345;14;3;154;72;11;82;26;333;11
545;4.41239e-15;9;164;152;10352;1;12;27;345;12;3;158;82;9;76;27;333;11
546;4.41239e-15;9;158;152;10352;1;12;31;345;10;5;180;71;5;109;31;334;11
547;4.41239e-15;11;159;152;10353;1;12;25;345;20;5;172;73;15;99;25;334;11
548;4.41303e-15;11;167;152;10354;1;12;35;346;8;8;170;80;0;90;35;334;12
549;4.41367e-15;21;177;152;10354;1;12;23;346;24;3;150;79;21;71;23;334;12
550;4.41367e-15;11;142;152;10355;1;12;27;346;11;5;154;84;6;70;27;335;12
551;4.41431e-15;15;175;152;10357;1;12;30;346;13;6;166;62;7;104;30;335;12
552;4.4156e-15;16;189;152;10357;1;12;31;346;13;5;153;84;8;69;31;335;12
553;4.4156e-15;16;174;152;10358;1;12;30;347;18;8;170;72;10;98;30;335;12
554;4.41624e-15;12;148;152;10358;1;12;31;347;13;4;165;86;9;79;31;336;12
555;4.41624e-15;12;179;152;10358;1;12;37;347;13;10;164;70;3;94;37;336;12
556;4.41624e-15;11;151;152;10358;1;12;34;347;22;9;172;91;13;81;34;336;12
557;4.41624e-15;16;178;152;10358;1;12;30;347;18;5;143;69;13;74;30;336;12
558;4.41624e-15;16;170;154;10358;1;11;35;348;11;5;159;81;6;78;35;336;12
559;4.41624e-15;17;161;153;10358;1;12;38;348;17;11;148;72;6;76;38;337;12
560;4.41624e-15;20;181;153;10358;1;12;40;348;14;7;163;85;7;78;40;337;12
561;4.41624e-15;16;159;153;10358;1;12;40;348;16;7;152;96;9;56;40;337;12
562;4.41624e-15;21;185;153;10359;1;12;46;348;13;10;167;75;3;92;46;337;12
563;4.41688e-15;14;165;152;10359;1;13;41;349;28;15;158;92;13;66;41;338;12
564;4.41688e-15;14;193;154;10359;1;12;35;349;19;4;155;89;15;66;35;338;12
565;4.41688e-15;18;190;156;10360;1;11;34;349;20;10;160;69;10;91;34;338;12
566;4.41753e-15;19;170;156;10362;1;11;36;349;15;6;142;82;9;60;36;338;12
567;4.41881e-15;22;196;158;10362;1;10;38;349;16;8;166;76;8;90;38;339;12
568;4.41881e-15;20;204;158;10363;1;10;33;350;20;6;149;72;14;77;33;339;12
569;4.41946e-15;17;196;158;10364;1;10;34;350;14;6;164;94;8;70;34;339;12
570;4.4201e-15;21;167;158;10364;1;10;36;350;9;2;156;75;7;81;36;339;13
571;4.4201e-15;11;168;157;10365;1;11;37;350;23;14;161;90;9;71;37;339;13
572;4.42074e-15;18;177;157;10366;1;11;39;350;14;7;187;74;7;113;39;340;13
573;4.42138e-15;21;176;156;10368;1;12;39;350;13;4;168;82;9;86;39;340;13
574;4.42267e-15;14;195;158;10370;1;11;37;351;19;8;157;68;11;89;37;340;13
575;4.42396e-15;14;186;158;10370;1;11;39;351;16;9;136;75;7;61;39;340;13
576;4.42396e-15;8;202;157;10371;1;12;44;351;12;8;152;76;4;76;44;341;13
577;4.4246e-15;12;189;159;10371;1;11;32;351;25;4;159;75;21;84;32;341;13
578;4.4246e-15;16;170;158;10374;1;12;28;351;17;4;146;75;13;71;28;341;13
579;4.42653e-15;17;168;158;10376;1;12;29;352;11;2;167;84;9;83;29;341;13
580;4.42782e-15;11;174;158;10379;1;12;35;352;11;8;157;72;3;85;35;341;13
581;4.42975e-15;14;163;158;10379;1;12;40;352;15;11;175;87;4;88;40;342;13
582;4.42975e-15;21;176;158;10379;1;12;35;352;25;11;134;63;14;71;35;342;13
583;4.42975e-15;26;180;158;10380;1;12;40;352;14;9;170;77;5;93;40;342;13
584;4.43039e-15;25;182;157;10380;1;13;43;353;19;13;154;75;6;79;43;342;13
585;4.43039e-15;22;184;156;10380;1;14;39;353;28;15;134;75;13;59;39;343;13
586;4.43039e-15;19;204;158;10381;1;13;42;353;15;9;179;71;6;108;42;343;13
587;4.43103e-15;22;183;158;10383;1;13;35;353;22;6;155;87;16;68;35;343;13
588;4.43232e-15;16;160;158;10383;1;13;33;353;19;8;157;88;11;69;33;343;13
589;4.43232e-15;17;166;157;10383;1;14;37;353;12;5;151;72;7;79;37;343;13
590;4.43232e-15;23;166;158;10384;1;14;35;354;18;7;153;73;11;80;35;344;13
591;4.43296e-15;14;158;160;10385;1;13;35;354;23;14;149;72;9;77;35;344;13
592;4.43361e-15;20;194;160;10386;1;13;34;354;16;6;158;73;10;85;34;344;14
593;4.43425e-15;22;179;159;10386;1;14;38;354;14;8;167;85;6;82;38;344;14
594;4.43425e-15;17;207;161;10386;1;13;44;354;15;12;163;78;3;85;44;344;14
595;4.43425e-15;15;178;163;10387;1;12;45;354;19;11;166;85;8;81;45;345;14
596;4.43489e-15;18;169;163;10387;1;12;41;355;20;7;151;86;13;65;41;345;14
597;4.43489e-15;19;152;163;10387;1;12;42;355;15;6;181;91;9;90;42;345;14
598;4.43489e-15;19;162;162;10389;1;13;45;355;16;10;151;63;6;88;45;345;14
599;4.43618e-15;22;151;162;10389;1;13;42;355;22;10;163;84;12;79;42;345;14
600;4.43618e-15;21;172;164;10389;1;12;47;355;20;15;163;76;5;87;47;346;14
601;4.43618e-15;23;168;167;10391;1;11;44;356;21;9;169;67;12;102;44;346;14
602;4.43747e-15;29;184;169;10394;1;10;38;356;22;6;148;78;16;70;38;346;14
603;4.4394e-15;23;212;169;10394;1;10;49;356;14;16;149;85;-2;64;49;346;14
604;4.4394e-15;19;183;169;10396;1;10;51;356;12;5;163;96;7;67;51;347;14
605;4.44069e-15;26;167;169;10397;1;10;37;356;32;9;158;77;23;81;37;347;14
606;4.44133e-15;19;180;169;10400;1;10;46;356;10;10;162;82;0;80;46;347;14
607;4.44326e-15;20;194;169;10401;1;10;41;357;26;12;162;69;14;93;41;347;14
608;4.44391e-15;21;179;169;10402;1;10;46;357;18;14;152;87;4;65;46;347;14
609;4.44455e-15;29;164;169;10402;1;10;45;357;21;11;157;69;10;88;45;348;14
610;4.44455e-15;22;179;169;10403;1;10;43;357;24;13;146;79;11;67;43;348;14
611;4.4452e-15;27;164;169;10404;1;10;41;357;15;4;154;89;11;65;41;348;14
612;4.44584e-15;20;188;169;10404;1;10;35;357;24;9;149;73;15;76;35;348;14
613;4.44584e-15;22;161;169;10404;1;10;45;358;13;14;166;81;-1;85;45;348;14
614;4.44584e-15;31;164;169;10405;1;10;41;358;17;4;146;79;13;67;41;349;14
615;4.44649e-15;19;163;169;10407;1;10;48;358;18;16;146;83;2;63;48;349;15
616;4.44777e-15;16;171;168;10407;1;11;46;358;19;8;162;83;11;79;46;349;15
617;4.44777e-15;16;179;168;10407;1;11;48;358;13;6;180;79;7;101;48;349;15
618;4.44777e-15;20;166;168;10407;1;11;42;359;21;6;168;77;15;91;42;349;15
619;4.44777e-15;19;168;168;10408;1;11;45;359;18;12;171;70;6;101;45;350;15
620;4.44842e-15;22;179;168;10408;1;11;43;359;22;11;160;74;11;86;43;350;15
621;4.44842e-15;25;187;168;10409;1;11;46;359;16;10;163;92;6;71;46;350;15
622;4.44906e-15;21;187;168;10409;1;11;46;359;22;13;156;83;9;73;46;350;15
623;4.44906e-15;19;169;168;10409;1;11;40;359;27;12;168;89;15;79;40;350;15
624;4.44906e-15;23;161;168;10410;1;11;47;360;10;8;165;94;2;71;47;351;15
625;4.44971e-15;25;168;168;10410;1;11;34;360;26;4;167;80;22;87;34;351;15
626;4.44971e-15;19;186;168;10411;1;11;35;360;18;9;154;78;9;76;35;351;15
627;4.45035e-15;19;181;168;10411;1;11;38;360;17;11;156;88;6;68;38;351;15
628;4.45035e-15;15;154;168;10412;1;11;29;360;25;6;163;76;19;87;29;351;15
629;4.451e-15;14;158;168;10414;1;11;33;360;17;12;160;85;5;75;33;351;15
630;4.45228e-15;18;159;167;10418;1;12;36;361;14;7;164;86;7;78;36;352;15
631;4.45486e-15;17;189;166;10418;1;13;36;361;15;6;162;78;9;84;36;352;15
632;4.45486e-15;18;162;166;10419;1;13;41;361;16;10;172;81;6;91;41;352;15
633;4.45551e-15;21;177;168;10419;1;12;38;361;26;14;161;74;12;87;38;352;15
634;4.45551e-15;17;172;168;10420;1;12;39;361;14;6;159;69;8;90;39;352;15
635;4.45615e-15;15;169;168;10421;1;12;33;361;25;9;182;88;16;94;33;353;15
636;4.4568e-15;15;180;167;10423;1;13;22;362;30;9;157;65;21;92;22;353;15
637;4.45809e-15;8;202;167;10424;1;13;30;362;14;12;148;88;2;60;30;353;16
638;4.45873e-15;12;192;166;10426;1;14;30;362;14;4;181;85;10;96;30;353;16
639;4.46002e-15;14;191;166;10426;1;14;26;362;18;4;180;82;14;98;26;353;16
640;4.46002e-15;10;164;166;10427;1;14;24;362;14;2;174;82;12;92;24;354;16
641;4.46067e-15;10;146;166;10427;1;14;31;362;9;6;153;75;3;78;31;354;16
642;4.46067e-15;14;154;166;10427;1;14;32;362;13;5;151;75;8;76;32;354;16
643;4.46067e-15;13;184;166;10428;1;14;29;363;16;3;182;77;13;105;29;354;16
644;4.46131e-15;13;169;166;10430;1;14;41;363;9;11;166;80;-2;86;41;354;16
645;4.4626e-15;20;174;168;10431;1;13;27;363;30;7;177;93;23;84;27;355;16
646;4.46325e-15;21;192;170;10434;1;12;25;363;16;4;160;76;12;84;25;355;16
647;4.46518e-15;16;185;172;10434;1;11;28;363;14;7;168;74;7;94;28;355;16
648;4.46518e-15;17;175;175;10435;1;10;27;363;15;5;182;102;10;80;27;355;16
649;4.46583e-15;15;174;175;10435;1;10;30;364;14;7;174;78;7;96;30;355;16
650;4.46583e-15;16;176;175;10436;1;10;25;364;19;4;177;84;15;93;25;355;16
651;4.46647e-15;12;194;175;10436;1;10;31;364;9;5;167;80;4;87;31;356;16
652;4.46647e-15;12;190;175;10436;1;10;35;364;16;10;165;92;6;73;35;356;16
653;4.46647e-15;19;171;175;10436;1;10;26;364;23;5;176;102;18;74;26;356;16
654;4.46647e-15;14;173;175;10436;1;10;32;364;10;6;152;79;4;73;32;356;16
655;4.46647e-15;10;183;177;10437;1;9;36;365;12;6;175;71;6;104;36;356;16
656;4.46712e-15;18;173;179;10440;1;8;37;365;17;9;212;86;8;126;37;357;16
657;4.46905e-15;16;172;179;10442;1;8;35;365;25;12;150;84;13;66;35;357;16
658;4.47034e-15;18;181;181;10444;1;7;27;365;20;3;191;78;17;113;27;357;16
659;4.47163e-15;17;179;181;10445;1;7;27;365;18;8;175;95;10;80;27;357;16
660;4.47228e-15;13;186;180;10445;1;8;31;365;11;5;168;79;6;89;31;357;17
661;4.47228e-15;20;161;182;10445;1;7;40;365;14;12;152;84;2;68;40;357;17
662;4.47228e-15;20;164;180;10448;1;9;41;366;16;8;169;79;8;90;41;358;17
663;4.47422e-15;19;175;180;10449;1;9;43;366;19;12;172;85;7;87;43;358;17
664;4.47486e-15;25;169;182;10451;1;8;51;366;13;11;155;86;2;69;51;358;17
665;4.47615e-15;30;179;181;10453;1;9;50;366;16;7;174;80;9;94;50;358;17
666;4.47744e-15;17;184;183;10453;1;8;41;366;26;8;186;84;18;102;41;358;17
667;4.47744e-15;20;181;182;10455;1;9;39;366;19;7;162;100;12;62;39;359;17
668;4.47874e-15;15;167;181;10456;1;10;33;367;22;7;162;71;15;91;33;359;17
669;4.47938e-15;9;182;181;10457;1;10;37;367;14;8;164;76;6;88;37;359;17
670;4.48003e-15;15;159;180;10457;1;11;34;367;20;8;162;91;12;71;34;359;17
671;4.48003e-15;19;179;180;10458;1;11;37;367;16;9;159;77;7;82;37;359;17
672;4.48067e-15;16;196;180;10458;1;11;46;367;14;12;182;89;2;93;46;359;17
673;4.48067e-15;23;195;178;10458;1;13;48;367;14;7;190;84;7;106;48;360;17
674;4.48067e-15;18;211;178;10460;1;13;47;367;23;12;150;75;11;75;47;360;17
675;4.48196e-15;16;223;180;10460;1;12;44;368;22;10;178;85;12;93;44;360;17
676;4.48196e-15;21;199;180;10461;1;12;34;368;23;4;162;113;19;49;34;360;17
677;4.48261e-15;21;176;182;10462;1;11;38;368;14;8;170;74;6;96;38;360;17
678;4.48326e-15;21;182;182;10462;1;11;40;368;12;5;152;91;7;61;40;360;17
679;4.48326e-15;19;199;182;10462;1;11;31;368;28;9;186;67;19;119;31;361;17
680;4.48326e-15;15;197;182;10463;1;11;37;368;11;6;140;88;5;52;37;361;17
681;4.4839e-15;15;184;182;10464;1;11;29;369;24;7;171;98;17;73;29;361;17
682;4.48455e-15;8;196;182;10465;1;11;33;369;16;10;159;92;6;67;33;361;17
683;4.48519e-15;17;194;182;10466;1;11;32;369;15;4;170;87;11;83;32;361;18
684;4.48584e-15;14;186;182;10467;1;11;26;369;20;4;177;78;16;99;26;361;18
685;4.48649e-15;13;176;182;10468;1;11;39;369;5;8;175;82;-3;93;39;362;18
686;4.48713e-15;18;176;182;10470;1;11;36;369;20;8;169;83;12;86;36;362;18
687;4.48843e-15;25;180;186;10472;1;9;44;369;12;10;150;78;2;72;44;362;18
688;4.48972e-15;17;167;188;10474;1;8;48;370;18;12;190;85;6;105;48;362;18
689;4.49101e-15;25;177;188;10474;1;8;48;370;16;7;172;79;9;93;48;362;18
690;4.49101e-15;29;179;189;10477;1;8;48;370;23;14;164;95;9;69;48;363;18
691;4.49295e-15;33;175;189;10477;1;8;48;370;25;15;157;89;10;68;48;363;18
692;4.49295e-15;33;199;189;10478;1;8;42;370;27;12;162;81;15;81;42;363;18
693;4.4936e-15;33;171;189;10478;1;8;38;370;27;14;184;92;13;92;38;363;18
694;4.4936e-15;30;200;189;10479;1;8;44;370;14;10;165;76;4;89;44;363;18
695;4.49424e-15;33;184;189;10479;1;8;48;371;17;12;154;87;5;67;48;363;18
696;4.49424e-15;23;156;189;10479;1;8;49;371;24;16;187;107;8;80;49;364;18
697;4.49424e-15;18;182;191;10480;1;7;45;371;25;12;161;82;13;79;45;364;18
698;4.49489e-15;22;192;191;10481;1;7;51;371;15;11;186;83;4;103;51;364;18
699;4.49554e-15;24;194;191;10484;1;7;52;371;21;13;183;86;8;97;52;364;18
700;4.49748e-15;28;194;191;10484;1;7;44;371;27;10;184;96;17;88;44;364;18
701;4.49748e-15;22;187;190;10484;1;8;44;371;20;11;184;82;9;102;44;364;18
702;4.49748e-15;29;186;190;10488;1;8;45;372;19;10;168;84;9;84;45;364;18
703;4.50006e-15;22;181;190;10488;1;8;54;372;22;22;157;88;0;69;54;365;18
704;4.50006e-15;23;207;190;10489;1;8;49;372;23;9;175;72;14;103;49;365;18
705;4.50071e-15;20;195;189;10490;1;9;45;372;21;8;146;89;13;57;45;365;18
706;4.50136e-15;22;207;189;10491;1;9;44;372;20;9;148;86;11;62;44;365;19
707;4.502e-15;17;197;189;10496;1;9;40;372;26;13;182;97;13;85;40;365;19
708;4.50524e-15;20;195;191;10498;1;8;38;372;19;7;179;100;12;79;38;365;19
709;4.50653e-15;27;190;191;10502;1;8;30;373;23;6;181;102;17;79;30;366;19
710;4.50912e-15;15;195;191;10503;1;8;35;373;13;7;156;95;6;61;35;366;19
711;4.50977e-15;14;207;193;10503;1;7;35;373;16;6;187;83;10;104;35;366;19
712;4.50977e-15;16;202;193;10504;1;7;40;373;14;9;206;79;5;127;40;366;19
713;4.51042e-15;14;187;195;10505;1;6;31;373;24;6;168;99;18;69;31;366;19
714;4.51106e-15;19;178;195;10508;1;6;34;373;16;9;186;93;7;93;34;366;19
715;4.51301e-15;15;182;195;10510;1;6;40;373;14;9;176;96;5;80;40;367;19
716;4.5143e-15;13;203;195;10510;1;6;46;374;16;12;172;86;4;86;46;367;19
717;4.5143e-15;21;191;195;10511;1;6;44;374;23;12;169;82;11;87;44;367;19
718;4.51495e-15;18;182;195;10511;1;6;50;374;20;17;179;75;3;104;50;367;19
719;4.51495e-15;19;182;195;10511;1;6;42;374;24;6;183;89;18;94;42;367;19
720;4.51495e-15;18;174;195;10513;1;6;26;374;35;10;197;88;25;109;26;367;19
721;4.51624e-15;11;193;195;10514;1;6;34;374;9;7;190;84;2;106;34;368;19
722;4.51689e-15;9;177;195;10517;1;6;29;374;20;5;173;94;15;79;29;368;19
723;4.51883e-15;12;177;195;10517;1;6;32;375;11;4;165;89;7;76;32;368;19
724;4.51883e-15;12;181;195;10518;1;6;31;375;18;7;149;68;11;81;31;368;19
725;4.51948e-15;14;190;195;10519;1;6;32;375;16;7;186;86;9;100;32;368;19
726;4.52013e-15;13;196;197;10520;1;5;36;375;10;4;153;98;6;55;36;368;19
727;4.52078e-15;11;181;197;10522;1;5;32;375;20;6;195;106;14;89;32;368;19
728;4.52207e-15;13;179;197;10523;1;5;34;375;14;6;151;79;8;72;34;369;19
729;4.52272e-15;19;182;199;10524;1;4;36;375;12;3;167;72;9;95;36;369;19
730;4.52337e-15;17;181;199;10525;1;4;35;375;19;9;177;83;10;94;35;369;20
731;4.52402e-15;11;187;199;10527;1;4;29;376;22;6;164;75;16;89;29;369;20
732;4.52531e-15;12;191;199;10528;1;4;29;376;16;5;176;90;11;86;29;369;20
733;4.52596e-15;8;176;199;10529;1;4;32;376;13;6;194;80;7;114;32;369;20
734;4.52661e-15;16;197;199;10531;1;4;29;376;16;3;165;82;13;83;29;370;20
735;4.5279e-15;20;190;199;10531;1;4;27;376;16;4;181;87;12;94;27;370;20
736;4.5279e-15;10;184;199;10531;1;4;31;376;16;10;192;78;6;114;31;370;20
737;4.5279e-15;14;191;199;10532;1;4;42;376;8;9;169;78;-1;91;42;370;20
738;4.52855e-15;24;173;198;10533;1;5;30;377;24;2;165;88;22;77;30;370;20
739;4.5292e-15;20;181;197;10535;1;6;37;377;15;12;179;85;3;94;37;370;20
740;4.5305e-15;20;202;199;10535;1;5;37;377;18;8;156;88;10;68;37;370;20
741;4.5305e-15;20;193;199;10535;1;5;46;377;12;12;143;90;0;53;46;371;20
742;4.5305e-15;13;182;199;10538;1;5;51;377;20;15;186;97;5;89;51;371;20
743;4.53244e-15;25;200;198;10539;1;6;55;377;13;8;164;75;5;89;55;371;20
744;4.53309e-15;18;187;198;10540;1;6;52;377;30;17;185;92;13;93;52;371;20
745;4.53374e-15;23;177;196;10542;1;8;38;377;28;5;179;96;23;83;38;371;20
746;4.53504e-15;21;179;196;10542;1;8;37;378;22;11;178;98;11;80;37;371;20
747;4.53504e-15;17;203;196;10544;1;8;43;378;13;9;172;84;4;88;43;371;20
748;4.53633e-15;23;180;195;10544;1;9;41;378;20;9;170;85;11;85;41;372;20
749;4.53633e-15;24;185;195;10545;1;9;41;378;18;8;167;89;10;78;41;372;20
750;4.53698e-15;19;221;195;10545;1;9;51;378;14;14;178;88;0;90;51;372;20
751;4.53698e-15;28;191;195;10546;1;9;49;378;21;10;166;93;11;73;49;372;20
752;4.53763e-15;29;182;197;10547;1;8;48;378;19;9;182;81;10;101;48;372;20
753;4.53828e-15;29;191;197;10547;1;8;45;378;26;12;166;96;14;70;45;372;20
754;4.53828e-15;23;186;197;10547;1;8;42;379;19;7;163;90;12;73;42;373;21
755;4.53828e-15;14;192;197;10548;1;8;41;379;21;10;172;82;11;90;41;373;21
756;4.53893e-15;13;176;197;10549;1;8;47;379;11;8;204;92;3;112;47;373;21
757;4.53958e-15;21;176;197;10550;1;8;49;379;16;8;167;84;8;83;49;373;21
758;4.54023e-15;18;176;197;10550;1;8;41;379;36;19;187;86;17;101;41;373;21
759;4.54023e-15;29;182;197;10550;1;8;41;379;18;8;189;71;10;118;41;373;21
760;4.54023e-15;26;180;197;10552;1;8;38;379;20;7;184;70;13;114;38;373;21
761;4.54152e-15;22;188;197;10552;1;8;41;379;19;12;168;88;7;80;41;374;21
762;4.54152e-15;21;201;197;10555;1;8;43;380;15;7;157;86;8;71;43;374;21
763;4.54347e-15;24;213;197;10556;1;8;38;380;25;9;204;86;16;118;38;374;21
764;4.54412e-15;19;218;198;10559;1;8;40;380;18;10;184;94;8;90;40;374;21
765;4.54607e-15;16;217;198;10559;1;8;42;380;15;8;183;98;7;85;42;374;21
766;4.54607e-15;15;192;197;10560;1;9;39;380;16;3;164;93;13;71;39;374;21
767;4.54671e-15;14;182;197;10561;1;9;40;380;19;10;162;107;9;55;40;374;21
768;4.54736e-15;19;204;196;10564;1;10;44;380;16;10;164;87;6;77;44;375;21
769;4.54931e-15;28;203;196;10564;1;10;47;380;19;13;172;76;6;96;47;375;21
770;4.54931e-15;20;176;196;10565;1;10;50;381;19;12;178;97;7;81;50;375;21
771;4.54996e-15;18;188;196;10566;1;10;53;381;23;17;158;88;6;70;53;375;21
772;4.55061e-15;23;183;196;10567;1;10;53;381;22;12;185;92;10;93;53;375;21
773;4.55126e-15;22;187;196;10567;1;10;51;381;28;17;188;81;11;107;51;375;21
774;4.55126e-15;24;211;196;10568;1;10;61;381;20;20;175;91;0;84;61;375;21
775;4.55191e-15;25;209;196;10568;1;10;55;381;27;12;192;63;15;129;55;376;21
776;4.55191e-15;21;183;196;10570;1;10;51;381;23;10;170;101;13;69;51;376;21
777;4.55321e-15;25;180;196;10570;1;10;51;381;20;11;178;76;9;102;51;376;21
778;4.55321e-15;28;186;196;10573;1;10;57;382;17;13;161;93;4;68;57;376;21
779;4.55515e-15;28;175;196;10574;1;10;44;382;31;9;193;91;22;102;44;376;22
780;4.5558e-15;21;205;196;10575;1;10;56;382;7;9;171;84;-2;87;56;376;22
781;4.55645e-15;29;193;193;10577;1;13;45;382;28;8;185;89;20;96;45;376;22
782;4.55775e-15;24;184;193;10579;1;13;51;382;14;10;178;90;4;88;51;376;22
783;4.55905e-15;22;207;193;10581;1;13;49;382;26;14;205;80;12;125;49;377;22
784;4.56035e-15;20;182;193;10582;1;13;42;382;29;13;189;98;16;91;42;377;22
785;4.561e-15;16;181;192;10583;1;14;51;382;16;14;165;97;2;68;51;377;22
786;4.56165e-15;22;206;193;10584;1;14;45;383;27;12;196;86;15;110;45;377;22
787;4.5623e-15;18;201;193;10584;1;14;51;383;16;12;171;100;4;71;51;377;22
788;4.5623e-15;15;200;193;10584;1;14;45;383;24;9;183;84;15;99;45;377;22
789;4.5623e-15;19;200;195;10585;1;13;39;383;22;6;183;94;16;89;39;377;22
790;4.56295e-15;18;209;194;10587;1;14;47;383;12;10;190;85;2;105;47;378;22
791;4.56425e-15;25;218;196;10588;1;13;42;383;28;14;175;100;14;75;42;378;22
792;4.5649e-15;23;174;195;10588;1;14;52;383;10;10;171;97;0;74;52;378;22
793;4.5649e-15;30;187;195;10589;1;14;45;383;30;13;182;92;17;90;45;378;22
794;4.56555e-15;28;194;198;10589;1;13;45;383;23;14;173;99;9;74;45;378;22
795;4.56555e-15;31;211;198;10589;1;13;45;384;19;9;181;81;10;100;45;378;22
796;4.56555e-15;33;200;197;10591;1;14;44;384;24;12;174;85;12;89;44;378;22
797;4.56685e-15;27;213;197;10591;1;14;44;384;22;13;198;88;9;110;44;378;22
798;4.56685e-15;26;207;197;10591;1;14;43;384;21;10;164;81;11;83;43;379;22
799;4.56685e-15;22;207;199;10591;1;13;52;384;19;18;170;101;1;69;52;379;22
800;4.56685e-15;29;227;199;10592;1;13;47;384;22;8;158;85;14;73;47;379;22
801;4.5675e-15;24;197;201;10594;1;12;53;384;22;18;159;99;4;60;53;379;22
802;4.5688e-15;24;185;201;10595;1;12;56;384;14;8;182;87;6;95;56;379;22
803;4.56945e-15;14;183;201;10598;1;12;60;385;22;16;164;100;6;64;60;379;22
804;4.5714e-15;23;205;203;10598;1;11;50;385;31;11;149;96;20;53;50;379;22
805;4.5714e-15;26;200;202;10599;1;12;50;385;21;12;204;92;9;112;50;380;23
806;4.57205e-15;22;171;204;10600;1;11;40;385;32;11;165;101;21;64;40;380;23
807;4.5727e-15;15;184;204;10600;1;11;40;385;18;9;187;87;9;100;40;380;23
808;4.5727e-15;24;157;204;10603;1;11;42;385;20;12;172;93;8;79;42;380;23
809;4.57465e-15;20;189;204;10603;1;11;43;385;20;11;181;85;9;96;43;380;23
810;4.57465e-15;21;197;204;10604;1;11;44;385;19;10;177;91;9;86;44;380;23
811;4.5753e-15;30;187;204;10604;1;11;32;385;31;9;168;79;22;89;32;380;23
812;4.5753e-15;24;176;204;10606;1;11;39;386;19;16;190;82;3;108;39;380;23
813;4.5766e-15;20;194;204;10608;1;11;47;386;14;12;169;71;2;98;47;381;23
814;4.5779e-15;18;187;204;10608;1;11;47;386;20;10;177;86;10;91;47;381;23
815;4.5779e-15;24;175;204;10608;1;11;36;386;29;9;182;89;20;93;36;381;23
816;4.5779e-15;15;205;204;10608;1;11;47;386;9;10;165;71;-1;94;47;381;23
817;4.5779e-15;26;196;206;10610;1;10;45;386;23;11;175;86;12;89;45;381;23
818;4.57921e-15;25;191;206;10611;1;10;41;386;26;12;175;68;14;107;41;381;23
819;4.57986e-15;30;196;206;10611;1;10;32;386;23;5;183;95;18;88;32;381;23
820;4.57986e-15;25;194;206;10612;1;10;42;386;11;10;195;75;1;120;42;381;23
821;4.58051e-15;25;205;206;10615;1;10;47;387;24;19;188;82;5;106;47;382;23
822;4.58246e-15;24;196;206;10615;1;10;44;387;20;8;169;93;12;76;44;382;23
823;4.58246e-15;17;197;206;10617;1;10;53;387;13;11;163;91;2;72;53;382;23
824;4.58376e-15;18;215;206;10617;1;10;46;387;27;11;195;76;16;119;46;382;23
825;4.58376e-15;23;185;206;10618;1;10;46;387;18;8;199;103;10;96;46;382;23
826;4.58441e-15;32;215;206;10619;1;10;41;387;21;6;191;88;15;103;41;382;23
827;4.58506e-15;21;196;206;10619;1;10;46;387;20;15;178;84;5;94;46;382;23
828;4.58506e-15;26;202;206;10619;1;10;36;387;29;10;159;99;19;60;36;382;23
829;4.58506e-15;17;213;208;10622;1;9;38;387;21;12;184;92;9;92;38;383;23
830;4.58701e-15;19;216;208;10623;1;9;38;388;19;9;174;86;10;88;38;383;23
831;4.58767e-15;16;209;208;10624;1;9;36;388;23;11;205;99;12;106;36;383;24
832;4.58832e-15;17;196;207;10626;1;10;42;388;14;10;176;83;4;93;42;383;24
833;4.58962e-15;18;188;207;10627;1;10;35;388;24;7;162;75;17;87;35;383;24
834;4.59027e-15;22;193;207;10627;1;10;33;388;17;5;171;79;12;92;33;383;24
835;4.59027e-15;18;190;207;10627;1;10;44;388;11;13;157;79;-2;78;44;383;24
836;4.59027e-15;26;182;207;10628;1;10;32;388;30;8;190;93;22;97;32;383;24
837;4.59092e-15;30;180;207;10629;1;10;42;388;7;7;182;98;0;84;42;384;24
838;4.59157e-15;23;190;207;10630;1;10;51;388;19;18;176;93;1;83;51;384;24
839;4.59222e-15;21;201;207;10631;1;10;44;389;30;13;152;78;17;74;44;384;24
840;4.59287e-15;15;186;207;10633;1;10;45;389;20;11;170;102;9;68;45;384;24
841;4.59418e-15;24;190;207;10633;1;10;48;389;22;15;202;88;7;114;48;384;24
842;4.59418e-15;26;201;206;10634;1;11;50;389;21;13;168;86;8;82;50;384;24
843;4.59483e-15;23;191;206;10636;1;11;54;389;17;11;211;89;6;122;54;384;24
844;4.59613e-15;18;173;206;10637;1;11;47;389;26;9;166;100;17;66;47;384;24
845;4.59678e-15;26;177;206;10638;1;11;43;389;19;6;174;80;13;94;43;385;24
846;4.59743e-15;11;183;206;10638;1;11;41;389;20;8;181;80;12;101;41;385;24
847;4.59743e-15;14;179;205;10638;1;12;38;389;16;3;169;72;13;97;38;385;24
848;4.59743e-15;7;171;205;10640;1;12;44;390;14;10;194;85;4;109;44;385;24
849;4.59874e-15;12;188;205;10640;1;12;34;390;26;6;172;83;20;89;34;385;24
850;4.59874e-15;9;199;206;10640;1;12;33;390;17;6;191;83;11;108;33;385;24
851;4.59874e-15;13;209;206;10644;1;12;39;390;12;6;191;98;6;93;39;385;24
852;4.60134e-15;12;198;204;10644;1;14;40;390;21;12;184;103;9;81;40;385;24
853;4.60134e-15;7;195;204;10645;1;14;35;390;22;6;196;100;16;96;35;386;24
854;4.602e-15;11;202;203;10646;1;15;28;390;19;2;175;101;17;74;28;386;24
855;4.60265e-15;13;178;205;10647;1;14;27;390;13;2;152;93;11;59;27;386;24
856;4.6033e-15;13;196;204;10649;1;15;38;390;9;9;196;76;0;120;38;386;24
857;4.6046e-15;15;189;206;10649;1;14;37;390;17;6;190;87;11;103;37;386;24
858;4.6046e-15;21;182;206;10652;1;14;40;391;15;8;171;95;7;76;40;386;25
859;4.60656e-15;19;195;206;10655;1;14;41;391;17;8;173;93;9;80;41;386;25
860;4.60851e-15;18;197;206;10655;1;14;41;391;19;9;184;88;10;96;41;386;25
861;4.60851e-15;21;187;206;10658;1;14;49;391;14;11;181;82;3;99;49;386;25
862;4.61047e-15;14;217;206;10659;1;14;43;391;24;7;185;70;17;115;43;387;25
863;4.61112e-15;16;219;208;10659;1;13;46;391;12;6;208;78;6;130;46;387;25
864;4.61112e-15;22;208;208;10662;1;13;41;391;23;8;199;109;15;90;41;387;25
865;4.61308e-15;23;173;208;10664;1;13;52;391;9;10;162;126;-1;36;52;387;25
866;4.61438e-15;25;193;208;10664;1;13;45;391;26;9;171;65;17;106;45;387;25
867;4.61438e-15;25;192;208;10664;1;13;44;391;20;9;166;77;11;89;44;387;25
868;4.61438e-15;20;211;207;10665;1;14;48;392;16;11;191;88;5;103;48;387;25
869;4.61504e-15;22;203;207;10665;1;14;46;392;22;10;179;95;12;84;46;387;25
