step;volume;A_0;B_0;C;L;p;Compl;Aext;Bext;A_ingresso;A_uscita;B_ingresso;B_uscita;A_netto;B_netto;Avicino;Amedio;Alontano
0;4.18816e-15;363;350;99;10000;1;1;980;1000;521;131;498;142;390;356;1000;2;0
1;4.18816e-15;351;342;97;10001;1;3;1021;1076;513;136;497;140;377;357;943;2;0
2;4.18879e-15;452;463;96;10001;1;4;1165;1250;508;208;508;208;300;300;909;5;0
3;4.18879e-15;519;562;95;10001;1;5;1090;1220;566;240;605;263;326;342;892;7;0
4;4.18879e-15;536;633;95;10001;1;6;1134;1288;556;252;610;287;304;323;866;7;0
5;4.18879e-15;517;655;93;10001;1;8;1193;1352;520;284;628;309;236;319;842;8;0
6;4.18879e-15;595;662;90;10001;1;11;1313;1514;612;279;660;325;333;335;808;8;0
7;4.18879e-15;696;751;90;10001;1;12;1262;1474;658;286;743;329;372;414;794;8;0
8;4.18879e-15;632;738;91;10001;1;13;1395;1631;619;332;707;375;287;332;763;7;0
9;4.18879e-15;643;794;90;10001;1;17;1421;1686;693;319;831;357;374;474;744;7;0
10;4.18879e-15;687;820;86;10001;1;22;1429;1739;708;336;867;386;372;481;723;7;0
11;4.18879e-15;695;801;84;10001;1;24;1473;1789;721;348;906;408;373;498;701;7;0
12;4.18879e-15;701;865;81;10001;1;27;1494;1838;733;378;899;416;355;483;680;6;0
13;4.18879e-15;753;946;83;10002;1;27;1413;1784;766;338;927;475;428;452;671;6;0
14;4.18942e-15;693;916;88;10002;1;25;1437;1829;693;359;887;445;334;442;653;6;0
15;4.18942e-15;693;889;89;10003;1;25;1564;1972;678;350;947;438;328;509;626;6;0
16;4.19005e-15;697;987;92;10003;1;26;1564;2014;765;365;1001;461;400;540;611;6;0
17;4.19005e-15;737;978;95;10005;1;27;1500;1954;802;391;967;477;411;490;602;6;0
18;4.19131e-15;742;1008;97;10007;1;28;1519;1992;721;375;996;493;346;503;588;6;0
19;4.19258e-15;750;994;102;10007;1;27;1636;2129;726;374;991;538;352;453;568;6;0
20;4.19258e-15;795;1059;105;10009;1;28;1650;2165;803;378;1066;521;425;545;555;6;0
21;4.19384e-15;824;1069;112;10010;1;27;1642;2199;853;398;1116;551;455;565;540;6;0
22;4.19447e-15;847;1127;118;10011;1;26;1674;2232;844;415;1105;575;429;530;528;6;0
23;4.1951e-15;867;1121;113;10011;1;31;1688;2264;796;423;1046;575;373;471;515;6;0
24;4.1951e-15;821;1146;113;10011;1;34;1700;2294;842;421;1132;561;421;571;503;6;0
25;4.1951e-15;818;1131;113;10013;1;37;1708;2324;854;405;1132;597;449;535;492;6;0
26;4.19637e-15;864;1132;133;10013;1;28;1715;2352;882;411;1186;550;471;636;480;6;0
27;4.19637e-15;856;1179;134;10013;1;30;1721;2380;892;439;1148;596;453;552;470;7;0
28;4.19637e-15;911;1183;128;10013;1;38;1703;2406;845;412;1181;617;433;564;461;7;0
29;4.19637e-15;885;1196;138;10014;1;35;1711;2432;872;476;1199;600;396;599;453;7;0
30;4.197e-15;896;1187;148;10016;1;34;1743;2456;819;434;1208;612;385;596;443;7;0
31;4.19826e-15;853;1201;147;10016;1;38;1752;2480;832;487;1235;612;345;623;432;8;0
32;4.19826e-15;871;1263;154;10017;1;38;1740;2503;873;406;1243;586;467;657;423;8;0
33;4.1989e-15;905;1226;151;10020;1;45;1767;2525;869;417;1287;597;452;690;413;8;0
34;4.20079e-15;907;1303;163;10020;1;41;1773;2547;923;464;1238;578;459;660;404;9;0
35;4.20079e-15;837;1305;164;10020;1;46;1779;2567;836;472;1202;684;364;518;396;9;0
36;4.20079e-15;850;1311;153;10022;1;59;1761;2587;916;456;1280;659;460;621;388;9;0
37;4.20206e-15;873;1292;155;10023;1;62;1765;2607;913;453;1285;662;460;623;380;10;0
38;4.20269e-15;890;1319;179;10025;1;51;1770;2626;862;439;1223;653;423;570;373;10;0
39;4.20395e-15;915;1306;191;10027;1;52;1775;2644;864;458;1295;654;406;641;367;10;0
40;4.20522e-15;864;1274;213;10031;1;47;1774;2661;938;432;1319;686;506;633;360;11;0
41;4.20775e-15;888;1409;216;10031;1;52;1782;2678;850;457;1376;640;393;736;353;11;0
42;4.20775e-15;917;1370;231;10031;1;53;1785;2695;902;409;1360;695;493;665;345;12;0
43;4.20775e-15;936;1376;234;10031;1;56;1787;2711;904;457;1326;675;447;651;339;12;0
44;4.20775e-15;890;1382;235;10036;1;60;1793;2726;865;450;1381;682;415;699;333;12;0
45;4.21091e-15;899;1326;239;10037;1;63;1794;2741;887;427;1401;672;460;729;327;13;0
46;4.21154e-15;856;1317;236;10039;1;74;1817;2755;952;459;1353;673;493;680;321;14;0
47;4.21281e-15;896;1362;241;10041;1;76;1822;2769;904;464;1419;655;440;764;315;14;0
48;4.21407e-15;951;1408;252;10041;1;77;1800;2783;943;474;1480;644;469;836;310;15;0
49;4.21407e-15;933;1290;262;10044;1;78;1801;2796;943;420;1391;690;523;701;305;15;0
50;4.21597e-15;918;1321;262;10047;1;86;1830;2809;833;468;1395;680;365;715;299;16;0
51;4.21787e-15;906;1381;286;10051;1;79;1808;2821;884;432;1395;660;452;735;295;16;0
52;4.2204e-15;898;1431;293;10054;1;83;1811;2833;886;470;1443;668;416;775;291;17;0
53;4.2223e-15;929;1405;292;10056;1;96;1833;2845;930;429;1448;682;501;766;286;17;0
54;4.22357e-15;870;1374;305;10057;1;97;1833;2856;913;430;1361;698;483;663;281;17;0
55;4.2242e-15;859;1412;334;10060;1;92;1813;2868;950;470;1414;730;480;684;277;18;0
56;4.2261e-15;892;1423;354;10063;1;91;1809;2878;954;434;1457;722;520;735;274;18;0
57;4.228e-15;886;1495;364;10063;1;95;1813;2889;844;474;1463;673;370;790;270;19;0
58;4.228e-15;871;1493;383;10067;1;95;1814;2899;960;481;1489;709;479;780;267;19;0
59;4.23053e-15;893;1500;394;10070;1;99;1834;2909;936;410;1461;730;526;731;265;20;0
60;4.23244e-15;890;1500;412;10073;1;100;1812;2918;895;416;1526;722;479;804;260;20;0
61;4.23434e-15;861;1490;425;10079;1;104;1836;2928;877;434;1388;760;443;628;256;21;0
62;4.23814e-15;846;1530;445;10084;1;106;1834;2937;956;454;1496;735;502;761;251;21;0
63;4.24131e-15;892;1567;458;10086;1;109;1807;2945;934;407;1430;753;527;677;247;22;0
64;4.24258e-15;866;1512;468;10086;1;115;1831;2954;898;420;1490;770;478;720;244;22;0
65;4.24258e-15;864;1472;480;10090;1;124;1805;2962;926;456;1448;755;470;693;242;23;0
66;4.24511e-15;879;1450;494;10091;1;131;1829;2971;872;427;1481;747;445;734;239;24;0
67;4.24575e-15;869;1457;521;10096;1;130;1728;2879;918;459;1524;744;459;780;238;24;0
68;4.24892e-15;807;1423;544;10104;1;130;1835;2986;822;460;1452;710;362;742;232;25;0
69;4.254e-15;824;1488;565;10108;1;136;1808;2994;867;442;1516;682;425;834;230;26;0
70;4.25654e-15;857;1460;577;10109;1;149;1834;3001;851;434;1515;776;417;739;226;26;0
71;4.25717e-15;825;1513;612;10115;1;147;1832;3008;931;431;1485;746;500;739;223;26;0
72;4.26098e-15;897;1503;639;10122;1;150;1808;3015;903;426;1526;737;477;789;221;27;0
73;4.26543e-15;884;1439;659;10127;1;155;1710;2922;881;446;1544;736;435;808;221;28;0
74;4.26861e-15;863;1448;673;10138;1;167;1836;3029;832;410;1523;775;422;748;217;29;0
75;4.2756e-15;809;1498;690;10143;1;177;1815;3035;928;475;1526;721;453;805;213;29;0
76;4.27878e-15;882;1497;714;10146;1;185;1839;3042;872;408;1593;756;464;837;211;30;0
77;4.28069e-15;914;1496;738;10148;1;188;1805;3048;953;419;1494;739;534;755;208;31;0
78;4.28196e-15;889;1518;765;10154;1;194;1801;3054;932;434;1562;721;498;841;206;31;0
79;4.28577e-15;888;1504;800;10157;1;192;1805;3060;865;439;1570;777;426;793;204;31;0
80;4.28768e-15;872;1511;820;10160;1;201;1831;3066;874;436;1564;747;438;817;202;32;0
81;4.28959e-15;920;1497;858;10170;1;206;1809;3071;913;443;1624;751;470;873;199;33;0
82;4.29596e-15;897;1516;894;10178;1;207;1830;3077;976;461;1675;745;515;930;197;34;0
83;4.30106e-15;900;1486;911;10183;1;223;1827;3082;946;418;1581;816;528;765;195;35;0
84;4.30424e-15;860;1528;955;10192;1;225;1805;3088;892;444;1544;747;448;797;194;35;0
85;4.30998e-15;861;1473;1010;10201;1;221;1804;3093;940;430;1567;800;510;767;191;36;0
86;4.31572e-15;896;1537;1052;10203;1;222;1803;3098;948;426;1531;731;522;800;189;36;0
87;4.31699e-15;861;1495;1085;10207;1;236;1728;3003;874;434;1578;781;440;797;190;37;0
88;4.31954e-15;827;1427;1106;10213;1;248;1830;3108;893;428;1454;735;465;719;186;37;0
89;4.32337e-15;902;1491;1132;10219;1;260;1831;3112;885;368;1581;727;517;854;185;38;0
90;4.3272e-15;831;1510;1173;10227;1;270;1804;3117;908;433;1576;780;475;796;183;39;0
91;4.33231e-15;823;1495;1211;10234;1;276;1831;3122;852;426;1564;776;426;788;182;40;0
92;4.33678e-15;798;1492;1255;10240;1;283;1806;3126;930;425;1589;746;505;843;181;40;0
93;4.34062e-15;817;1508;1294;10249;1;291;1806;3130;945;413;1634;769;532;865;181;41;0
94;4.34637e-15;851;1526;1315;10255;1;315;1827;3135;909;378;1614;757;531;857;179;41;0
95;4.3502e-15;819;1570;1368;10262;1;317;1826;3139;956;439;1569;756;517;813;177;42;0
96;4.35468e-15;846;1493;1367;10269;1;357;1699;3043;927;417;1554;770;510;784;178;43;0
97;4.35916e-15;779;1443;1413;10273;1;367;1823;3147;850;389;1530;718;461;812;174;43;0
98;4.36172e-15;840;1464;1465;10277;1;375;1798;3151;935;388;1589;748;547;841;173;43;0
99;4.36428e-15;835;1492;1511;10289;1;391;1796;3155;876;403;1540;734;473;806;172;44;0
100;4.37197e-15;827;1527;1596;10300;1;377;1720;3059;885;404;1605;735;481;870;173;44;0
101;4.37901e-15;787;1542;1625;10310;1;406;1796;3162;848;402;1491;747;446;744;168;45;0
102;4.38543e-15;834;1517;1699;10314;1;408;1695;3066;886;383;1617;757;503;860;169;45;0
103;4.38799e-15;787;1493;1752;10325;1;422;1723;3070;810;406;1537;765;404;772;168;47;0
104;4.39505e-15;769;1407;1796;10335;1;453;1800;3173;886;385;1579;759;501;820;165;46;0
105;4.40147e-15;799;1400;1855;10344;1;470;1819;3177;923;361;1599;763;562;836;164;47;0
106;4.40725e-15;795;1502;1938;10355;1;469;1794;3180;918;403;1584;738;515;846;163;48;0
107;4.41431e-15;840;1536;2002;10366;1;486;1817;3184;869;387;1587;721;482;866;162;49;0
108;4.42138e-15;913;1495;2051;10374;1;519;1790;3187;896;402;1562;758;494;804;161;49;0
109;4.42653e-15;798;1443;2132;10388;1;536;1816;3190;885;439;1645;771;446;874;161;50;0
110;4.43554e-15;794;1465;2219;10397;1;541;1788;3193;912;407;1587;740;505;847;159;51;0
111;4.44133e-15;822;1432;2311;10412;1;544;1810;3196;891;381;1562;728;510;834;159;51;0
112;4.451e-15;766;1505;2364;10427;1;575;1788;3199;905;437;1569;750;468;819;158;52;0
113;4.46067e-15;734;1436;2469;10447;1;569;1809;3203;926;387;1596;731;539;865;157;53;0
114;4.47357e-15;773;1542;2553;10464;1;580;1804;3206;904;372;1614;726;532;888;157;53;0
115;4.48455e-15;782;1505;2624;10475;1;600;1775;3208;878;377;1534;791;501;743;156;54;0
116;4.49166e-15;762;1443;2675;10504;1;636;1773;3211;863;409;1608;791;454;817;155;54;0
117;4.51042e-15;814;1483;2751;10522;1;646;1797;3214;884;389;1569;756;495;813;154;55;0
118;4.52207e-15;764;1455;2866;10538;1;640;1792;3217;916;369;1667;747;547;920;153;55;0
119;4.53244e-15;767;1423;2971;10553;1;653;1794;3220;862;395;1555;694;467;861;152;56;0
120;4.54217e-15;709;1506;3052;10571;1;676;1796;3222;840;411;1574;744;429;830;151;56;0
121;4.55386e-15;787;1532;3144;10586;1;683;1792;3225;925;360;1624;741;565;883;150;57;0
122;4.5636e-15;792;1511;3210;10598;1;728;1791;3228;896;372;1591;746;524;845;150;58;0
123;4.5714e-15;731;1473;3305;10613;1;757;1769;3230;875;436;1641;747;439;894;150;58;0
124;4.58116e-15;747;1460;3416;10628;1;768;1791;3233;906;358;1672;743;548;929;149;59;0
125;4.59092e-15;739;1443;3569;10649;1;761;1660;3135;884;338;1648;718;546;930;150;60;0
126;4.6046e-15;716;1460;3644;10669;1;798;1784;3238;869;363;1533;716;506;817;148;61;0
127;4.61764e-15;712;1465;3714;10686;1;834;1759;3240;924;350;1622;720;574;902;146;60;0
128;4.62874e-15;690;1548;3857;10695;1;833;1757;3243;878;382;1672;737;496;935;145;61;0
129;4.63462e-15;691;1539;3971;10721;1;851;1750;3245;944;342;1652;730;602;922;144;61;0
130;4.65161e-15;708;1526;4089;10744;1;866;1751;3248;869;364;1562;756;505;806;143;62;0
131;4.66666e-15;677;1532;4237;10771;1;867;1751;3250;830;388;1704;759;442;945;142;62;0
132;4.68435e-15;676;1493;4378;10797;1;863;1754;3252;862;368;1624;754;494;870;141;62;0
133;4.70141e-15;707;1442;4553;10814;1;851;1781;3254;823;374;1649;761;449;888;141;63;0
134;4.71257e-15;695;1482;4629;10842;1;906;1744;3257;973;364;1610;751;609;859;140;63;0
135;4.73097e-15;735;1507;4747;10868;1;932;1745;3259;814;358;1618;767;456;851;140;64;0
136;4.74809e-15;683;1530;4838;10898;1;983;1741;3261;910;373;1745;729;537;1016;139;64;0
137;4.76786e-15;643;1497;5025;10928;1;977;1738;3263;854;352;1645;753;502;892;139;64;0
138;4.78765e-15;686;1435;5147;10949;1;1006;1764;3265;834;349;1599;788;485;811;139;64;0
139;4.80153e-15;702;1507;5304;10976;1;1016;1759;3267;863;365;1626;691;498;935;140;64;0
140;4.81939e-15;708;1504;5422;11002;1;1057;1730;3269;889;372;1691;748;517;943;139;65;0
141;4.8366e-15;684;1400;5549;11034;1;1096;1725;3271;869;337;1651;736;532;915;138;66;0
142;4.85782e-15;678;1409;5644;11064;1;1149;1752;3273;839;365;1622;747;474;875;137;67;0
143;4.87775e-15;686;1497;5791;11099;1;1173;1748;3275;909;340;1588;706;569;882;138;67;0
144;4.90102e-15;711;1453;5974;11138;1;1181;1748;3277;825;331;1734;759;494;975;137;68;0
145;4.927e-15;686;1490;6120;11165;1;1218;1719;3279;861;356;1605;782;505;823;136;68;0
146;4.94502e-15;687;1539;6274;11189;1;1249;1719;3281;841;322;1657;692;519;965;135;68;0
147;4.96105e-15;620;1478;6432;11220;1;1281;1746;3283;819;331;1643;751;488;892;134;68;0
148;4.98178e-15;672;1478;6622;11253;1;1284;1742;3285;853;298;1625;685;555;940;134;68;0
149;5.00388e-15;670;1487;6762;11294;1;1318;1609;3187;924;329;1675;769;595;906;136;69;0
150;5.03138e-15;616;1350;6926;11330;1;1346;1735;3289;815;310;1631;766;505;865;133;70;0
151;5.05557e-15;610;1391;7106;11367;1;1372;1731;3291;881;294;1684;733;587;951;132;70;0
152;5.08048e-15;615;1436;7257;11413;1;1409;1728;3292;838;313;1631;745;525;886;131;71;0
153;5.1115e-15;643;1389;7421;11452;1;1436;1724;3294;836;317;1703;732;519;971;131;71;0
154;5.13784e-15;685;1458;7572;11484;1;1475;1694;3296;873;310;1630;740;563;890;131;71;0
155;5.1595e-15;616;1468;7744;11521;1;1517;1719;3298;840;315;1603;722;525;881;131;71;0
156;5.18457e-15;625;1420;7884;11559;1;1577;1715;3299;879;308;1612;720;571;892;131;72;0
157;5.21036e-15;599;1476;8069;11597;1;1609;1711;3301;849;320;1619;723;529;896;131;72;0
158;5.2362e-15;631;1450;8305;11635;1;1603;1679;3303;889;286;1567;743;603;824;130;71;0
159;5.26208e-15;631;1452;8439;11668;1;1666;1675;3304;849;314;1640;739;535;901;130;72;0
160;5.28459e-15;619;1481;8632;11708;1;1693;1702;3306;845;334;1667;716;511;951;130;72;0
161;5.31192e-15;599;1399;8804;11740;1;1737;1698;3308;894;326;1613;725;568;888;130;72;0
162;5.33381e-15;574;1409;8978;11792;1;1773;1693;3309;870;304;1618;715;566;903;130;73;0
163;5.36946e-15;612;1436;9210;11835;1;1769;1692;3311;820;293;1664;733;527;931;129;74;0
164;5.39899e-15;589;1451;9417;11882;1;1795;1660;3312;816;301;1691;686;515;1005;129;74;0
165;5.43133e-15;596;1399;9680;11918;1;1800;1654;3314;849;276;1622;726;573;896;129;74;0
166;5.45615e-15;573;1404;9932;11971;1;1799;1652;3315;856;314;1733;696;542;1037;129;74;0
167;5.49276e-15;581;1423;10066;12018;1;1882;1679;3317;812;288;1592;679;524;913;128;74;0
168;5.52529e-15;593;1453;10278;12062;1;1909;1677;3318;844;304;1642;752;540;890;128;75;0
169;5.5558e-15;611;1429;10425;12105;1;1974;1674;3320;891;292;1664;748;599;916;128;75;0
170;5.58568e-15;555;1380;10680;12150;1;1990;1645;3321;845;299;1659;748;546;911;128;76;0
171;5.617e-15;552;1344;10843;12191;1;2054;1670;3323;837;274;1697;720;563;977;127;75;0
172;5.64558e-15;577;1383;11133;12232;1;2036;1669;3324;859;290;1711;672;569;1039;127;76;0
173;5.67422e-15;578;1404;11280;12279;1;2112;1670;3326;792;275;1726;717;517;1009;127;76;0
174;5.70711e-15;506;1361;11488;12322;1;2163;1670;3327;840;285;1683;776;555;907;127;78;0
175;5.73725e-15;494;1361;11720;12373;1;2191;1639;3329;837;256;1636;720;581;916;127;78;0
176;5.77307e-15;518;1383;11994;12423;1;2182;1665;3330;807;268;1630;677;539;953;126;78;0
177;5.80826e-15;546;1391;12271;12471;1;2183;1564;3231;780;257;1574;700;523;874;128;78;0
178;5.84211e-15;510;1389;12538;12519;1;2189;1637;3333;802;237;1572;738;565;834;126;79;0
179;5.87603e-15;536;1428;12820;12573;1;2175;1634;3334;822;232;1717;670;590;1047;126;79;0
180;5.91426e-15;511;1418;13040;12626;1;2212;1629;3336;824;266;1756;730;558;1026;126;79;0
181;5.95187e-15;539;1405;13307;12688;1;2212;1658;3337;769;270;1616;697;499;919;126;79;0
182;5.99596e-15;569;1429;13533;12744;1;2250;1629;3338;856;278;1688;688;578;1000;125;81;0
183;6.03588e-15;525;1375;13738;12796;1;2303;1657;3340;817;286;1675;733;531;942;126;81;0
184;6.07303e-15;518;1293;13965;12848;1;2339;1552;3241;853;262;1672;713;591;959;127;82;0
185;6.11025e-15;486;1391;14207;12899;1;2353;1628;3342;762;264;1612;638;498;974;125;82;0
186;6.14683e-15;524;1398;14374;12945;1;2418;1623;3343;848;255;1626;699;593;927;124;82;0
187;6.17989e-15;525;1325;14602;13011;1;2465;1625;3345;795;261;1678;696;534;982;125;82;0
188;6.22742e-15;483;1376;14832;13067;1;2512;1651;3346;825;262;1692;678;563;1014;124;82;0
189;6.26785e-15;462;1380;15059;13134;1;2558;1649;3347;796;264;1659;709;532;950;124;84;0
190;6.31634e-15;486;1391;15273;13208;1;2615;1642;3349;842;225;1640;697;617;943;125;82;0
191;6.37003e-15;527;1347;15590;13272;1;2622;1611;3350;802;237;1701;703;565;998;124;83;0
192;6.41659e-15;533;1467;15881;13324;1;2623;1607;3351;834;248;1746;633;586;1113;124;83;0
193;6.45451e-15;499;1418;16054;13383;1;2706;1605;3352;818;244;1651;754;574;897;124;83;0
194;6.49762e-15;504;1443;16330;13444;1;2731;1630;3353;812;223;1663;666;589;997;124;84;0
195;6.54229e-15;491;1428;16640;13501;1;2743;1628;3355;805;259;1708;679;546;1029;124;84;0
196;6.58412e-15;520;1419;16980;13565;1;2733;1599;3356;833;253;1614;672;580;942;125;83;0
197;6.6312e-15;481;1402;17215;13636;1;2778;1602;3357;778;257;1562;709;521;853;124;83;0
198;6.68356e-15;487;1411;17511;13698;1;2777;1632;3358;757;268;1680;695;489;985;123;83;0
199;6.72939e-15;480;1409;17796;13763;1;2796;1598;3359;879;244;1646;687;635;959;123;83;0
200;6.77756e-15;468;1365;18085;13830;1;2808;1600;3360;793;253;1672;742;540;930;124;83;0
201;6.82732e-15;499;1384;18294;13895;1;2871;1627;3362;786;225;1711;683;561;1028;123;83;0
202;6.87572e-15;485;1390;18559;13956;1;2908;1598;3363;807;240;1650;718;567;932;122;84;0
203;6.92124e-15;492;1401;18777;14021;1;2973;1598;3364;808;248;1633;669;560;964;122;84;0
204;6.96986e-15;475;1343;19071;14093;1;2992;1596;3365;786;251;1665;714;535;951;122;84;0
205;7.02385e-15;540;1392;19290;14151;1;3032;1624;3366;793;257;1650;696;536;954;122;85;0
206;7.06744e-15;492;1422;19523;14222;1;3093;1597;3367;794;266;1722;664;528;1058;123;84;0
207;7.12093e-15;481;1441;19754;14312;1;3147;1598;3368;750;257;1770;672;493;1098;122;84;0
208;7.18892e-15;485;1403;20015;14382;1;3180;1594;3369;815;235;1729;705;580;1024;122;84;0
209;7.24195e-15;476;1378;20250;14449;1;3236;1622;3370;791;252;1708;688;539;1020;122;85;0
210;7.29283e-15;445;1362;20529;14517;1;3278;1494;3271;843;242;1664;657;601;1007;124;86;0
211;7.34459e-15;418;1276;20812;14594;1;3286;1623;3373;743;216;1609;711;527;898;122;86;0
212;7.40335e-15;457;1397;21067;14669;1;3318;1522;3274;839;224;1660;659;615;1001;124;85;0
213;7.46073e-15;439;1364;21429;14740;1;3271;1598;3375;724;237;1664;676;487;988;123;85;0
214;7.51519e-15;488;1406;21678;14811;1;3308;1623;3376;817;215;1717;663;602;1054;124;85;0
215;7.56979e-15;478;1407;21971;14865;1;3339;1622;3377;801;244;1684;725;557;959;124;86;0
216;7.6114e-15;463;1421;22252;14928;1;3375;1594;3378;823;234;1731;693;589;1038;123;86;0
217;7.66004e-15;437;1359;22532;14992;1;3413;1623;3379;742;219;1700;716;523;984;123;85;0
218;7.70956e-15;441;1401;22822;15065;1;3430;1621;3380;801;225;1663;670;576;993;122;85;0
219;7.76617e-15;464;1417;23064;15136;1;3481;1616;3381;805;224;1635;675;581;960;121;87;0
220;7.82136e-15;478;1414;23391;15201;1;3485;1613;3382;843;243;1729;686;600;1043;122;86;0
221;7.87201e-15;468;1378;23673;15264;1;3519;1588;3383;739;229;1637;701;510;936;122;87;0
222;7.9212e-15;441;1383;23946;15343;1;3556;1616;3384;771;220;1644;719;551;925;122;87;0
223;7.98303e-15;461;1447;24185;15404;1;3618;1588;3385;828;241;1682;689;587;993;121;87;0
224;8.03088e-15;485;1368;24536;15474;1;3606;1587;3386;814;206;1630;754;608;876;121;87;0
225;8.08591e-15;432;1402;24840;15558;1;3625;1486;3287;815;233;1712;662;582;1050;122;87;0
226;8.15211e-15;420;1379;25163;15623;1;3621;1588;3388;715;214;1579;726;501;853;120;87;0
227;8.20346e-15;404;1339;25433;15693;1;3659;1616;3389;773;242;1643;732;531;911;120;87;0
228;8.25888e-15;451;1329;25702;15761;1;3701;1588;3390;784;208;1671;703;576;968;120;87;0
229;8.31284e-15;420;1349;25895;15832;1;3794;1617;3390;764;229;1696;668;535;1028;120;87;0
230;8.3693e-15;448;1344;26201;15902;1;3811;1613;3391;824;240;1675;707;584;968;120;87;0
231;8.42509e-15;448;1409;26395;15983;1;3893;1582;3392;805;215;1742;685;590;1057;122;87;0
232;8.48981e-15;414;1327;26678;16070;1;3932;1580;3393;830;255;1748;698;575;1050;121;87;0
233;8.5595e-15;414;1356;26956;16146;1;3955;1607;3394;779;205;1664;702;574;962;121;88;0
234;8.62054e-15;429;1388;27228;16231;1;3993;1575;3395;841;212;1721;714;629;1007;122;87;0
235;8.68897e-15;442;1416;27518;16329;1;4015;1604;3396;753;228;1693;659;525;1034;121;88;0
236;8.7681e-15;388;1402;27807;16400;1;4033;1599;3397;789;251;1729;716;538;1013;122;89;0
237;8.82558e-15;415;1359;28127;16466;1;4039;1596;3398;790;197;1715;704;593;1011;122;88;0
238;8.87912e-15;424;1440;28329;16536;1;4119;1600;3399;804;239;1723;658;565;1065;122;87;0
239;8.93602e-15;433;1389;28581;16607;1;4181;1596;3400;813;195;1782;712;618;1070;122;89;0
240;8.99387e-15;479;1367;28838;16685;1;4222;1592;3400;862;231;1641;733;631;908;123;87;0
241;9.05756e-15;426;1339;29143;16775;1;4248;1568;3401;782;240;1715;639;542;1076;122;88;0
242;9.13123e-15;409;1370;29369;16853;1;4318;1597;3402;755;215;1672;643;540;1029;122;89;0
243;9.19524e-15;451;1359;29697;16944;1;4318;1499;3303;772;231;1764;694;541;1070;123;90;0
244;9.27011e-15;436;1396;29917;17018;1;4386;1600;3404;726;212;1666;676;514;990;121;89;0
245;9.33114e-15;488;1441;30156;17118;1;4453;1595;3405;836;212;1738;724;624;1014;121;90;0
246;9.41383e-15;460;1422;30487;17199;1;4460;1596;3406;756;238;1733;695;518;1038;120;91;0
247;9.48099e-15;448;1364;30741;17275;1;4522;1594;3406;767;230;1763;756;537;1007;119;90;0
248;9.54414e-15;439;1375;31038;17349;1;4544;1562;3407;834;244;1698;706;590;992;118;90;0
249;9.60577e-15;436;1392;31338;17425;1;4575;1559;3408;750;207;1740;710;543;1030;118;89;0
250;9.66921e-15;415;1371;31599;17495;1;4622;1558;3409;752;214;1715;699;538;1016;118;90;0
251;9.72775e-15;418;1419;31888;17561;1;4653;1559;3410;765;210;1733;660;555;1073;117;89;0
252;9.78306e-15;455;1414;32253;17654;1;4638;1557;3411;794;212;1677;714;582;963;117;89;0
253;9.86118e-15;434;1437;32569;17737;1;4664;1586;3411;782;240;1689;668;542;1021;117;89;0
254;9.93107e-15;419;1403;32860;17816;1;4690;1482;3312;833;244;1749;722;589;1027;117;89;0
255;9.99775e-15;438;1413;33125;17907;1;4725;1561;3413;728;212;1716;651;516;1065;117;89;0
256;1.00747e-14;430;1350;33368;17991;1;4800;1590;3414;749;216;1730;667;533;1063;117;90;0
257;1.0146e-14;446;1383;33752;18058;1;4781;1588;3415;784;238;1732;693;546;1039;118;90;0
258;1.02029e-14;470;1359;34029;18137;1;4824;1587;3415;798;240;1746;691;558;1055;117;90;0
259;1.02702e-14;445;1421;34314;18231;1;4859;1562;3416;758;236;1688;659;522;1029;117;90;0
260;1.03505e-14;447;1423;34657;18320;1;4850;1588;3417;805;213;1690;683;592;1007;118;90;0
261;1.04266e-14;415;1397;34912;18419;1;4897;1588;3418;794;244;1680;692;550;988;118;91;0
262;1.05116e-14;428;1401;35133;18495;1;4979;1585;3419;816;195;1636;706;621;930;118;91;0
263;1.05769e-14;461;1324;35427;18570;1;5011;1583;3419;786;203;1728;717;583;1011;118;92;0
264;1.06416e-14;440;1352;35758;18649;1;5020;1582;3420;772;192;1723;636;580;1087;117;91;0
265;1.07098e-14;449;1386;35980;18728;1;5095;1581;3421;815;228;1674;680;587;994;117;92;0
266;1.07782e-14;409;1419;36307;18812;1;5124;1550;3422;882;221;1696;663;661;1033;117;92;0
267;1.08511e-14;421;1397;36608;18901;1;5148;1580;3422;760;225;1769;717;535;1052;117;92;0
268;1.09284e-14;420;1335;36852;18961;1;5220;1575;3423;793;195;1633;703;598;930;116;91;0
269;1.09807e-14;469;1340;37175;19049;1;5234;1575;3424;814;202;1708;681;612;1027;116;92;0
270;1.10575e-14;458;1376;37415;19146;1;5304;1574;3425;772;223;1732;692;549;1040;116;92;0
271;1.11424e-14;439;1371;37709;19240;1;5326;1446;3325;759;226;1735;670;533;1065;117;94;1
272;1.12249e-14;405;1353;38033;19338;1;5330;1577;3426;703;189;1673;671;514;1002;116;92;1
273;1.13111e-14;383;1397;38326;19414;1;5352;1575;3427;805;227;1791;738;578;1053;116;92;1
274;1.1378e-14;427;1408;38650;19492;1;5349;1546;3428;806;202;1770;728;604;1042;116;92;1
275;1.14469e-14;404;1406;38932;19580;1;5375;1575;3428;779;223;1726;706;556;1020;116;94;1
276;1.15248e-14;392;1338;39271;19672;1;5358;1576;3429;773;222;1695;740;551;955;116;93;1
277;1.16064e-14;376;1395;39604;19747;1;5367;1557;3430;789;213;1742;643;576;1099;116;93;1
278;1.16731e-14;418;1354;39866;19847;1;5412;1519;3431;797;213;1724;713;584;1011;116;93;1
279;1.17622e-14;410;1376;40170;19936;1;5441;1469;3431;780;214;1642;685;566;957;117;93;1
280;1.18417e-14;412;1407;40466;20007;1;5462;1502;3432;730;199;1771;663;531;1108;117;94;1
281;4.19068e-15;334;953;15082;10110.5;1;5202;1474;3433;821;153;1658;376;668;1282;116;95;1
282;4.25844e-15;412;985;15910;10201.5;1;4958;1385;3433;744;159;1751;503;585;1248;117;94;1
283;4.31635e-15;391;1038;16675;10307.5;1;4767;1320;3434;653;211;1746;530;442;1216;117;94;1
284;4.38414e-15;335;1103;17516;10401.5;1;4501;1343;3435;606;172;1696;527;434;1169;118;94;1
285;4.44455e-15;294;1094;18242;10516.5;1;4319;1291;3435;663;161;1645;539;502;1106;117;96;1
286;4.51883e-15;309;1138;19000;10599.5;1;4096;1287;3436;659;156;1709;569;503;1140;117;96;1
287;4.5727e-15;294;1118;19696;10707.5;1;3923;1210;3437;672;157;1686;625;515;1061;117;96;1
288;4.64311e-15;265;1117;20294;10798.5;1;3775;1237;3438;609;156;1755;589;453;1166;117;97;1
289;4.70272e-15;271;1177;20951;10928.5;1;3599;1213;3438;605;148;1674;629;457;1045;117;98;1
290;4.78831e-15;278;1212;21484;11045.5;1;3497;1192;3439;598;122;1779;600;476;1179;117;97;1
291;4.86579e-15;236;1268;22115;11170.5;1;3338;1177;3440;642;142;1687;592;500;1095;116;96;1
292;4.94902e-15;291;1310;22617;11298.5;1;3248;1183;3440;534;124;1739;676;410;1063;117;97;1
293;5.03474e-15;271;1343;23167;11436.5;1;3145;1148;3441;580;125;1748;637;455;1111;117;96;1
294;5.1277e-15;270;1336;23674;11549.5;1;3041;1132;3442;583;141;1715;649;442;1066;117;96;1
295;5.20425e-15;254;1293;24165;11664.5;1;2947;1123;3442;550;144;1743;664;406;1079;117;96;1
296;5.28254e-15;230;1395;24669;11786.5;1;2841;1073;3443;566;120;1763;626;446;1137;117;95;1
297;5.36602e-15;242;1398;25124;11909.5;1;2761;1067;3444;519;105;1676;685;414;991;117;96;1
298;5.45063e-15;217;1341;25536;12013.5;1;2704;1100;3444;548;137;1778;747;411;1031;117;96;1
299;5.52252e-15;229;1404;25965;12138.5;1;2634;1074;3445;535;114;1708;661;421;1047;116;96;1
300;5.60934e-15;253;1386;26321;12243.5;1;2593;1081;3445;577;110;1692;719;467;973;116;96;1
301;5.68261e-15;267;1435;26650;12373.5;1;2578;1073;3446;531;142;1710;723;389;987;117;96;1
302;5.77377e-15;271;1430;26982;12482.5;1;2558;1038;3447;502;131;1731;700;371;1031;116;96;1
303;5.85058e-15;245;1449;27286;12598.5;1;2551;1072;3447;532;134;1698;713;398;985;116;97;1
304;5.9327e-15;241;1445;27602;12703.5;1;2542;1083;3448;561;117;1735;722;444;1013;115;98;1
305;6.00735e-15;264;1457;27953;12818.5;1;2508;1040;3449;529;132;1738;706;397;1032;114;97;1
306;6.08948e-15;216;1492;28237;12953.5;1;2504;1062;3449;504;126;1755;749;378;1006;115;99;1
307;6.18636e-15;257;1465;28521;13050.5;1;2497;1078;3450;548;120;1744;727;428;1017;115;97;1
308;6.25629e-15;250;1371;28792;13169.5;1;2524;1072;3451;553;120;1675;714;433;961;113;97;1
309;6.34244e-15;250;1429;29065;13282.5;1;2541;1034;3451;520;107;1701;685;413;1016;114;97;1
310;6.42461e-15;236;1424;29337;13386.5;1;2545;1070;3452;522;130;1698;701;392;997;113;97;1
311;6.50054e-15;250;1457;29659;13496.5;1;2510;1012;3452;521;128;1701;730;393;971;113;96;1
312;6.58118e-15;251;1495;29966;13614.5;1;2485;1012;3453;513;127;1742;714;386;1028;114;96;1
313;6.66806e-15;241;1474;30199;13736.5;1;2513;1048;3454;504;135;1705;796;369;909;114;96;1
314;6.75828e-15;230;1487;30488;13853.5;1;2508;1066;3454;523;115;1641;756;408;885;114;97;1
315;6.84518e-15;250;1528;30763;13976.5;1;2500;1063;3455;499;145;1831;767;354;1064;114;96;1
316;6.93694e-15;250;1491;31010;14077.5;1;2530;1062;3455;557;127;1777;739;430;1038;115;96;1
317;7.01259e-15;260;1449;31247;14171.5;1;2555;1013;3456;560;111;1676;763;449;913;115;96;1
318;7.08325e-15;229;1480;31451;14293.5;1;2583;1053;3457;497;131;1781;679;366;1102;114;96;1
319;7.1753e-15;247;1479;31694;14404.5;1;2602;1032;3457;486;129;1761;743;357;1018;115;96;1
320;7.2594e-15;252;1507;31910;14502.5;1;2627;1014;3458;516;141;1696;745;375;951;113;97;1
321;7.33392e-15;250;1501;32207;14605.5;1;2610;1017;3458;480;129;1708;750;351;958;113;98;1
322;7.41252e-15;226;1500;32458;14717.5;1;2610;1036;3459;519;125;1751;733;394;1018;113;98;1
323;7.4983e-15;251;1486;32683;14813.5;1;2651;1014;3460;528;102;1744;742;426;1002;114;98;1
324;7.5721e-15;268;1508;32926;14910.5;1;2659;1016;3460;479;146;1730;737;333;993;114;97;1
325;7.6469e-15;242;1419;33180;15035.5;1;2668;1038;3461;482;140;1724;705;342;1019;113;98;1
326;7.74366e-15;267;1456;33379;15154.5;1;2712;997;3461;516;106;1731;729;410;1002;114;97;1
327;7.83616e-15;265;1468;33594;15259.5;1;2753;1033;3462;481;111;1703;755;370;948;113;97;1
328;7.91807e-15;265;1462;33842;15360.5;1;2762;1051;3462;509;139;1746;733;370;1013;113;96;1
329;7.99714e-15;244;1477;34104;15450.5;1;2770;992;3463;506;153;1686;732;353;954;112;97;1
330;8.06781e-15;247;1514;34341;15549.5;1;2786;995;3464;494;120;1674;706;374;968;112;97;1
331;8.1458e-15;220;1499;34603;15654.5;1;2777;1016;3464;470;134;1804;703;336;1101;113;98;1
332;8.22878e-15;253;1467;34919;15748.5;1;2749;989;3465;546;107;1727;718;439;1009;112;97;1
333;8.30331e-15;250;1517;35167;15861.5;1;2762;1028;3465;486;103;1709;747;383;962;111;98;1
334;8.3932e-15;251;1467;35475;15982.5;1;2739;1006;3466;509;113;1769;766;396;1003;112;98;2
335;8.48981e-15;246;1561;35671;16073.5;1;2773;1043;3466;521;127;1754;682;394;1072;112;98;2
336;8.56271e-15;264;1458;35885;16175.5;1;2794;1024;3467;520;138;1711;758;382;953;112;99;2
337;8.64467e-15;239;1472;36107;16268.5;1;2819;1022;3467;502;130;1750;685;372;1065;111;99;2
338;8.71963e-15;244;1497;36309;16360.5;1;2855;1019;3468;545;127;1728;749;418;979;111;97;2
339;8.79399e-15;248;1484;36500;16479.5;1;2890;1013;3469;494;119;1761;758;375;1003;110;96;2
340;8.89049e-15;250;1455;36780;16594.5;1;2875;995;3469;504;116;1714;727;388;987;110;97;2
341;8.98408e-15;229;1459;37014;16687.5;1;2876;1035;3470;514;109;1744;715;405;1029;110;97;2
342;9.06001e-15;237;1420;37331;16787.5;1;2839;1040;3470;448;139;1732;727;309;1005;110;96;2
343;9.14189e-15;237;1477;37568;16907.5;1;2836;1042;3471;512;99;1779;743;413;1036;109;97;2
344;9.24047e-15;263;1509;37743;16997.5;1;2875;1040;3471;511;116;1720;755;395;965;109;97;2
345;9.31463e-15;261;1532;37956;17085.5;1;2895;1024;3472;522;140;1713;723;382;990;109;96;2
346;9.38734e-15;265;1503;38230;17194.5;1;2888;984;3472;510;135;1737;740;375;997;109;96;2
347;9.47767e-15;224;1601;38444;17301.5;1;2908;1020;3473;494;93;1745;760;401;985;108;96;2
348;9.56662e-15;236;1574;38669;17411.5;1;2902;1041;3473;539;142;1738;784;397;954;108;96;2
349;9.65835e-15;283;1600;38900;17507.5;1;2922;1002;3474;536;126;1695;764;410;931;108;97;2
350;9.73864e-15;254;1555;39100;17598.5;1;2955;1041;3474;502;112;1769;779;390;990;108;98;2
351;9.81496e-15;267;1494;39291;17688.5;1;2986;1022;3475;539;135;1713;773;404;940;108;98;2
352;9.89063e-15;247;1542;39476;17789.5;1;3030;982;3475;486;121;1681;777;365;904;108;96;2
353;9.97579e-15;225;1527;39666;17889.5;1;3052;1018;3476;509;115;1748;785;394;963;108;96;2
354;1.00603e-14;271;1528;39866;17982.5;1;3072;998;3476;501;120;1708;747;381;961;108;96;2
355;1.01392e-14;258;1532;40095;18074.5;1;3086;1017;3477;504;132;1750;762;372;988;108;97;2
356;1.02174e-14;256;1586;40278;18154.5;1;3129;1017;3477;513;141;1697;796;372;901;107;97;2
357;1.02856e-14;254;1524;40522;18249.5;1;3129;998;3478;507;133;1717;720;374;997;108;96;2
358;1.03667e-14;269;1546;40727;18334.5;1;3149;1017;3479;511;133;1753;784;378;969;107;96;2
359;1.04395e-14;261;1514;40897;18419.5;1;3194;1021;3479;470;147;1737;749;323;988;107;96;2
360;1.05124e-14;259;1515;41080;18544.5;1;3231;1023;3480;495;137;1689;799;358;890;107;97;2
361;1.062e-14;280;1539;41322;18635.5;1;3228;986;3480;529;118;1759;749;411;1010;107;96;2
362;1.06986e-14;240;1458;41552;18713.5;1;3242;1041;3481;509;127;1714;760;382;954;107;96;2
363;1.07661e-14;258;1521;41741;18810.5;1;3282;1020;3481;516;124;1731;765;392;966;106;97;2
364;1.08502e-14;261;1553;41955;18899.5;1;3297;1021;3482;525;121;1731;729;404;1002;106;96;2
365;1.09276e-14;260;1541;42133;19005.5;1;3342;1019;3482;515;125;1763;783;390;980;105;96;2
366;1.102e-14;235;1518;42358;19102.5;1;3351;1020;3482;484;145;1779;779;339;1000;105;96;2
367;1.11048e-14;268;1499;42600;19202.5;1;3346;1021;3483;540;125;1755;758;415;997;105;97;2
368;1.11924e-14;239;1549;42845;19299.5;1;3346;1006;3483;482;139;1739;786;343;953;105;96;2
369;1.12776e-14;257;1476;43071;19382.5;1;3357;987;3484;495;134;1843;730;361;1113;104;97;2
370;1.13507e-14;251;1544;43293;19495.5;1;3368;988;3484;532;125;1748;747;407;1001;104;96;2
371;1.14505e-14;259;1527;43484;19600.5;1;3403;985;3485;497;139;1771;778;358;993;104;96;2
372;1.15434e-14;268;1518;43720;19686.5;1;3408;1042;3485;483;141;1774;829;342;945;103;97;2
373;1.16198e-14;253;1525;43894;19773.5;1;3458;1002;3486;505;126;1726;783;379;943;103;95;2
374;1.16972e-14;255;1460;44121;19868.5;1;3456;966;3486;503;125;1737;778;378;959;103;96;2
375;1.17819e-14;256;1519;44335;19966.5;1;3462;971;3487;456;109;1799;727;347;1072;103;94;2
376;1.18694e-14;265;1501;44556;20054.5;1;3482;925;3487;505;134;1751;753;371;998;103;95;2
377;4.20585e-15;218;1113;16324;10128.2;1;3273;965;3488;458;82;1704;397;376;1307;103;96;2
378;4.26988e-15;240;1219;16984;10224.2;1;3045;861;3488;465;121;1782;604;344;1178;102;95;2
379;4.33103e-15;216;1328;17641;10338.2;1;2822;861;3489;389;105;1811;616;284;1195;102;95;2
380;4.40403e-15;198;1314;18283;10427.2;1;2618;908;3489;428;85;1804;657;343;1147;102;96;2
381;4.46131e-15;226;1307;18789;10527.2;1;2467;875;3490;449;108;1752;686;341;1066;102;96;2
382;4.52596e-15;213;1344;19342;10636.2;1;2297;857;3490;445;118;1753;666;327;1087;101;95;2
383;4.59678e-15;199;1446;19745;10736.2;1;2216;818;3491;460;96;1792;653;364;1139;101;95;2
384;4.66208e-15;198;1479;20160;10857.2;1;2118;827;3491;413;105;1767;737;308;1030;101;95;2
385;4.7415e-15;204;1501;20595;10958.2;1;2002;833;3491;447;104;1745;719;343;1026;101;94;2
386;4.80814e-15;195;1527;20994;11067.2;1;1909;809;3492;419;92;1786;741;327;1045;101;94;3
387;4.8804e-15;167;1503;21360;11185.2;1;1835;819;3492;426;98;1734;752;328;982;102;94;3
388;4.95904e-15;189;1401;21696;11287.2;1;1766;782;3493;409;78;1748;764;331;984;102;94;3
389;5.02735e-15;198;1480;21980;11405.2;1;1728;789;3493;393;88;1735;706;305;1029;102;93;3
390;5.10677e-15;164;1480;22264;11511.2;1;1694;748;3494;374;99;1700;751;275;949;102;93;3
391;5.17847e-15;208;1548;22578;11618.2;1;1633;777;3494;370;92;1839;745;278;1094;102;94;3
392;5.25118e-15;178;1516;22793;11737.2;1;1634;750;3495;395;109;1736;743;286;993;101;95;3
393;5.33244e-15;191;1541;23048;11859.2;1;1607;767;3495;391;93;1770;832;298;938;101;94;3
394;5.41619e-15;191;1554;23334;11967.2;1;1563;746;3496;412;96;1744;779;316;965;100;93;3
395;5.49068e-15;168;1483;23593;12092.2;1;1549;773;3496;361;89;1797;735;272;1062;100;94;3
396;5.57733e-15;170;1449;23779;12186.2;1;1553;769;3496;399;81;1734;753;318;981;100;95;3
397;5.64279e-15;170;1541;23965;12285.2;1;1554;768;3497;397;95;1707;729;302;978;99;95;3
398;5.71201e-15;158;1525;24152;12391.2;1;1555;794;3497;402;74;1800;765;328;1035;99;95;3
399;5.78643e-15;211;1521;24364;12498.2;1;1539;789;3498;380;85;1716;784;295;932;98;94;3
400;5.86189e-15;201;1582;24557;12600.2;1;1549;765;3498;411;111;1784;757;300;1027;99;93;3
401;5.93412e-15;192;1615;24778;12677.2;1;1546;778;3499;375;86;1768;762;289;1006;98;93;3
402;5.98884e-15;195;1626;24937;12770.2;1;1571;703;3499;387;76;1762;794;311;968;98;93;3
403;6.05516e-15;161;1629;25140;12868.2;1;1565;749;3499;334;94;1789;835;240;954;98;94;3
404;6.1253e-15;184;1569;25366;12980.2;1;1546;708;3500;350;85;1770;814;265;956;98;93;3
405;6.2058e-15;163;1584;25591;13079.2;1;1513;710;3500;336;99;1755;761;237;994;97;93;3
406;6.27725e-15;166;1568;25822;13156.2;1;1480;631;3501;356;82;1752;787;274;965;97;92;3
407;6.33301e-15;142;1580;26013;13257.2;1;1461;671;3501;318;72;1808;779;246;1029;97;92;3
408;6.4064e-15;164;1559;26207;13349.2;1;1450;643;3502;346;84;1637;761;262;876;96;91;3
409;6.47349e-15;157;1565;26361;13462.2;1;1460;671;3502;313;87;1743;754;226;989;96;92;3
410;6.55622e-15;157;1530;26545;13553.2;1;1447;620;3502;347;73;1772;795;274;977;96;92;3
411;6.6231e-15;145;1567;26710;13656.2;1;1446;617;3503;303;65;1822;766;238;1056;95;93;3
412;6.69907e-15;158;1540;26858;13745.2;1;1463;577;3503;287;83;1828;778;204;1050;95;92;3
413;6.76495e-15;147;1540;27017;13839.2;1;1454;586;3504;271;81;1763;768;190;995;95;92;3
414;6.83476e-15;148;1569;27197;13948.2;1;1426;569;3504;306;74;1769;769;232;1000;95;91;3
415;6.91602e-15;148;1619;27386;14042.2;1;1395;582;3505;301;65;1727;800;236;927;95;91;3
416;6.98634e-15;163;1618;27567;14162.2;1;1379;564;3505;299;93;1828;809;206;1019;94;90;3
417;7.07647e-15;130;1654;27761;14262.2;1;1345;560;3505;281;100;1731;831;181;900;94;91;3
418;7.15187e-15;146;1637;27963;14359.2;1;1314;542;3506;291;75;1709;798;216;911;93;90;3
419;7.22527e-15;123;1612;28168;14455.2;1;1275;538;3506;285;86;1694;819;199;875;93;90;3
420;7.29815e-15;138;1668;28328;14544.2;1;1261;544;3507;262;75;1763;791;187;972;93;90;3
421;7.36594e-15;123;1673;28510;14656.2;1;1235;535;3507;267;72;1777;818;195;959;93;90;3
422;7.45154e-15;139;1660;28689;14763.2;1;1206;551;3507;278;74;1740;839;204;901;94;89;3
423;7.53363e-15;152;1651;28851;14861.2;1;1192;541;3508;293;64;1703;823;229;880;93;90;3
424;7.60908e-15;129;1655;29015;14944.2;1;1172;502;3508;277;83;1720;849;194;871;94;89;3
425;7.67318e-15;123;1703;29176;15040.2;1;1155;553;3509;230;60;1735;832;170;903;93;90;3
426;7.74754e-15;137;1694;29284;15133.2;1;1162;516;3509;278;74;1768;834;204;934;93;89;3
427;7.81981e-15;143;1651;29404;15219.2;1;1164;493;3509;277;75;1748;824;202;924;93;90;3
428;7.88683e-15;121;1625;29505;15314.2;1;1170;514;3510;247;70;1743;775;177;968;93;90;3
429;7.9611e-15;127;1625;29654;15407.2;1;1156;543;3510;273;41;1811;750;232;1061;92;89;3
430;8.03402e-15;145;1600;29742;15503.2;1;1189;530;3511;284;59;1747;812;225;935;91;88;3
431;8.10953e-15;127;1684;29855;15590.2;1;1193;493;3511;277;76;1724;805;201;919;91;87;3
432;8.17817e-15;135;1660;29940;15673.2;1;1211;547;3511;270;63;1785;778;207;1007;91;88;3
433;8.24383e-15;130;1595;30073;15776.2;1;1213;501;3512;257;60;1818;778;197;1040;91;87;3
434;8.32555e-15;126;1641;30203;15870.2;1;1201;548;3512;276;63;1804;806;213;998;91;87;4
435;8.40037e-15;138;1593;30322;15959.2;1;1199;510;3513;272;65;1704;816;207;888;91;86;4
436;8.47141e-15;92;1673;30427;16066.2;1;1201;560;3513;254;81;1747;795;173;952;90;87;4
437;8.55709e-15;114;1664;30558;16152.2;1;1184;535;3513;282;62;1785;790;220;995;91;87;4
438;8.62617e-15;146;1708;30690;16244.2;1;1172;547;3514;244;66;1772;817;178;955;90;87;4
439;8.70026e-15;146;1619;30815;16320.2;1;1167;537;3514;309;87;1863;803;222;1060;90;86;4
440;8.76163e-15;143;1640;30926;16398.2;1;1173;547;3514;264;57;1826;834;207;992;90;86;4
441;8.82477e-15;135;1643;31066;16477.2;1;1170;553;3515;296;64;1788;793;232;995;89;85;4
442;8.88887e-15;155;1711;31158;16596.2;1;1188;543;3515;279;72;1762;788;207;974;90;85;4
443;8.98571e-15;152;1683;31258;16685.2;1;1201;540;3516;284;59;1703;884;225;819;90;85;4
444;9.05837e-15;137;1618;31393;16758.2;1;1197;521;3516;292;82;1749;854;210;895;90;84;4
445;9.11812e-15;123;1636;31479;16831.2;1;1219;522;3516;271;68;1665;817;203;848;90;83;4
446;9.17799e-15;142;1674;31581;16913.2;1;1225;551;3517;253;53;1719;863;200;856;89;84;4
447;9.24541e-15;137;1697;31700;17015.2;1;1228;538;3517;266;82;1764;881;184;883;89;84;4
448;9.32949e-15;121;1715;31793;17099.2;1;1243;488;3517;273;81;1812;794;192;1018;89;82;4
449;9.39893e-15;126;1603;31888;17185.2;1;1255;533;3518;265;58;1727;835;207;892;88;81;4
450;9.4702e-15;136;1689;31981;17275.2;1;1269;543;3518;268;69;1745;772;199;973;88;82;4
451;9.54498e-15;151;1632;32113;17349.2;1;1262;542;3519;273;72;1816;839;201;977;88;82;4
452;9.60661e-15;135;1629;32230;17412.2;1;1263;484;3519;293;83;1796;809;210;987;87;80;4
453;9.65918e-15;150;1691;32332;17501.2;1;1271;496;3519;243;65;1775;875;178;900;86;80;4
454;9.73362e-15;155;1676;32458;17571.2;1;1268;539;3520;243;59;1814;852;184;962;86;80;4
455;9.79229e-15;166;1685;32543;17656.2;1;1283;530;3520;281;88;1752;771;193;981;87;80;4
456;9.8637e-15;163;1649;32624;17740.2;1;1305;538;3520;276;81;1812;809;195;1003;86;80;4
457;9.93444e-15;170;1642;32745;17813.2;1;1302;551;3521;264;75;1705;838;189;867;85;80;4
458;9.99606e-15;167;1686;32814;17903.2;1;1330;545;3521;279;72;1762;804;207;958;84;81;4
459;1.00722e-14;155;1688;32928;17979.2;1;1333;542;3521;264;74;1710;796;190;914;85;81;4
460;1.01366e-14;150;1604;33055;18075.2;1;1326;528;3522;274;72;1765;833;202;932;85;80;4
461;1.02182e-14;174;1584;33165;18158.2;1;1329;485;3522;297;68;1718;835;229;883;85;78;4
462;1.0289e-14;131;1629;33292;18246.2;1;1329;541;3523;212;74;1625;819;138;806;85;79;4
463;1.03641e-14;153;1686;33410;18339.2;1;1328;551;3523;267;64;1695;756;203;939;84;79;4
464;1.04438e-14;146;1636;33473;18423.2;1;1358;541;3523;295;72;1834;853;223;981;84;79;4
465;1.05159e-14;139;1638;33536;18502.2;1;1398;531;3524;267;76;1745;771;191;974;84;79;4
466;1.05838e-14;162;1638;33649;18581.2;1;1390;515;3524;261;80;1833;794;181;1039;83;78;4
467;1.06519e-14;132;1661;33742;18657.2;1;1396;476;3524;269;84;1794;799;185;995;83;78;4
468;1.07176e-14;151;1695;33865;18734.2;1;1386;539;3525;242;61;1796;814;181;982;83;77;4
469;1.07843e-14;151;1705;33941;18826.2;1;1409;507;3525;267;83;1829;852;184;977;83;78;4
470;1.08641e-14;153;1695;34044;18911.2;1;1412;536;3525;249;75;1783;802;174;981;82;78;4
471;1.0938e-14;142;1689;34131;18984.2;1;1423;542;3526;271;60;1803;839;211;964;83;78;4
472;1.10016e-14;175;1635;34232;19062.2;1;1429;525;3526;281;80;1770;860;201;910;83;77;4
473;1.10698e-14;145;1675;34327;19137.2;1;1449;545;3526;246;74;1803;792;172;1011;83;78;4
474;1.11354e-14;153;1707;34409;19215.2;1;1470;544;3527;272;77;1781;823;195;958;83;77;4
475;1.12038e-14;159;1690;34524;19288.2;1;1481;553;3527;233;62;1689;872;171;817;83;77;4
476;1.12679e-14;158;1661;34626;19346.2;1;1489;515;3527;267;79;1747;835;188;912;83;76;4
477;1.1319e-14;154;1655;34736;19426.2;1;1489;544;3528;234;82;1763;832;152;931;82;77;4
478;1.13895e-14;141;1734;34838;19500.2;1;1507;516;3528;272;71;1744;846;201;898;82;75;4
479;1.14549e-14;127;1709;34941;19573.2;1;1516;554;3528;257;79;1746;803;178;943;81;76;4
480;1.15195e-14;164;1683;35088;19656.2;1;1492;542;3529;264;65;1732;845;199;887;81;76;4
481;1.15931e-14;136;1685;35170;19730.2;1;1509;522;3529;274;69;1718;835;205;883;80;74;4
482;1.16589e-14;149;1723;35278;19819.2;1;1510;516;3529;321;71;1806;815;250;991;80;75;4
483;1.17381e-14;144;1713;35384;19883.2;1;1518;507;3530;247;68;1727;869;179;858;80;75;4
484;1.17952e-14;142;1708;35518;19966.2;1;1497;522;3530;285;62;1764;838;223;926;80;75;5
485;1.18694e-14;135;1705;35617;20024.2;1;1505;496;3530;260;81;1696;791;179;905;79;74;5
486;4.19637e-15;146;1273;12863;10094.1;1;1413;518;3531;263;41;1770;491;222;1279;80;73;5
487;4.24829e-15;145;1428;13191;10169.1;1;1300;457;3531;283;84;1764;679;199;1085;80;73;5
488;4.29596e-15;131;1474;13473;10249.1;1;1215;487;3531;260;49;1774;726;211;1048;80;74;5
489;4.34701e-15;145;1568;13755;10314.1;1;1132;445;3532;222;63;1752;783;159;969;79;73;5
490;4.38863e-15;134;1547;14039;10401.1;1;1045;477;3532;234;54;1752;821;180;931;79;73;5
491;4.44455e-15;140;1542;14345;10495.1;1;936;488;3532;260;65;1740;785;195;955;79;72;5
492;4.50524e-15;138;1595;14549;10573.1;1;887;462;3533;232;79;1766;779;153;987;79;72;5
493;4.5558e-15;123;1615;14761;10660.1;1;839;458;3533;235;61;1767;802;174;965;78;72;5
494;4.61243e-15;128;1597;14932;10752.1;1;802;448;3533;218;77;1809;826;141;983;78;71;5
495;4.67256e-15;142;1624;15100;10824.1;1;763;470;3534;220;60;1794;806;160;988;78;71;5
496;4.7198e-15;159;1546;15243;10908.1;1;754;485;3534;252;61;1715;827;191;888;78;71;5
497;4.77511e-15;145;1655;15395;10982.1;1;736;483;3534;244;69;1820;766;175;1054;78;71;5
498;4.82402e-15;134;1585;15505;11078.1;1;744;470;3535;228;56;1782;816;172;966;78;70;5
499;4.88772e-15;147;1587;15651;11159.1;1;719;455;3535;268;72;1854;798;196;1056;78;70;5
500;4.94168e-15;138;1691;15783;11235.1;1;703;444;3535;233;65;1817;767;168;1050;78;69;5
501;4.99249e-15;135;1684;15897;11317.1;1;695;478;3536;209;71;1746;818;138;928;77;68;5
502;5.0475e-15;125;1689;16055;11385.1;1;658;430;3536;239;83;1744;809;156;935;77;68;5
503;5.09328e-15;137;1723;16165;11467.1;1;654;464;3536;214;56;1768;815;158;953;77;69;5
504;5.14867e-15;135;1691;16310;11547.1;1;628;450;3537;224;70;1796;832;154;964;77;68;5
505;5.20289e-15;133;1694;16418;11629.1;1;623;472;3537;216;59;1742;922;157;820;77;69;5
506;5.25867e-15;117;1762;16543;11716.1;1;614;452;3537;228;74;1737;829;154;908;77;68;5
507;5.31807e-15;131;1638;16653;11790.1;1;611;491;3537;216;55;1720;853;161;867;77;68;5
508;5.36877e-15;151;1680;16731;11867.1;1;630;446;3538;260;66;1723;803;194;920;76;68;5
509;5.42169e-15;139;1694;16826;11938.1;1;637;438;3538;227;76;1802;863;151;939;75;68;5
510;5.47065e-15;130;1699;16933;12011.1;1;640;425;3538;214;78;1788;835;136;953;74;67;5
511;5.52113e-15;124;1672;17010;12083.1;1;644;415;3539;220;59;1730;836;161;894;74;67;5
512;5.57108e-15;120;1717;17080;12164.1;1;653;435;3539;199;62;1753;855;137;898;74;68;5
513;5.62745e-15;131;1640;17169;12243.1;1;656;438;3539;205;56;1747;844;149;903;74;69;5
514;5.68261e-15;146;1622;17272;12331.1;1;658;412;3540;214;57;1839;830;157;1009;74;69;5
515;5.74427e-15;106;1679;17382;12410.1;1;651;431;3540;219;51;1765;819;168;946;74;69;5
516;5.79981e-15;127;1595;17490;12494.1;1;634;369;3540;226;63;1858;864;163;994;73;69;5
517;5.85906e-15;97;1718;17607;12571.1;1;617;366;3541;197;72;1771;813;125;958;73;70;5
518;5.91355e-15;116;1667;17692;12642.1;1;609;372;3541;170;52;1788;865;118;923;73;71;5
519;5.96394e-15;124;1667;17788;12697.1;1;607;368;3541;177;41;1770;828;136;942;73;70;5
520;6.00308e-15;119;1693;17867;12785.1;1;607;385;3541;168;57;1779;827;111;952;73;70;5
521;6.06588e-15;137;1720;17967;12858.1;1;594;382;3542;201;58;1800;824;143;976;73;69;5
522;6.11813e-15;116;1688;18044;12952.1;1;592;382;3542;212;61;1744;822;151;922;73;69;5
523;6.18564e-15;97;1693;18137;13022.1;1;590;393;3542;186;60;1761;862;126;899;73;70;5
524;6.23608e-15;108;1583;18210;13093.1;1;592;395;3543;178;50;1846;857;128;989;73;68;5
525;6.28738e-15;92;1692;18266;13167.1;1;606;385;3543;188;52;1727;825;136;902;73;69;5
526;6.34099e-15;98;1696;18357;13240.1;1;604;392;3543;180;61;1798;831;119;967;72;69;5
527;6.39403e-15;116;1736;18449;13308.1;1;594;353;3544;175;61;1808;863;114;945;72;69;5
528;6.44356e-15;111;1685;18512;13381.1;1;603;384;3544;167;50;1882;882;117;1000;72;68;5
529;6.49688e-15;114;1759;18571;13452.1;1;622;394;3544;181;47;1777;830;134;947;72;69;5
530;6.54889e-15;112;1730;18650;13515.1;1;616;389;3544;210;54;1768;872;156;896;72;68;5
531;6.59515e-15;119;1673;18702;13586.1;1;629;388;3545;198;54;1832;836;144;996;70;67;5
532;6.64741e-15;113;1677;18785;13661.1;1;628;388;3545;179;51;1805;836;128;969;71;67;5
533;6.70277e-15;122;1729;18821;13734.1;1;655;339;3545;202;46;1821;842;156;979;70;67;5
534;6.7568e-15;114;1696;18927;13794.1;1;632;330;3546;155;66;1654;870;89;784;70;67;5
535;6.80131e-15;96;1739;18996;13864.1;1;635;331;3546;177;51;1757;810;126;947;70;66;5
536;6.85337e-15;105;1666;19072;13928.1;1;625;306;3546;165;50;1844;863;115;981;70;67;5
537;6.90108e-15;103;1662;19156;13993.1;1;614;352;3546;163;44;1802;817;119;985;69;67;5
538;6.94965e-15;133;1660;19250;14045.1;1;601;328;3547;205;47;1741;840;158;901;69;68;6
539;6.98859e-15;104;1704;19352;14120.1;1;584;357;3547;162;77;1848;791;85;1057;69;69;6
540;7.04488e-15;112;1648;19425;14189.1;1;586;351;3547;171;53;1704;828;118;876;69;68;6
541;7.0968e-15;101;1658;19497;14248.1;1;584;349;3548;163;56;1821;849;107;972;69;68;6
542;7.1413e-15;117;1742;19563;14316.1;1;588;344;3548;176;42;1744;834;134;910;70;68;6
543;7.1927e-15;100;1701;19664;14380.1;1;566;341;3548;159;62;1859;818;97;1041;69;69;6
544;7.24119e-15;103;1681;19748;14438.1;1;555;351;3548;175;51;1798;859;124;939;69;69;6
545;7.28523e-15;105;1651;19816;14491.1;1;553;348;3549;189;68;1744;867;121;877;69;69;6
546;7.32555e-15;88;1724;19864;14556.1;1;564;312;3549;169;40;1780;868;129;912;68;68;6
547;7.37509e-15;89;1724;19929;14627.1;1;566;293;3549;167;51;1775;866;116;909;68;68;6
548;7.42935e-15;94;1645;20057;14702.1;1;528;286;3550;156;40;1760;820;116;940;69;67;6
549;7.4868e-15;101;1706;20123;14767.1;1;524;319;3550;140;63;1822;870;77;952;68;68;6
550;7.53671e-15;93;1683;20180;14838.1;1;526;329;3550;166;47;1724;911;119;813;68;68;6
551;7.59135e-15;92;1667;20228;14917.1;1;535;287;3550;184;49;1787;873;135;914;68;67;6
552;7.65231e-15;85;1810;20310;14975.1;1;520;323;3551;140;47;1834;821;93;1013;67;66;6
553;7.69717e-15;93;1728;20381;15050.1;1;516;323;3551;161;37;1760;891;124;869;67;66;6
554;7.7553e-15;90;1687;20428;15114.1;1;526;310;3551;135;34;1775;844;101;931;67;66;6
555;7.80503e-15;95;1694;20478;15169.1;1;532;324;3551;159;45;1751;833;114;918;67;66;6
556;7.84784e-15;95;1810;20557;15255.1;1;524;334;3552;170;48;1820;821;122;999;67;66;6
557;7.91495e-15;114;1667;20626;15309.1;1;524;333;3552;157;57;1805;915;100;890;67;65;6
558;7.95718e-15;91;1776;20687;15375.1;1;531;330;3552;165;53;1788;825;112;963;66;64;6
559;8.0089e-15;104;1732;20728;15428.1;1;538;289;3553;167;46;1882;864;121;1018;66;65;6
560;8.05052e-15;92;1704;20764;15498.1;1;545;323;3553;161;52;1736;876;109;860;66;64;6
561;8.10559e-15;93;1748;20808;15570.1;1;556;2.14749e+08;-2.14748e+09;168;42;1814;836;126;978;66;64;6
562;8.16237e-15;93;1747;20808;15570.1;1;556;3.13773e+08;-2.06399e+09;1;0;-1;0;1;-1;65;63;6
563;8.16237e-15;93;1745;20808;15570.1;1;556;6.19576e+08;-1.98428e+09;0;0;-1;0;0;-1;65;63;6
564;8.16237e-15;93;1740;20808;15570.1;1;556;8.10393e+08;-1.90817e+09;1;0;-1;0;1;-1;416;414;6
565;8.16237e-15;93;1740;20808;15570.1;1;556;8.86568e+08;-1.83548e+09;0;0;-1;0;0;-1;1764;1761;6
566;8.16237e-15;93;1739;20808;15570.1;1;556;9.55798e+08;-1.76604e+09;0;0;-1;0;0;-1;5004;5001;6
567;8.16237e-15;93;1737;20808;15570.1;1;556;1.34052e+09;-1.69969e+09;1;0;-1;0;1;-1;11232;11230;6
568;8.16237e-15;93;1736;20808;15570.1;1;556;1.28939e+09;-1.63627e+09;0;0;-1;0;0;-1;21712;21710;6
569;8.16237e-15;93;1736;20808;15570.1;1;556;1.55433e+09;-1.57565e+09;0;0;-1;0;0;-1;37837;37834;6
570;8.16237e-15;93;1736;20808;15570.1;1;556;1.7061e+09;-1.51768e+09;0;0;-1;0;0;-1;61099;61096;6
571;8.16237e-15;93;1736;20808;15570.1;1;556;1.9597e+09;-1.46224e+09;1;0;-1;0;1;-1;93064;93061;6
572;8.16237e-15;94;1736;20808;15570.1;1;556;1.88587e+09;-1.40921e+09;0;0;-1;0;0;-1;135348;135345;6
573;8.16237e-15;96;1734;20808;15570.1;1;556;2.02172e+09;-1.35846e+09;5;0;-1;0;5;-1;189593;189590;6
574;8.16237e-15;97;1734;20808;15570.1;1;556;-2.14748e+09;-1.30989e+09;1;0;-1;0;1;-1;257453;257450;6
575;8.16237e-15;97;1734;20808;15570.1;1;556;-2.14748e+09;-1.2634e+09;0;0;-1;0;0;-1;340574;340572;6
576;8.16237e-15;95;1734;20808;15570.1;1;556;-2.14748e+09;-1.21888e+09;-1;0;0;0;-1;0;440587;440584;6
577;8.16237e-15;95;1733;20808;15570.1;1;556;-2.14748e+09;-1.17625e+09;0;0;-1;0;0;-1;559086;559083;6
578;8.16237e-15;93;1730;20808;15570.1;1;556;-2.14748e+09;-1.13541e+09;-1;0;0;0;-1;0;697627;697624;6
579;8.16237e-15;93;1730;20808;15570.1;1;556;-2.14748e+09;-1.09627e+09;-1;0;0;0;-1;0;857717;857715;6
580;8.16237e-15;93;1730;20808;15570.1;1;556;-2.14748e+09;-1.05877e+09;-1;0;0;0;-1;0;1040806;1040803;6
581;8.16237e-15;91;1729;20808;15570.1;1;556;-2.14748e+09;-1.02281e+09;-1;0;0;0;-1;0;1248279;1248276;6
582;8.16237e-15;91;1729;20808;15570.1;1;556;-2.14748e+09;-9.88342e+08;0;0;-1;0;0;-1;1481457;1481455;6
583;8.16237e-15;91;1729;20808;15570.1;1;556;-2.14748e+09;-9.5528e+08;0;0;-1;0;0;-1;1741590;1741587;6
584;8.16237e-15;90;1729;20808;15570.1;1;556;-2.14748e+09;-9.23566e+08;-1;0;0;0;-1;0;2029853;2029850;6
585;8.16237e-15;90;1729;20808;15570.1;1;556;-2.14748e+09;-8.93136e+08;0;0;-1;0;0;-1;2347347;2347344;6
586;8.16237e-15;90;1728;20808;15570.1;1;556;-2.14748e+09;-8.63933e+08;0;0;-1;0;0;-1;2695095;2695092;6
587;8.16237e-15;89;1728;20808;15570.1;1;556;-2.14748e+09;-8.359e+08;-1;0;0;0;-1;0;3074045;3074042;6
588;8.16237e-15;89;1728;20808;15570.1;1;556;-2.14748e+09;-8.08984e+08;-1;0;0;0;-1;0;3485064;3485062;6
589;8.16237e-15;89;1728;20808;15570.1;1;556;-2.14748e+09;-7.83135e+08;-1;0;0;0;-1;0;3928947;3928944;6
590;8.16237e-15;89;1727;20808;15570.1;1;556;-2.14748e+09;-7.58305e+08;0;0;-1;0;0;-1;4406407;4406404;6
591;8.16237e-15;87;1726;20808;15570.1;1;556;-2.14748e+09;-7.34449e+08;0;0;-1;0;0;-1;4918086;4918083;6
592;8.16237e-15;87;1726;20808;15570.1;1;556;-2.14748e+09;-7.11523e+08;0;0;-1;0;0;-1;5464550;5464547;7
593;8.16237e-15;86;1724;20808;15570.1;1;556;-2.14748e+09;-6.89486e+08;-1;0;0;0;-1;0;6046293;6046291;7
594;8.16237e-15;86;1724;20808;15570.1;1;556;-2.14748e+09;-6.68298e+08;-1;0;0;0;-1;0;6663741;6663738;7
595;8.16237e-15;84;1724;20808;15570.1;1;556;-2.14748e+09;-6.47923e+08;-1;0;0;0;-1;0;7317248;7317245;7
596;8.16237e-15;84;1724;20808;15570.1;1;556;-2.14748e+09;-6.28325e+08;-1;0;0;0;-1;0;8007105;8007102;7
597;8.16237e-15;83;1724;20808;15570.1;1;556;-2.14748e+09;-6.0947e+08;-1;0;0;0;-1;0;8733537;8733534;7
598;8.16237e-15;79;1723;20808;15570.1;1;556;-2.14748e+09;-5.91326e+08;-1;0;0;0;-1;0;9496710;9496707;8
599;8.16237e-15;76;1722;20808;15570.1;1;556;-2.14748e+09;-5.73862e+08;0;0;-1;0;0;-1;10296729;10296727;8
600;8.16237e-15;74;1722;20808;15570.1;1;556;-2.14748e+09;-5.57049e+08;0;0;-1;0;0;-1;11133645;11133642;9
601;8.16237e-15;74;1722;20808;15570.1;1;556;-2.14748e+09;-5.40859e+08;-1;0;0;0;-1;0;12007452;12007450;9
602;8.16237e-15;74;1722;20808;15570.1;1;556;-2.14748e+09;-5.25265e+08;-1;0;0;0;-1;0;12918097;12918094;10
603;8.16237e-15;74;1722;20808;15570.1;1;556;-2.14748e+09;-5.10244e+08;-1;0;0;0;-1;0;13865473;13865471;11
604;8.16237e-15;72;1720;20808;15570.1;1;556;-2.14748e+09;-4.95769e+08;-1;0;0;0;-1;0;14849432;14849430;12
605;8.16237e-15;72;1720;20808;15570.1;1;556;-2.14748e+09;-4.81819e+08;-1;0;0;0;-1;0;15869779;15869777;13
606;8.16237e-15;72;1720;20808;15570.1;1;556;-2.14748e+09;-4.68371e+08;-1;0;0;0;-1;0;16926279;16926277;15
607;8.16237e-15;70;1719;20808;15570.1;1;556;-2.14748e+09;-4.55404e+08;-1;0;0;0;-1;0;18018659;18018657;17
608;8.16237e-15;70;1719;20808;15570.1;1;556;-2.14748e+09;-4.429e+08;-1;0;0;0;-1;0;19146609;19146607;19
609;8.16237e-15;68;1719;20808;15570.1;1;556;-2.14748e+09;-4.30837e+08;0;0;-1;0;0;-1;20309783;20309782;22
610;8.16237e-15;68;1719;20808;15570.1;1;556;-2.14748e+09;-4.192e+08;-1;0;0;0;-1;0;21507808;21507806;25
611;8.16237e-15;68;1719;20808;15570.1;1;556;-2.14748e+09;-4.07969e+08;-1;0;0;0;-1;0;22740277;22740275;29
612;8.16237e-15;67;1719;20808;15570.1;1;556;-2.14748e+09;-3.97129e+08;-1;0;0;0;-1;0;24006757;24006756;33
613;8.16237e-15;67;1718;20808;15570.1;1;556;-2.14748e+09;-3.86664e+08;0;0;-1;0;0;-1;25306792;25306791;39
614;8.16237e-15;67;1718;20808;15570.1;1;556;-2.14748e+09;-3.76558e+08;-1;0;0;0;-1;0;26639899;26639898;45
615;8.16237e-15;67;1718;20808;15570.1;1;556;-2.14748e+09;-3.66798e+08;-1;0;0;0;-1;0;28005576;28005576;52
616;8.16237e-15;66;1718;20808;15570.1;1;556;-2.14748e+09;-3.57369e+08;-1;0;0;0;-1;0;29403302;29403302;60
617;8.16237e-15;66;1718;20808;15570.1;1;556;-2.14748e+09;-3.48258e+08;0;0;-1;0;0;-1;30832536;30832537;69
618;8.16237e-15;66;1718;20808;15570.1;1;556;-2.14748e+09;-3.39454e+08;-1;0;0;0;-1;0;32292724;32292725;79
619;8.16237e-15;65;1718;20808;15570.1;1;556;-2.14748e+09;-3.30943e+08;-1;0;0;0;-1;0;33783295;33783296;91
620;8.16237e-15;62;1718;20808;15570.1;1;556;-2.14748e+09;-3.22714e+08;-1;0;0;0;-1;0;35303666;35303669;105
621;8.16237e-15;61;1718;20808;15570.1;1;556;-2.14748e+09;-3.14757e+08;-1;0;0;0;-1;0;36853245;36853247;121
622;8.16237e-15;60;1717;20808;15570.1;1;556;-2.14748e+09;-3.07061e+08;-1;0;0;0;-1;0;38431426;38431429;138
623;8.16237e-15;60;1717;20808;15570.1;1;556;-2.14748e+09;-2.99615e+08;-1;0;0;0;-1;0;40037598;40037603;158
624;8.16237e-15;60;1716;20808;15570.1;1;556;-2.14748e+09;-2.92411e+08;-1;0;0;0;-1;0;41671142;41671148;180
625;8.16237e-15;60;1716;20808;15570.1;1;556;-2.14748e+09;-2.85438e+08;-1;0;0;0;-1;0;43331432;43331439;205
626;8.16237e-15;60;1716;20808;15570.1;1;556;-2.14748e+09;-2.78689e+08;0;0;-1;0;0;-1;45017839;45017848;233
627;8.16237e-15;57;1716;20808;15570.1;1;556;-2.14748e+09;-2.72154e+08;-1;0;0;0;-1;0;46729729;46729739;264
628;8.16237e-15;57;1716;20808;15570.1;1;556;-2.14748e+09;-2.65826e+08;-1;0;0;0;-1;0;48466466;48466476;299
629;8.16237e-15;57;1716;20808;15570.1;1;556;-2.14748e+09;-2.59696e+08;0;0;-1;0;0;-1;50227410;50227423;338
630;8.16237e-15;55;1716;20808;15570.1;1;556;-2.14748e+09;-2.53759e+08;-1;0;0;0;-1;0;52011925;52011940;381
631;8.16237e-15;53;1716;20808;15570.1;1;556;-2.14748e+09;-2.48005e+08;-1;0;0;0;-1;0;53819371;53819388;429
632;8.16237e-15;53;1716;20808;15570.1;1;556;-2.14748e+09;-2.42429e+08;-1;0;0;0;-1;0;55649111;55649131;481
633;8.16237e-15;53;1716;20808;15570.1;1;556;-2.14748e+09;-2.37024e+08;-1;0;0;0;-1;0;57500510;57500531;539
634;8.16237e-15;51;1716;20808;15570.1;1;556;-2.14748e+09;-2.31784e+08;-1;0;0;0;-1;0;59372932;59372957;603
635;8.16237e-15;50;1714;20808;15570.1;1;556;-2.14748e+09;-2.26703e+08;-1;0;0;0;-1;0;61265750;61265777;674
636;8.16237e-15;49;1714;20808;15570.1;1;556;-2.14748e+09;-2.21775e+08;-1;0;0;0;-1;0;63178335;63178365;751
637;8.16237e-15;49;1714;20808;15570.1;1;556;-2.14748e+09;-2.16994e+08;-1;0;0;0;-1;0;65110065;65110100;835
638;8.16237e-15;44;1714;20808;15570.1;1;556;-2.14748e+09;-2.12356e+08;-1;0;0;0;-1;0;67060324;67060363;927
639;8.16237e-15;43;1714;20808;15570.1;1;556;-2.14748e+09;-2.07855e+08;-1;0;0;0;-1;0;69028499;69028543;1028
640;8.16237e-15;42;1714;20808;15570.1;1;556;-2.14748e+09;-2.03486e+08;-1;0;0;0;-1;0;71013983;71014033;1137
641;8.16237e-15;42;1714;20808;15570.1;1;556;-2.14748e+09;-1.99245e+08;-1;0;0;0;-1;0;73016177;73016233;1257
642;8.16237e-15;38;1714;20808;15570.1;1;556;-2.14748e+09;-1.95127e+08;-1;0;0;0;-1;0;75034487;75034549;1386
643;8.16237e-15;36;1714;20808;15570.1;1;556;-2.14748e+09;-1.91128e+08;-1;0;0;0;-1;0;77068327;77068396;1527
644;8.16237e-15;36;1714;20808;15570.1;1;556;-2.14748e+09;-1.87243e+08;-1;0;0;0;-1;0;79117118;79117193;1680
645;8.16237e-15;33;1714;20808;15570.1;1;556;-2.14748e+09;-1.83469e+08;-1;0;0;0;-1;0;81180287;81180369;1844
646;8.16237e-15;33;1714;20808;15570.1;1;556;-2.14748e+09;-1.79803e+08;-1;0;0;0;-1;0;83257270;83257361;2022
647;8.16237e-15;33;1714;20808;15570.1;1;556;-2.14748e+09;-1.76239e+08;0;0;-1;0;0;-1;85347512;85347613;2215
648;8.16237e-15;33;1714;20808;15570.1;1;556;-2.14748e+09;-1.72776e+08;-1;0;0;0;-1;0;87450466;87450575;2422
649;8.16237e-15;33;1714;20808;15570.1;1;556;-2.14748e+09;-1.69408e+08;-1;0;0;0;-1;0;89565591;89565711;2644
650;8.16237e-15;33;1714;20808;15570.1;1;556;-2.14748e+09;-1.66134e+08;-1;0;0;0;-1;0;91692358;91692490;2884
651;8.16237e-15;28;1714;20808;15570.1;1;556;-2.14748e+09;-1.6295e+08;-1;0;0;0;-1;0;93830245;93830389;3141
652;8.16237e-15;27;1714;20808;15570.1;1;556;-2.14748e+09;-1.59852e+08;-1;0;0;0;-1;0;95978738;95978895;3417
653;8.16237e-15;27;1714;20808;15570.1;1;556;-2.14748e+09;-1.56839e+08;-1;0;0;0;-1;0;98137335;98137506;3712
654;8.16237e-15;26;1714;20808;15570.1;1;556;-2.14748e+09;-1.53907e+08;-1;0;0;0;-1;0;100305538;100305725;4028
655;8.16237e-15;24;1714;20808;15570.1;1;556;-2.14748e+09;-1.51054e+08;-1;0;0;0;-1;0;102482865;102483067;4366
656;8.16237e-15;24;1714;20808;15570.1;1;556;-2.14748e+09;-1.48277e+08;-1;0;0;0;-1;0;104668836;104669056;4726
657;8.16237e-15;21;1714;20808;15570.1;1;556;-2.14748e+09;-1.45573e+08;-1;0;0;0;-1;0;106862986;106863224;5111
658;8.16237e-15;21;1714;20808;15570.1;1;556;-2.14748e+09;-1.42941e+08;-1;0;0;0;-1;0;109064855;109065113;5521
659;8.16237e-15;21;1714;20808;15570.1;1;556;-2.14748e+09;-1.40378e+08;-1;0;0;0;-1;0;111273995;111274274;5957
660;8.16237e-15;21;1714;20808;15570.1;1;556;-2.14748e+09;-1.37881e+08;-1;0;0;0;-1;0;113489966;113490268;6421
661;8.16237e-15;21;1714;20808;15570.1;1;556;-2.14748e+09;-1.35448e+08;-1;0;0;0;-1;0;115712338;115712664;6914
662;8.16237e-15;21;1714;20808;15570.1;1;556;-2.14748e+09;-1.33079e+08;-1;0;0;0;-1;0;117940689;117941040;7438
663;8.16237e-15;17;1714;20808;15570.1;1;556;-2.14748e+09;-1.30769e+08;-1;0;0;0;-1;0;120174606;120174985;7993
664;8.16237e-15;17;1714;20808;15570.1;1;556;-2.14748e+09;-1.28518e+08;-1;0;0;0;-1;0;122413688;122414096;8581
665;8.16237e-15;17;1714;20808;15570.1;1;556;-2.14748e+09;-1.26325e+08;-1;0;0;0;-1;0;124657539;124657977;9204
666;8.16237e-15;13;1714;20808;15570.1;1;556;-2.14748e+09;-1.24186e+08;-1;0;0;0;-1;0;126905774;126906246;9862
667;8.16237e-15;13;1714;20808;15570.1;1;556;-2.14748e+09;-1.221e+08;-1;0;0;0;-1;0;129158017;129158524;10559
668;8.16237e-15;13;1714;20808;15570.1;1;556;-2.14748e+09;-1.20066e+08;-1;0;0;0;-1;0;131413902;131414446;11294
669;8.16237e-15;13;1714;20808;15570.1;1;556;-2.14748e+09;-1.18082e+08;-1;0;0;0;-1;0;133673070;133673651;12070
670;8.16237e-15;13;1714;20808;15570.1;1;556;-2.14748e+09;-1.16147e+08;-1;0;0;0;-1;0;135935168;135935792;12889
671;8.16237e-15;12;1714;20808;15570.1;1;556;-2.14748e+09;-1.14258e+08;-1;0;0;0;-1;0;138199859;138200525;13751
672;8.16237e-15;12;1714;20808;15570.1;1;556;-2.14748e+09;-1.12415e+08;-1;0;0;0;-1;0;140466807;140467519;14659
673;8.16237e-15;11;1714;20808;15570.1;1;556;-2.14748e+09;-1.10617e+08;-1;0;0;0;-1;0;142735689;142736449;15614
674;8.16237e-15;11;1714;20808;15570.1;1;556;-2.14748e+09;-1.08861e+08;-1;0;0;0;-1;0;145006187;145006998;16619
675;8.16237e-15;10;1714;20808;15570.1;1;556;-2.14748e+09;-1.07148e+08;-1;0;0;0;-1;0;147277994;147278859;17674
676;8.16237e-15;9;1714;20808;15570.1;1;556;-2.14748e+09;-1.05474e+08;-1;0;0;0;-1;0;149550810;149551731;18782
677;8.16237e-15;4;1712;20808;15570.1;1;556;-2.14748e+09;-1.0384e+08;-1;0;0;0;-1;0;151824342;151825322;19944
678;8.16237e-15;4;1712;20808;15570.1;1;556;-2.14748e+09;-1.02244e+08;-1;0;0;0;-1;0;154098305;154099348;21163
679;8.16237e-15;4;1712;20808;15570.1;1;556;-2.14748e+09;-1.00684e+08;-1;0;0;0;-1;0;156372424;156373533;22441
680;8.16237e-15;4;1712;20808;15570.1;1;556;-2.14748e+09;-9.9161e+07;-1;0;0;0;-1;0;158646429;158647607;23779
681;8.16237e-15;4;1712;20808;15570.1;1;556;-2.14748e+09;-9.76725e+07;-1;0;0;0;-1;0;160920057;160921308;25179
682;8.16237e-15;4;1712;20808;15570.1;1;556;-2.14748e+09;-9.62178e+07;-1;0;0;0;-1;0;163193056;163194382;26643
683;8.16237e-15;4;1712;20808;15570.1;1;556;-2.14748e+09;-9.4796e+07;-1;0;0;0;-1;0;165465176;165466582;28174
684;8.16237e-15;3;1712;20808;15570.1;1;556;-2.14748e+09;-9.34062e+07;-1;0;0;0;-1;0;167736178;167737668;29773
685;8.16237e-15;2;1712;20808;15570.1;1;556;-2.14748e+09;-9.20473e+07;-1;0;0;0;-1;0;170005829;170007407;31443
686;8.16237e-15;0;1712;20808;15570.1;1;556;-2.14748e+09;-9.07186e+07;-1;0;0;0;-1;0;172273901;172275571;33185
687;8.16237e-15;-1;1712;20808;15570.1;1;556;-2.14748e+09;-8.94192e+07;0;0;0;0;0;0;174540177;174541942;35002
688;8.16237e-15;-2;1712;20808;15570.1;1;556;-2.14748e+09;-8.81483e+07;0;0;0;0;0;0;176804441;176806306;36896
689;8.16237e-15;-3;1712;20808;15570.1;1;556;-2.14748e+09;-8.69051e+07;0;0;0;0;0;0;179066487;179068456;38870
690;8.16237e-15;-3;1712;20808;15570.1;1;556;-2.14748e+09;-8.56888e+07;-1;0;0;0;-1;0;181326114;181328193;40924
691;8.16237e-15;-3;1712;20808;15570.1;1;556;-2.14748e+09;-8.44987e+07;-1;0;0;0;-1;0;183583128;183585322;43063
692;8.16237e-15;-3;1712;20808;15570.1;1;556;-2.14748e+09;-8.33341e+07;-1;0;0;0;-1;0;185837342;185839654;45287
693;8.16237e-15;-4;1712;20808;15570.1;1;556;-2.14748e+09;-8.21942e+07;0;0;0;0;0;0;188088571;188091008;47600
694;8.16237e-15;-4;1712;20808;15570.1;1;556;-2.14748e+09;-8.10785e+07;-1;0;0;0;-1;0;190336640;190339206;50003
695;8.16237e-15;-4;1712;20808;15570.1;1;556;-2.14748e+09;-7.99862e+07;-1;0;0;0;-1;0;192581378;192584079;52499
696;8.16237e-15;-5;1712;20808;15570.1;1;556;-2.14748e+09;-7.89167e+07;0;0;0;0;0;0;194822618;194825460;55091
697;8.16237e-15;-6;1712;20808;15570.1;1;556;-2.14748e+09;-7.78694e+07;0;0;0;0;0;0;197060202;197063191;57780
698;8.16237e-15;-7;1712;20808;15570.1;1;556;-2.14748e+09;-7.68437e+07;0;0;0;0;0;0;199293975;199297116;60569
699;8.16237e-15;-7;1712;20808;15570.1;1;556;-2.14748e+09;-7.58391e+07;-1;0;0;0;-1;0;201523786;201527085;63461
700;8.16237e-15;-7;1712;20808;15570.1;1;556;-2.14748e+09;-7.4855e+07;-1;0;0;0;-1;0;203749491;203752956;66458
701;8.16237e-15;-7;1712;20808;15570.1;1;556;-2.14748e+09;-7.38908e+07;-1;0;0;0;-1;0;205970953;205974588;69562
702;8.16237e-15;-8;1712;20808;15570.1;1;556;-2.14748e+09;-7.2946e+07;0;0;0;0;0;0;208188036;208191848;72776
703;8.16237e-15;-8;1712;20808;15570.1;1;556;-2.14748e+09;-7.20202e+07;-1;0;0;0;-1;0;210400609;210404606;76103
704;8.16237e-15;-9;1712;20808;15570.1;1;556;-2.14748e+09;-7.11128e+07;0;0;0;0;0;0;212608547;212612737;79544
705;8.16237e-15;-9;1712;20808;15570.1;1;556;-2.14748e+09;-7.02234e+07;-1;0;0;0;-1;0;214811731;214816119;83103
706;8.16237e-15;-10;1712;20808;15570.1;1;556;-2.14748e+09;-6.93515e+07;0;0;0;0;0;0;217010043;217014638;86781
707;8.16237e-15;-11;1712;20808;15570.1;1;556;-2.14748e+09;-6.84966e+07;0;0;0;0;0;0;219203372;219208180;90583
708;8.16237e-15;-11;1712;20808;15570.1;1;556;-2.14748e+09;-6.76584e+07;-1;0;0;0;-1;0;221391609;221396640;94509
709;8.16237e-15;-12;1712;20808;15570.1;1;556;-2.14748e+09;-6.68363e+07;0;0;0;0;0;0;223574652;223579913;98563
710;8.16237e-15;-12;1712;20808;15570.1;1;556;-2.14748e+09;-6.60301e+07;-1;0;0;0;-1;0;225752401;225757899;102747
711;8.16237e-15;-12;1712;20808;15570.1;1;556;-2.14748e+09;-6.52393e+07;-1;0;0;0;-1;0;227924759;227930504;107063
712;8.16237e-15;-13;1712;20808;15570.1;1;556;-2.14748e+09;-6.44635e+07;0;0;0;0;0;0;230091635;230097636;111516
713;8.16237e-15;-14;1712;20808;15570.1;1;556;-2.14748e+09;-6.37023e+07;0;0;0;0;0;0;232252940;232259205;116106
714;8.16237e-15;-14;1712;20808;15570.1;1;556;-2.14748e+09;-6.29555e+07;-1;0;0;0;-1;0;234408588;234415128;120836
715;8.16237e-15;-14;1711;20808;15570.1;1;556;-2.14748e+09;-6.22226e+07;0;0;0;0;0;0;236558502;236565325;125710
716;8.16237e-15;-15;1711;20808;15570.1;1;556;-2.14748e+09;-6.15032e+07;0;0;0;0;0;0;238702602;238709718;130730
717;8.16237e-15;-16;1711;20808;15570.1;1;556;-2.14748e+09;-6.07972e+07;0;0;0;0;0;0;240840814;240848231;135898
718;8.16237e-15;-16;1711;20808;15570.1;1;556;-2.14748e+09;-6.01041e+07;-1;0;0;0;-1;0;242973066;242980795;141217
719;8.16237e-15;-17;1711;20808;15570.1;1;556;-2.14748e+09;-5.94236e+07;0;0;0;0;0;0;245099291;245107342;146689
720;8.16237e-15;-17;1711;20808;15570.1;1;556;-2.14748e+09;-5.87555e+07;-1;0;0;0;-1;0;247219423;247227805;152318
721;8.16237e-15;-17;1711;20808;15570.1;1;556;-2.14748e+09;-5.80994e+07;-1;0;0;0;-1;0;249333401;249342126;158106
722;8.16237e-15;-18;1711;20808;15570.1;1;556;-2.14748e+09;-5.74551e+07;0;0;0;0;0;0;251441166;251450244;164055
723;8.16237e-15;-19;1711;20808;15570.1;1;556;-2.14748e+09;-5.68223e+07;0;0;0;0;0;0;253542662;253552105;170168
724;8.16237e-15;-20;1711;20808;15570.1;1;556;-2.14748e+09;-5.62006e+07;0;0;0;0;0;0;255637835;255647654;176448
725;8.16237e-15;-20;1711;20808;15570.1;1;556;-2.14748e+09;-5.559e+07;-1;0;0;0;-1;0;257726633;257736841;182897
726;8.16237e-15;-20;1711;20808;15570.1;1;556;-2.14748e+09;-5.499e+07;-1;0;0;0;-1;0;259809009;259819619;189519
727;8.16237e-15;-20;1711;20808;15570.1;1;556;-2.14748e+09;-5.44004e+07;-1;0;0;0;-1;0;261884921;261895942;196315
728;8.16237e-15;-21;1711;20808;15570.1;1;556;-2.14748e+09;-5.38211e+07;0;0;0;0;0;0;263954323;263965767;203288
729;8.16237e-15;-22;1711;20808;15570.1;1;556;-2.14748e+09;-5.32517e+07;0;0;0;0;0;0;266017174;266029054;210440
730;8.16237e-15;-23;1711;20808;15570.1;1;556;-2.14748e+09;-5.26921e+07;0;0;0;0;0;0;268073436;268085764;217776
731;8.16237e-15;-23;1711;20808;15570.1;1;556;-2.14748e+09;-5.2142e+07;-1;0;0;0;-1;0;270123074;270135864;225296
732;8.16237e-15;-24;1711;20808;15570.1;1;556;-2.14748e+09;-5.16013e+07;0;0;0;0;0;0;272166054;272179319;233003
733;8.16237e-15;-25;1711;20808;15570.1;1;556;-2.14748e+09;-5.10696e+07;0;0;0;0;0;0;274202342;274216097;240901
734;8.16237e-15;-26;1711;20808;15570.1;1;556;-2.14748e+09;-5.05468e+07;0;0;0;0;0;0;276231911;276246169;248991
735;8.16237e-15;-26;1711;20808;15570.1;1;556;-2.14748e+09;-5.00327e+07;-1;0;0;0;-1;0;278254734;278269508;257276
736;8.16237e-15;-26;1711;20808;15570.1;1;556;-2.14748e+09;-4.95272e+07;-1;0;0;0;-1;0;280270783;280286089;265760
737;8.16237e-15;-26;1711;20808;15570.1;1;556;-2.14748e+09;-4.90299e+07;-1;0;0;0;-1;0;282280034;282295887;274443
738;8.16237e-15;-26;1711;20808;15570.1;1;556;-2.14748e+09;-4.85408e+07;-1;0;0;0;-1;0;284282468;284298879;283329
739;8.16237e-15;-26;1711;20808;15570.1;1;556;-2.14748e+09;-4.80597e+07;-1;0;0;0;-1;0;286278063;286295049;292420
740;8.16237e-15;-26;1711;20808;15570.1;1;556;-2.14748e+09;-4.75863e+07;-1;0;0;0;-1;0;288266801;288284379;301719
741;8.16237e-15;-26;1711;20808;15570.1;1;556;-2.14748e+09;-4.71205e+07;-1;0;0;0;-1;0;290248665;290266850;311229
742;8.16237e-15;-26;1711;20808;15570.1;1;556;-2.14748e+09;-4.66622e+07;-1;0;0;0;-1;0;292223641;292242449;320950
743;8.16237e-15;-27;1711;20808;15570.1;1;556;-2.14748e+09;-4.62112e+07;0;0;0;0;0;0;294191713;294211162;330887
744;8.16237e-15;-28;1711;20808;15570.1;1;556;-2.14748e+09;-4.57674e+07;0;0;0;0;0;0;296152872;296172978;341042
745;8.16237e-15;-29;1711;20808;15570.1;1;556;-2.14748e+09;-4.53305e+07;0;0;0;0;0;0;298107108;298127886;351416
746;8.16237e-15;-30;1711;20808;15570.1;1;556;-2.14748e+09;-4.49004e+07;0;0;0;0;0;0;300054405;300075878;362013
747;8.16237e-15;-30;1711;20808;15570.1;1;556;-2.14748e+09;-4.44771e+07;-1;0;0;0;-1;0;301994764;302016944;372834
748;8.16237e-15;-31;1711;20808;15570.1;1;556;-2.14748e+09;-4.40603e+07;0;0;0;0;0;0;303928179;303951083;383883
749;8.16237e-15;-32;1711;20808;15570.1;1;556;-2.14748e+09;-4.36499e+07;0;0;0;0;0;0;305854640;305878287;395161
750;8.16237e-15;-32;1711;20808;15570.1;1;556;-2.14748e+09;-4.32458e+07;-1;0;0;0;-1;0;307774146;307798554;406670
751;8.16237e-15;-32;1711;20808;15570.1;1;556;-2.14748e+09;-4.28479e+07;-1;0;0;0;-1;0;309686695;309711881;418414
752;8.16237e-15;-32;1711;20808;15570.1;1;556;-2.14748e+09;-4.2456e+07;-1;0;0;0;-1;0;311592283;311618268;430393
753;8.16237e-15;-32;1711;20808;15570.1;1;556;-2.14748e+09;-4.207e+07;-1;0;0;0;-1;0;313490914;313517714;442612
754;8.16237e-15;-33;1711;20808;15570.1;1;556;-2.14748e+09;-4.16897e+07;0;0;0;0;0;0;315382586;315410223;455071
755;8.16237e-15;-34;1711;20808;15570.1;1;556;-2.14748e+09;-4.13152e+07;0;0;0;0;0;0;317267301;317295789;467773
756;8.16237e-15;-34;1711;20808;15570.1;1;556;-2.14748e+09;-4.09462e+07;-1;0;0;0;-1;0;319145063;319174428;480720
757;8.16237e-15;-34;1711;20808;15570.1;1;556;-2.14748e+09;-4.05826e+07;-1;0;0;0;-1;0;321015877;321046139;493915
758;8.16237e-15;-34;1711;20808;15570.1;1;556;-2.14748e+09;-4.02244e+07;-1;0;0;0;-1;0;322879747;322910924;507359
759;8.16237e-15;-35;1711;20808;15570.1;1;556;-2.14748e+09;-3.98714e+07;0;0;0;0;0;0;324736679;324768795;521055
760;8.16237e-15;-35;1711;20808;15570.1;1;556;-2.14748e+09;-3.95235e+07;-1;0;0;0;-1;0;326586680;326619756;535005
761;8.16237e-15;-36;1711;20808;15570.1;1;556;-2.14748e+09;-3.91807e+07;0;0;0;0;0;0;328429759;328463815;549210
762;8.16237e-15;-37;1711;20808;15570.1;1;556;-2.14748e+09;-3.88428e+07;0;0;0;0;0;0;330265925;330300983;563674
763;8.16237e-15;-37;1711;20808;15570.1;1;556;-2.14748e+09;-3.85097e+07;-1;0;0;0;-1;0;332095186;332131267;578397
764;8.16237e-15;-37;1711;20808;15570.1;1;556;-2.14748e+09;-3.81813e+07;-1;0;0;0;-1;0;333917553;333954680;593382
765;8.16237e-15;-37;1711;20808;15570.1;1;556;-2.14748e+09;-3.78576e+07;-1;0;0;0;-1;0;335733037;335771231;608631
766;8.16237e-15;-37;1711;20808;15570.1;1;556;-2.14748e+09;-3.75384e+07;-1;0;0;0;-1;0;337541650;337580934;624146
767;8.16237e-15;-38;1711;20808;15570.1;1;556;-2.14748e+09;-3.72237e+07;0;0;0;0;0;0;339343403;339383802;639929
768;8.16237e-15;-38;1711;20808;15570.1;1;556;-2.14748e+09;-3.69134e+07;-1;0;0;0;-1;0;341138311;341179849;655982
769;8.16237e-15;-38;1711;20808;15570.1;1;556;-2.14748e+09;-3.66073e+07;-1;0;0;0;-1;0;342926388;342969088;672306
770;8.16237e-15;-38;1711;20808;15570.1;1;556;-2.14748e+09;-3.63055e+07;-1;0;0;0;-1;0;344707647;344751533;688904
771;8.16237e-15;-38;1711;20808;15570.1;1;556;-2.14748e+09;-3.60078e+07;-1;0;0;0;-1;0;346482103;346527201;705776
772;8.16237e-15;-39;1711;20808;15570.1;1;556;-2.14748e+09;-3.57142e+07;0;0;0;0;0;0;348249773;348296107;722926
773;8.16237e-15;-39;1711;20808;15570.1;1;556;-2.14748e+09;-3.54246e+07;-1;0;0;0;-1;0;350010673;350058267;740355
774;8.16237e-15;-40;1711;20808;15570.1;1;556;-2.14748e+09;-3.51389e+07;0;0;0;0;0;0;351764818;351813700;758065
775;8.16237e-15;-41;1711;20808;15570.1;1;556;-2.14748e+09;-3.4857e+07;0;0;0;0;0;0;353512228;353562421;776057
776;8.16237e-15;-42;1711;20808;15570.1;1;556;-2.14748e+09;-3.45788e+07;0;0;0;0;0;0;355252919;355304449;794333
777;8.16237e-15;-42;1711;20808;15570.1;1;556;-2.14748e+09;-3.43044e+07;-1;0;0;0;-1;0;356986909;357039803;812894
778;8.16237e-15;-43;1711;20808;15570.1;1;556;-2.14748e+09;-3.40336e+07;0;0;0;0;0;0;358714217;358768501;831743
779;8.16237e-15;-43;1711;20808;15570.1;1;556;-2.14748e+09;-3.37664e+07;-1;0;0;0;-1;0;360434863;360490564;850881
780;8.16237e-15;-43;1711;20808;15570.1;1;556;-2.14748e+09;-3.35026e+07;-1;0;0;0;-1;0;362148866;362206011;870309
781;8.16237e-15;-44;1711;20808;15570.1;1;556;-2.14748e+09;-3.32423e+07;0;0;0;0;0;0;363856245;363914861;890030
782;8.16237e-15;-44;1711;20808;15570.1;1;556;-2.14748e+09;-3.29854e+07;-1;0;0;0;-1;0;365557022;365617139;910044
783;8.16237e-15;-44;1711;20808;15570.1;1;556;-2.14748e+09;-3.27317e+07;-1;0;0;0;-1;0;367251217;367312864;930353
784;8.16237e-15;-45;1711;20808;15570.1;1;556;-2.14748e+09;-3.24814e+07;0;0;0;0;0;0;368938851;369002055;950959
785;8.16237e-15;-46;1711;20808;15570.1;1;556;-2.14748e+09;-3.22342e+07;0;0;0;0;0;0;370619945;370684736;971863
786;8.16237e-15;-47;1711;20808;15570.1;1;556;-2.14748e+09;-3.19902e+07;0;0;0;0;0;0;372294521;372360929;993066
787;8.16237e-15;-48;1711;20808;15570.1;1;556;-2.14748e+09;-3.17492e+07;0;0;0;0;0;0;373962601;374030654;1014570
788;8.16237e-15;-49;1711;20808;15570.1;1;556;-2.14748e+09;-3.15113e+07;0;0;0;0;0;0;375624207;375693936;1036377
789;8.16237e-15;-50;1711;20808;15570.1;1;556;-2.14748e+09;-3.12764e+07;0;0;0;0;0;0;377279363;377350797;1058486
790;8.16237e-15;-51;1711;20808;15570.1;1;556;-2.14748e+09;-3.10444e+07;0;0;0;0;0;0;378928090;379001260;1080901
791;8.16237e-15;-52;1711;20808;15570.1;1;556;-2.14748e+09;-3.08153e+07;0;0;0;0;0;0;380570412;380645349;1103622
792;8.16237e-15;-52;1711;20808;15570.1;1;556;-2.14748e+09;-3.0589e+07;-1;0;0;0;-1;0;382206352;382283086;1126650
793;8.16237e-15;-53;1711;20808;15570.1;1;556;-2.14748e+09;-3.03654e+07;0;0;0;0;0;0;383835934;383914497;1149986
794;8.16237e-15;-54;1711;20808;15570.1;1;556;-2.14748e+09;-3.01446e+07;0;0;0;0;0;0;385459182;385539605;1173632
795;8.16237e-15;-55;1711;20808;15570.1;1;556;-2.14748e+09;-2.99265e+07;0;0;0;0;0;0;387076119;387158435;1197589
796;8.16237e-15;-56;1711;20808;15570.1;1;556;-2.14748e+09;-2.97111e+07;0;0;0;0;0;0;388686769;388771010;1221858
797;8.16237e-15;-56;1711;20808;15570.1;1;556;-2.14748e+09;-2.94982e+07;-1;0;0;0;-1;0;390291158;390377356;1246440
798;8.16237e-15;-56;1711;20808;15570.1;1;556;-2.14748e+09;-2.92879e+07;-1;0;0;0;-1;0;391889309;391977498;1271336
799;8.16237e-15;-56;1711;20808;15570.1;1;556;-2.14748e+09;-2.90801e+07;-1;0;0;0;-1;0;393481247;393571459;1296548
800;8.16237e-15;-56;1711;20808;15570.1;1;556;-2.14748e+09;-2.88747e+07;-1;0;0;0;-1;0;395066997;395159266;1322075
801;8.16237e-15;-57;1711;20808;15570.1;1;556;-2.14748e+09;-2.86718e+07;0;0;0;0;0;0;396646584;396740944;1347920
802;8.16237e-15;-57;1711;20808;15570.1;1;556;-2.14748e+09;-2.84713e+07;-1;0;0;0;-1;0;398220032;398316518;1374083
803;8.16237e-15;-57;1711;20808;15570.1;1;556;-2.14748e+09;-2.82731e+07;-1;0;0;0;-1;0;399787368;399886013;1400565
804;8.16237e-15;-58;1711;20808;15570.1;1;556;-2.14748e+09;-2.80773e+07;0;0;0;0;0;0;401348616;401449456;1427367
805;8.16237e-15;-58;1711;20808;15570.1;1;556;-2.14748e+09;-2.78837e+07;-1;0;0;0;-1;0;402903802;403006871;1454489
806;8.16237e-15;-59;1711;20808;15570.1;1;556;-2.14748e+09;-2.76923e+07;0;0;0;0;0;0;404452951;404558285;1481934
807;8.16237e-15;-59;1711;20808;15570.1;1;556;-2.14748e+09;-2.75032e+07;-1;0;0;0;-1;0;405996089;406103724;1509700
808;8.16237e-15;-59;1711;20808;15570.1;1;556;-2.14748e+09;-2.73162e+07;-1;0;0;0;-1;0;407533241;407643213;1537790
809;8.16237e-15;-60;1711;20808;15570.1;1;556;-2.14748e+09;-2.71313e+07;0;0;0;0;0;0;409064433;409176778;1566204
810;8.16237e-15;-61;1711;20808;15570.1;1;556;-2.14748e+09;-2.69485e+07;0;0;0;0;0;0;410589692;410704447;1594943
811;8.16237e-15;-62;1711;20808;15570.1;1;556;-2.14748e+09;-2.67678e+07;0;0;0;0;0;0;412109042;412226243;1624007
812;8.16237e-15;-63;1711;20808;15570.1;1;556;-2.14748e+09;-2.65892e+07;0;0;0;0;0;0;413622509;413742195;1653397
813;8.16237e-15;-63;1711;20808;15570.1;1;556;-2.14748e+09;-2.64125e+07;-1;0;0;0;-1;0;415130121;415252328;1683114
814;8.16237e-15;-64;1711;20808;15570.1;1;556;-2.14748e+09;-2.62378e+07;0;0;0;0;0;0;416631901;416756668;1713158
815;8.16237e-15;-65;1711;20808;15570.1;1;556;-2.14748e+09;-2.6065e+07;0;0;0;0;0;0;418127878;418255242;1743530
816;8.16237e-15;-66;1711;20808;15570.1;1;556;-2.14748e+09;-2.58941e+07;0;0;0;0;0;0;419618075;419748076;1774231
817;8.16237e-15;-67;1711;20808;15570.1;1;556;-2.14748e+09;-2.57251e+07;0;0;0;0;0;0;421102521;421235197;1805260
818;8.16237e-15;-68;1711;20808;15570.1;1;556;-2.14748e+09;-2.5558e+07;0;0;0;0;0;0;422581239;422716630;1836619
819;8.16237e-15;-68;1711;20808;15570.1;1;556;-2.14748e+09;-2.53927e+07;-1;0;0;0;-1;0;424054258;424192402;1868308
820;8.16237e-15;-68;1711;20808;15570.1;1;556;-2.14748e+09;-2.52292e+07;-1;0;0;0;-1;0;425521602;425662539;1900328
821;8.16237e-15;-69;1711;20808;15570.1;1;556;-2.14748e+09;-2.50674e+07;0;0;0;0;0;0;426983297;427127068;1932678
822;8.16237e-15;-70;1711;20808;15570.1;1;556;-2.14748e+09;-2.49074e+07;0;0;0;0;0;0;428439370;428586015;1965360
823;8.16237e-15;-70;1711;20808;15570.1;1;556;-2.14748e+09;-2.47491e+07;-1;0;0;0;-1;0;429889847;430039407;1998373
824;8.16237e-15;-71;1711;20808;15570.1;1;556;-2.14748e+09;-2.45924e+07;0;0;0;0;0;0;431334754;431487269;2031719
825;8.16237e-15;-72;1711;20808;15570.1;1;556;-2.14748e+09;-2.44375e+07;0;0;0;0;0;0;432774116;432929628;2065396
826;8.16237e-15;-72;1711;20808;15570.1;1;556;-2.14748e+09;-2.42841e+07;-1;0;0;0;-1;0;434207960;434366510;2099407
827;8.16237e-15;-72;1711;20808;15570.1;1;556;-2.14748e+09;-2.41324e+07;-1;0;0;0;-1;0;435636312;435797942;2133750
828;8.16237e-15;-72;1711;20808;15570.1;1;556;-2.14748e+09;-2.39823e+07;-1;0;0;0;-1;0;437059197;437223949;2168426
829;8.16237e-15;-72;1711;20808;15570.1;1;556;-2.14748e+09;-2.38337e+07;-1;0;0;0;-1;0;438476641;438644557;2203436
830;8.16237e-15;-72;1711;20808;15570.1;1;556;-2.14748e+09;-2.36867e+07;-1;0;0;0;-1;0;439888670;440059794;2238779
831;8.16237e-15;-73;1711;20808;15570.1;1;556;-2.14748e+09;-2.35412e+07;0;0;0;0;0;0;441295310;441469684;2274456
832;8.16237e-15;-74;1711;20808;15570.1;1;556;-2.14748e+09;-2.33972e+07;0;0;0;0;0;0;442696587;442874255;2310467
833;8.16237e-15;-75;1711;20808;15570.1;1;556;-2.14748e+09;-2.32547e+07;0;0;0;0;0;0;444092525;444273531;2346812
834;8.16237e-15;-76;1711;20808;15570.1;1;556;-2.14748e+09;-2.31136e+07;0;0;0;0;0;0;445483152;445667538;2383491
835;8.16237e-15;-77;1711;20808;15570.1;1;556;-2.14748e+09;-2.29739e+07;0;0;0;0;0;0;446868492;447056303;2420504
836;8.16237e-15;-78;1711;20808;15570.1;1;556;-2.14748e+09;-2.28357e+07;0;0;0;0;0;0;448248570;448439852;2457851
837;8.16237e-15;-78;1711;20808;15570.1;1;556;-2.14748e+09;-2.26989e+07;-1;0;0;0;-1;0;449623413;449818209;2495533
838;8.16237e-15;-79;1711;20808;15570.1;1;556;-2.14748e+09;-2.25634e+07;0;0;0;0;0;0;450993045;451191401;2533549
839;8.16237e-15;-79;1711;20808;15570.1;1;556;-2.14748e+09;-2.24293e+07;-1;0;0;0;-1;0;452357493;452559453;2571899
840;8.16237e-15;-79;1711;20808;15570.1;1;556;-2.14748e+09;-2.22965e+07;-1;0;0;0;-1;0;453716780;453922391;2610583
841;8.16237e-15;-79;1711;20808;15570.1;1;556;-2.14748e+09;-2.21651e+07;-1;0;0;0;-1;0;455070933;455280240;2649602
842;8.16237e-15;-79;1711;20808;15570.1;1;556;-2.14748e+09;-2.20349e+07;-1;0;0;0;-1;0;456419975;456633025;2688954
843;8.16237e-15;-79;1711;20808;15570.1;1;556;-2.14748e+09;-2.1906e+07;-1;0;0;0;-1;0;457763934;457980772;2728641
844;8.16237e-15;-79;1711;20808;15570.1;1;556;-2.14748e+09;-2.17784e+07;0;0;-1;0;0;-1;459102832;459323506;2768661
845;8.16237e-15;-80;1711;20808;15570.1;1;556;-2.14748e+09;-2.16521e+07;0;0;0;0;0;0;460436695;460661252;2809015
846;8.16237e-15;-81;1711;20808;15570.1;1;556;-2.14748e+09;-2.15269e+07;0;0;0;0;0;0;461765548;461994034;2849703
847;8.16237e-15;-82;1711;20808;15570.1;1;556;-2.14748e+09;-2.1403e+07;0;0;0;0;0;0;463089415;463321879;2890723
848;8.16237e-15;-83;1711;20808;15570.1;1;556;-2.14748e+09;-2.12802e+07;0;0;0;0;0;0;464408321;464644810;2932077
849;8.16237e-15;-83;1711;20808;15570.1;1;556;-2.14748e+09;-2.11587e+07;-1;0;0;0;-1;0;465722291;465962853;2973764
850;8.16237e-15;-84;1711;20808;15570.1;1;556;-2.14748e+09;-2.10383e+07;0;0;0;0;0;0;467031348;467276032;3015783
851;8.16237e-15;-84;1711;20808;15570.1;1;556;-2.14748e+09;-2.0919e+07;-1;0;0;0;-1;0;468335518;468584372;3058135
852;8.16237e-15;-84;1711;20808;15570.1;1;556;-2.14748e+09;-2.08009e+07;-1;0;0;0;-1;0;469634823;469887897;3100818
853;8.16237e-15;-85;1711;20808;15570.1;1;556;-2.14748e+09;-2.06839e+07;0;0;0;0;0;0;470929289;471186631;3143833
854;8.16237e-15;-85;1711;20808;15570.1;1;556;-2.14748e+09;-2.05679e+07;-1;0;0;0;-1;0;472218940;472480599;3187180
855;8.16237e-15;-85;1711;20808;15570.1;1;556;-2.14748e+09;-2.04531e+07;-1;0;0;0;-1;0;473503799;473769825;3230858
856;8.16237e-15;-85;1711;20808;15570.1;1;556;-2.14748e+09;-2.03394e+07;-1;0;0;0;-1;0;474783890;475054334;3274866
857;8.16237e-15;-86;1711;20808;15570.1;1;556;-2.14748e+09;-2.02267e+07;0;0;0;0;0;0;476059236;476334148;3319204
858;8.16237e-15;-87;1711;20808;15570.1;1;556;-2.14748e+09;-2.0115e+07;0;0;0;0;0;0;477329862;477609292;3363873
859;8.16237e-15;-88;1711;20808;15570.1;1;556;-2.14748e+09;-2.00044e+07;0;0;0;0;0;0;478595792;478879789;3408870
860;8.16237e-15;-89;1711;20808;15570.1;1;556;-2.14748e+09;-1.98948e+07;0;0;0;0;0;0;479857047;480145664;3454197
861;8.16237e-15;-90;1711;20808;15570.1;1;556;-2.14748e+09;-1.97862e+07;0;0;0;0;0;0;481113652;481406940;3499852
862;8.16237e-15;-91;1711;20808;15570.1;1;556;-2.14748e+09;-1.96786e+07;0;0;0;0;0;0;482365630;482663640;3545835
863;8.16237e-15;-91;1711;20808;15570.1;1;556;-2.14748e+09;-1.95719e+07;-1;0;0;0;-1;0;483613004;483915788;3592145
864;8.16237e-15;-92;1711;20808;15570.1;1;556;-2.14748e+09;-1.94663e+07;0;0;0;0;0;0;484855796;485163407;3638783
865;8.16237e-15;-93;1711;20808;15570.1;1;556;-2.14748e+09;-1.93615e+07;0;0;0;0;0;0;486094031;486406520;3685746
866;8.16237e-15;-94;1711;20808;15570.1;1;556;-2.14748e+09;-1.92578e+07;0;0;0;0;0;0;487327730;487645149;3733036
867;8.16237e-15;-94;1711;20808;15570.1;1;556;-2.14748e+09;-1.91549e+07;-1;0;0;0;-1;0;488556917;488879319;3780651
868;8.16237e-15;-94;1711;20808;15570.1;1;556;-2.14748e+09;-1.9053e+07;-1;0;0;0;-1;0;489781613;490109051;3828591
869;8.16237e-15;-95;1711;20808;15570.1;1;556;-2.14748e+09;-1.89519e+07;0;0;0;0;0;0;491001841;491334369;3876854
870;8.16237e-15;-95;1711;20808;15570.1;1;556;-2.14748e+09;-1.88518e+07;-1;0;0;0;-1;0;492217624;492555295;3925441
871;8.16237e-15;-95;1711;20808;15570.1;1;556;-2.14748e+09;-1.87526e+07;-1;0;0;0;-1;0;493428984;493771851;3974351
872;8.16237e-15;-96;1711;20808;15570.1;1;556;-2.14748e+09;-1.86542e+07;0;0;0;0;0;0;494635943;494984060;4023583
873;8.16237e-15;-96;1711;20808;15570.1;1;556;-2.14748e+09;-1.85566e+07;-1;0;0;0;-1;0;495838523;496191944;4073137
874;8.16237e-15;-96;1711;20808;15570.1;1;556;-2.14748e+09;-1.846e+07;-1;0;0;0;-1;0;497036746;497395526;4123011
875;8.16237e-15;-97;1711;20808;15570.1;1;556;-2.14748e+09;-1.83641e+07;0;0;0;0;0;0;498230633;498594826;4173206
876;8.16237e-15;-97;1711;20808;15570.1;1;556;-2.14748e+09;-1.82691e+07;-1;0;0;0;-1;0;499420207;499789868;4223720
877;8.16237e-15;-97;1711;20808;15570.1;1;556;-2.14748e+09;-1.8175e+07;-1;0;0;0;-1;0;500605489;500980672;4274552
878;8.16237e-15;-98;1711;20808;15570.1;1;556;-2.14748e+09;-1.80816e+07;0;0;0;0;0;0;501786500;502167262;4325703
879;8.16237e-15;-99;1711;20808;15570.1;1;556;-2.14748e+09;-1.7989e+07;0;0;0;0;0;0;502963261;503349657;4377170
880;8.16237e-15;-99;1711;20808;15570.1;1;556;-2.14748e+09;-1.78972e+07;-1;0;0;0;-1;0;504135795;504527880;4428954
881;8.16237e-15;-99;1711;20808;15570.1;1;556;-2.14748e+09;-1.78062e+07;-1;0;0;0;-1;0;505304121;505701952;4481054
882;8.16237e-15;-99;1711;20808;15570.1;1;556;-2.14748e+09;-1.7716e+07;-1;0;0;0;-1;0;506468262;506871894;4533468
883;8.16237e-15;-99;1711;20808;15570.1;1;556;-2.14748e+09;-1.76265e+07;-1;0;0;0;-1;0;507628238;508037727;4586197
884;8.16237e-15;-99;1711;20808;15570.1;1;556;-2.14748e+09;-1.75378e+07;-1;0;0;0;-1;0;508784069;509199473;4639238
885;8.16237e-15;-99;1711;20808;15570.1;1;556;-2.14748e+09;-1.74498e+07;-1;0;0;0;-1;0;509935777;510357152;4692592
886;8.16237e-15;-100;1711;20808;15570.1;1;556;-2.14748e+09;-1.73625e+07;0;0;0;0;0;0;511083382;511510785;4746258
887;8.16237e-15;-100;1711;20808;15570.1;1;556;-2.14748e+09;-1.7276e+07;-1;0;0;0;-1;0;512226905;512660392;4800234
888;8.16237e-15;-100;1711;20808;15570.1;1;556;-2.14748e+09;-1.71902e+07;-1;0;0;0;-1;0;513366365;513805994;4854519
889;8.16237e-15;-100;1711;20808;15570.1;1;556;-2.14748e+09;-1.71051e+07;-1;0;0;0;-1;0;514501783;514947613;4909114
890;8.16237e-15;-100;1711;20808;15570.1;1;556;-2.14748e+09;-1.70207e+07;-1;0;0;0;-1;0;515633179;516085266;4964016
891;8.16237e-15;-101;1711;20808;15570.1;1;556;-2.14748e+09;-1.6937e+07;0;0;0;0;0;0;516760573;517218977;5019226
892;8.16237e-15;-101;1711;20808;15570.1;1;556;-2.14748e+09;-1.6854e+07;-1;0;0;0;-1;0;517883986;518348763;5074741
893;8.16237e-15;-102;1711;20808;15570.1;1;556;-2.14748e+09;-1.67716e+07;0;0;0;0;0;0;519003436;519474645;5130562
894;8.16237e-15;-102;1711;20808;15570.1;1;556;-2.14748e+09;-1.66899e+07;-1;0;0;0;-1;0;520118944;520596644;5186687
895;8.16237e-15;-102;1711;20808;15570.1;1;556;-2.14748e+09;-1.66089e+07;-1;0;0;0;-1;0;521230528;521714778;5243115
896;8.16237e-15;-103;1711;20808;15570.1;1;556;-2.14748e+09;-1.65285e+07;0;0;0;0;0;0;522338210;522829068;5299846
897;8.16237e-15;-104;1711;20808;15570.1;1;556;-2.14748e+09;-1.64488e+07;0;0;0;0;0;0;523442007;523939532;5356878
898;8.16237e-15;-104;1711;20808;15570.1;1;556;-2.14748e+09;-1.63697e+07;-1;0;0;0;-1;0;524541939;525046191;5414210
899;8.16237e-15;-105;1711;20808;15570.1;1;556;-2.14748e+09;-1.62913e+07;0;0;0;0;0;0;525638025;526149064;5471842
900;8.16237e-15;-105;1711;20808;15570.1;1;556;-2.14748e+09;-1.62134e+07;-1;0;0;0;-1;0;526730284;527248169;5529772
901;8.16237e-15;-105;1711;20808;15570.1;1;556;-2.14748e+09;-1.61362e+07;-1;0;0;0;-1;0;527818736;528343527;5587999
902;8.16237e-15;-106;1711;20808;15570.1;1;556;-2.14748e+09;-1.60596e+07;0;0;0;0;0;0;528903398;529435155;5646523
903;8.16237e-15;-107;1711;20808;15570.1;1;556;-2.14748e+09;-1.59836e+07;0;0;0;0;0;0;529984291;530523073;5705342
904;8.16237e-15;-107;1711;20808;15570.1;1;556;-2.14748e+09;-1.59082e+07;-1;0;0;0;-1;0;531061431;531607300;5764455
905;8.16237e-15;-108;1711;20808;15570.1;1;556;-2.14748e+09;-1.58334e+07;0;0;0;0;0;0;532134838;532687854;5823861
906;8.16237e-15;-108;1711;20808;15570.1;1;556;-2.14748e+09;-1.57592e+07;-1;0;0;0;-1;0;533204529;533764753;5883559
907;8.16237e-15;-108;1711;20808;15570.1;1;556;-2.14748e+09;-1.56855e+07;-1;0;0;0;-1;0;534270524;534838017;5943548
908;8.16237e-15;-108;1711;20808;15570.1;1;556;-2.14748e+09;-1.56124e+07;-1;0;0;0;-1;0;535332841;535907663;6003828
909;8.16237e-15;-109;1711;20808;15570.1;1;556;-2.14748e+09;-1.55399e+07;0;0;0;0;0;0;536391497;536973710;6064396
910;8.16237e-15;-109;1711;20808;15570.1;1;556;-2.14748e+09;-1.54679e+07;-1;0;0;0;-1;0;537446510;538036176;6125252
911;8.16237e-15;-109;1711;20808;15570.1;1;556;-2.14748e+09;-1.53965e+07;-1;0;0;0;-1;0;538497899;539095078;6186394
912;8.16237e-15;-109;1711;20808;15570.1;1;556;-2.14748e+09;-1.53256e+07;-1;0;0;0;-1;0;539545680;540150435;6247822
913;8.16237e-15;-110;1711;20808;15570.1;1;556;-2.14748e+09;-1.52553e+07;0;0;0;0;0;0;540589872;541202265;6309535
914;8.16237e-15;-111;1711;20808;15570.1;1;556;-2.14748e+09;-1.51855e+07;0;0;0;0;0;0;541630493;542250584;6371531
915;8.16237e-15;-112;1711;20808;15570.1;1;556;-2.14748e+09;-1.51162e+07;0;0;0;0;0;0;542667558;543295411;6433809
916;8.16237e-15;-112;1711;20808;15570.1;1;556;-2.14748e+09;-1.50475e+07;-1;0;0;0;-1;0;543701087;544336764;6496368
917;8.16237e-15;-112;1711;20808;15570.1;1;556;-2.14748e+09;-1.49792e+07;-1;0;0;0;-1;0;544731095;545374658;6559206
918;8.16237e-15;-112;1711;20808;15570.1;1;556;-2.14748e+09;-1.49115e+07;-1;0;0;0;-1;0;545757601;546409113;6622324
919;8.16237e-15;-113;1711;20808;15570.1;1;556;-2.14748e+09;-1.48443e+07;0;0;0;0;0;0;546780621;547440144;6685719
920;8.16237e-15;-114;1711;20808;15570.1;1;556;-2.14748e+09;-1.47776e+07;0;0;0;0;0;0;547800172;548467770;6749391
921;8.16237e-15;-114;1711;20808;15570.1;1;556;-2.14748e+09;-1.47113e+07;-1;0;0;0;-1;0;548816270;549492006;6813337
922;8.16237e-15;-115;1711;20808;15570.1;1;556;-2.14748e+09;-1.46456e+07;0;0;0;0;0;0;549828934;550512870;6877558
923;8.16237e-15;-115;1711;20808;15570.1;1;556;-2.14748e+09;-1.45803e+07;-1;0;0;0;-1;0;550838178;551530379;6942052
924;8.16237e-15;-116;1711;20808;15570.1;1;556;-2.14748e+09;-1.45156e+07;0;0;0;0;0;0;551844020;552544548;7006817
925;8.16237e-15;-117;1711;20808;15570.1;1;556;-2.14748e+09;-1.44513e+07;0;0;0;0;0;0;552846477;553555395;7071853
926;8.16237e-15;-117;1711;20808;15570.1;1;556;-2.14748e+09;-1.43874e+07;-1;0;0;0;-1;0;553845563;554562937;7137158
927;8.16237e-15;-117;1711;20808;15570.1;1;556;-2.14748e+09;-1.43241e+07;-1;0;0;0;-1;0;554841296;555567188;7202731
928;8.16237e-15;-118;1711;20808;15570.1;1;556;-2.14748e+09;-1.42612e+07;0;0;0;0;0;0;555833692;556568167;7268571
929;8.16237e-15;-119;1711;20808;15570.1;1;556;-2.14748e+09;-1.41987e+07;0;0;0;0;0;0;556822767;557565888;7334676
930;8.16237e-15;-119;1711;20808;15570.1;1;556;-2.14748e+09;-1.41367e+07;-1;0;0;0;-1;0;557808536;558560368;7401046
931;8.16237e-15;-119;1711;20808;15570.1;1;556;-2.14748e+09;-1.40752e+07;-1;0;0;0;-1;0;558791016;559551622;7467679
932;8.16237e-15;-119;1711;20808;15570.1;1;556;-2.14748e+09;-1.4014e+07;-1;0;0;0;-1;0;559770222;560539668;7534574
933;8.16237e-15;-120;1711;20808;15570.1;1;556;-2.14748e+09;-1.39534e+07;0;0;0;0;0;0;560746169;561524519;7601730
934;8.16237e-15;-121;1711;20808;15570.1;1;556;-2.14748e+09;-1.38931e+07;0;0;0;0;0;0;561718874;562506193;7669145
935;8.16237e-15;-122;1711;20808;15570.1;1;556;-2.14748e+09;-1.38333e+07;0;0;0;0;0;0;562688352;563484704;7736819
936;8.16237e-15;-122;1711;20808;15570.1;1;556;-2.14748e+09;-1.37739e+07;-1;0;0;0;-1;0;563654618;564460069;7804749
937;8.16237e-15;-123;1711;20808;15570.1;1;556;-2.14748e+09;-1.37149e+07;0;0;0;0;0;0;564617688;565432301;7872935
938;8.16237e-15;-123;1711;20808;15570.1;1;556;-2.14748e+09;-1.36564e+07;-1;0;0;0;-1;0;565577576;566401418;7941376
939;8.16237e-15;-124;1711;20808;15570.1;1;556;-2.14748e+09;-1.35982e+07;0;0;0;0;0;0;566534297;567367433;8010070
940;8.16237e-15;-125;1711;20808;15570.1;1;556;-2.14748e+09;-1.35405e+07;0;0;0;0;0;0;567487868;568330362;8079015
941;8.16237e-15;-126;1711;20808;15570.1;1;556;-2.14748e+09;-1.34831e+07;0;0;0;0;0;0;568438301;569290220;8148212
942;8.16237e-15;-126;1711;20808;15570.1;1;556;-2.14748e+09;-1.34262e+07;-1;0;0;0;-1;0;569385614;570247022;8217657
943;8.16237e-15;-126;1711;20808;15570.1;1;556;-2.14748e+09;-1.33696e+07;-1;0;0;0;-1;0;570329819;571200782;8287351
944;8.16237e-15;-126;1711;20808;15570.1;1;556;-2.14748e+09;-1.33134e+07;-1;0;0;0;-1;0;571270932;572151516;8357292
945;8.16237e-15;-127;1711;20808;15570.1;1;556;-2.14748e+09;-1.32577e+07;0;0;0;0;0;0;572208966;573099238;8427478
946;8.16237e-15;-128;1711;20808;15570.1;1;556;-2.14748e+09;-1.32023e+07;0;0;0;0;0;0;573143938;574043962;8497909
947;8.16237e-15;-129;1711;20808;15570.1;1;556;-2.14748e+09;-1.31473e+07;0;0;0;0;0;0;574075861;574985703;8568583
948;8.16237e-15;-130;1711;20808;15570.1;1;556;-2.14748e+09;-1.30926e+07;0;0;0;0;0;0;575004748;575924476;8639498
949;8.16237e-15;-131;1711;20808;15570.1;1;556;-2.14748e+09;-1.30384e+07;0;0;0;0;0;0;575930616;576860294;8710654
950;8.16237e-15;-132;1711;20808;15570.1;1;556;-2.14748e+09;-1.29845e+07;0;0;0;0;0;0;576853477;577793172;8782049
951;8.16237e-15;-132;1711;20808;15570.1;1;556;-2.14748e+09;-1.29309e+07;-1;0;0;0;-1;0;577773345;578723123;8853681
952;8.16237e-15;-132;1711;20808;15570.1;1;556;-2.14748e+09;-1.28777e+07;-1;0;0;0;-1;0;578690235;579650163;8925551
953;8.16237e-15;-133;1711;20808;15570.1;1;556;-2.14748e+09;-1.28249e+07;0;0;0;0;0;0;579604160;580574304;8997655
954;8.16237e-15;-133;1711;20808;15570.1;1;556;-2.14748e+09;-1.27725e+07;-1;0;0;0;-1;0;580515134;581495561;9069994
955;8.16237e-15;-133;1711;20808;15570.1;1;556;-2.14748e+09;-1.27203e+07;-1;0;0;0;-1;0;581423171;582413947;9142565
956;8.16237e-15;-134;1711;20808;15570.1;1;556;-2.14748e+09;-1.26686e+07;0;0;0;0;0;0;582328285;583329476;9215367
957;8.16237e-15;-134;1711;20808;15570.1;1;556;-2.14748e+09;-1.26172e+07;-1;0;0;0;-1;0;583230488;584242162;9288400
958;8.16237e-15;-134;1711;20808;15570.1;1;556;-2.14748e+09;-1.25661e+07;-1;0;0;0;-1;0;584129794;585152018;9361661
959;8.16237e-15;-134;1711;20808;15570.1;1;556;-2.14748e+09;-1.25153e+07;-1;0;0;0;-1;0;585026217;586059057;9435149
960;8.16237e-15;-134;1711;20808;15570.1;1;556;-2.14748e+09;-1.24649e+07;-1;0;0;0;-1;0;585919770;586963293;9508864
961;8.16237e-15;-135;1711;20808;15570.1;1;556;-2.14748e+09;-1.24148e+07;0;0;0;0;0;0;586810467;587864739;9582804
962;8.16237e-15;-136;1711;20808;15570.1;1;556;-2.14748e+09;-1.23651e+07;0;0;0;0;0;0;587698319;588763408;9656967
963;8.16237e-15;-136;1711;20808;15570.1;1;556;-2.14748e+09;-1.23157e+07;-1;0;0;0;-1;0;588583340;589659314;9731352
964;8.16237e-15;-137;1711;20808;15570.1;1;556;-2.14748e+09;-1.22665e+07;0;0;0;0;0;0;589465544;590552469;9805958
965;8.16237e-15;-137;1711;20808;15570.1;1;556;-2.14748e+09;-1.22178e+07;-1;0;0;0;-1;0;590344943;591442886;9880784
966;8.16237e-15;-138;1711;20808;15570.1;1;556;-2.14748e+09;-1.21693e+07;0;0;0;0;0;0;591221549;592330578;9955828
967;8.16237e-15;-139;1711;20808;15570.1;1;556;-2.14748e+09;-1.21211e+07;0;0;0;0;0;0;592095376;593215558;10031088
968;8.16237e-15;-140;1711;20808;15570.1;1;556;-2.14748e+09;-1.20733e+07;0;0;0;0;0;0;592966436;594097838;10106565
969;8.16237e-15;-141;1711;20808;15570.1;1;556;-2.14748e+09;-1.20257e+07;0;0;0;0;0;0;593834742;594977432;10182256
970;8.16237e-15;-142;1711;20808;15570.1;1;556;-2.14748e+09;-1.19785e+07;0;0;0;0;0;0;594700306;595854351;10258159
971;8.16237e-15;-143;1711;20808;15570.1;1;556;-2.14748e+09;-1.19316e+07;0;0;0;0;0;0;595563141;596728608;10334275
972;8.16237e-15;-143;1711;20808;15570.1;1;556;-2.14748e+09;-1.18849e+07;-1;0;0;0;-1;0;596423258;597600216;10410600
973;8.16237e-15;-144;1711;20808;15570.1;1;556;-2.14748e+09;-1.18386e+07;0;0;0;0;0;0;597280671;598469187;10487135
974;8.16237e-15;-144;1711;20808;15570.1;1;556;-2.14748e+09;-1.17925e+07;-1;0;0;0;-1;0;598135391;599335532;10563878
975;8.16237e-15;-144;1711;20808;15570.1;1;556;-2.14748e+09;-1.17468e+07;-1;0;0;0;-1;0;598987431;600199265;10640827
976;8.16237e-15;-145;1711;20808;15570.1;1;556;-2.14748e+09;-1.17013e+07;0;0;0;0;0;0;599836802;601060396;10717981
977;8.16237e-15;-145;1711;20808;15570.1;1;556;-2.14748e+09;-1.16561e+07;-1;0;0;0;-1;0;600683517;601918939;10795338
978;8.16237e-15;-145;1711;20808;15570.1;1;556;-2.14748e+09;-1.16112e+07;-1;0;0;0;-1;0;601527587;602774905;10872898
979;8.16237e-15;-145;1711;20808;15570.1;1;556;-2.14748e+09;-1.15666e+07;-1;0;0;0;-1;0;602369025;603628306;10950660
980;8.16237e-15;-145;1711;20808;15570.1;1;556;-2.14748e+09;-1.15223e+07;-1;0;0;0;-1;0;603207841;604479154;11028621
981;8.16237e-15;-145;1711;20808;15570.1;1;556;-2.14748e+09;-1.14782e+07;-1;0;0;0;-1;0;604044048;605327460;11106781
982;8.16237e-15;-146;1711;20808;15570.1;1;556;-2.14748e+09;-1.14344e+07;0;0;0;0;0;0;604877658;606173237;11185138
983;8.16237e-15;-146;1711;20808;15570.1;1;556;-2.14748e+09;-1.13909e+07;-1;0;0;0;-1;0;605708681;607016495;11263690
984;8.16237e-15;-147;1711;20808;15570.1;1;556;-2.14748e+09;-1.13476e+07;0;0;0;0;0;0;606537129;607857246;11342438
985;8.16237e-15;-147;1711;20808;15570.1;1;556;-2.14748e+09;-1.13046e+07;-1;0;0;0;-1;0;607363015;608695501;11421378
986;8.16237e-15;-147;1711;20808;15570.1;1;556;-2.14748e+09;-1.12619e+07;0;0;-1;0;0;-1;608186348;609531273;11500511
987;8.16237e-15;-148;1711;20808;15570.1;1;556;-2.14748e+09;-1.12194e+07;0;0;0;0;0;0;609007140;610364571;11579834
988;8.16237e-15;-149;1711;20808;15570.1;1;556;-2.14748e+09;-1.11772e+07;0;0;0;0;0;0;609825403;611195408;11659347
989;8.16237e-15;-149;1711;20808;15570.1;1;556;-2.14748e+09;-1.11352e+07;-1;0;0;0;-1;0;610641148;612023795;11739047
990;8.16237e-15;-150;1711;20808;15570.1;1;556;-2.14748e+09;-1.10935e+07;0;0;0;0;0;0;611454385;612849742;11818935
991;8.16237e-15;-150;1711;20808;15570.1;1;556;-2.14748e+09;-1.10521e+07;-1;0;0;0;-1;0;612265126;613673261;11899008
992;8.16237e-15;-150;1711;20808;15570.1;1;556;-2.14748e+09;-1.10109e+07;-1;0;0;0;-1;0;613073382;614494362;11979265
993;8.16237e-15;-150;1711;20808;15570.1;1;556;-2.14748e+09;-1.09699e+07;-1;0;0;0;-1;0;613879163;615313057;12059704
994;8.16237e-15;-150;1711;20808;15570.1;1;556;-2.14748e+09;-1.09292e+07;-1;0;0;0;-1;0;614682481;616129356;12140326
995;8.16237e-15;-150;1711;20808;15570.1;1;556;-2.14748e+09;-1.08888e+07;-1;0;0;0;-1;0;615483345;616943270;12221127
996;8.16237e-15;-151;1711;20808;15570.1;1;556;-2.14748e+09;-1.08486e+07;0;0;0;0;0;0;616281768;617754809;12302108
997;8.16237e-15;-151;1711;20808;15570.1;1;556;-2.14748e+09;-1.08086e+07;-1;0;0;0;-1;0;617077758;618563985;12383266
998;8.16237e-15;-152;1711;20808;15570.1;1;556;-2.14748e+09;-1.07688e+07;0;0;0;0;0;0;617871328;619370807;12464600
999;8.16237e-15;-153;1711;20808;15570.1;1;556;-2.14748e+09;-1.07293e+07;0;0;0;0;0;0;618662487;620175287;12546110
1000;8.16237e-15;-154;1711;20808;15570.1;1;556;-2.14748e+09;-1.069e+07;0;0;0;0;0;0;619451246;620977435;12627793
1001;8.16237e-15;-155;1711;20808;15570.1;1;556;-2.14748e+09;-1.0651e+07;0;0;0;0;0;0;620237615;621777261;12709649
1002;8.16237e-15;-156;1711;20808;15570.1;1;556;-2.14748e+09;-1.06122e+07;0;0;0;0;0;0;621021604;622574775;12791676
1003;8.16237e-15;-156;1711;20808;15570.1;1;556;-2.14748e+09;-1.05736e+07;-1;0;0;0;-1;0;621803225;623369987;12873873
1004;8.16237e-15;-157;1711;20808;15570.1;1;556;-2.14748e+09;-1.05352e+07;0;0;0;0;0;0;622582486;624162908;12956239
1005;8.16237e-15;-157;1711;20808;15570.1;1;556;-2.14748e+09;-1.04971e+07;-1;0;0;0;-1;0;623359398;624953549;13038772
1006;8.16237e-15;-157;1711;20808;15570.1;1;556;-2.14748e+09;-1.04592e+07;-1;0;0;0;-1;0;624133972;625741918;13121471
1007;8.16237e-15;-157;1711;20808;15570.1;1;556;-2.14748e+09;-1.04215e+07;-1;0;0;0;-1;0;624906216;626528026;13204334
1008;8.16237e-15;-158;1711;20808;15570.1;1;556;-2.14748e+09;-1.0384e+07;0;0;0;0;0;0;625676142;627311882;13287362
1009;8.16237e-15;-159;1711;20808;15570.1;1;556;-2.14748e+09;-1.03467e+07;0;0;0;0;0;0;626443759;628093498;13370552
1010;8.16237e-15;-159;1711;20808;15570.1;1;556;-2.14748e+09;-1.03096e+07;-1;0;0;0;-1;0;627209076;628872882;13453902
1011;8.16237e-15;-160;1711;20808;15570.1;1;556;-2.14748e+09;-1.02728e+07;0;0;0;0;0;0;627972104;629650044;13537413
1012;8.16237e-15;-160;1711;20808;15570.1;1;556;-2.14748e+09;-1.02362e+07;-1;0;0;0;-1;0;628732853;630424994;13621081
1013;8.16237e-15;-161;1711;20808;15570.1;1;556;-2.14748e+09;-1.01998e+07;0;0;0;0;0;0;629491331;631197741;13704908
1014;8.16237e-15;-161;1711;20808;15570.1;1;556;-2.14748e+09;-1.01635e+07;-1;0;0;0;-1;0;630247549;631968296;13788890
1015;8.16237e-15;-162;1711;20808;15570.1;1;556;-2.14748e+09;-1.01275e+07;0;0;0;0;0;0;631001516;632736667;13873026
1016;8.16237e-15;-163;1711;20808;15570.1;1;556;-2.14748e+09;-1.00917e+07;0;0;0;0;0;0;631753242;633502865;13957316
1017;8.16237e-15;-164;1711;20808;15570.1;1;556;-2.14748e+09;-1.00561e+07;0;0;0;0;0;0;632502735;634266897;14041759
1018;8.16237e-15;-164;1711;20808;15570.1;1;556;-2.14748e+09;-1.00207e+07;-1;0;0;0;-1;0;633250006;635028775;14126352
1019;8.16237e-15;-164;1711;20808;15570.1;1;556;-2.14748e+09;-9.98552e+06;-1;0;0;0;-1;0;633995064;635788507;14211095
1020;8.16237e-15;-165;1711;20808;15570.1;1;556;-2.14748e+09;-9.95051e+06;0;0;0;0;0;0;634737918;636546102;14295987
1021;8.16237e-15;-165;1711;20808;15570.1;1;556;-2.14748e+09;-9.9157e+06;-1;0;0;0;-1;0;635478577;637301570;14381025
1022;8.16237e-15;-166;1711;20808;15570.1;1;556;-2.14748e+09;-9.88108e+06;0;0;0;0;0;0;636217051;638054919;14466210
1023;8.16237e-15;-167;1711;20808;15570.1;1;556;-2.14748e+09;-9.84666e+06;0;0;0;0;0;0;636953348;638806159;14551539
1024;8.16237e-15;-167;1711;20808;15570.1;1;556;-2.14748e+09;-9.81242e+06;-1;0;0;0;-1;0;637687478;639555299;14637012
1025;8.16237e-15;-168;1711;20808;15570.1;1;556;-2.14748e+09;-9.77838e+06;0;0;0;0;0;0;638419449;640302347;14722628
1026;8.16237e-15;-168;1711;20808;15570.1;1;556;-2.14748e+09;-9.74452e+06;-1;0;0;0;-1;0;639149271;641047313;14808384
1027;8.16237e-15;-169;1711;20808;15570.1;1;556;-2.14748e+09;-9.71085e+06;0;0;0;0;0;0;639876953;641790205;14894280
1028;8.16237e-15;-170;1711;20808;15570.1;1;556;-2.14748e+09;-9.67736e+06;0;0;0;0;0;0;640602503;642531033;14980315
1029;8.16237e-15;-171;1711;20808;15570.1;1;556;-2.14748e+09;-9.64406e+06;0;0;0;0;0;0;641325930;643269805;15066487
1030;8.16237e-15;-172;1711;20808;15570.1;1;556;-2.14748e+09;-9.61094e+06;0;0;0;0;0;0;642047243;644006529;15152796
1031;8.16237e-15;-172;1711;20808;15570.1;1;556;-2.14748e+09;-9.578e+06;-1;0;0;0;-1;0;642766450;644741215;15239239
1032;8.16237e-15;-173;1711;20808;15570.1;1;556;-2.14748e+09;-9.54524e+06;0;0;0;0;0;0;643483561;645473871;15325816
1033;8.16237e-15;-173;1711;20808;15570.1;1;556;-2.14748e+09;-9.51266e+06;-1;0;0;0;-1;0;644198584;646204505;15412526
1034;8.16237e-15;-173;1711;20808;15570.1;1;556;-2.14748e+09;-9.48025e+06;-1;0;0;0;-1;0;644911527;646933126;15499367
1035;8.16237e-15;-173;1711;20808;15570.1;1;556;-2.14748e+09;-9.44802e+06;-1;0;0;0;-1;0;645622399;647659743;15586339
1036;8.16237e-15;-174;1711;20808;15570.1;1;556;-2.14748e+09;-9.41596e+06;0;0;0;0;0;0;646331209;648384363;15673439
1037;8.16237e-15;-175;1711;20808;15570.1;1;556;-2.14748e+09;-9.38407e+06;0;0;0;0;0;0;647037964;649106996;15760667
1038;8.16237e-15;-176;1711;20808;15570.1;1;556;-2.14748e+09;-9.35236e+06;0;0;0;0;0;0;647742674;649827649;15848022
1039;8.16237e-15;-177;1711;20808;15570.1;1;556;-2.14748e+09;-9.32081e+06;0;0;0;0;0;0;648445346;650546331;15935502
1040;8.16237e-15;-178;1711;20808;15570.1;1;556;-2.14748e+09;-9.28943e+06;0;0;0;0;0;0;649145989;651263049;16023107
1041;8.16237e-15;-178;1711;20808;15570.1;1;556;-2.14748e+09;-9.25822e+06;-1;0;0;0;-1;0;649844611;651977813;16110834
1042;8.16237e-15;-179;1711;20808;15570.1;1;556;-2.14748e+09;-9.22718e+06;0;0;0;0;0;0;650541220;652690630;16198683
1043;8.16237e-15;-179;1711;20808;15570.1;1;556;-2.14748e+09;-9.1963e+06;-1;0;0;0;-1;0;651235824;653401508;16286654
1044;8.16237e-15;-180;1711;20808;15570.1;1;556;-2.14748e+09;-9.16558e+06;0;0;0;0;0;0;651928432;654110456;16374743
1045;8.16237e-15;-181;1711;20808;15570.1;1;556;-2.14748e+09;-9.13502e+06;0;0;0;0;0;0;652619051;654817480;16462951
1046;8.16237e-15;-181;1711;20808;15570.1;1;556;-2.14748e+09;-9.10463e+06;-1;0;0;0;-1;0;653307690;655522590;16551277
1047;8.16237e-15;-181;1711;20808;15570.1;1;556;-2.14748e+09;-9.07439e+06;-1;0;0;0;-1;0;653994356;656225793;16639718
1048;8.16237e-15;-181;1711;20808;15570.1;1;556;-2.14748e+09;-9.04431e+06;-1;0;0;0;-1;0;654679058;656927096;16728275
1049;8.16237e-15;-181;1711;20808;15570.1;1;556;-2.14748e+09;-9.01439e+06;-1;0;0;0;-1;0;655361803;657626508;16816945
1050;8.16237e-15;-182;1711;20808;15570.1;1;556;-2.14748e+09;-8.98462e+06;0;0;0;0;0;0;656042598;658324037;16905728
1051;8.16237e-15;-183;1711;20808;15570.1;1;556;-2.14748e+09;-8.95501e+06;0;0;0;0;0;0;656721453;659019689;16994622
1052;8.16237e-15;-184;1711;20808;15570.1;1;556;-2.14748e+09;-8.92556e+06;0;0;0;0;0;0;657398374;659713473;17083627
1053;8.16237e-15;-185;1711;20808;15570.1;1;556;-2.14748e+09;-8.89625e+06;0;0;0;0;0;0;658073369;660405397;17172740
1054;8.16237e-15;-186;1711;20808;15570.1;1;556;-2.14748e+09;-8.8671e+06;0;0;0;0;0;0;658746446;661095467;17261962
1055;8.16237e-15;-187;1711;20808;15570.1;1;556;-2.14748e+09;-8.83809e+06;0;0;0;0;0;0;659417613;661783692;17351291
1056;8.16237e-15;-187;1711;20808;15570.1;1;556;-2.14748e+09;-8.80924e+06;-1;0;0;0;-1;0;660086876;662470078;17440726
1057;8.16237e-15;-187;1711;20808;15570.1;1;556;-2.14748e+09;-8.78053e+06;-1;0;0;0;-1;0;660754244;663154634;17530266
1058;8.16237e-15;-188;1711;20808;15570.1;1;556;-2.14748e+09;-8.75197e+06;0;0;0;0;0;0;661419724;663837366;17619909
1059;8.16237e-15;-189;1711;20808;15570.1;1;556;-2.14748e+09;-8.72355e+06;0;0;0;0;0;0;662083324;664518282;17709654
1060;8.16237e-15;-190;1711;20808;15570.1;1;556;-2.14748e+09;-8.69528e+06;0;0;0;0;0;0;662745050;665197389;17799501
1061;8.16237e-15;-190;1711;20808;15570.1;1;556;-2.14748e+09;-8.66715e+06;-1;0;0;0;-1;0;663404911;665874696;17889449
1062;8.16237e-15;-190;1711;20808;15570.1;1;556;-2.14748e+09;-8.63917e+06;-1;0;0;0;-1;0;664062913;666550207;17979495
1063;8.16237e-15;-190;1711;20808;15570.1;1;556;-2.14748e+09;-8.61132e+06;-1;0;0;0;-1;0;664719064;667223932;18069640
1064;8.16237e-15;-190;1711;20808;15570.1;1;556;-2.14748e+09;-8.58362e+06;-1;0;0;0;-1;0;665373371;667895877;18159881
1065;8.16237e-15;-191;1711;20808;15570.1;1;556;-2.14748e+09;-8.55606e+06;0;0;0;0;0;0;666025842;668566049;18250218
1066;8.16237e-15;-191;1711;20808;15570.1;1;556;-2.14748e+09;-8.52863e+06;-1;0;0;0;-1;0;666676483;669234455;18340651
1067;8.16237e-15;-192;1711;20808;15570.1;1;556;-2.14748e+09;-8.50134e+06;0;0;0;0;0;0;667325301;669901102;18431177
1068;8.16237e-15;-193;1711;20808;15570.1;1;556;-2.14748e+09;-8.47419e+06;0;0;0;0;0;0;667972304;670565997;18521795
1069;8.16237e-15;-193;1711;20808;15570.1;1;556;-2.14748e+09;-8.44717e+06;-1;0;0;0;-1;0;668617498;671229148;18612505
1070;8.16237e-15;-193;1711;20808;15570.1;1;556;-2.14748e+09;-8.42028e+06;-1;0;0;0;-1;0;669260892;671890561;18703306
1071;8.16237e-15;-193;1711;20808;15570.1;1;556;-2.14748e+09;-8.39354e+06;-1;0;0;0;-1;0;669902490;672550242;18794196
1072;8.16237e-15;-194;1711;20808;15570.1;1;556;-2.14748e+09;-8.36692e+06;0;0;0;0;0;0;670542302;673208199;18885175
1073;8.16237e-15;-194;1711;20808;15570.1;1;556;-2.14748e+09;-8.34043e+06;-1;0;0;0;-1;0;671180333;673864439;18976240
1074;8.16237e-15;-195;1711;20808;15570.1;1;556;-2.14748e+09;-8.31407e+06;0;0;0;0;0;0;671816590;674518968;19067392
1075;8.16237e-15;-195;1711;20808;15570.1;1;556;-2.14748e+09;-8.28785e+06;-1;0;0;0;-1;0;672451080;675171793;19158630
1076;8.16237e-15;-196;1711;20808;15570.1;1;556;-2.14748e+09;-8.26175e+06;0;0;0;0;0;0;673083811;675822920;19249951
1077;8.16237e-15;-196;1711;20808;15570.1;1;556;-2.14748e+09;-8.23578e+06;-1;0;0;0;-1;0;673714788;676472357;19341356
1078;8.16237e-15;-197;1711;20808;15570.1;1;556;-2.14748e+09;-8.20994e+06;0;0;0;0;0;0;674344018;677120109;19432842
1079;8.16237e-15;-197;1711;20808;15570.1;1;556;-2.14748e+09;-8.18422e+06;-1;0;0;0;-1;0;674971508;677766184;19524410
1080;8.16237e-15;-198;1711;20808;15570.1;1;556;-2.14748e+09;-8.15862e+06;0;0;0;0;0;0;675597265;678410588;19616058
1081;8.16237e-15;-199;1711;20808;15570.1;1;556;-2.14748e+09;-8.13316e+06;0;0;0;0;0;0;676221296;679053327;19707784
1082;8.16237e-15;-199;1711;20808;15570.1;1;556;-2.14748e+09;-8.10781e+06;-1;0;0;0;-1;0;676843606;679694408;19799589
1083;8.16237e-15;-199;1711;20808;15570.1;1;556;-2.14748e+09;-8.08259e+06;-1;0;0;0;-1;0;677464202;680333837;19891470
1084;8.16237e-15;-200;1711;20808;15570.1;1;556;-2.14748e+09;-8.05748e+06;0;0;0;0;0;0;678083092;680971621;19983428
1085;8.16237e-15;-200;1711;20808;15570.1;1;556;-2.14748e+09;-8.0325e+06;-1;0;0;0;-1;0;678700281;681607765;20075460
1086;8.16237e-15;-200;1711;20808;15570.1;1;556;-2.14748e+09;-8.00764e+06;-1;0;0;0;-1;0;679315775;682242277;20167566
1087;8.16237e-15;-201;1711;20808;15570.1;1;556;-2.14748e+09;-7.9829e+06;0;0;0;0;0;0;679929582;682875162;20259745
1088;8.16237e-15;-201;1711;20808;15570.1;1;556;-2.14748e+09;-7.95827e+06;-1;0;0;0;-1;0;680541707;683506427;20351996
1089;8.16237e-15;-202;1711;20808;15570.1;1;556;-2.14748e+09;-7.93376e+06;0;0;0;0;0;0;681152157;684136078;20444318
1090;8.16237e-15;-202;1711;20808;15570.1;1;556;-2.14748e+09;-7.90937e+06;-1;0;0;0;-1;0;681760939;684764121;20536710
1091;8.16237e-15;-203;1711;20808;15570.1;1;556;-2.14748e+09;-7.8851e+06;0;0;0;0;0;0;682368057;685390563;20629171
1092;8.16237e-15;-204;1711;20808;15570.1;1;556;-2.14748e+09;-7.86094e+06;0;0;0;0;0;0;682973520;686015408;20721700
1093;8.16237e-15;-204;1711;20808;15570.1;1;556;-2.14748e+09;-7.83689e+06;-1;0;0;0;-1;0;683577332;686638664;20814295
1094;8.16237e-15;-204;1711;20808;15570.1;1;556;-2.14748e+09;-7.81296e+06;-1;0;0;0;-1;0;684179500;687260337;20906957
1095;8.16237e-15;-204;1711;20808;15570.1;1;556;-2.14748e+09;-7.78914e+06;-1;0;0;0;-1;0;684780030;687880432;20999684
1096;8.16237e-15;-204;1711;20808;15570.1;1;556;-2.14748e+09;-7.76543e+06;-1;0;0;0;-1;0;685378929;688498955;21092474
1097;8.16237e-15;-204;1711;20808;15570.1;1;556;-2.14748e+09;-7.74183e+06;0;0;-1;0;0;-1;685976202;689115912;21185328
1098;8.16237e-15;-204;1711;20808;15570.1;1;556;-2.14748e+09;-7.71834e+06;-1;0;0;0;-1;0;686571855;689731310;21278244
1099;8.16237e-15;-204;1711;20808;15570.1;1;556;-2.14748e+09;-7.69496e+06;-1;0;0;0;-1;0;687165894;690345154;21371221
1100;8.16237e-15;-205;1711;20808;15570.1;1;556;-2.14748e+09;-7.67169e+06;0;0;0;0;0;0;687758326;690957450;21464258
1101;8.16237e-15;-205;1711;20808;15570.1;1;556;-2.14748e+09;-7.64853e+06;-1;0;0;0;-1;0;688349156;691568203;21557354
1102;8.16237e-15;-206;1711;20808;15570.1;1;556;-2.14748e+09;-7.62547e+06;0;0;0;0;0;0;688938391;692177420;21650509
1103;8.16237e-15;-207;1711;20808;15570.1;1;556;-2.14748e+09;-7.60252e+06;0;0;0;0;0;0;689526035;692785106;21743721
1104;8.16237e-15;-207;1711;20808;15570.1;1;556;-2.14748e+09;-7.57968e+06;-1;0;0;0;-1;0;690112095;693391267;21836990
1105;8.16237e-15;-207;1711;20808;15570.1;1;556;-2.14748e+09;-7.55694e+06;-1;0;0;0;-1;0;690696577;693995908;21930314
1106;8.16237e-15;-208;1711;20808;15570.1;1;556;-2.14748e+09;-7.53431e+06;0;0;0;0;0;0;691279486;694599036;22023692
1107;8.16237e-15;-209;1711;20808;15570.1;1;556;-2.14748e+09;-7.51178e+06;0;0;0;0;0;0;691860829;695200656;22117124
1108;8.16237e-15;-209;1711;20808;15570.1;1;556;-2.14748e+09;-7.48936e+06;-1;0;0;0;-1;0;692440611;695800773;22210609
1109;8.16237e-15;-209;1711;20808;15570.1;1;556;-2.14748e+09;-7.46703e+06;-1;0;0;0;-1;0;693018837;696399393;22304146
1110;8.16237e-15;-209;1711;20808;15570.1;1;556;-2.14748e+09;-7.44481e+06;-1;0;0;0;-1;0;693595514;696996522;22397734
1111;8.16237e-15;-209;1711;20808;15570.1;1;556;-2.14748e+09;-7.42269e+06;-1;0;0;0;-1;0;694170647;697592165;22491371
1112;8.16237e-15;-210;1711;20808;15570.1;1;556;-2.14748e+09;-7.40066e+06;0;0;0;0;0;0;694744242;698186327;22585058
1113;8.16237e-15;-211;1711;20808;15570.1;1;556;-2.14748e+09;-7.37874e+06;0;0;0;0;0;0;695316303;698779014;22678793
1114;8.16237e-15;-211;1711;20808;15570.1;1;556;-2.14748e+09;-7.35692e+06;-1;0;0;0;-1;0;695886838;699370232;22772575
1115;8.16237e-15;-212;1711;20808;15570.1;1;556;-2.14748e+09;-7.33519e+06;0;0;0;0;0;0;696455851;699959985;22866404
1116;8.16237e-15;-212;1711;20808;15570.1;1;556;-2.14748e+09;-7.31357e+06;-1;0;0;0;-1;0;697023348;700548279;22960278
1117;8.16237e-15;-212;1711;20808;15570.1;1;556;-2.14748e+09;-7.29204e+06;-1;0;0;0;-1;0;697589334;701135120;23054196
1118;8.16237e-15;-213;1711;20808;15570.1;1;556;-2.14748e+09;-7.2706e+06;0;0;0;0;0;0;698153814;701720512;23148159
1119;8.16237e-15;-213;1711;20808;15570.1;1;556;-2.14748e+09;-7.24926e+06;-1;0;0;0;-1;0;698716795;702304462;23242164
1120;8.16237e-15;-213;1711;20808;15570.1;1;556;-2.14748e+09;-7.22802e+06;-1;0;0;0;-1;0;699278282;702886973;23336211
1121;8.16237e-15;-213;1711;20808;15570.1;1;556;-2.14748e+09;-7.20687e+06;-1;0;0;0;-1;0;699838279;703468052;23430300
1122;8.16237e-15;-214;1711;20808;15570.1;1;556;-2.14748e+09;-7.18581e+06;0;0;0;0;0;0;700396793;704047704;23524428
1123;8.16237e-15;-215;1711;20808;15570.1;1;556;-2.14748e+09;-7.16485e+06;0;0;0;0;0;0;700953828;704625933;23618596
1124;8.16237e-15;-216;1711;20808;15570.1;1;556;-2.14748e+09;-7.14398e+06;0;0;0;0;0;0;701509390;705202745;23712803
1125;8.16237e-15;-217;1711;20808;15570.1;1;556;-2.14748e+09;-7.12321e+06;0;0;0;0;0;0;702063484;705778145;23807047
1126;8.16237e-15;-218;1711;20808;15570.1;1;556;-2.14748e+09;-7.10252e+06;0;0;0;0;0;0;702616116;706352139;23901328
1127;8.16237e-15;-219;1711;20808;15570.1;1;556;-2.14748e+09;-7.08193e+06;0;0;0;0;0;0;703167290;706924730;23995645
1128;8.16237e-15;-219;1711;20808;15570.1;1;556;-2.14748e+09;-7.06142e+06;-1;0;0;0;-1;0;703717012;707495924;24089997
1129;8.16237e-15;-220;1711;20808;15570.1;1;556;-2.14748e+09;-7.04101e+06;0;0;0;0;0;0;704265286;708065727;24184383
1130;8.16237e-15;-220;1711;20808;15570.1;1;556;-2.14748e+09;-7.02068e+06;-1;0;0;0;-1;0;704812119;708634142;24278803
1131;8.16237e-15;-221;1711;20808;15570.1;1;556;-2.14748e+09;-7.00044e+06;0;0;0;0;0;0;705357515;709201176;24373256
1132;8.16237e-15;-222;1711;20808;15570.1;1;556;-2.14748e+09;-6.98029e+06;0;0;0;0;0;0;705901479;709766832;24467740
1133;8.16237e-15;-222;1711;20808;15570.1;1;556;-2.14748e+09;-6.96023e+06;-1;0;0;0;-1;0;706444016;710331117;24562255
1134;8.16237e-15;-223;1711;20808;15570.1;1;556;-2.14748e+09;-6.94026e+06;0;0;0;0;0;0;706985132;710894033;24656801
1135;8.16237e-15;-223;1711;20808;15570.1;1;556;-2.14748e+09;-6.92037e+06;-1;0;0;0;-1;0;707524831;711455588;24751375
1136;8.16237e-15;-223;1711;20808;15570.1;1;556;-2.14748e+09;-6.90056e+06;-1;0;0;0;-1;0;708063118;712015785;24845979
1137;8.16237e-15;-224;1711;20808;15570.1;1;556;-2.14748e+09;-6.88085e+06;0;0;0;0;0;0;708599998;712574629;24940610
1138;8.16237e-15;-224;1711;20808;15570.1;1;556;-2.14748e+09;-6.86121e+06;-1;0;0;0;-1;0;709135477;713132125;25035268
1139;8.16237e-15;-224;1711;20808;15570.1;1;556;-2.14748e+09;-6.84166e+06;-1;0;0;0;-1;0;709669559;713688277;25129952
1140;8.16237e-15;-224;1711;20808;15570.1;1;556;-2.14748e+09;-6.8222e+06;-1;0;0;0;-1;0;710202248;714243091;25224661
1141;8.16237e-15;-225;1711;20808;15570.1;1;556;-2.14748e+09;-6.80282e+06;0;0;0;0;0;0;710733550;714796570;25319395
1142;8.16237e-15;-225;1711;20808;15570.1;1;556;-2.14748e+09;-6.78352e+06;-1;0;0;0;-1;0;711263470;715348721;25414153
1143;8.16237e-15;-226;1711;20808;15570.1;1;556;-2.14748e+09;-6.7643e+06;0;0;0;0;0;0;711792013;715899547;25508934
1144;8.16237e-15;-227;1711;20808;15570.1;1;556;-2.14748e+09;-6.74516e+06;0;0;0;0;0;0;712319182;716449053;25603737
1145;8.16237e-15;-227;1711;20808;15570.1;1;556;-2.14748e+09;-6.72611e+06;-1;0;0;0;-1;0;712844984;716997243;25698561
1146;8.16237e-15;-228;1711;20808;15570.1;1;556;-2.14748e+09;-6.70713e+06;0;0;0;0;0;0;713369423;717544123;25793406
1147;8.16237e-15;-229;1711;20808;15570.1;1;556;-2.14748e+09;-6.68824e+06;0;0;0;0;0;0;713892502;718089696;25888271
1148;8.16237e-15;-230;1711;20808;15570.1;1;556;-2.14748e+09;-6.66942e+06;0;0;0;0;0;0;714414229;718633967;25983155
1149;8.16237e-15;-230;1711;20808;15570.1;1;556;-2.14748e+09;-6.65069e+06;-1;0;0;0;-1;0;714934605;719176941;26078057
1150;8.16237e-15;-230;1711;20808;15570.1;1;556;-2.14748e+09;-6.63203e+06;-1;0;0;0;-1;0;715453638;719718623;26172977
1151;8.16237e-15;-231;1711;20808;15570.1;1;556;-2.14748e+09;-6.61345e+06;0;0;0;0;0;0;715971330;720259016;26267914
1152;8.16237e-15;-231;1711;20808;15570.1;1;556;-2.14748e+09;-6.59495e+06;-1;0;0;0;-1;0;716487687;720798125;26362867
1153;8.16237e-15;-232;1711;20808;15570.1;1;556;-2.14748e+09;-6.57652e+06;0;0;0;0;0;0;717002714;721335954;26457835
1154;8.16237e-15;-232;1711;20808;15570.1;1;556;-2.14748e+09;-6.55818e+06;-1;0;0;0;-1;0;717516414;721872508;26552818
1155;8.16237e-15;-233;1711;20808;15570.1;1;556;-2.14748e+09;-6.5399e+06;0;0;0;0;0;0;718028793;722407792;26647814
1156;8.16237e-15;-233;1711;20808;15570.1;1;556;-2.14748e+09;-6.52171e+06;-1;0;0;0;-1;0;718539855;722941809;26742824
1157;8.16237e-15;-233;1711;20808;15570.1;1;556;-2.14748e+09;-6.50359e+06;-1;0;0;0;-1;0;719049604;723474564;26837846
1158;8.16237e-15;-233;1711;20808;15570.1;1;556;-2.14748e+09;-6.48554e+06;-1;0;0;0;-1;0;719558045;724006061;26932880
1159;8.16237e-15;-233;1711;20808;15570.1;1;556;-2.14748e+09;-6.46757e+06;-1;0;0;0;-1;0;720065182;724536305;27027924
1160;8.16237e-15;-233;1711;20808;15570.1;1;556;-2.14748e+09;-6.44967e+06;-1;0;0;0;-1;0;720571020;725065300;27122979
1161;8.16237e-15;-233;1711;20808;15570.1;1;556;-2.14748e+09;-6.43184e+06;-1;0;0;0;-1;0;721075563;725593049;27218044
1162;8.16237e-15;-233;1711;20808;15570.1;1;556;-2.14748e+09;-6.41409e+06;-1;0;0;0;-1;0;721578816;726119558;27313117
1163;8.16237e-15;-233;1711;20808;15570.1;1;556;-2.14748e+09;-6.39642e+06;-1;0;0;0;-1;0;722080783;726644830;27408198
1164;8.16237e-15;-233;1711;20808;15570.1;1;556;-2.14748e+09;-6.37881e+06;-1;0;0;0;-1;0;722581468;727168869;27503287
1165;8.16237e-15;-234;1711;20808;15570.1;1;556;-2.14748e+09;-6.36127e+06;0;0;0;0;0;0;723080876;727691680;27598382
1166;8.16237e-15;-234;1711;20808;15570.1;1;556;-2.14748e+09;-6.34381e+06;-1;0;0;0;-1;0;723579010;728213267;27693484
1167;8.16237e-15;-235;1711;20808;15570.1;1;556;-2.14748e+09;-6.32642e+06;0;0;0;0;0;0;724075876;728733634;27788590
1168;8.16237e-15;-235;1711;20808;15570.1;1;556;-2.14748e+09;-6.30909e+06;-1;0;0;0;-1;0;724571478;729252786;27883701
1169;8.16237e-15;-235;1711;20808;15570.1;1;556;-2.14748e+09;-6.29184e+06;-1;0;0;0;-1;0;725065819;729770725;27978817
1170;8.16237e-15;-235;1711;20808;15570.1;1;556;-2.14748e+09;-6.27466e+06;-1;0;0;0;-1;0;725558904;730287456;28073935
1171;8.16237e-15;-235;1711;20808;15570.1;1;556;-2.14748e+09;-6.25754e+06;-1;0;0;0;-1;0;726050738;730802984;28169056
1172;8.16237e-15;-235;1711;20808;15570.1;1;556;-2.14748e+09;-6.2405e+06;-1;0;0;0;-1;0;726541324;731317311;28264178
1173;8.16237e-15;-236;1711;20808;15570.1;1;556;-2.14748e+09;-6.22352e+06;0;0;0;0;0;0;727030666;731830443;28359302
1174;8.16237e-15;-236;1711;20808;15570.1;1;556;-2.14748e+09;-6.20661e+06;-1;0;0;0;-1;0;727518769;732342383;28454426
1175;8.16237e-15;-236;1711;20808;15570.1;1;556;-2.14748e+09;-6.18977e+06;-1;0;0;0;-1;0;728005637;732853135;28549551
1176;8.16237e-15;-236;1711;20808;15570.1;1;556;-2.14748e+09;-6.173e+06;-1;0;0;0;-1;0;728491274;733362703;28644674
1177;8.16237e-15;-237;1711;20808;15570.1;1;556;-2.14748e+09;-6.15629e+06;0;0;0;0;0;0;728975684;733871091;28739796
1178;8.16237e-15;-237;1711;20808;15570.1;1;556;-2.14748e+09;-6.13965e+06;-1;0;0;0;-1;0;729458871;734378303;28834916
1179;8.16237e-15;-238;1711;20808;15570.1;1;556;-2.14748e+09;-6.12307e+06;0;0;0;0;0;0;729940839;734884343;28930033
1180;8.16237e-15;-238;1711;20808;15570.1;1;556;-2.14748e+09;-6.10656e+06;-1;0;0;0;-1;0;730421593;735389214;29025146
1181;8.16237e-15;-238;1711;20808;15570.1;1;556;-2.14748e+09;-6.09012e+06;-1;0;0;0;-1;0;730901136;735892921;29120256
1182;8.16237e-15;-239;1711;20808;15570.1;1;556;-2.14748e+09;-6.07374e+06;0;0;0;0;0;0;731379471;736395466;29215360
1183;8.16237e-15;-239;1711;20808;15570.1;1;556;-2.14748e+09;-6.05743e+06;-1;0;0;0;-1;0;731856605;736896855;29310460
1184;8.16237e-15;-240;1711;20808;15570.1;1;556;-2.14748e+09;-6.04118e+06;0;0;0;0;0;0;732332539;737397091;29405553
1185;8.16237e-15;-241;1711;20808;15570.1;1;556;-2.14748e+09;-6.02499e+06;0;0;0;0;0;0;732807279;737896177;29500640
1186;8.16237e-15;-241;1711;20808;15570.1;1;556;-2.14748e+09;-6.00886e+06;-1;0;0;0;-1;0;733280827;738394117;29595719
1187;8.16237e-15;-241;1711;20808;15570.1;1;556;-2.14748e+09;-5.9928e+06;-1;0;0;0;-1;0;733753189;738890916;29690791
1188;8.16237e-15;-242;1711;20808;15570.1;1;556;-2.14748e+09;-5.97681e+06;0;0;0;0;0;0;734224367;739386576;29785854
1189;8.16237e-15;-243;1711;20808;15570.1;1;556;-2.14748e+09;-5.96087e+06;0;0;0;0;0;0;734694366;739881101;29880908
1190;8.16237e-15;-243;1711;20808;15570.1;1;556;-2.14748e+09;-5.945e+06;-1;0;0;0;-1;0;735163190;740374496;29975952
1191;8.16237e-15;-243;1711;20808;15570.1;1;556;-2.14748e+09;-5.92918e+06;-1;0;0;0;-1;0;735630842;740866764;30070986
1192;8.16237e-15;-243;1711;20808;15570.1;1;556;-2.14748e+09;-5.91343e+06;-1;0;0;0;-1;0;736097327;741357907;30166009
1193;8.16237e-15;-243;1711;20808;15570.1;1;556;-2.14748e+09;-5.89774e+06;-1;0;0;0;-1;0;736562647;741847931;30261021
1194;8.16237e-15;-243;1711;20808;15570.1;1;556;-2.14748e+09;-5.88211e+06;-1;0;0;0;-1;0;737026808;742336838;30356020
1195;8.16237e-15;-243;1711;20808;15570.1;1;556;-2.14748e+09;-5.86654e+06;-1;0;0;0;-1;0;737489812;742824633;30451006
1196;8.16237e-15;-244;1711;20808;15570.1;1;556;-2.14748e+09;-5.85103e+06;0;0;0;0;0;0;737951663;743311318;30545979
1197;8.16237e-15;-244;1711;20808;15570.1;1;556;-2.14748e+09;-5.83558e+06;-1;0;0;0;-1;0;738412366;743796898;30640939
1198;8.16237e-15;-245;1711;20808;15570.1;1;556;-2.14748e+09;-5.82019e+06;0;0;0;0;0;0;738871923;744281375;30735883
1199;8.16237e-15;-245;1711;20808;15570.1;1;556;-2.14748e+09;-5.80486e+06;-1;0;0;0;-1;0;739330339;744764754;30830813
1200;8.16237e-15;-246;1711;20808;15570.1;1;556;-2.14748e+09;-5.78959e+06;0;0;0;0;0;0;739787617;745247037;30925726
1201;8.16237e-15;-247;1711;20808;15570.1;1;556;-2.14748e+09;-5.77437e+06;0;0;0;0;0;0;740243761;745728229;31020624
1202;8.16237e-15;-248;1711;20808;15570.1;1;556;-2.14748e+09;-5.75921e+06;0;0;0;0;0;0;740698775;746208333;31115505
1203;8.16237e-15;-248;1711;20808;15570.1;1;556;-2.14748e+09;-5.74411e+06;-1;0;0;0;-1;0;741152661;746687352;31210368
1204;8.16237e-15;-249;1711;20808;15570.1;1;556;-2.14748e+09;-5.72907e+06;0;0;0;0;0;0;741605425;747165289;31305213
1205;8.16237e-15;-249;1711;20808;15570.1;1;556;-2.14748e+09;-5.71408e+06;-1;0;0;0;-1;0;742057069;747642149;31400040
1206;8.16237e-15;-249;1711;20808;15570.1;1;556;-2.14748e+09;-5.69915e+06;-1;0;0;0;-1;0;742507597;748117934;31494847
1207;8.16237e-15;-249;1711;20808;15570.1;1;556;-2.14748e+09;-5.68428e+06;-1;0;0;0;-1;0;742957013;748592648;31589635
1208;8.16237e-15;-250;1711;20808;15570.1;1;556;-2.14748e+09;-5.66946e+06;0;0;0;0;0;0;743405319;749066294;31684403
1209;8.16237e-15;-250;1711;20808;15570.1;1;556;-2.14748e+09;-5.6547e+06;-1;0;0;0;-1;0;743852521;749538876;31779150
1210;8.16237e-15;-251;1711;20808;15570.1;1;556;-2.14748e+09;-5.63999e+06;0;0;0;0;0;0;744298620;750010397;31873875
1211;8.16237e-15;-252;1711;20808;15570.1;1;556;-2.14748e+09;-5.62534e+06;0;0;0;0;0;0;744743622;750480860;31968579
1212;8.16237e-15;-252;1711;20808;15570.1;1;556;-2.14748e+09;-5.61074e+06;-1;0;0;0;-1;0;745187528;750950268;32063260
1213;8.16237e-15;-252;1711;20808;15570.1;1;556;-2.14748e+09;-5.5962e+06;-1;0;0;0;-1;0;745630344;751418626;32157918
1214;8.16237e-15;-252;1711;20808;15570.1;1;556;-2.14748e+09;-5.58171e+06;-1;0;0;0;-1;0;746072071;751885935;32252553
1215;8.16237e-15;-252;1711;20808;15570.1;1;556;-2.14748e+09;-5.56728e+06;-1;0;0;0;-1;0;746512714;752352200;32347164
1216;8.16237e-15;-253;1711;20808;15570.1;1;556;-2.14748e+09;-5.5529e+06;0;0;0;0;0;0;746952276;752817424;32441750
1217;8.16237e-15;-254;1711;20808;15570.1;1;556;-2.14748e+09;-5.53857e+06;0;0;0;0;0;0;747390761;753281609;32536311
1218;8.16237e-15;-255;1711;20808;15570.1;1;556;-2.14748e+09;-5.5243e+06;0;0;0;0;0;0;747828172;753744760;32630846
1219;8.16237e-15;-255;1711;20808;15570.1;1;556;-2.14748e+09;-5.51007e+06;-1;0;0;0;-1;0;748264511;754206878;32725356
1220;8.16237e-15;-256;1711;20808;15570.1;1;556;-2.14748e+09;-5.4959e+06;0;0;0;0;0;0;748699784;754667969;32819838
1221;8.16237e-15;-257;1711;20808;15570.1;1;556;-2.14748e+09;-5.48179e+06;0;0;0;0;0;0;749133992;755128034;32914294
1222;8.16237e-15;-257;1711;20808;15570.1;1;556;-2.14748e+09;-5.46772e+06;-1;0;0;0;-1;0;749567140;755587076;33008721
1223;8.16237e-15;-258;1711;20808;15570.1;1;556;-2.14748e+09;-5.45371e+06;0;0;0;0;0;0;749999230;756045100;33103121
1224;8.16237e-15;-259;1711;20808;15570.1;1;556;-2.14748e+09;-5.43974e+06;0;0;0;0;0;0;750430267;756502107;33197492
1225;8.16237e-15;-260;1711;20808;15570.1;1;556;-2.14748e+09;-5.42583e+06;0;0;0;0;0;0;750860253;756958102;33291833
1226;8.16237e-15;-260;1711;20808;15570.1;1;556;-2.14748e+09;-5.41197e+06;-1;0;0;0;-1;0;751289191;757413087;33386145
1227;8.16237e-15;-260;1711;20808;15570.1;1;556;-2.14748e+09;-5.39816e+06;-1;0;0;0;-1;0;751717085;757867066;33480427
1228;8.16237e-15;-261;1711;20808;15570.1;1;556;-2.14748e+09;-5.3844e+06;0;0;0;0;0;0;752143939;758320041;33574678
1229;8.16237e-15;-261;1711;20808;15570.1;1;556;-2.14748e+09;-5.37069e+06;-1;0;0;0;-1;0;752569755;758772015;33668898
1230;8.16237e-15;-262;1711;20808;15570.1;1;556;-2.14748e+09;-5.35702e+06;0;0;0;0;0;0;752994536;759222992;33763086
1231;8.16237e-15;-263;1711;20808;15570.1;1;556;-2.14748e+09;-5.34341e+06;0;0;0;0;0;0;753418286;759672975;33857242
1232;8.16237e-15;-264;1711;20808;15570.1;1;556;-2.14748e+09;-5.32985e+06;0;0;0;0;0;0;753841008;760121966;33951365
1233;8.16237e-15;-264;1711;20808;15570.1;1;556;-2.14748e+09;-5.31634e+06;-1;0;0;0;-1;0;754262706;760569968;34045455
1234;8.16237e-15;-265;1711;20808;15570.1;1;556;-2.14748e+09;-5.30287e+06;0;0;0;0;0;0;754683382;761016985;34139512
1235;8.16237e-15;-266;1711;20808;15570.1;1;556;-2.14748e+09;-5.28945e+06;0;0;0;0;0;0;755103039;761463020;34233534
1236;8.16237e-15;-267;1711;20808;15570.1;1;556;-2.14748e+09;-5.27608e+06;0;0;0;0;0;0;755521682;761908075;34327522
1237;8.16237e-15;-267;1711;20808;15570.1;1;556;-2.14748e+09;-5.26276e+06;-1;0;0;0;-1;0;755939312;762352154;34421475
1238;8.16237e-15;-268;1711;20808;15570.1;1;556;-2.14748e+09;-5.24949e+06;0;0;0;0;0;0;756355933;762795259;34515393
1239;8.16237e-15;-268;1711;20808;15570.1;1;556;-2.14748e+09;-5.23626e+06;-1;0;0;0;-1;0;756771548;763237393;34609274
1240;8.16237e-15;-269;1711;20808;15570.1;1;556;-2.14748e+09;-5.22308e+06;0;0;0;0;0;0;757186161;763678560;34703119
1241;8.16237e-15;-269;1711;20808;15570.1;1;556;-2.14748e+09;-5.20995e+06;-1;0;0;0;-1;0;757599773;764118761;34796927
1242;8.16237e-15;-269;1711;20808;15570.1;1;556;-2.14748e+09;-5.19686e+06;-1;0;0;0;-1;0;758012390;764558001;34890698
1243;8.16237e-15;-270;1711;20808;15570.1;1;556;-2.14748e+09;-5.18382e+06;0;0;0;0;0;0;758424012;764996281;34984431
1244;8.16237e-15;-270;1711;20808;15570.1;1;556;-2.14748e+09;-5.17083e+06;-1;0;0;0;-1;0;758834644;765433605;35078126
1245;8.16237e-15;-270;1711;20808;15570.1;1;556;-2.14748e+09;-5.15788e+06;-1;0;0;0;-1;0;759244289;765869976;35171783
1246;8.16237e-15;-270;1711;20808;15570.1;1;556;-2.14748e+09;-5.14498e+06;-1;0;0;0;-1;0;759652949;766305396;35265400
1247;8.16237e-15;-271;1711;20808;15570.1;1;556;-2.14748e+09;-5.13212e+06;0;0;0;0;0;0;760060627;766739868;35358977
1248;8.16237e-15;-272;1711;20808;15570.1;1;556;-2.14748e+09;-5.11931e+06;0;0;0;0;0;0;760467328;767173396;35452515
1249;8.16237e-15;-272;1711;20808;15570.1;1;556;-2.14748e+09;-5.10655e+06;-1;0;0;0;-1;0;760873052;767605981;35546012
1250;8.16237e-15;-272;1711;20808;15570.1;1;556;-2.14748e+09;-5.09382e+06;-1;0;0;0;-1;0;761277804;768037626;35639468
1251;8.16237e-15;-273;1711;20808;15570.1;1;556;-2.14748e+09;-5.08115e+06;0;0;0;0;0;0;761681587;768468335;35732884
1252;8.16237e-15;-274;1711;20808;15570.1;1;556;-2.14748e+09;-5.06852e+06;0;0;0;0;0;0;762084403;768898111;35826257
1253;8.16237e-15;-275;1711;20808;15570.1;1;556;-2.14748e+09;-5.05592e+06;0;0;0;0;0;0;762486256;769326955;35919588
1254;8.16237e-15;-276;1711;20808;15570.1;1;556;-2.14748e+09;-5.04338e+06;0;0;0;0;0;0;762887147;769754870;36012877
1255;8.16237e-15;-276;1711;20808;15570.1;1;556;-2.14748e+09;-5.03088e+06;-1;0;0;0;-1;0;763287081;770181860;36106123
1256;8.16237e-15;-276;1711;20808;15570.1;1;556;-2.14748e+09;-5.01842e+06;-1;0;0;0;-1;0;763686060;770607927;36199325
1257;8.16237e-15;-276;1711;20808;15570.1;1;556;-2.14748e+09;-5.006e+06;-1;0;0;0;-1;0;764084087;771033073;36292484
1258;8.16237e-15;-277;1711;20808;15570.1;1;556;-2.14748e+09;-4.99363e+06;0;0;0;0;0;0;764481165;771457302;36385598
1259;8.16237e-15;-277;1711;20808;15570.1;1;556;-2.14748e+09;-4.9813e+06;-1;0;0;0;-1;0;764877296;771880617;36478668
1260;8.16237e-15;-278;1711;20808;15570.1;1;556;-2.14748e+09;-4.96901e+06;0;0;0;0;0;0;765272484;772303018;36571692
1261;8.16237e-15;-279;1711;20808;15570.1;1;556;-2.14748e+09;-4.95677e+06;0;0;0;0;0;0;765666731;772724510;36664672
1262;8.16237e-15;-279;1711;20808;15570.1;1;556;-2.14748e+09;-4.94457e+06;-1;0;0;0;-1;0;766060041;773145096;36757605
1263;8.16237e-15;-279;1711;20808;15570.1;1;556;-2.14748e+09;-4.9324e+06;-1;0;0;0;-1;0;766452415;773564777;36850492
1264;8.16237e-15;-280;1711;20808;15570.1;1;556;-2.14748e+09;-4.92028e+06;0;0;0;0;0;0;766843858;773983556;36943333
1265;8.16237e-15;-280;1711;20808;15570.1;1;556;-2.14748e+09;-4.90821e+06;-1;0;0;0;-1;0;767234371;774401436;37036127
1266;8.16237e-15;-281;1711;20808;15570.1;1;556;-2.14748e+09;-4.89617e+06;0;0;0;0;0;0;767623957;774818419;37128873
1267;8.16237e-15;-282;1711;20808;15570.1;1;556;-2.14748e+09;-4.88417e+06;0;0;0;0;0;0;768012620;775234509;37221571
1268;8.16237e-15;-282;1711;20808;15570.1;1;556;-2.14748e+09;-4.87222e+06;-1;0;0;0;-1;0;768400361;775649707;37314221
1269;8.16237e-15;-282;1711;20808;15570.1;1;556;-2.14748e+09;-4.8603e+06;-1;0;0;0;-1;0;768787185;776064016;37406823
1270;8.16237e-15;-282;1711;20808;15570.1;1;556;-2.14748e+09;-4.84843e+06;-1;0;0;0;-1;0;769173092;776477439;37499376
1271;8.16237e-15;-283;1711;20808;15570.1;1;556;-2.14748e+09;-4.83659e+06;0;0;0;0;0;0;769558087;776889978;37591879
1272;8.16237e-15;-283;1711;20808;15570.1;1;556;-2.14748e+09;-4.8248e+06;-1;0;0;0;-1;0;769942172;777301636;37684333
1273;8.16237e-15;-283;1711;20808;15570.1;1;556;-2.14748e+09;-4.81304e+06;-1;0;0;0;-1;0;770325349;777712415;37776737
1274;8.16237e-15;-284;1711;20808;15570.1;1;556;-2.14748e+09;-4.80133e+06;0;0;0;0;0;0;770707622;778122319;37869090
1275;8.16237e-15;-285;1711;20808;15570.1;1;556;-2.14748e+09;-4.78965e+06;0;0;0;0;0;0;771088992;778531348;37961393
1276;8.16237e-15;-285;1711;20808;15570.1;1;556;-2.14748e+09;-4.77802e+06;-1;0;0;0;-1;0;771469464;778939506;38053644
1277;8.16237e-15;-285;1711;20808;15570.1;1;556;-2.14748e+09;-4.76642e+06;-1;0;0;0;-1;0;771849038;779346796;38145844
1278;8.16237e-15;-286;1711;20808;15570.1;1;556;-2.14748e+09;-4.75486e+06;0;0;0;0;0;0;772227718;779753219;38237992
1279;8.16237e-15;-286;1711;20808;15570.1;1;556;-2.14748e+09;-4.74334e+06;-1;0;0;0;-1;0;772605507;780158778;38330088
1280;8.16237e-15;-287;1711;20808;15570.1;1;556;-2.14748e+09;-4.73186e+06;0;0;0;0;0;0;772982407;780563476;38422131
1281;8.16237e-15;-287;1711;20808;15570.1;1;556;-2.14748e+09;-4.72042e+06;-1;0;0;0;-1;0;773358422;780967315;38514121
1282;8.16237e-15;-287;1711;20808;15570.1;1;556;-2.14748e+09;-4.70901e+06;-1;0;0;0;-1;0;773733552;781370298;38606058
1283;8.16237e-15;-287;1711;20808;15570.1;1;556;-2.14748e+09;-4.69764e+06;-1;0;0;0;-1;0;774107802;781772426;38697941
1284;8.16237e-15;-287;1711;20808;15570.1;1;556;-2.14748e+09;-4.68632e+06;-1;0;0;0;-1;0;774481173;782173703;38789771
1285;8.16237e-15;-288;1711;20808;15570.1;1;556;-2.14748e+09;-4.67502e+06;0;0;0;0;0;0;774853668;782574131;38881545
1286;8.16237e-15;-288;1711;20808;15570.1;1;556;-2.14748e+09;-4.66377e+06;-1;0;0;0;-1;0;775225290;782973711;38973266
1287;8.16237e-15;-289;1711;20808;15570.1;1;556;-2.14748e+09;-4.65255e+06;0;0;0;0;0;0;775596042;783372447;39064931
1288;8.16237e-15;-290;1711;20808;15570.1;1;556;-2.14748e+09;-4.64137e+06;0;0;0;0;0;0;775965925;783770341;39156541
1289;8.16237e-15;-291;1711;20808;15570.1;1;556;-2.14748e+09;-4.63022e+06;0;0;0;0;0;0;776334942;784167395;39248095
1290;8.16237e-15;-292;1711;20808;15570.1;1;556;-2.14748e+09;-4.61912e+06;0;0;0;0;0;0;776703097;784563611;39339593
1291;8.16237e-15;-293;1711;20808;15570.1;1;556;-2.14748e+09;-4.60805e+06;0;0;0;0;0;0;777070391;784958992;39431035
1292;8.16237e-15;-293;1711;20808;15570.1;1;556;-2.14748e+09;-4.59701e+06;-1;0;0;0;-1;0;777436827;785353541;39522420
1293;8.16237e-15;-293;1711;20808;15570.1;1;556;-2.14748e+09;-4.58601e+06;-1;0;0;0;-1;0;777802408;785747258;39613749
1294;8.16237e-15;-293;1711;20808;15570.1;1;556;-2.14748e+09;-4.57505e+06;-1;0;0;0;-1;0;778167135;786140148;39705019
1295;8.16237e-15;-293;1711;20808;15570.1;1;556;-2.14748e+09;-4.56412e+06;-1;0;0;0;-1;0;778531012;786532212;39796233
1296;8.16237e-15;-293;1711;20808;15570.1;1;556;-2.14748e+09;-4.55323e+06;-1;0;0;0;-1;0;778894041;786923452;39887388
1297;8.16237e-15;-293;1711;20808;15570.1;1;556;-2.14748e+09;-4.54238e+06;-1;0;0;0;-1;0;779256224;787313870;39978485
1298;8.16237e-15;-294;1711;20808;15570.1;1;556;-2.14748e+09;-4.53156e+06;0;0;0;0;0;0;779617564;787703470;40069523
1299;8.16237e-15;-295;1711;20808;15570.1;1;556;-2.14748e+09;-4.52077e+06;0;0;0;0;0;0;779978064;788092252;40160503
1300;8.16237e-15;-296;1711;20808;15570.1;1;556;-2.14748e+09;-4.51002e+06;0;0;0;0;0;0;780337724;788480220;40251423
1301;8.16237e-15;-296;1711;20808;15570.1;1;556;-2.14748e+09;-4.4993e+06;-1;0;0;0;-1;0;780696550;788867376;40342284
1302;8.16237e-15;-296;1711;20808;15570.1;1;556;-2.14748e+09;-4.48862e+06;-1;0;0;0;-1;0;781054541;789253721;40433085
1303;8.16237e-15;-296;1711;20808;15570.1;1;556;-2.14748e+09;-4.47798e+06;-1;0;0;0;-1;0;781411702;789639259;40523826
1304;8.16237e-15;-297;1711;20808;15570.1;1;556;-2.14748e+09;-4.46736e+06;0;0;0;0;0;0;781768033;790023991;40614507
1305;8.16237e-15;-298;1711;20808;15570.1;1;556;-2.14748e+09;-4.45678e+06;0;0;0;0;0;0;782123539;790407919;40705126
1306;8.16237e-15;-299;1711;20808;15570.1;1;556;-2.14748e+09;-4.44624e+06;0;0;0;0;0;0;782478220;790791046;40795685
1307;8.16237e-15;-300;1711;20808;15570.1;1;556;-2.14748e+09;-4.43573e+06;0;0;0;0;0;0;782832080;791173374;40886183
1308;8.16237e-15;-300;1711;20808;15570.1;1;556;-2.14748e+09;-4.42525e+06;-1;0;0;0;-1;0;783185121;791554905;40976618
1309;8.16237e-15;-301;1711;20808;15570.1;1;556;-2.14748e+09;-4.41481e+06;0;0;0;0;0;0;783537345;791935641;41066992
1310;8.16237e-15;-301;1711;20808;15570.1;1;556;-2.14748e+09;-4.4044e+06;-1;0;0;0;-1;0;783888754;792315585;41157304
1311;8.16237e-15;-301;1711;20808;15570.1;1;556;-2.14748e+09;-4.39402e+06;-1;0;0;0;-1;0;784239351;792694738;41247553
1312;8.16237e-15;-301;1711;20808;15570.1;1;556;-2.14748e+09;-4.38368e+06;-1;0;0;0;-1;0;784589139;793073102;41337740
1313;8.16237e-15;-302;1711;20808;15570.1;1;556;-2.14748e+09;-4.37336e+06;0;0;0;0;0;0;784938119;793450681;41427864
1314;8.16237e-15;-303;1711;20808;15570.1;1;556;-2.14748e+09;-4.36308e+06;0;0;0;0;0;0;785286293;793827475;41517924
1315;8.16237e-15;-304;1711;20808;15570.1;1;556;-2.14748e+09;-4.35284e+06;0;0;0;0;0;0;785633664;794203487;41607920
1316;8.16237e-15;-304;1711;20808;15570.1;1;556;-2.14748e+09;-4.34262e+06;-1;0;0;0;-1;0;785980235;794578720;41697853
1317;8.16237e-15;-304;1711;20808;15570.1;1;556;-2.14748e+09;-4.33244e+06;-1;0;0;0;-1;0;786326008;794953175;41787722
1318;8.16237e-15;-305;1711;20808;15570.1;1;556;-2.14748e+09;-4.32229e+06;0;0;0;0;0;0;786670984;795326854;41877526
1319;8.16237e-15;-305;1711;20808;15570.1;1;556;-2.14748e+09;-4.31218e+06;-1;0;0;0;-1;0;787015166;795699759;41967266
1320;8.16237e-15;-306;1711;20808;15570.1;1;556;-2.14748e+09;-4.30209e+06;0;0;0;0;0;0;787358557;796071893;42056940
1321;8.16237e-15;-307;1711;20808;15570.1;1;556;-2.14748e+09;-4.29204e+06;0;0;0;0;0;0;787701158;796443257;42146550
1322;8.16237e-15;-308;1711;20808;15570.1;1;556;-2.14748e+09;-4.28201e+06;0;0;0;0;0;0;788042973;796813854;42236094
1323;8.16237e-15;-308;1711;20808;15570.1;1;556;-2.14748e+09;-4.27202e+06;-1;0;0;0;-1;0;788384002;797183686;42325572
1324;8.16237e-15;-308;1711;20808;15570.1;1;556;-2.14748e+09;-4.26206e+06;-1;0;0;0;-1;0;788724249;797552754;42414984
1325;8.16237e-15;-309;1711;20808;15570.1;1;556;-2.14748e+09;-4.25213e+06;0;0;0;0;0;0;789063715;797921061;42504330
1326;8.16237e-15;-309;1711;20808;15570.1;1;556;-2.14748e+09;-4.24224e+06;-1;0;0;0;-1;0;789402403;798288609;42593610
1327;8.16237e-15;-310;1711;20808;15570.1;1;556;-2.14748e+09;-4.23237e+06;0;0;0;0;0;0;789740314;798655400;42682823
1328;8.16237e-15;-310;1711;20808;15570.1;1;556;-2.14748e+09;-4.22253e+06;-1;0;0;0;-1;0;790077452;799021435;42771969
1329;8.16237e-15;-310;1711;20808;15570.1;1;556;-2.14748e+09;-4.21272e+06;-1;0;0;0;-1;0;790413818;799386717;42861047
1330;8.16237e-15;-311;1711;20808;15570.1;1;556;-2.14748e+09;-4.20295e+06;0;0;0;0;0;0;790749415;799751248;42950058
1331;8.16237e-15;-312;1711;20808;15570.1;1;556;-2.14748e+09;-4.1932e+06;0;0;0;0;0;0;791084244;800115029;43039001
1332;8.16237e-15;-312;1711;20808;15570.1;1;556;-2.14748e+09;-4.18349e+06;-1;0;0;0;-1;0;791418307;800478064;43127877
1333;8.16237e-15;-312;1711;20808;15570.1;1;556;-2.14748e+09;-4.1738e+06;-1;0;0;0;-1;0;791751608;800840353;43216684
1334;8.16237e-15;-313;1711;20808;15570.1;1;556;-2.14748e+09;-4.16415e+06;0;0;0;0;0;0;792084148;801201898;43305422
1335;8.16237e-15;-314;1711;20808;15570.1;1;556;-2.14748e+09;-4.15452e+06;0;0;0;0;0;0;792415928;801562702;43394092
1336;8.16237e-15;-315;1711;20808;15570.1;1;556;-2.14748e+09;-4.14493e+06;0;0;0;0;0;0;792746952;801922767;43482693
1337;8.16237e-15;-316;1711;20808;15570.1;1;556;-2.14748e+09;-4.13536e+06;0;0;0;0;0;0;793077222;802282094;43571225
1338;8.16237e-15;-317;1711;20808;15570.1;1;556;-2.14748e+09;-4.12582e+06;0;0;0;0;0;0;793406739;802640686;43659687
1339;8.16237e-15;-318;1711;20808;15570.1;1;556;-2.14748e+09;-4.11631e+06;0;0;0;0;0;0;793735505;802998544;43748080
1340;8.16237e-15;-319;1711;20808;15570.1;1;556;-2.14748e+09;-4.10683e+06;0;0;0;0;0;0;794063524;803355670;43836403
1341;8.16237e-15;-319;1711;20808;15570.1;1;556;-2.14748e+09;-4.09738e+06;-1;0;0;0;-1;0;794390795;803712066;43924656
1342;8.16237e-15;-319;1711;20808;15570.1;1;556;-2.14748e+09;-4.08796e+06;-1;0;0;0;-1;0;794717323;804067735;44012838
1343;8.16237e-15;-320;1711;20808;15570.1;1;556;-2.14748e+09;-4.07857e+06;0;0;0;0;0;0;795043109;804422677;44100950
1344;8.16237e-15;-321;1711;20808;15570.1;1;556;-2.14748e+09;-4.0692e+06;0;0;0;0;0;0;795368154;804776895;44188991
1345;8.16237e-15;-322;1711;20808;15570.1;1;556;-2.14748e+09;-4.05987e+06;0;0;0;0;0;0;795692462;805130391;44276961
1346;8.16237e-15;-322;1711;20808;15570.1;1;556;-2.14748e+09;-4.05056e+06;-1;0;0;0;-1;0;796016033;805483167;44364860
1347;8.16237e-15;-323;1711;20808;15570.1;1;556;-2.14748e+09;-4.04128e+06;0;0;0;0;0;0;796338871;805835224;44452688
1348;8.16237e-15;-324;1711;20808;15570.1;1;556;-2.14748e+09;-4.03203e+06;0;0;0;0;0;0;796660977;806186564;44540444
1349;8.16237e-15;-325;1711;20808;15570.1;1;556;-2.14748e+09;-4.02281e+06;0;0;0;0;0;0;796982353;806537190;44628128
1350;8.16237e-15;-326;1711;20808;15570.1;1;556;-2.14748e+09;-4.01361e+06;0;0;0;0;0;0;797303001;806887102;44715740
1351;8.16237e-15;-327;1711;20808;15570.1;1;556;-2.14748e+09;-4.00444e+06;0;0;0;0;0;0;797622923;807236304;44803279
1352;8.16237e-15;-328;1711;20808;15570.1;1;556;-2.14748e+09;-3.9953e+06;0;0;0;0;0;0;797942121;807584796;44890746
1353;8.16237e-15;-329;1711;20808;15570.1;1;556;-2.14748e+09;-3.98619e+06;0;0;0;0;0;0;798260598;807932580;44978141
1354;8.16237e-15;-330;1711;20808;15570.1;1;556;-2.14748e+09;-3.9771e+06;0;0;0;0;0;0;798578354;808279659;45065463
1355;8.16237e-15;-330;1711;20808;15570.1;1;556;-2.14748e+09;-3.96805e+06;-1;0;0;0;-1;0;798895393;808626034;45152711
1356;8.16237e-15;-330;1711;20808;15570.1;1;556;-2.14748e+09;-3.95902e+06;-1;0;0;0;-1;0;799211715;808971707;45239887
1357;8.16237e-15;-331;1711;20808;15570.1;1;556;-2.14748e+09;-3.95001e+06;0;0;0;0;0;0;799527324;809316680;45326988
1358;8.16237e-15;-331;1711;20808;15570.1;1;556;-2.14748e+09;-3.94103e+06;-1;0;0;0;-1;0;799842221;809660954;45414017
1359;8.16237e-15;-331;1711;20808;15570.1;1;556;-2.14748e+09;-3.93208e+06;-1;0;0;0;-1;0;800156407;810004532;45500971
1360;8.16237e-15;-332;1711;20808;15570.1;1;556;-2.14748e+09;-3.92316e+06;0;0;0;0;0;0;800469886;810347415;45587851
1361;8.16237e-15;-333;1711;20808;15570.1;1;556;-2.14748e+09;-3.91426e+06;0;0;0;0;0;0;800782658;810689604;45674657
1362;8.16237e-15;-334;1711;20808;15570.1;1;556;-2.14748e+09;-3.90539e+06;0;0;0;0;0;0;801094726;811031102;45761388
1363;8.16237e-15;-334;1711;20808;15570.1;1;556;-2.14748e+09;-3.89655e+06;-1;0;0;0;-1;0;801406092;811371911;45848045
1364;8.16237e-15;-334;1711;20808;15570.1;1;556;-2.14748e+09;-3.88773e+06;-1;0;0;0;-1;0;801716757;811712031;45934627
1365;8.16237e-15;-334;1711;20808;15570.1;1;556;-2.14748e+09;-3.87894e+06;-1;0;0;0;-1;0;802026724;812051466;46021134
1366;8.16237e-15;-334;1711;20808;15570.1;1;556;-2.14748e+09;-3.87017e+06;-1;0;0;0;-1;0;802335994;812390216;46107566
1367;8.16237e-15;-335;1711;20808;15570.1;1;556;-2.14748e+09;-3.86143e+06;0;0;0;0;0;0;802644569;812728283;46193923
1368;8.16237e-15;-335;1711;20808;15570.1;1;556;-2.14748e+09;-3.85271e+06;-1;0;0;0;-1;0;802952452;813065670;46280203
1369;8.16237e-15;-335;1711;20808;15570.1;1;556;-2.14748e+09;-3.84402e+06;-1;0;0;0;-1;0;803259644;813402377;46366409
1370;8.16237e-15;-335;1711;20808;15570.1;1;556;-2.14748e+09;-3.83536e+06;-1;0;0;0;-1;0;803566146;813738407;46452538
1371;8.16237e-15;-336;1711;20808;15570.1;1;556;-2.14748e+09;-3.82672e+06;0;0;0;0;0;0;803871961;814073761;46538591
1372;8.16237e-15;-336;1711;20808;15570.1;1;556;-2.14748e+09;-3.81811e+06;-1;0;0;0;-1;0;804177091;814408441;46624568
1373;8.16237e-15;-336;1711;20808;15570.1;1;556;-2.14748e+09;-3.80952e+06;-1;0;0;0;-1;0;804481538;814742448;46710468
1374;8.16237e-15;-337;1711;20808;15570.1;1;556;-2.14748e+09;-3.80096e+06;0;0;0;0;0;0;804785302;815075785;46796292
1375;8.16237e-15;-338;1711;20808;15570.1;1;556;-2.14748e+09;-3.79242e+06;0;0;0;0;0;0;805088387;815408452;46882039
1376;8.16237e-15;-339;1711;20808;15570.1;1;556;-2.14748e+09;-3.7839e+06;0;0;0;0;0;0;805390794;815740452;46967709
1377;8.16237e-15;-339;1711;20808;15570.1;1;556;-2.14748e+09;-3.77542e+06;-1;0;0;0;-1;0;805692525;816071787;47053302
1378;8.16237e-15;-339;1711;20808;15570.1;1;556;-2.14748e+09;-3.76695e+06;-1;0;0;0;-1;0;805993581;816402457;47138818
1379;8.16237e-15;-339;1711;20808;15570.1;1;556;-2.14748e+09;-3.75851e+06;-1;0;0;0;-1;0;806293965;816732465;47224256
1380;8.16237e-15;-339;1711;20808;15570.1;1;556;-2.14748e+09;-3.7501e+06;-1;0;0;0;-1;0;806593678;817061813;47309617
1381;8.16237e-15;-339;1711;20808;15570.1;1;556;-2.14748e+09;-3.74171e+06;-1;0;0;0;-1;0;806892723;817390501;47394900
1382;8.16237e-15;-339;1711;20808;15570.1;1;556;-2.14748e+09;-3.73334e+06;-1;0;0;0;-1;0;807191100;817718532;47480104
1383;8.16237e-15;-339;1711;20808;15570.1;1;556;-2.14748e+09;-3.725e+06;-1;0;0;0;-1;0;807488812;818045907;47565231
1384;8.16237e-15;-339;1711;20808;15570.1;1;556;-2.14748e+09;-3.71668e+06;-1;0;0;0;-1;0;807785860;818372627;47650280
1385;8.16237e-15;-339;1711;20808;15570.1;1;556;-2.14748e+09;-3.70839e+06;-1;0;0;0;-1;0;808082247;818698695;47735250
1386;8.16237e-15;-339;1711;20808;15570.1;1;556;-2.14748e+09;-3.70012e+06;-1;0;0;0;-1;0;808377973;819024113;47820142
1387;8.16237e-15;-339;1711;20808;15570.1;1;556;-2.14748e+09;-3.69187e+06;-1;0;0;0;-1;0;808673042;819348880;47904955
1388;8.16237e-15;-340;1711;20808;15570.1;1;556;-2.14748e+09;-3.68365e+06;0;0;0;0;0;0;808967453;819673000;47989689
1389;8.16237e-15;-341;1711;20808;15570.1;1;556;-2.14748e+09;-3.67545e+06;0;0;0;0;0;0;809261211;819996474;48074344
1390;8.16237e-15;-342;1711;20808;15570.1;1;556;-2.14748e+09;-3.66728e+06;0;0;0;0;0;0;809554315;820319303;48158920
1391;8.16237e-15;-342;1711;20808;15570.1;1;556;-2.14748e+09;-3.65912e+06;-1;0;0;0;-1;0;809846768;820641490;48243417
1392;8.16237e-15;-342;1711;20808;15570.1;1;556;-2.14748e+09;-3.651e+06;-1;0;0;0;-1;0;810138571;820963034;48327834
1393;8.16237e-15;-342;1711;20808;15570.1;1;556;-2.14748e+09;-3.64289e+06;-1;0;0;0;-1;0;810429727;821283940;48412172
1394;8.16237e-15;-343;1711;20808;15570.1;1;556;-2.14748e+09;-3.63481e+06;0;0;0;0;0;0;810720236;821604206;48496430
1395;8.16237e-15;-343;1711;20808;15570.1;1;556;-2.14748e+09;-3.62675e+06;-1;0;0;0;-1;0;811010102;821923836;48580608
1396;8.16237e-15;-343;1711;20808;15570.1;1;556;-2.14748e+09;-3.61871e+06;-1;0;0;0;-1;0;811299324;822242831;48664706
1397;8.16237e-15;-343;1711;20808;15570.1;1;556;-2.14748e+09;-3.6107e+06;-1;0;0;0;-1;0;811587906;822561193;48748724
1398;8.16237e-15;-343;1711;20808;15570.1;1;556;-2.14748e+09;-3.60271e+06;-1;0;0;0;-1;0;811875849;822878922;48832662
1399;8.16237e-15;-344;1711;20808;15570.1;1;556;-2.14748e+09;-3.59474e+06;0;0;0;0;0;0;812163154;823196021;48916519
1400;8.16237e-15;-344;1711;20808;15570.1;1;556;-2.14748e+09;-3.58679e+06;-1;0;0;0;-1;0;812449823;823512491;49000296
1401;8.16237e-15;-344;1711;20808;15570.1;1;556;-2.14748e+09;-3.57887e+06;-1;0;0;0;-1;0;812735858;823828333;49083992
1402;8.16237e-15;-344;1711;20808;15570.1;1;556;-2.14748e+09;-3.57097e+06;-1;0;0;0;-1;0;813021260;824143549;49167607
1403;8.16237e-15;-345;1711;20808;15570.1;1;556;-2.14748e+09;-3.56309e+06;0;0;0;0;0;0;813306032;824458142;49251142
1404;8.16237e-15;-345;1711;20808;15570.1;1;556;-2.14748e+09;-3.55523e+06;-1;0;0;0;-1;0;813590175;824772111;49334595
1405;8.16237e-15;-346;1711;20808;15570.1;1;556;-2.14748e+09;-3.5474e+06;0;0;0;0;0;0;813873690;825085459;49417967
1406;8.16237e-15;-347;1711;20808;15570.1;1;556;-2.14748e+09;-3.53959e+06;0;0;0;0;0;0;814156579;825398187;49501258
1407;8.16237e-15;-347;1711;20808;15570.1;1;556;-2.14748e+09;-3.5318e+06;-1;0;0;0;-1;0;814438844;825710296;49584467
1408;8.16237e-15;-348;1711;20808;15570.1;1;556;-2.14748e+09;-3.52403e+06;0;0;0;0;0;0;814720486;826021789;49667595
1409;8.16237e-15;-349;1711;20808;15570.1;1;556;-2.14748e+09;-3.51628e+06;0;0;0;0;0;0;815001508;826332666;49750641
1410;8.16237e-15;-349;1711;20808;15570.1;1;556;-2.14748e+09;-3.50856e+06;-1;0;0;0;-1;0;815281910;826642930;49833606
1411;8.16237e-15;-350;1711;20808;15570.1;1;556;-2.14748e+09;-3.50085e+06;0;0;0;0;0;0;815561695;826952581;49916488
1412;8.16237e-15;-350;1711;20808;15570.1;1;556;-2.14748e+09;-3.49317e+06;-1;0;0;0;-1;0;815840863;827261621;49999288
1413;8.16237e-15;-350;1711;20808;15570.1;1;556;-2.14748e+09;-3.48551e+06;-1;0;0;0;-1;0;816119418;827570051;50082007
1414;8.16237e-15;-351;1711;20808;15570.1;1;556;-2.14748e+09;-3.47787e+06;0;0;0;0;0;0;816397359;827877874;50164643
1415;8.16237e-15;-351;1711;20808;15570.1;1;556;-2.14748e+09;-3.47025e+06;-1;0;0;0;-1;0;816674689;828185090;50247196
1416;8.16237e-15;-351;1711;20808;15570.1;1;556;-2.14748e+09;-3.46265e+06;-1;0;0;0;-1;0;816951409;828491701;50329667
1417;8.16237e-15;-352;1711;20808;15570.1;1;556;-2.14748e+09;-3.45508e+06;0;0;0;0;0;0;817227522;828797708;50412056
1418;8.16237e-15;-353;1711;20808;15570.1;1;556;-2.14748e+09;-3.44752e+06;0;0;0;0;0;0;817503028;829103113;50494362
1419;8.16237e-15;-354;1711;20808;15570.1;1;556;-2.14748e+09;-3.43999e+06;0;0;0;0;0;0;817777929;829407917;50576585
1420;8.16237e-15;-355;1711;20808;15570.1;1;556;-2.14748e+09;-3.43248e+06;0;0;0;0;0;0;818052227;829712122;50658725
1421;8.16237e-15;-356;1711;20808;15570.1;1;556;-2.14748e+09;-3.42498e+06;0;0;0;0;0;0;818325923;830015729;50740782
1422;8.16237e-15;-356;1711;20808;15570.1;1;556;-2.14748e+09;-3.41751e+06;-1;0;0;0;-1;0;818599019;830318739;50822755
1423;8.16237e-15;-357;1711;20808;15570.1;1;556;-2.14748e+09;-3.41006e+06;0;0;0;0;0;0;818871517;830621154;50904646
1424;8.16237e-15;-358;1711;20808;15570.1;1;556;-2.14748e+09;-3.40263e+06;0;0;0;0;0;0;819143417;830922976;50986453
1425;8.16237e-15;-358;1711;20808;15570.1;1;556;-2.14748e+09;-3.39522e+06;-1;0;0;0;-1;0;819414722;831224205;51068177
1426;8.16237e-15;-359;1711;20808;15570.1;1;556;-2.14748e+09;-3.38783e+06;0;0;0;0;0;0;819685433;831524844;51149817
1427;8.16237e-15;-360;1711;20808;15570.1;1;556;-2.14748e+09;-3.38046e+06;0;0;0;0;0;0;819955552;831824893;51231374
1428;8.16237e-15;-361;1711;20808;15570.1;1;556;-2.14748e+09;-3.37311e+06;0;0;0;0;0;0;820225079;832124354;51312847
1429;8.16237e-15;-361;1711;20808;15570.1;1;556;-2.14748e+09;-3.36578e+06;-1;0;0;0;-1;0;820494018;832423228;51394236
1430;8.16237e-15;-361;1711;20808;15570.1;1;556;-2.14748e+09;-3.35847e+06;-1;0;0;0;-1;0;820762368;832721517;51475541
1431;8.16237e-15;-362;1711;20808;15570.1;1;556;-2.14748e+09;-3.35118e+06;0;0;0;0;0;0;821030133;833019222;51556762
1432;8.16237e-15;-363;1711;20808;15570.1;1;556;-2.14748e+09;-3.34391e+06;0;0;0;0;0;0;821297312;833316345;51637899
1433;8.16237e-15;-363;1711;20808;15570.1;1;556;-2.14748e+09;-3.33666e+06;-1;0;0;0;-1;0;821563909;833612886;51718952
1434;8.16237e-15;-364;1711;20808;15570.1;1;556;-2.14748e+09;-3.32943e+06;0;0;0;0;0;0;821829923;833908847;51799920
1435;8.16237e-15;-365;1711;20808;15570.1;1;556;-2.14748e+09;-3.32222e+06;0;0;0;0;0;0;822095357;834204231;51880804
1436;8.16237e-15;-366;1711;20808;15570.1;1;556;-2.14748e+09;-3.31503e+06;0;0;0;0;0;0;822360213;834499037;51961604
1437;8.16237e-15;-367;1711;20808;15570.1;1;556;-2.14748e+09;-3.30786e+06;0;0;0;0;0;0;822624491;834793267;52042319
1438;8.16237e-15;-368;1711;20808;15570.1;1;556;-2.14748e+09;-3.3007e+06;0;0;0;0;0;0;822888193;835086923;52122949
1439;8.16237e-15;-369;1711;20808;15570.1;1;556;-2.14748e+09;-3.29357e+06;0;0;0;0;0;0;823151322;835380006;52203495
1440;8.16237e-15;-370;1711;20808;15570.1;1;556;-2.14748e+09;-3.28646e+06;0;0;0;0;0;0;823413877;835672517;52283955
1441;8.16237e-15;-370;1711;20808;15570.1;1;556;-2.14748e+09;-3.27936e+06;-1;0;0;0;-1;0;823675861;835964458;52364331
1442;8.16237e-15;-371;1711;20808;15570.1;1;556;-2.14748e+09;-3.27229e+06;0;0;0;0;0;0;823937275;836255830;52444622
1443;8.16237e-15;-371;1711;20808;15570.1;1;556;-2.14748e+09;-3.26523e+06;-1;0;0;0;-1;0;824198120;836546634;52524828
1444;8.16237e-15;-371;1711;20808;15570.1;1;556;-2.14748e+09;-3.2582e+06;-1;0;0;0;-1;0;824458399;836836871;52604949
1445;8.16237e-15;-372;1711;20808;15570.1;1;556;-2.14748e+09;-3.25118e+06;0;0;0;0;0;0;824718112;837126544;52684984
1446;8.16237e-15;-373;1711;20808;15570.1;1;556;-2.14748e+09;-3.24418e+06;0;0;0;0;0;0;824977261;837415653;52764934
1447;8.16237e-15;-374;1711;20808;15570.1;1;556;-2.14748e+09;-3.2372e+06;0;0;0;0;0;0;825235847;837704199;52844799
1448;8.16237e-15;-375;1711;20808;15570.1;1;556;-2.14748e+09;-3.23024e+06;0;0;0;0;0;0;825493872;837992184;52924578
1449;8.16237e-15;-376;1711;20808;15570.1;1;556;-2.14748e+09;-3.22329e+06;0;0;0;0;0;0;825751337;838279610;53004272
1450;8.16237e-15;-376;1711;20808;15570.1;1;556;-2.14748e+09;-3.21637e+06;-1;0;0;0;-1;0;826008244;838566477;53083880
1451;8.16237e-15;-377;1711;20808;15570.1;1;556;-2.14748e+09;-3.20946e+06;0;0;0;0;0;0;826264594;838852786;53163402
1452;8.16237e-15;-378;1711;20808;15570.1;1;556;-2.14748e+09;-3.20257e+06;0;0;0;0;0;0;826520388;839138540;53242839
1453;8.16237e-15;-378;1711;20808;15570.1;1;556;-2.14748e+09;-3.1957e+06;-1;0;0;0;-1;0;826775629;839423739;53322190
1454;8.16237e-15;-378;1711;20808;15570.1;1;556;-2.14748e+09;-3.18885e+06;-1;0;0;0;-1;0;827030316;839708385;53401455
1455;8.16237e-15;-378;1711;20808;15570.1;1;556;-2.14748e+09;-3.18202e+06;-1;0;0;0;-1;0;827284453;839992478;53480634
1456;8.16237e-15;-378;1711;20808;15570.1;1;556;-2.14748e+09;-3.1752e+06;-1;0;0;0;-1;0;827538039;840276020;53559726
1457;8.16237e-15;-378;1711;20808;15570.1;1;556;-2.14748e+09;-3.16841e+06;-1;0;0;0;-1;0;827791077;840559013;53638733
1458;8.16237e-15;-378;1711;20808;15570.1;1;556;-2.14748e+09;-3.16163e+06;-1;0;0;0;-1;0;828043568;840841458;53717654
1459;8.16237e-15;-379;1711;20808;15570.1;1;556;-2.14748e+09;-3.15487e+06;0;0;0;0;0;0;828295513;841123356;53796489
1460;8.16237e-15;-380;1711;20808;15570.1;1;556;-2.14748e+09;-3.14812e+06;0;0;0;0;0;0;828546914;841404707;53875237
1461;8.16237e-15;-381;1711;20808;15570.1;1;556;-2.14748e+09;-3.1414e+06;0;0;0;0;0;0;828797772;841685515;53953899
1462;8.16237e-15;-382;1711;20808;15570.1;1;556;-2.14748e+09;-3.13469e+06;0;0;0;0;0;0;829048088;841965778;54032474
1463;8.16237e-15;-383;1711;20808;15570.1;1;556;-2.14748e+09;-3.128e+06;0;0;0;0;0;0;829297864;842245500;54110963
1464;8.16237e-15;-384;1711;20808;15570.1;1;556;-2.14748e+09;-3.12133e+06;0;0;0;0;0;0;829547101;842524681;54189366
1465;8.16237e-15;-385;1711;20808;15570.1;1;556;-2.14748e+09;-3.11468e+06;0;0;0;0;0;0;829795801;842803322;54267681
1466;8.16237e-15;-386;1711;20808;15570.1;1;556;-2.14748e+09;-3.10804e+06;0;0;0;0;0;0;830043965;843081425;54345911
1467;8.16237e-15;-387;1711;20808;15570.1;1;556;-2.14748e+09;-3.10142e+06;0;0;0;0;0;0;830291593;843358991;54424053
1468;8.16237e-15;-387;1711;20808;15570.1;1;556;-2.14748e+09;-3.09482e+06;-1;0;0;0;-1;0;830538689;843636021;54502109
1469;8.16237e-15;-387;1711;20808;15570.1;1;556;-2.14748e+09;-3.08823e+06;-1;0;0;0;-1;0;830785252;843912516;54580078
1470;8.16237e-15;-388;1711;20808;15570.1;1;556;-2.14748e+09;-3.08166e+06;0;0;0;0;0;0;831031284;844188478;54657960
1471;8.16237e-15;-389;1711;20808;15570.1;1;556;-2.14748e+09;-3.07511e+06;0;0;0;0;0;0;831276788;844463907;54735755
1472;8.16237e-15;-390;1711;20808;15570.1;1;556;-2.14748e+09;-3.06858e+06;0;0;0;0;0;0;831521763;844738805;54813463
1473;8.16237e-15;-391;1711;20808;15570.1;1;556;-2.14748e+09;-3.06207e+06;0;0;0;0;0;0;831766211;845013174;54891085
1474;8.16237e-15;-392;1711;20808;15570.1;1;556;-2.14748e+09;-3.05556e+06;0;0;0;0;0;0;832010133;845287013;54968619
1475;8.16237e-15;-393;1711;20808;15570.1;1;556;-2.14748e+09;-3.04908e+06;0;0;0;0;0;0;832253532;845560326;55046066
1476;8.16237e-15;-393;1711;20808;15570.1;1;556;-2.14748e+09;-3.04262e+06;-1;0;0;0;-1;0;832496408;845833112;55123426
1477;8.16237e-15;-394;1711;20808;15570.1;1;556;-2.14748e+09;-3.03617e+06;0;0;0;0;0;0;832738762;846105372;55200698
1478;8.16237e-15;-395;1711;20808;15570.1;1;556;-2.14748e+09;-3.02974e+06;0;0;0;0;0;0;832980596;846377109;55277884
1479;8.16237e-15;-396;1711;20808;15570.1;1;556;-2.14748e+09;-3.02332e+06;0;0;0;0;0;0;833221911;846648324;55354982
1480;8.16237e-15;-396;1711;20808;15570.1;1;556;-2.14748e+09;-3.01692e+06;-1;0;0;0;-1;0;833462709;846919016;55431993
1481;8.16237e-15;-397;1711;20808;15570.1;1;556;-2.14748e+09;-3.01054e+06;0;0;0;0;0;0;833702990;847189188;55508916
1482;8.16237e-15;-397;1711;20808;15570.1;1;556;-2.14748e+09;-3.00417e+06;-1;0;0;0;-1;0;833942756;847458841;55585752
1483;8.16237e-15;-397;1711;20808;15570.1;1;556;-2.14748e+09;-2.99782e+06;-1;0;0;0;-1;0;834182009;847727976;55662501
1484;8.16237e-15;-397;1711;20808;15570.1;1;556;-2.14748e+09;-2.99149e+06;-1;0;0;0;-1;0;834420749;847996595;55739161
1485;8.16237e-15;-398;1711;20808;15570.1;1;556;-2.14748e+09;-2.98518e+06;0;0;0;0;0;0;834658978;848264697;55815735
1486;8.16237e-15;-399;1711;20808;15570.1;1;556;-2.14748e+09;-2.97888e+06;0;0;0;0;0;0;834896696;848532285;55892221
1487;8.16237e-15;-400;1711;20808;15570.1;1;556;-2.14748e+09;-2.97259e+06;0;0;0;0;0;0;835133907;848799359;55968619
1488;8.16237e-15;-400;1711;20808;15570.1;1;556;-2.14748e+09;-2.96632e+06;-1;0;0;0;-1;0;835370610;849065921;56044929
1489;8.16237e-15;-401;1711;20808;15570.1;1;556;-2.14748e+09;-2.96007e+06;0;0;0;0;0;0;835606806;849331972;56121152
1490;8.16237e-15;-401;1711;20808;15570.1;1;556;-2.14748e+09;-2.95384e+06;-1;0;0;0;-1;0;835842498;849597513;56197287
1491;8.16237e-15;-402;1711;20808;15570.1;1;556;-2.14748e+09;-2.94762e+06;0;0;0;0;0;0;836077686;849862545;56273335
1492;8.16237e-15;-402;1711;20808;15570.1;1;556;-2.14748e+09;-2.94141e+06;-1;0;0;0;-1;0;836312372;850127070;56349294
1493;8.16237e-15;-402;1711;20808;15570.1;1;556;-2.14748e+09;-2.93522e+06;-1;0;0;0;-1;0;836546557;850391088;56425166
1494;8.16237e-15;-402;1711;20808;15570.1;1;556;-2.14748e+09;-2.92905e+06;-1;0;0;0;-1;0;836780242;850654600;56500950
1495;8.16237e-15;-403;1711;20808;15570.1;1;556;-2.14748e+09;-2.9229e+06;0;0;0;0;0;0;837013428;850917608;56576646
1496;8.16237e-15;-404;1711;20808;15570.1;1;556;-2.14748e+09;-2.91676e+06;0;0;0;0;0;0;837246117;851180113;56652254
1497;8.16237e-15;-404;1711;20808;15570.1;1;556;-2.14748e+09;-2.91063e+06;-1;0;0;0;-1;0;837478310;851442116;56727774
1498;8.16237e-15;-405;1711;20808;15570.1;1;556;-2.14748e+09;-2.90452e+06;0;0;0;0;0;0;837710007;851703617;56803206
1499;8.16237e-15;-405;1711;20808;15570.1;1;556;-2.14748e+09;-2.89843e+06;-1;0;0;0;-1;0;837941211;851964619;56878550
1500;8.16237e-15;-406;1711;20808;15570.1;1;556;-2.14748e+09;-2.89235e+06;0;0;0;0;0;0;838171923;852225122;56953806
1501;8.16237e-15;-407;1711;20808;15570.1;1;556;-2.14748e+09;-2.88629e+06;0;0;0;0;0;0;838402143;852485128;57028973
1502;8.16237e-15;-407;1711;20808;15570.1;1;556;-2.14748e+09;-2.88024e+06;-1;0;0;0;-1;0;838631873;852744637;57104053
1503;8.16237e-15;-408;1711;20808;15570.1;1;556;-2.14748e+09;-2.87421e+06;0;0;0;0;0;0;838861114;853003650;57179045
1504;8.16237e-15;-409;1711;20808;15570.1;1;556;-2.14748e+09;-2.86819e+06;0;0;0;0;0;0;839089868;853262169;57253948
1505;8.16237e-15;-410;1711;20808;15570.1;1;556;-2.14748e+09;-2.86219e+06;0;0;0;0;0;0;839318135;853520195;57328764
1506;8.16237e-15;-411;1711;20808;15570.1;1;556;-2.14748e+09;-2.8562e+06;0;0;0;0;0;0;839545916;853777729;57403491
1507;8.16237e-15;-411;1711;20808;15570.1;1;556;-2.14748e+09;-2.85023e+06;-1;0;0;0;-1;0;839773214;854034771;57478130
1508;8.16237e-15;-412;1711;20808;15570.1;1;556;-2.14748e+09;-2.84427e+06;0;0;0;0;0;0;840000028;854291323;57552681
1509;8.16237e-15;-413;1711;20808;15570.1;1;556;-2.14748e+09;-2.83833e+06;0;0;0;0;0;0;840226361;854547387;57627143
1510;8.16237e-15;-414;1711;20808;15570.1;1;556;-2.14748e+09;-2.8324e+06;0;0;0;0;0;0;840452214;854802963;57701517
1511;8.16237e-15;-415;1711;20808;15570.1;1;556;-2.14748e+09;-2.82649e+06;0;0;0;0;0;0;840677587;855058051;57775803
1512;8.16237e-15;-416;1711;20808;15570.1;1;556;-2.14748e+09;-2.8206e+06;0;0;0;0;0;0;840902482;855312654;57850000
1513;8.16237e-15;-416;1711;20808;15570.1;1;556;-2.14748e+09;-2.81472e+06;-1;0;0;0;-1;0;841126900;855566773;57924110
1514;8.16237e-15;-416;1711;20808;15570.1;1;556;-2.14748e+09;-2.80885e+06;-1;0;0;0;-1;0;841350842;855820407;57998131
1515;8.16237e-15;-417;1711;20808;15570.1;1;556;-2.14748e+09;-2.803e+06;0;0;0;0;0;0;841574309;856073560;58072063
1516;8.16237e-15;-417;1711;20808;15570.1;1;556;-2.14748e+09;-2.79716e+06;-1;0;0;0;-1;0;841797303;856326230;58145907
1517;8.16237e-15;-417;1711;20808;15570.1;1;556;-2.14748e+09;-2.79134e+06;-1;0;0;0;-1;0;842019824;856578420;58219663
1518;8.16237e-15;-418;1711;20808;15570.1;1;556;-2.14748e+09;-2.78553e+06;0;0;0;0;0;0;842241874;856830131;58293330
1519;8.16237e-15;-419;1711;20808;15570.1;1;556;-2.14748e+09;-2.77973e+06;0;0;0;0;0;0;842463454;857081363;58366909
1520;8.16237e-15;-419;1711;20808;15570.1;1;556;-2.14748e+09;-2.77395e+06;-1;0;0;0;-1;0;842684565;857332119;58440400
1521;8.16237e-15;-419;1711;20808;15570.1;1;556;-2.14748e+09;-2.76819e+06;-1;0;0;0;-1;0;842905209;857582397;58513802
1522;8.16237e-15;-419;1711;20808;15570.1;1;556;-2.14748e+09;-2.76244e+06;-1;0;0;0;-1;0;843125385;857832201;58587115
1523;8.16237e-15;-419;1711;20808;15570.1;1;556;-2.14748e+09;-2.7567e+06;-1;0;0;0;-1;0;843345096;858081530;58660340
1524;8.16237e-15;-419;1711;20808;15570.1;1;556;-2.14748e+09;-2.75098e+06;-1;0;0;0;-1;0;843564343;858330386;58733477
1525;8.16237e-15;-420;1711;20808;15570.1;1;556;-2.14748e+09;-2.74527e+06;0;0;0;0;0;0;843783127;858578770;58806525
1526;8.16237e-15;-421;1711;20808;15570.1;1;556;-2.14748e+09;-2.73958e+06;0;0;0;0;0;0;844001448;858826683;58879485
1527;8.16237e-15;-422;1711;20808;15570.1;1;556;-2.14748e+09;-2.7339e+06;0;0;0;0;0;0;844219309;859074126;58952356
1528;8.16237e-15;-422;1711;20808;15570.1;1;556;-2.14748e+09;-2.72823e+06;-1;0;0;0;-1;0;844436709;859321100;59025138
1529;8.16237e-15;-422;1711;20808;15570.1;1;556;-2.14748e+09;-2.72258e+06;-1;0;0;0;-1;0;844653651;859567605;59097833
1530;8.16237e-15;-423;1711;20808;15570.1;1;556;-2.14748e+09;-2.71694e+06;0;0;0;0;0;0;844870135;859813644;59170438
1531;8.16237e-15;-424;1711;20808;15570.1;1;556;-2.14748e+09;-2.71132e+06;0;0;0;0;0;0;845086162;860059216;59242955
1532;8.16237e-15;-424;1711;20808;15570.1;1;556;-2.14748e+09;-2.70571e+06;-1;0;0;0;-1;0;845301734;860304324;59315384
1533;8.16237e-15;-425;1711;20808;15570.1;1;556;-2.14748e+09;-2.70011e+06;0;0;0;0;0;0;845516852;860548967;59387724
1534;8.16237e-15;-425;1711;20808;15570.1;1;556;-2.14748e+09;-2.69453e+06;-1;0;0;0;-1;0;845731517;860793147;59459975
1535;8.16237e-15;-425;1711;20808;15570.1;1;556;-2.14748e+09;-2.68896e+06;-1;0;0;0;-1;0;845945729;861036865;59532138
1536;8.16237e-15;-425;1711;20808;15570.1;1;556;-2.14748e+09;-2.68341e+06;-1;0;0;0;-1;0;846159490;861280123;59604213
1537;8.16237e-15;-426;1711;20808;15570.1;1;556;-2.14748e+09;-2.67786e+06;0;0;0;0;0;0;846372801;861522920;59676199
1538;8.16237e-15;-427;1711;20808;15570.1;1;556;-2.14748e+09;-2.67234e+06;0;0;0;0;0;0;846585664;861765258;59748096
1539;8.16237e-15;-427;1711;20808;15570.1;1;556;-2.14748e+09;-2.66682e+06;-1;0;0;0;-1;0;846798078;862007138;59819905
1540;8.16237e-15;-427;1711;20808;15570.1;1;556;-2.14748e+09;-2.66132e+06;-1;0;0;0;-1;0;847010046;862248560;59891625
1541;8.16237e-15;-427;1711;20808;15570.1;1;556;-2.14748e+09;-2.65584e+06;-1;0;0;0;-1;0;847221568;862489527;59963257
1542;8.16237e-15;-427;1711;20808;15570.1;1;556;-2.14748e+09;-2.65036e+06;-1;0;0;0;-1;0;847432646;862730039;60034800
1543;8.16237e-15;-428;1711;20808;15570.1;1;556;-2.14748e+09;-2.6449e+06;0;0;0;0;0;0;847643280;862970096;60106255
1544;8.16237e-15;-428;1711;20808;15570.1;1;556;-2.14748e+09;-2.63946e+06;-1;0;0;0;-1;0;847853471;863209700;60177621
1545;8.16237e-15;-428;1711;20808;15570.1;1;556;-2.14748e+09;-2.63402e+06;-1;0;0;0;-1;0;848063221;863448852;60248899
1546;8.16237e-15;-428;1711;20808;15570.1;1;556;-2.14748e+09;-2.6286e+06;-1;0;0;0;-1;0;848272531;863687553;60320088
1547;8.16237e-15;-428;1711;20808;15570.1;1;556;-2.14748e+09;-2.62319e+06;-1;0;0;0;-1;0;848481402;863925803;60391188
1548;8.16237e-15;-429;1711;20808;15570.1;1;556;-2.14748e+09;-2.6178e+06;0;0;0;0;0;0;848689834;864163604;60462201
1549;8.16237e-15;-430;1711;20808;15570.1;1;556;-2.14748e+09;-2.61242e+06;0;0;0;0;0;0;848897829;864400957;60533124
1550;8.16237e-15;-431;1711;20808;15570.1;1;556;-2.14748e+09;-2.60705e+06;0;0;0;0;0;0;849105388;864637862;60603959
1551;8.16237e-15;-431;1711;20808;15570.1;1;556;-2.14748e+09;-2.6017e+06;-1;0;0;0;-1;0;849312512;864874320;60674706
1552;8.16237e-15;-432;1711;20808;15570.1;1;556;-2.14748e+09;-2.59636e+06;0;0;0;0;0;0;849519202;865110334;60745364
1553;8.16237e-15;-432;1711;20808;15570.1;1;556;-2.14748e+09;-2.59103e+06;-1;0;0;0;-1;0;849725459;865345902;60815934
1554;8.16237e-15;-433;1711;20808;15570.1;1;556;-2.14748e+09;-2.58571e+06;0;0;0;0;0;0;849931284;865581027;60886415
1555;8.16237e-15;-433;1711;20808;15570.1;1;556;-2.14748e+09;-2.58041e+06;-1;0;0;0;-1;0;850136678;865815709;60956808
1556;8.16237e-15;-434;1711;20808;15570.1;1;556;-2.14748e+09;-2.57512e+06;0;0;0;0;0;0;850341642;866049950;61027112
1557;8.16237e-15;-435;1711;20808;15570.1;1;556;-2.14748e+09;-2.56984e+06;0;0;0;0;0;0;850546177;866283749;61097328
1558;8.16237e-15;-435;1711;20808;15570.1;1;556;-2.14748e+09;-2.56458e+06;-1;0;0;0;-1;0;850750285;866517109;61167456
1559;8.16237e-15;-435;1711;20808;15570.1;1;556;-2.14748e+09;-2.55932e+06;-1;0;0;0;-1;0;850953965;866750030;61237495
1560;8.16237e-15;-436;1711;20808;15570.1;1;556;-2.14748e+09;-2.55408e+06;0;0;0;0;0;0;851157220;866982513;61307446
1561;8.16237e-15;-436;1711;20808;15570.1;1;556;-2.14748e+09;-2.54886e+06;-1;0;0;0;-1;0;851360050;867214558;61377308
1562;8.16237e-15;-436;1711;20808;15570.1;1;556;-2.14748e+09;-2.54364e+06;-1;0;0;0;-1;0;851562456;867446168;61447082
1563;8.16237e-15;-437;1711;20808;15570.1;1;556;-2.14748e+09;-2.53844e+06;0;0;0;0;0;0;851764439;867677342;61516768
1564;8.16237e-15;-437;1711;20808;15570.1;1;556;-2.14748e+09;-2.53325e+06;-1;0;0;0;-1;0;851966001;867908082;61586365
1565;8.16237e-15;-438;1711;20808;15570.1;1;556;-2.14748e+09;-2.52808e+06;0;0;0;0;0;0;852167142;868138388;61655875
1566;8.16237e-15;-438;1711;20808;15570.1;1;556;-2.14748e+09;-2.52291e+06;-1;0;0;0;-1;0;852367863;868368262;61725295
1567;8.16237e-15;-438;1711;20808;15570.1;1;556;-2.14748e+09;-2.51776e+06;-1;0;0;0;-1;0;852568165;868597705;61794628
1568;8.16237e-15;-439;1711;20808;15570.1;1;556;-2.14748e+09;-2.51262e+06;0;0;0;0;0;0;852768049;868826716;61863872
1569;8.16237e-15;-440;1711;20808;15570.1;1;556;-2.14748e+09;-2.5075e+06;0;0;0;0;0;0;852967517;869055298;61933028
1570;8.16237e-15;-441;1711;20808;15570.1;1;556;-2.14748e+09;-2.50238e+06;0;0;0;0;0;0;853166569;869283451;62002096
1571;8.16237e-15;-442;1711;20808;15570.1;1;556;-2.14748e+09;-2.49728e+06;0;0;0;0;0;0;853365206;869511176;62071075
1572;8.16237e-15;-443;1711;20808;15570.1;1;556;-2.14748e+09;-2.49219e+06;0;0;0;0;0;0;853563429;869738474;62139967
1573;8.16237e-15;-444;1711;20808;15570.1;1;556;-2.14748e+09;-2.48711e+06;0;0;0;0;0;0;853761239;869965346;62208770
1574;8.16237e-15;-445;1711;20808;15570.1;1;556;-2.14748e+09;-2.48204e+06;0;0;0;0;0;0;853958637;870191792;62277485
1575;8.16237e-15;-445;1711;20808;15570.1;1;556;-2.14748e+09;-2.47699e+06;-1;0;0;0;-1;0;854155624;870417814;62346112
1576;8.16237e-15;-445;1711;20808;15570.1;1;556;-2.14748e+09;-2.47195e+06;-1;0;0;0;-1;0;854352202;870643413;62414651
1577;8.16237e-15;-445;1711;20808;15570.1;1;556;-2.14748e+09;-2.46692e+06;-1;0;0;0;-1;0;854548370;870868589;62483102
1578;8.16237e-15;-446;1711;20808;15570.1;1;556;-2.14748e+09;-2.4619e+06;0;0;0;0;0;0;854744131;871093343;62551465
1579;8.16237e-15;-447;1711;20808;15570.1;1;556;-2.14748e+09;-2.45689e+06;0;0;0;0;0;0;854939484;871317676;62619739
1580;8.16237e-15;-448;1711;20808;15570.1;1;556;-2.14748e+09;-2.4519e+06;0;0;0;0;0;0;855134431;871541589;62687926
1581;8.16237e-15;-449;1711;20808;15570.1;1;556;-2.14748e+09;-2.44692e+06;0;0;0;0;0;0;855328973;871765084;62756025
1582;8.16237e-15;-449;1711;20808;15570.1;1;556;-2.14748e+09;-2.44194e+06;-1;0;0;0;-1;0;855523111;871988159;62824035
1583;8.16237e-15;-450;1711;20808;15570.1;1;556;-2.14748e+09;-2.43699e+06;0;0;0;0;0;0;855716846;872210818;62891958
1584;8.16237e-15;-451;1711;20808;15570.1;1;556;-2.14748e+09;-2.43204e+06;0;0;0;0;0;0;855910178;872433060;62959793
1585;8.16237e-15;-452;1711;20808;15570.1;1;556;-2.14748e+09;-2.4271e+06;0;0;0;0;0;0;856103109;872654887;63027540
1586;8.16237e-15;-452;1711;20808;15570.1;1;556;-2.14748e+09;-2.42218e+06;-1;0;0;0;-1;0;856295640;872876298;63095199
1587;8.16237e-15;-453;1711;20808;15570.1;1;556;-2.14748e+09;-2.41727e+06;0;0;0;0;0;0;856487771;873097296;63162771
1588;8.16237e-15;-454;1711;20808;15570.1;1;556;-2.14748e+09;-2.41237e+06;0;0;0;0;0;0;856679504;873317881;63230254
1589;8.16237e-15;-454;1711;20808;15570.1;1;556;-2.14748e+09;-2.40748e+06;-1;0;0;0;-1;0;856870839;873538053;63297650
1590;8.16237e-15;-455;1711;20808;15570.1;1;556;-2.14748e+09;-2.4026e+06;0;0;0;0;0;0;857061777;873757814;63364958
1591;8.16237e-15;-456;1711;20808;15570.1;1;556;-2.14748e+09;-2.39774e+06;0;0;0;0;0;0;857252320;873977165;63432178
1592;8.16237e-15;-456;1711;20808;15570.1;1;556;-2.14748e+09;-2.39288e+06;-1;0;0;0;-1;0;857442468;874196106;63499311
1593;8.16237e-15;-457;1711;20808;15570.1;1;556;-2.14748e+09;-2.38804e+06;0;0;0;0;0;0;857632222;874414638;63566356
1594;8.16237e-15;-458;1711;20808;15570.1;1;556;-2.14748e+09;-2.38321e+06;0;0;0;0;0;0;857821582;874632763;63633313
1595;8.16237e-15;-459;1711;20808;15570.1;1;556;-2.14748e+09;-2.37839e+06;0;0;0;0;0;0;858010551;874850480;63700183
1596;8.16237e-15;-459;1711;20808;15570.1;1;556;-2.14748e+09;-2.37358e+06;-1;0;0;0;-1;0;858199129;875067791;63766965
1597;8.16237e-15;-460;1711;20808;15570.1;1;556;-2.14748e+09;-2.36878e+06;0;0;0;0;0;0;858387317;875284696;63833659
1598;8.16237e-15;-461;1711;20808;15570.1;1;556;-2.14748e+09;-2.36399e+06;0;0;0;0;0;0;858575115;875501197;63900266
1599;8.16237e-15;-462;1711;20808;15570.1;1;556;-2.14748e+09;-2.35922e+06;0;0;0;0;0;0;858762525;875717295;63966786
1600;8.16237e-15;-463;1711;20808;15570.1;1;556;-2.14748e+09;-2.35445e+06;0;0;0;0;0;0;858949548;875932989;64033218
1601;8.16237e-15;-463;1711;20808;15570.1;1;556;-2.14748e+09;-2.3497e+06;-1;0;0;0;-1;0;859136184;876148281;64099563
1602;8.16237e-15;-463;1711;20808;15570.1;1;556;-2.14748e+09;-2.34496e+06;-1;0;0;0;-1;0;859322434;876363172;64165820
1603;8.16237e-15;-463;1711;20808;15570.1;1;556;-2.14748e+09;-2.34023e+06;-1;0;0;0;-1;0;859508299;876577663;64231990
1604;8.16237e-15;-463;1711;20808;15570.1;1;556;-2.14748e+09;-2.33551e+06;-1;0;0;0;-1;0;859693781;876791754;64298073
1605;8.16237e-15;-463;1711;20808;15570.1;1;556;-2.14748e+09;-2.3308e+06;-1;0;0;0;-1;0;859878879;877005446;64364069
1606;8.16237e-15;-464;1711;20808;15570.1;1;556;-2.14748e+09;-2.3261e+06;0;0;0;0;0;0;860063596;877218741;64429977
1607;8.16237e-15;-464;1711;20808;15570.1;1;556;-2.14748e+09;-2.32141e+06;-1;0;0;0;-1;0;860247931;877431638;64495798
1608;8.16237e-15;-465;1711;20808;15570.1;1;556;-2.14748e+09;-2.31674e+06;0;0;0;0;0;0;860431886;877644139;64561532
1609;8.16237e-15;-465;1711;20808;15570.1;1;556;-2.14748e+09;-2.31207e+06;-1;0;0;0;-1;0;860615461;877856244;64627179
1610;8.16237e-15;-465;1711;20808;15570.1;1;556;-2.14748e+09;-2.30742e+06;-1;0;0;0;-1;0;860798658;878067955;64692738
1611;8.16237e-15;-465;1711;20808;15570.1;1;556;-2.14748e+09;-2.30277e+06;-1;0;0;0;-1;0;860981477;878279271;64758211
1612;8.16237e-15;-466;1711;20808;15570.1;1;556;-2.14748e+09;-2.29814e+06;0;0;0;0;0;0;861163920;878490195;64823597
1613;8.16237e-15;-466;1711;20808;15570.1;1;556;-2.14748e+09;-2.29352e+06;-1;0;0;0;-1;0;861345986;878700726;64888895
1614;8.16237e-15;-466;1711;20808;15570.1;1;556;-2.14748e+09;-2.28891e+06;-1;0;0;0;-1;0;861527678;878910866;64954107
1615;8.16237e-15;-466;1711;20808;15570.1;1;556;-2.14748e+09;-2.28431e+06;-1;0;0;0;-1;0;861708995;879120615;65019232
1616;8.16237e-15;-466;1711;20808;15570.1;1;556;-2.14748e+09;-2.27972e+06;-1;0;0;0;-1;0;861889939;879329974;65084270
1617;8.16237e-15;-467;1711;20808;15570.1;1;556;-2.14748e+09;-2.27514e+06;0;0;0;0;0;0;862070510;879538945;65149221
1618;8.16237e-15;-468;1711;20808;15570.1;1;556;-2.14748e+09;-2.27057e+06;0;0;0;0;0;0;862250710;879747527;65214086
1619;8.16237e-15;-468;1711;20808;15570.1;1;556;-2.14748e+09;-2.26601e+06;-1;0;0;0;-1;0;862430539;879955721;65278863
1620;8.16237e-15;-468;1711;20808;15570.1;1;556;-2.14748e+09;-2.26146e+06;-1;0;0;0;-1;0;862609998;880163529;65343554
1621;8.16237e-15;-468;1711;20808;15570.1;1;556;-2.14748e+09;-2.25692e+06;-1;0;0;0;-1;0;862789088;880370950;65408159
1622;8.16237e-15;-468;1711;20808;15570.1;1;556;-2.14748e+09;-2.2524e+06;-1;0;0;0;-1;0;862967810;880577987;65472676
1623;8.16237e-15;-468;1711;20808;15570.1;1;556;-2.14748e+09;-2.24788e+06;-1;0;0;0;-1;0;863146165;880784639;65537107
1624;8.16237e-15;-468;1711;20808;15570.1;1;556;-2.14748e+09;-2.24337e+06;-1;0;0;0;-1;0;863324153;880990908;65601452
1625;8.16237e-15;-468;1711;20808;15570.1;1;556;-2.14748e+09;-2.23888e+06;-1;0;0;0;-1;0;863501775;881196794;65665710
1626;8.16237e-15;-469;1711;20808;15570.1;1;556;-2.14748e+09;-2.23439e+06;0;0;0;0;0;0;863679033;881402298;65729882
1627;8.16237e-15;-469;1711;20808;15570.1;1;556;-2.14748e+09;-2.22992e+06;-1;0;0;0;-1;0;863855927;881607420;65793967
1628;8.16237e-15;-469;1711;20808;15570.1;1;556;-2.14748e+09;-2.22545e+06;-1;0;0;0;-1;0;864032457;881812163;65857966
1629;8.16237e-15;-470;1711;20808;15570.1;1;556;-2.14748e+09;-2.221e+06;0;0;0;0;0;0;864208625;882016525;65921879
1630;8.16237e-15;-471;1711;20808;15570.1;1;556;-2.14748e+09;-2.21655e+06;0;0;0;0;0;0;864384432;882220509;65985705
1631;8.16237e-15;-471;1711;20808;15570.1;1;556;-2.14748e+09;-2.21212e+06;-1;0;0;0;-1;0;864559878;882424114;66049445
1632;8.16237e-15;-472;1711;20808;15570.1;1;556;-2.14748e+09;-2.2077e+06;0;0;0;0;0;0;864734965;882627342;66113099
1633;8.16237e-15;-473;1711;20808;15570.1;1;556;-2.14748e+09;-2.20328e+06;0;0;0;0;0;0;864909692;882830193;66176667
1634;8.16237e-15;-474;1711;20808;15570.1;1;556;-2.14748e+09;-2.19888e+06;0;0;0;0;0;0;865084062;883032669;66240149
1635;8.16237e-15;-475;1711;20808;15570.1;1;556;-2.14748e+09;-2.19448e+06;0;0;0;0;0;0;865258073;883234769;66303545
1636;8.16237e-15;-475;1711;20808;15570.1;1;556;-2.14748e+09;-2.1901e+06;-1;0;0;0;-1;0;865431729;883436495;66366855
1637;8.16237e-15;-476;1711;20808;15570.1;1;556;-2.14748e+09;-2.18572e+06;0;0;0;0;0;0;865605029;883637848;66430079
1638;8.16237e-15;-477;1711;20808;15570.1;1;556;-2.14748e+09;-2.18136e+06;0;0;0;0;0;0;865777973;883838827;66493217
1639;8.16237e-15;-477;1711;20808;15570.1;1;556;-2.14748e+09;-2.17701e+06;-1;0;0;0;-1;0;865950564;884039435;66556269
1640;8.16237e-15;-478;1711;20808;15570.1;1;556;-2.14748e+09;-2.17266e+06;0;0;0;0;0;0;866122802;884239671;66619235
1641;8.16237e-15;-479;1711;20808;15570.1;1;556;-2.14748e+09;-2.16833e+06;0;0;0;0;0;0;866294687;884439537;66682116
1642;8.16237e-15;-480;1711;20808;15570.1;1;556;-2.14748e+09;-2.164e+06;0;0;0;0;0;0;866466220;884639033;66744911
1643;8.16237e-15;-481;1711;20808;15570.1;1;556;-2.14748e+09;-2.15969e+06;0;0;0;0;0;0;866637403;884838159;66807620
1644;8.16237e-15;-481;1711;20808;15570.1;1;556;-2.14748e+09;-2.15538e+06;-1;0;0;0;-1;0;866808235;885036918;66870243
1645;8.16237e-15;-481;1711;20808;15570.1;1;556;-2.14748e+09;-2.15109e+06;-1;0;0;0;-1;0;866978719;885235308;66932781
1646;8.16237e-15;-482;1711;20808;15570.1;1;556;-2.14748e+09;-2.1468e+06;0;0;0;0;0;0;867148854;885433332;66995234
1647;8.16237e-15;-482;1711;20808;15570.1;1;556;-2.14748e+09;-2.14253e+06;-1;0;0;0;-1;0;867318641;885630990;67057601
1648;8.16237e-15;-482;1711;20808;15570.1;1;556;-2.14748e+09;-2.13826e+06;-1;0;0;0;-1;0;867488081;885828282;67119883
1649;8.16237e-15;-483;1711;20808;15570.1;1;556;-2.14748e+09;-2.13401e+06;0;0;0;0;0;0;867657176;886025210;67182079
1650;8.16237e-15;-484;1711;20808;15570.1;1;556;-2.14748e+09;-2.12976e+06;0;0;0;0;0;0;867825925;886221773;67244191
1651;8.16237e-15;-484;1711;20808;15570.1;1;556;-2.14748e+09;-2.12552e+06;-1;0;0;0;-1;0;867994329;886417974;67306216
1652;8.16237e-15;-485;1711;20808;15570.1;1;556;-2.14748e+09;-2.1213e+06;0;0;0;0;0;0;868162390;886613812;67368157
1653;8.16237e-15;-485;1711;20808;15570.1;1;556;-2.14748e+09;-2.11708e+06;-1;0;0;0;-1;0;868330108;886809288;67430013
1654;8.16237e-15;-485;1711;20808;15570.1;1;556;-2.14748e+09;-2.11287e+06;-1;0;0;0;-1;0;868497484;887004403;67491783
1655;8.16237e-15;-486;1711;20808;15570.1;1;556;-2.14748e+09;-2.10867e+06;0;0;0;0;0;0;868664518;887199158;67553468
1656;8.16237e-15;-487;1711;20808;15570.1;1;556;-2.14748e+09;-2.10448e+06;0;0;0;0;0;0;868831212;887393553;67615069
1657;8.16237e-15;-488;1711;20808;15570.1;1;556;-2.14748e+09;-2.1003e+06;0;0;0;0;0;0;868997566;887587590;67676584
1658;8.16237e-15;-489;1711;20808;15570.1;1;556;-2.14748e+09;-2.09613e+06;0;0;0;0;0;0;869163581;887781268;67738015
1659;8.16237e-15;-489;1711;20808;15570.1;1;556;-2.14748e+09;-2.09197e+06;-1;0;0;0;-1;0;869329258;887974589;67799361
1660;8.16237e-15;-490;1711;20808;15570.1;1;556;-2.14748e+09;-2.08782e+06;0;0;0;0;0;0;869494597;888167553;67860622
1661;8.16237e-15;-491;1711;20808;15570.1;1;556;-2.14748e+09;-2.08367e+06;0;0;0;0;0;0;869659599;888360161;67921798
1662;8.16237e-15;-491;1711;20808;15570.1;1;556;-2.14748e+09;-2.07954e+06;-1;0;0;0;-1;0;869824266;888552414;67982890
1663;8.16237e-15;-492;1711;20808;15570.1;1;556;-2.14748e+09;-2.07542e+06;0;0;0;0;0;0;869988597;888744312;68043897
1664;8.16237e-15;-493;1711;20808;15570.1;1;556;-2.14748e+09;-2.0713e+06;0;0;0;0;0;0;870152594;888935857;68104820
1665;8.16237e-15;-493;1711;20808;15570.1;1;556;-2.14748e+09;-2.0672e+06;-1;0;0;0;-1;0;870316257;889127048;68165658
1666;8.16237e-15;-494;1711;20808;15570.1;1;556;-2.14748e+09;-2.0631e+06;0;0;0;0;0;0;870479587;889317886;68226412
1667;8.16237e-15;-495;1711;20808;15570.1;1;556;-2.14748e+09;-2.05901e+06;0;0;0;0;0;0;870642585;889508373;68287081
1668;8.16237e-15;-496;1711;20808;15570.1;1;556;-2.14748e+09;-2.05493e+06;0;0;0;0;0;0;870805252;889698509;68347666
1669;8.16237e-15;-496;1711;20808;15570.1;1;556;-2.14748e+09;-2.05086e+06;-1;0;0;0;-1;0;870967588;889888295;68408166
1670;8.16237e-15;-496;1711;20808;15570.1;1;556;-2.14748e+09;-2.0468e+06;-1;0;0;0;-1;0;871129594;890077730;68468583
1671;8.16237e-15;-496;1711;20808;15570.1;1;556;-2.14748e+09;-2.04275e+06;-1;0;0;0;-1;0;871291270;890266817;68528915
1672;8.16237e-15;-496;1711;20808;15570.1;1;556;-2.14748e+09;-2.03871e+06;-1;0;0;0;-1;0;871452619;890455556;68589164
1673;8.16237e-15;-496;1711;20808;15570.1;1;556;-2.14748e+09;-2.03468e+06;-1;0;0;0;-1;0;871613639;890643946;68649328
1674;8.16237e-15;-496;1711;20808;15570.1;1;556;-2.14748e+09;-2.03066e+06;-1;0;0;0;-1;0;871774333;890831990;68709408
1675;8.16237e-15;-497;1711;20808;15570.1;1;556;-2.14748e+09;-2.02664e+06;0;0;0;0;0;0;871934700;891019688;68769404
1676;8.16237e-15;-497;1711;20808;15570.1;1;556;-2.14748e+09;-2.02263e+06;-1;0;0;0;-1;0;872094742;891207040;68829317
1677;8.16237e-15;-497;1711;20808;15570.1;1;556;-2.14748e+09;-2.01864e+06;-1;0;0;0;-1;0;872254459;891394048;68889146
1678;8.16237e-15;-497;1711;20808;15570.1;1;556;-2.14748e+09;-2.01465e+06;-1;0;0;0;-1;0;872413852;891580711;68948891
1679;8.16237e-15;-497;1711;20808;15570.1;1;556;-2.14748e+09;-2.01067e+06;-1;0;0;0;-1;0;872572921;891767030;69008552
1680;8.16237e-15;-498;1711;20808;15570.1;1;556;-2.14748e+09;-2.0067e+06;0;0;0;0;0;0;872731668;891953007;69068130
1681;8.16237e-15;-498;1711;20808;15570.1;1;556;-2.14748e+09;-2.00274e+06;-1;0;0;0;-1;0;872890094;892138642;69127624
1682;8.16237e-15;-498;1711;20808;15570.1;1;556;-2.14748e+09;-1.99878e+06;-1;0;0;0;-1;0;873048198;892323935;69187034
1683;8.16237e-15;-498;1711;20808;15570.1;1;556;-2.14748e+09;-1.99484e+06;-1;0;0;0;-1;0;873205981;892508887;69246361
1684;8.16237e-15;-498;1711;20808;15570.1;1;556;-2.14748e+09;-1.9909e+06;-1;0;0;0;-1;0;873363445;892693500;69305605
1685;8.16237e-15;-499;1711;20808;15570.1;1;556;-2.14748e+09;-1.98698e+06;0;0;0;0;0;0;873520590;892877772;69364766
1686;8.16237e-15;-499;1711;20808;15570.1;1;556;-2.14748e+09;-1.98306e+06;-1;0;0;0;-1;0;873677417;893061707;69423843
1687;8.16237e-15;-500;1711;20808;15570.1;1;556;-2.14748e+09;-1.97915e+06;0;0;0;0;0;0;873833926;893245302;69482837
1688;8.16237e-15;-501;1711;20808;15570.1;1;556;-2.14748e+09;-1.97525e+06;0;0;0;0;0;0;873990118;893428561;69541748
1689;8.16237e-15;-501;1711;20808;15570.1;1;556;-2.14748e+09;-1.97136e+06;-1;0;0;0;-1;0;874145995;893611483;69600576
1690;8.16237e-15;-501;1711;20808;15570.1;1;556;-2.14748e+09;-1.96747e+06;-1;0;0;0;-1;0;874301555;893794068;69659321
1691;8.16237e-15;-501;1711;20808;15570.1;1;556;-2.14748e+09;-1.9636e+06;-1;0;0;0;-1;0;874456801;893976319;69717983
1692;8.16237e-15;-502;1711;20808;15570.1;1;556;-2.14748e+09;-1.95973e+06;0;0;0;0;0;0;874611733;894158234;69776562
1693;8.16237e-15;-502;1711;20808;15570.1;1;556;-2.14748e+09;-1.95588e+06;-1;0;0;0;-1;0;874766352;894339815;69835058
1694;8.16237e-15;-503;1711;20808;15570.1;1;556;-2.14748e+09;-1.95203e+06;0;0;0;0;0;0;874920658;894521063;69893471
1695;8.16237e-15;-503;1711;20808;15570.1;1;556;-2.14748e+09;-1.94818e+06;-1;0;0;0;-1;0;875074652;894701978;69951802
1696;8.16237e-15;-503;1711;20808;15570.1;1;556;-2.14748e+09;-1.94435e+06;-1;0;0;0;-1;0;875228335;894882561;70010050
1697;8.16237e-15;-503;1711;20808;15570.1;1;556;-2.14748e+09;-1.94053e+06;-1;0;0;0;-1;0;875381708;895062812;70068216
1698;8.16237e-15;-504;1711;20808;15570.1;1;556;-2.14748e+09;-1.93671e+06;0;0;0;0;0;0;875534770;895242732;70126299
1699;8.16237e-15;-504;1711;20808;15570.1;1;556;-2.14748e+09;-1.9329e+06;-1;0;0;0;-1;0;875687524;895422322;70184300
1700;8.16237e-15;-505;1711;20808;15570.1;1;556;-2.14748e+09;-1.92911e+06;0;0;0;0;0;0;875839969;895601583;70242218
1701;8.16237e-15;-505;1711;20808;15570.1;1;556;-2.14748e+09;-1.92532e+06;-1;0;0;0;-1;0;875992106;895780514;70300054
1702;8.16237e-15;-505;1711;20808;15570.1;1;556;-2.14748e+09;-1.92153e+06;-1;0;0;0;-1;0;876143936;895959118;70357808
1703;8.16237e-15;-506;1711;20808;15570.1;1;556;-2.14748e+09;-1.91776e+06;0;0;0;0;0;0;876295460;896137394;70415479
1704;8.16237e-15;-507;1711;20808;15570.1;1;556;-2.14748e+09;-1.91399e+06;0;0;0;0;0;0;876446678;896315342;70473069
1705;8.16237e-15;-508;1711;20808;15570.1;1;556;-2.14748e+09;-1.91024e+06;0;0;0;0;0;0;876597591;896492965;70530576
1706;8.16237e-15;-509;1711;20808;15570.1;1;556;-2.14748e+09;-1.90649e+06;0;0;0;0;0;0;876748200;896670261;70588001
1707;8.16237e-15;-510;1711;20808;15570.1;1;556;-2.14748e+09;-1.90275e+06;0;0;0;0;0;0;876898505;896847233;70645345
1708;8.16237e-15;-511;1711;20808;15570.1;1;556;-2.14748e+09;-1.89901e+06;0;0;0;0;0;0;877048507;897023880;70702607
1709;8.16237e-15;-512;1711;20808;15570.1;1;556;-2.14748e+09;-1.89529e+06;0;0;0;0;0;0;877198207;897200203;70759787
1710;8.16237e-15;-513;1711;20808;15570.1;1;556;-2.14748e+09;-1.89157e+06;0;0;0;0;0;0;877347605;897376203;70816885
1711;8.16237e-15;-514;1711;20808;15570.1;1;556;-2.14748e+09;-1.88786e+06;0;0;0;0;0;0;877496702;897551881;70873901
1712;8.16237e-15;-514;1711;20808;15570.1;1;556;-2.14748e+09;-1.88416e+06;-1;0;0;0;-1;0;877645499;897727237;70930836
1713;8.16237e-15;-515;1711;20808;15570.1;1;556;-2.14748e+09;-1.88047e+06;0;0;0;0;0;0;877793996;897902271;70987690
1714;8.16237e-15;-515;1711;20808;15570.1;1;556;-2.14748e+09;-1.87679e+06;-1;0;0;0;-1;0;877942194;898076985;71044462
1715;8.16237e-15;-515;1711;20808;15570.1;1;556;-2.14748e+09;-1.87311e+06;-1;0;0;0;-1;0;878090094;898251379;71101152
1716;8.16237e-15;-515;1711;20808;15570.1;1;556;-2.14748e+09;-1.86944e+06;-1;0;0;0;-1;0;878237696;898425453;71157761
1717;8.16237e-15;-515;1711;20808;15570.1;1;556;-2.14748e+09;-1.86578e+06;-1;0;0;0;-1;0;878385001;898599208;71214289
1718;8.16237e-15;-515;1711;20808;15570.1;1;556;-2.14748e+09;-1.86213e+06;-1;0;0;0;-1;0;878532010;898772645;71270736
1719;8.16237e-15;-515;1711;20808;15570.1;1;556;-2.14748e+09;-1.85848e+06;-1;0;0;0;-1;0;878678723;898945765;71327102
1720;8.16237e-15;-515;1711;20808;15570.1;1;556;-2.14748e+09;-1.85485e+06;-1;0;0;0;-1;0;878825141;899118568;71383387
1721;8.16237e-15;-516;1711;20808;15570.1;1;556;-2.14748e+09;-1.85122e+06;0;0;0;0;0;0;878971265;899291054;71439591
1722;8.16237e-15;-517;1711;20808;15570.1;1;556;-2.14748e+09;-1.8476e+06;0;0;0;0;0;0;879117095;899463225;71495713
1723;8.16237e-15;-518;1711;20808;15570.1;1;556;-2.14748e+09;-1.84398e+06;0;0;0;0;0;0;879262632;899635081;71551755
1724;8.16237e-15;-518;1711;20808;15570.1;1;556;-2.14748e+09;-1.84038e+06;-1;0;0;0;-1;0;879407876;899806622;71607717
1725;8.16237e-15;-519;1711;20808;15570.1;1;556;-2.14748e+09;-1.83678e+06;0;0;0;0;0;0;879552829;899977849;71663597
1726;8.16237e-15;-519;1711;20808;15570.1;1;556;-2.14748e+09;-1.83319e+06;-1;0;0;0;-1;0;879697490;900148763;71719397
1727;8.16237e-15;-519;1711;20808;15570.1;1;556;-2.14748e+09;-1.82961e+06;-1;0;0;0;-1;0;879841861;900319364;71775117
1728;8.16237e-15;-519;1710;20808;15570.1;1;556;-2.14748e+09;-1.82604e+06;0;0;0;0;0;0;879985943;900489653;71830755
1729;8.16237e-15;-519;1710;20808;15570.1;1;556;-2.14748e+09;-1.82247e+06;-1;0;0;0;-1;0;880129735;900659631;71886314
1730;8.16237e-15;-520;1710;20808;15570.1;1;556;-2.14748e+09;-1.81891e+06;0;0;0;0;0;0;880273238;900829298;71941792
1731;8.16237e-15;-521;1710;20808;15570.1;1;556;-2.14748e+09;-1.81536e+06;0;0;0;0;0;0;880416454;900998655;71997190
1732;8.16237e-15;-522;1710;20808;15570.1;1;556;-2.14748e+09;-1.81182e+06;0;0;0;0;0;0;880559382;901167702;72052508
1733;8.16237e-15;-522;1710;20808;15570.1;1;556;-2.14748e+09;-1.80828e+06;-1;0;0;0;-1;0;880702023;901336440;72107745
1734;8.16237e-15;-522;1710;20808;15570.1;1;556;-2.14748e+09;-1.80476e+06;-1;0;0;0;-1;0;880844379;901504870;72162902
1735;8.16237e-15;-523;1710;20808;15570.1;1;556;-2.14748e+09;-1.80123e+06;0;0;0;0;0;0;880986449;901672992;72217980
1736;8.16237e-15;-523;1710;20808;15570.1;1;556;-2.14748e+09;-1.79772e+06;-1;0;0;0;-1;0;881128234;901840806;72272977
1737;8.16237e-15;-523;1710;20808;15570.1;1;556;-2.14748e+09;-1.79422e+06;-1;0;0;0;-1;0;881269735;902008314;72327895
1738;8.16237e-15;-524;1710;20808;15570.1;1;556;-2.14748e+09;-1.79072e+06;0;0;0;0;0;0;881410953;902175516;72382733
1739;8.16237e-15;-525;1710;20808;15570.1;1;556;-2.14748e+09;-1.78723e+06;0;0;0;0;0;0;881551887;902342412;72437491
1740;8.16237e-15;-526;1710;20808;15570.1;1;556;-2.14748e+09;-1.78375e+06;0;0;0;0;0;0;881692540;902509004;72492170
1741;8.16237e-15;-527;1710;20808;15570.1;1;556;-2.14748e+09;-1.78027e+06;0;0;0;0;0;0;881832910;902675291;72546769
1742;8.16237e-15;-527;1710;20808;15570.1;1;556;-2.14748e+09;-1.7768e+06;-1;0;0;0;-1;0;881973000;902841274;72601288
1743;8.16237e-15;-527;1710;20808;15570.1;1;556;-2.14748e+09;-1.77334e+06;-1;0;0;0;-1;0;882112809;903006954;72655728
1744;8.16237e-15;-527;1710;20808;15570.1;1;556;-2.14748e+09;-1.76989e+06;-1;0;0;0;-1;0;882252339;903172332;72710089
1745;8.16237e-15;-528;1710;20808;15570.1;1;556;-2.14748e+09;-1.76644e+06;0;0;0;0;0;0;882391589;903337408;72764370
1746;8.16237e-15;-528;1710;20808;15570.1;1;556;-2.14748e+09;-1.76301e+06;-1;0;0;0;-1;0;882530560;903502182;72818573
1747;8.16237e-15;-529;1710;20808;15570.1;1;556;-2.14748e+09;-1.75958e+06;0;0;0;0;0;0;882669254;903666656;72872696
1748;8.16237e-15;-530;1710;20808;15570.1;1;556;-2.14748e+09;-1.75615e+06;0;0;0;0;0;0;882807670;903830829;72926740
1749;8.16237e-15;-531;1710;20808;15570.1;1;556;-2.14748e+09;-1.75274e+06;0;0;0;0;0;0;882945809;903994703;72980705
1750;8.16237e-15;-532;1710;20808;15570.1;1;556;-2.14748e+09;-1.74933e+06;0;0;0;0;0;0;883083673;904158278;73034591
1751;8.16237e-15;-532;1710;20808;15570.1;1;556;-2.14748e+09;-1.74593e+06;-1;0;0;0;-1;0;883221260;904321554;73088398
1752;8.16237e-15;-533;1710;20808;15570.1;1;556;-2.14748e+09;-1.74253e+06;0;0;0;0;0;0;883358573;904484532;73142127
1753;8.16237e-15;-533;1710;20808;15570.1;1;556;-2.14748e+09;-1.73914e+06;-1;0;0;0;-1;0;883495611;904647213;73195777
1754;8.16237e-15;-534;1710;20808;15570.1;1;556;-2.14748e+09;-1.73576e+06;0;0;0;0;0;0;883632376;904809597;73249348
1755;8.16237e-15;-534;1710;20808;15570.1;1;556;-2.14748e+09;-1.73239e+06;-1;0;0;0;-1;0;883768867;904971685;73302841
1756;8.16237e-15;-535;1710;20808;15570.1;1;556;-2.14748e+09;-1.72903e+06;0;0;0;0;0;0;883905086;905133478;73356255
1757;8.16237e-15;-536;1710;20808;15570.1;1;556;-2.14748e+09;-1.72567e+06;0;0;0;0;0;0;884041033;905294975;73409591
1758;8.16237e-15;-537;1710;20808;15570.1;1;556;-2.14748e+09;-1.72232e+06;0;0;0;0;0;0;884176709;905456178;73462848
1759;8.16237e-15;-537;1710;20808;15570.1;1;556;-2.14748e+09;-1.71898e+06;-1;0;0;0;-1;0;884312113;905617087;73516028
1760;8.16237e-15;-537;1710;20808;15570.1;1;556;-2.14748e+09;-1.71564e+06;-1;0;0;0;-1;0;884447248;905777702;73569129
1761;8.16237e-15;-537;1710;20808;15570.1;1;556;-2.14748e+09;-1.71231e+06;-1;0;0;0;-1;0;884582113;905938025;73622152
1762;8.16237e-15;-538;1710;20808;15570.1;1;556;-2.14748e+09;-1.70899e+06;0;0;0;0;0;0;884716709;906098055;73675097
1763;8.16237e-15;-538;1710;20808;15570.1;1;556;-2.14748e+09;-1.70567e+06;-1;0;0;0;-1;0;884851036;906257794;73727964
1764;8.16237e-15;-539;1710;20808;15570.1;1;556;-2.14748e+09;-1.70236e+06;0;0;0;0;0;0;884985096;906417242;73780753
1765;8.16237e-15;-539;1710;20808;15570.1;1;556;-2.14748e+09;-1.69906e+06;-1;0;0;0;-1;0;885118888;906576399;73833464
1766;8.16237e-15;-539;1710;20808;15570.1;1;556;-2.14748e+09;-1.69577e+06;-1;0;0;0;-1;0;885252414;906735266;73886098
1767;8.16237e-15;-540;1710;20808;15570.1;1;556;-2.14748e+09;-1.69248e+06;0;0;0;0;0;0;885385674;906893843;73938654
1768;8.16237e-15;-541;1710;20808;15570.1;1;556;-2.14748e+09;-1.6892e+06;0;0;0;0;0;0;885518668;907052132;73991132
1769;8.16237e-15;-541;1710;20808;15570.1;1;556;-2.14748e+09;-1.68592e+06;-1;0;0;0;-1;0;885651397;907210132;74043533
1770;8.16237e-15;-542;1710;20808;15570.1;1;556;-2.14748e+09;-1.68266e+06;0;0;0;0;0;0;885783862;907367845;74095856
1771;8.16237e-15;-543;1710;20808;15570.1;1;556;-2.14748e+09;-1.6794e+06;0;0;0;0;0;0;885916063;907525270;74148102
1772;8.16237e-15;-543;1710;20808;15570.1;1;556;-2.14748e+09;-1.67615e+06;-1;0;0;0;-1;0;886048000;907682408;74200271
1773;8.16237e-15;-544;1710;20808;15570.1;1;556;-2.14748e+09;-1.6729e+06;0;0;0;0;0;0;886179675;907839261;74252363
1774;8.16237e-15;-545;1710;20808;15570.1;1;556;-2.14748e+09;-1.66966e+06;0;0;0;0;0;0;886311088;907995827;74304377
1775;8.16237e-15;-545;1710;20808;15570.1;1;556;-2.14748e+09;-1.66643e+06;-1;0;0;0;-1;0;886442240;908152109;74356315
1776;8.16237e-15;-546;1710;20808;15570.1;1;556;-2.14748e+09;-1.6632e+06;0;0;0;0;0;0;886573131;908308106;74408175
1777;8.16237e-15;-547;1710;20808;15570.1;1;556;-2.14748e+09;-1.65999e+06;0;0;0;0;0;0;886703761;908463819;74459959
1778;8.16237e-15;-548;1710;20808;15570.1;1;556;-2.14748e+09;-1.65677e+06;0;0;0;0;0;0;886834131;908619249;74511666
1779;8.16237e-15;-549;1710;20808;15570.1;1;556;-2.14748e+09;-1.65357e+06;0;0;0;0;0;0;886964242;908774396;74563296
1780;8.16237e-15;-549;1710;20808;15570.1;1;556;-2.14748e+09;-1.65037e+06;-1;0;0;0;-1;0;887094095;908929260;74614849
1781;8.16237e-15;-549;1710;20808;15570.1;1;556;-2.14748e+09;-1.64718e+06;-1;0;0;0;-1;0;887223689;909083843;74666326
1782;8.16237e-15;-549;1710;20808;15570.1;1;556;-2.14748e+09;-1.644e+06;-1;0;0;0;-1;0;887353026;909238144;74717727
1783;8.16237e-15;-549;1710;20808;15570.1;1;556;-2.14748e+09;-1.64082e+06;-1;0;0;0;-1;0;887482105;909392165;74769050
1784;8.16237e-15;-549;1710;20808;15570.1;1;556;-2.14748e+09;-1.63765e+06;-1;0;0;0;-1;0;887610928;909545905;74820298
1785;8.16237e-15;-549;1710;20808;15570.1;1;556;-2.14748e+09;-1.63448e+06;-1;0;0;0;-1;0;887739496;909699366;74871469
1786;8.16237e-15;-550;1710;20808;15570.1;1;556;-2.14748e+09;-1.63132e+06;0;0;0;0;0;0;887867808;909852547;74922564
1787;8.16237e-15;-551;1710;20808;15570.1;1;556;-2.14748e+09;-1.62817e+06;0;0;0;0;0;0;887995865;910005450;74973583
1788;8.16237e-15;-551;1710;20808;15570.1;1;556;-2.14748e+09;-1.62503e+06;-1;0;0;0;-1;0;888123668;910158075;75024526
1789;8.16237e-15;-552;1710;20808;15570.1;1;556;-2.14748e+09;-1.62189e+06;0;0;0;0;0;0;888251217;910310422;75075393
1790;8.16237e-15;-553;1710;20808;15570.1;1;556;-2.14748e+09;-1.61876e+06;0;0;0;0;0;0;888378513;910462493;75126184
1791;8.16237e-15;-554;1710;20808;15570.1;1;556;-2.14748e+09;-1.61563e+06;0;0;0;0;0;0;888505557;910614286;75176899
1792;8.16237e-15;-555;1710;20808;15570.1;1;556;-2.14748e+09;-1.61252e+06;0;0;0;0;0;0;888632348;910765804;75227539
1793;8.16237e-15;-556;1710;20808;15570.1;1;556;-2.14748e+09;-1.6094e+06;0;0;0;0;0;0;888758888;910917046;75278102
1794;8.16237e-15;-557;1710;20808;15570.1;1;556;-2.14748e+09;-1.6063e+06;0;0;0;0;0;0;888885177;911068013;75328591
1795;8.16237e-15;-557;1710;20808;15570.1;1;556;-2.14748e+09;-1.6032e+06;-1;0;0;0;-1;0;889011215;911218706;75379003
1796;8.16237e-15;-558;1710;20808;15570.1;1;556;-2.14748e+09;-1.60011e+06;0;0;0;0;0;0;889137004;911369125;75429341
1797;8.16237e-15;-558;1710;20808;15570.1;1;556;-2.14748e+09;-1.59702e+06;-1;0;0;0;-1;0;889262543;911519271;75479603
1798;8.16237e-15;-558;1710;20808;15570.1;1;556;-2.14748e+09;-1.59394e+06;-1;0;0;0;-1;0;889387833;911669144;75529789
1799;8.16237e-15;-558;1710;20808;15570.1;1;556;-2.14748e+09;-1.59087e+06;-1;0;0;0;-1;0;889512875;911818744;75579901
1800;8.16237e-15;-558;1710;20808;15570.1;1;556;-2.14748e+09;-1.5878e+06;-1;0;0;0;-1;0;889637670;911968073;75629937
1801;8.16237e-15;-558;1710;20808;15570.1;1;556;-2.14748e+09;-1.58474e+06;-1;0;0;0;-1;0;889762217;912117130;75679899
1802;8.16237e-15;-559;1710;20808;15570.1;1;556;-2.14748e+09;-1.58169e+06;0;0;0;0;0;0;889886517;912265916;75729785
1803;8.16237e-15;-560;1710;20808;15570.1;1;556;-2.14748e+09;-1.57864e+06;0;0;0;0;0;0;890010572;912414433;75779597
1804;8.16237e-15;-560;1710;20808;15570.1;1;556;-2.14748e+09;-1.5756e+06;-1;0;0;0;-1;0;890134380;912562679;75829333
1805;8.16237e-15;-560;1710;20808;15570.1;1;556;-2.14748e+09;-1.57257e+06;-1;0;0;0;-1;0;890257944;912710656;75878996
1806;8.16237e-15;-561;1710;20808;15570.1;1;556;-2.14748e+09;-1.56954e+06;0;0;0;0;0;0;890381263;912858364;75928583
1807;8.16237e-15;-562;1710;20808;15570.1;1;556;-2.14748e+09;-1.56652e+06;0;0;0;0;0;0;890504338;913005805;75978096
1808;8.16237e-15;-563;1710;20808;15570.1;1;556;-2.14748e+09;-1.5635e+06;0;0;0;0;0;0;890627169;913152977;76027534
1809;8.16237e-15;-563;1710;20808;15570.1;1;556;-2.14748e+09;-1.56049e+06;-1;0;0;0;-1;0;890749757;913299882;76076898
1810;8.16237e-15;-563;1710;20808;15570.1;1;556;-2.14748e+09;-1.55749e+06;-1;0;0;0;-1;0;890872103;913446520;76126188
1811;8.16237e-15;-563;1710;20808;15570.1;1;556;-2.14748e+09;-1.55449e+06;-1;0;0;0;-1;0;890994207;913592893;76175403
1812;8.16237e-15;-564;1710;20808;15570.1;1;556;-2.14748e+09;-1.5515e+06;0;0;0;0;0;0;891116070;913738999;76224544
1813;8.16237e-15;-565;1710;20808;15570.1;1;556;-2.14748e+09;-1.54852e+06;0;0;0;0;0;0;891237691;913884840;76273611
1814;8.16237e-15;-565;1710;20808;15570.1;1;556;-2.14748e+09;-1.54554e+06;-1;0;0;0;-1;0;891359072;914030417;76322605
1815;8.16237e-15;-565;1710;20808;15570.1;1;556;-2.14748e+09;-1.54257e+06;-1;0;0;0;-1;0;891480214;914175729;76371524
1816;8.16237e-15;-565;1710;20808;15570.1;1;556;-2.14748e+09;-1.5396e+06;-1;0;0;0;-1;0;891601116;914320777;76420369
1817;8.16237e-15;-565;1710;20808;15570.1;1;556;-2.14748e+09;-1.53664e+06;-1;0;0;0;-1;0;891721779;914465563;76469141
1818;8.16237e-15;-566;1710;20808;15570.1;1;556;-2.14748e+09;-1.53369e+06;0;0;0;0;0;0;891842203;914610085;76517839
1819;8.16237e-15;-567;1710;20808;15570.1;1;556;-2.14748e+09;-1.53074e+06;0;0;0;0;0;0;891962390;914754346;76566463
1820;8.16237e-15;-568;1710;20808;15570.1;1;556;-2.14748e+09;-1.5278e+06;0;0;0;0;0;0;892082340;914898344;76615014
1821;8.16237e-15;-569;1710;20808;15570.1;1;556;-2.14748e+09;-1.52487e+06;0;0;0;0;0;0;892202052;915042082;76663491
1822;8.16237e-15;-569;1710;20808;15570.1;1;556;-2.14748e+09;-1.52194e+06;-1;0;0;0;-1;0;892321529;915185558;76711895
1823;8.16237e-15;-570;1710;20808;15570.1;1;556;-2.14748e+09;-1.51902e+06;0;0;0;0;0;0;892440769;915328774;76760226
1824;8.16237e-15;-570;1710;20808;15570.1;1;556;-2.14748e+09;-1.5161e+06;-1;0;0;0;-1;0;892559774;915471731;76808483
1825;8.16237e-15;-570;1710;20808;15570.1;1;556;-2.14748e+09;-1.51319e+06;-1;0;0;0;-1;0;892678544;915614428;76856668
1826;8.16237e-15;-571;1710;20808;15570.1;1;556;-2.14748e+09;-1.51028e+06;0;0;0;0;0;0;892797080;915756867;76904779
1827;8.16237e-15;-571;1710;20808;15570.1;1;556;-2.14748e+09;-1.50738e+06;-1;0;0;0;-1;0;892915383;915899047;76952817
1828;8.16237e-15;-572;1710;20808;15570.1;1;556;-2.14748e+09;-1.50449e+06;0;0;0;0;0;0;893033451;916040969;77000783
1829;8.16237e-15;-572;1710;20808;15570.1;1;556;-2.14748e+09;-1.5016e+06;-1;0;0;0;-1;0;893151287;916182634;77048675
1830;8.16237e-15;-573;1710;20808;15570.1;1;556;-2.14748e+09;-1.49872e+06;0;0;0;0;0;0;893268891;916324042;77096495
1831;8.16237e-15;-573;1710;20808;15570.1;1;556;-2.14748e+09;-1.49585e+06;-1;0;0;0;-1;0;893386263;916465194;77144243
1832;8.16237e-15;-573;1710;20808;15570.1;1;556;-2.14748e+09;-1.49298e+06;-1;0;0;0;-1;0;893503404;916606090;77191917
1833;8.16237e-15;-574;1710;20808;15570.1;1;556;-2.14748e+09;-1.49012e+06;0;0;0;0;0;0;893620313;916746730;77239520
1834;8.16237e-15;-574;1710;20808;15570.1;1;556;-2.14748e+09;-1.48726e+06;-1;0;0;0;-1;0;893736993;916887115;77287049
1835;8.16237e-15;-575;1710;20808;15570.1;1;556;-2.14748e+09;-1.48441e+06;0;0;0;0;0;0;893853442;917027246;77334507
1836;8.16237e-15;-576;1710;20808;15570.1;1;556;-2.14748e+09;-1.48156e+06;0;0;0;0;0;0;893969662;917167123;77381892
1837;8.16237e-15;-577;1710;20808;15570.1;1;556;-2.14748e+09;-1.47872e+06;0;0;0;0;0;0;894085653;917306747;77429205
1838;8.16237e-15;-578;1710;20808;15570.1;1;556;-2.14748e+09;-1.47589e+06;0;0;0;0;0;0;894201416;917446117;77476446
1839;8.16237e-15;-579;1710;20808;15570.1;1;556;-2.14748e+09;-1.47306e+06;0;0;0;0;0;0;894316951;917585235;77523615
1840;8.16237e-15;-579;1710;20808;15570.1;1;556;-2.14748e+09;-1.47024e+06;-1;0;0;0;-1;0;894432259;917724101;77570712
1841;8.16237e-15;-580;1710;20808;15570.1;1;556;-2.14748e+09;-1.46742e+06;0;0;0;0;0;0;894547339;917862715;77617738
1842;8.16237e-15;-581;1710;20808;15570.1;1;556;-2.14748e+09;-1.46462e+06;0;0;0;0;0;0;894662193;918001078;77664691
1843;8.16237e-15;-581;1710;20808;15570.1;1;556;-2.14748e+09;-1.46181e+06;-1;0;0;0;-1;0;894776821;918139190;77711573
1844;8.16237e-15;-581;1710;20808;15570.1;1;556;-2.14748e+09;-1.45901e+06;-1;0;0;0;-1;0;894891224;918277053;77758383
1845;8.16237e-15;-582;1710;20808;15570.1;1;556;-2.14748e+09;-1.45622e+06;0;0;0;0;0;0;895005402;918414665;77805122
1846;8.16237e-15;-582;1710;20808;15570.1;1;556;-2.14748e+09;-1.45343e+06;-1;0;0;0;-1;0;895119355;918552028;77851789
1847;8.16237e-15;-582;1710;20808;15570.1;1;556;-2.14748e+09;-1.45065e+06;-1;0;0;0;-1;0;895233084;918689143;77898385
1848;8.16237e-15;-583;1710;20808;15570.1;1;556;-2.14748e+09;-1.44788e+06;0;0;0;0;0;0;895346589;918826009;77944910
1849;8.16237e-15;-584;1710;20808;15570.1;1;556;-2.14748e+09;-1.4451e+06;0;0;0;0;0;0;895459871;918962627;77991363
1850;8.16237e-15;-584;1710;20808;15570.1;1;556;-2.14748e+09;-1.44234e+06;-1;0;0;0;-1;0;895572931;919098998;78037746
1851;8.16237e-15;-584;1710;20808;15570.1;1;556;-2.14748e+09;-1.43958e+06;-1;0;0;0;-1;0;895685768;919235121;78084057
1852;8.16237e-15;-584;1710;20808;15570.1;1;556;-2.14748e+09;-1.43683e+06;-1;0;0;0;-1;0;895798384;919370999;78130297
1853;8.16237e-15;-585;1710;20808;15570.1;1;556;-2.14748e+09;-1.43408e+06;0;0;0;0;0;0;895910778;919506630;78176467
1854;8.16237e-15;-585;1710;20808;15570.1;1;556;-2.14748e+09;-1.43134e+06;-1;0;0;0;-1;0;896022952;919642016;78222566
1855;8.16237e-15;-586;1710;20808;15570.1;1;556;-2.14748e+09;-1.4286e+06;0;0;0;0;0;0;896134905;919777157;78268594
1856;8.16237e-15;-586;1710;20808;15570.1;1;556;-2.14748e+09;-1.42587e+06;-1;0;0;0;-1;0;896246639;919912053;78314551
1857;8.16237e-15;-587;1710;20808;15570.1;1;556;-2.14748e+09;-1.42315e+06;0;0;0;0;0;0;896358153;920046704;78360438
1858;8.16237e-15;-587;1710;20808;15570.1;1;556;-2.14748e+09;-1.42043e+06;-1;0;0;0;-1;0;896469448;920181113;78406254
1859;8.16237e-15;-587;1710;20808;15570.1;1;556;-2.14748e+09;-1.41771e+06;-1;0;0;0;-1;0;896580525;920315277;78452000
1860;8.16237e-15;-588;1710;20808;15570.1;1;556;-2.14748e+09;-1.41501e+06;0;0;0;0;0;0;896691384;920449199;78497676
1861;8.16237e-15;-588;1710;20808;15570.1;1;556;-2.14748e+09;-1.4123e+06;-1;0;0;0;-1;0;896802025;920582879;78543282
1862;8.16237e-15;-588;1710;20808;15570.1;1;556;-2.14748e+09;-1.40961e+06;-1;0;0;0;-1;0;896912449;920716317;78588817
1863;8.16237e-15;-589;1710;20808;15570.1;1;556;-2.14748e+09;-1.40691e+06;0;0;0;0;0;0;897022657;920849513;78634282
1864;8.16237e-15;-589;1710;20808;15570.1;1;556;-2.14748e+09;-1.40423e+06;-1;0;0;0;-1;0;897132648;920982468;78679678
1865;8.16237e-15;-590;1710;20808;15570.1;1;556;-2.14748e+09;-1.40155e+06;0;0;0;0;0;0;897242424;921115183;78725003
1866;8.16237e-15;-590;1710;20808;15570.1;1;556;-2.14748e+09;-1.39887e+06;-1;0;0;0;-1;0;897351984;921247658;78770259
1867;8.16237e-15;-591;1710;20808;15570.1;1;556;-2.14748e+09;-1.3962e+06;0;0;0;0;0;0;897461330;921379892;78815445
1868;8.16237e-15;-591;1710;20808;15570.1;1;556;-2.14748e+09;-1.39354e+06;-1;0;0;0;-1;0;897570461;921511888;78860561
1869;8.16237e-15;-591;1710;20808;15570.1;1;556;-2.14748e+09;-1.39088e+06;-1;0;0;0;-1;0;897679379;921643645;78905608
1870;8.16237e-15;-591;1710;20808;15570.1;1;556;-2.14748e+09;-1.38823e+06;-1;0;0;0;-1;0;897788083;921775163;78950585
1871;8.16237e-15;-592;1710;20808;15570.1;1;556;-2.14748e+09;-1.38558e+06;0;0;0;0;0;0;897896574;921906444;78995493
1872;8.16237e-15;-593;1710;20808;15570.1;1;556;-2.14748e+09;-1.38294e+06;0;0;0;0;0;0;898004853;922037487;79040331
1873;8.16237e-15;-593;1710;20808;15570.1;1;556;-2.14748e+09;-1.3803e+06;-1;0;0;0;-1;0;898112919;922168293;79085101
1874;8.16237e-15;-593;1710;20808;15570.1;1;556;-2.14748e+09;-1.37767e+06;-1;0;0;0;-1;0;898220774;922298863;79129801
1875;8.16237e-15;-594;1710;20808;15570.1;1;556;-2.14748e+09;-1.37504e+06;0;0;0;0;0;0;898328418;922429197;79174432
1876;8.16237e-15;-594;1710;20808;15570.1;1;556;-2.14748e+09;-1.37242e+06;-1;0;0;0;-1;0;898435850;922559294;79218994
1877;8.16237e-15;-594;1710;20808;15570.1;1;556;-2.14748e+09;-1.3698e+06;-1;0;0;0;-1;0;898543073;922689157;79263487
1878;8.16237e-15;-594;1710;20808;15570.1;1;556;-2.14748e+09;-1.36719e+06;-1;0;0;0;-1;0;898650086;922818785;79307911
1879;8.16237e-15;-594;1710;20808;15570.1;1;556;-2.14748e+09;-1.36459e+06;-1;0;0;0;-1;0;898756889;922948178;79352267
1880;8.16237e-15;-594;1710;20808;15570.1;1;556;-2.14748e+09;-1.36199e+06;-1;0;0;0;-1;0;898863483;923077338;79396554
1881;8.16237e-15;-594;1710;20808;15570.1;1;556;-2.14748e+09;-1.35939e+06;-1;0;0;0;-1;0;898969869;923206264;79440772
1882;8.16237e-15;-594;1710;20808;15570.1;1;556;-2.14748e+09;-1.3568e+06;-1;0;0;0;-1;0;899076047;923334956;79484922
1883;8.16237e-15;-594;1710;20808;15570.1;1;556;-2.14748e+09;-1.35422e+06;-1;0;0;0;-1;0;899182017;923463417;79529004
1884;8.16237e-15;-594;1710;20808;15570.1;1;556;-2.14748e+09;-1.35164e+06;-1;0;0;0;-1;0;899287779;923591645;79573017
1885;8.16237e-15;-594;1710;20808;15570.1;1;556;-2.14748e+09;-1.34907e+06;-1;0;0;0;-1;0;899393335;923719641;79616962
1886;8.16237e-15;-595;1710;20808;15570.1;1;556;-2.14748e+09;-1.3465e+06;0;0;0;0;0;0;899498685;923847406;79660838
1887;8.16237e-15;-595;1710;20808;15570.1;1;556;-2.14748e+09;-1.34393e+06;-1;0;0;0;-1;0;899603828;923974940;79704647
1888;8.16237e-15;-595;1710;20808;15570.1;1;556;-2.14748e+09;-1.34138e+06;-1;0;0;0;-1;0;899708766;924102243;79748388
1889;8.16237e-15;-595;1710;20808;15570.1;1;556;-2.14748e+09;-1.33882e+06;-1;0;0;0;-1;0;899813499;924229317;79792060
1890;8.16237e-15;-595;1710;20808;15570.1;1;556;-2.14748e+09;-1.33628e+06;-1;0;0;0;-1;0;899918028;924356160;79835665
1891;8.16237e-15;-595;1710;20808;15570.1;1;556;-2.14748e+09;-1.33373e+06;-1;0;0;0;-1;0;900022352;924482775;79879202
1892;8.16237e-15;-596;1710;20808;15570.1;1;556;-2.14748e+09;-1.3312e+06;0;0;0;0;0;0;900126472;924609161;79922672
1893;8.16237e-15;-597;1710;20808;15570.1;1;556;-2.14748e+09;-1.32866e+06;0;0;0;0;0;0;900230389;924735318;79966073
1894;8.16237e-15;-597;1710;20808;15570.1;1;556;-2.14748e+09;-1.32614e+06;-1;0;0;0;-1;0;900334104;924861248;80009408
1895;8.16237e-15;-598;1710;20808;15570.1;1;556;-2.14748e+09;-1.32361e+06;0;0;0;0;0;0;900437615;924986950;80052674
1896;8.16237e-15;-599;1710;20808;15570.1;1;556;-2.14748e+09;-1.3211e+06;0;0;0;0;0;0;900540925;925112425;80095874
1897;8.16237e-15;-599;1710;20808;15570.1;1;556;-2.14748e+09;-1.31858e+06;-1;0;0;0;-1;0;900644032;925237673;80139006
1898;8.16237e-15;-599;1710;20808;15570.1;1;556;-2.14748e+09;-1.31608e+06;-1;0;0;0;-1;0;900746939;925362695;80182071
1899;8.16237e-15;-600;1710;20808;15570.1;1;556;-2.14748e+09;-1.31358e+06;0;0;0;0;0;0;900849645;925487491;80225069
1900;8.16237e-15;-601;1710;20808;15570.1;1;556;-2.14748e+09;-1.31108e+06;0;0;0;0;0;0;900952150;925612062;80268000
1901;8.16237e-15;-602;1710;20808;15570.1;1;556;-2.14748e+09;-1.30859e+06;0;0;0;0;0;0;901054456;925736408;80310864
1902;8.16237e-15;-603;1710;20808;15570.1;1;556;-2.14748e+09;-1.3061e+06;0;0;0;0;0;0;901156561;925860529;80353661
1903;8.16237e-15;-603;1710;20808;15570.1;1;556;-2.14748e+09;-1.30362e+06;-1;0;0;0;-1;0;901258468;925984426;80396391
1904;8.16237e-15;-604;1710;20808;15570.1;1;556;-2.14748e+09;-1.30114e+06;0;0;0;0;0;0;901360176;926108099;80439055
1905;8.16237e-15;-604;1710;20808;15570.1;1;556;-2.14748e+09;-1.29867e+06;-1;0;0;0;-1;0;901461685;926231549;80481652
1906;8.16237e-15;-605;1710;20808;15570.1;1;556;-2.14748e+09;-1.2962e+06;0;0;0;0;0;0;901562997;926354776;80524183
1907;8.16237e-15;-605;1710;20808;15570.1;1;556;-2.14748e+09;-1.29374e+06;-1;0;0;0;-1;0;901664111;926477781;80566647
1908;8.16237e-15;-605;1710;20808;15570.1;1;556;-2.14748e+09;-1.29129e+06;-1;0;0;0;-1;0;901765028;926600563;80609044
1909;8.16237e-15;-605;1710;20808;15570.1;1;556;-2.14748e+09;-1.28884e+06;-1;0;0;0;-1;0;901865749;926723124;80651376
1910;8.16237e-15;-606;1710;20808;15570.1;1;556;-2.14748e+09;-1.28639e+06;0;0;0;0;0;0;901966273;926845463;80693641
1911;8.16237e-15;-606;1710;20808;15570.1;1;556;-2.14748e+09;-1.28395e+06;-1;0;0;0;-1;0;902066601;926967582;80735840
1912;8.16237e-15;-606;1710;20808;15570.1;1;556;-2.14748e+09;-1.28151e+06;-1;0;0;0;-1;0;902166734;927089480;80777973
1913;8.16237e-15;-606;1710;20808;15570.1;1;556;-2.14748e+09;-1.27908e+06;-1;0;0;0;-1;0;902266672;927211158;80820040
1914;8.16237e-15;-606;1710;20808;15570.1;1;556;-2.14748e+09;-1.27665e+06;-1;0;0;0;-1;0;902366415;927332616;80862041
1915;8.16237e-15;-607;1710;20808;15570.1;1;556;-2.14748e+09;-1.27423e+06;0;0;0;0;0;0;902465964;927453855;80903976
1916;8.16237e-15;-607;1710;20808;15570.1;1;556;-2.14748e+09;-1.27181e+06;-1;0;0;0;-1;0;902565319;927574876;80945846
1917;8.16237e-15;-607;1710;20808;15570.1;1;556;-2.14748e+09;-1.2694e+06;-1;0;0;0;-1;0;902664481;927695677;80987650
1918;8.16237e-15;-608;1710;20808;15570.1;1;556;-2.14748e+09;-1.26699e+06;0;0;0;0;0;0;902763450;927816261;81029389
1919;8.16237e-15;-609;1710;20808;15570.1;1;556;-2.14748e+09;-1.26459e+06;0;0;0;0;0;0;902862226;927936627;81071062
1920;8.16237e-15;-609;1710;20808;15570.1;1;556;-2.14748e+09;-1.26219e+06;-1;0;0;0;-1;0;902960810;928056776;81112669
1921;8.16237e-15;-610;1710;20808;15570.1;1;556;-2.14748e+09;-1.2598e+06;0;0;0;0;0;0;903059202;928176709;81154212
1922;8.16237e-15;-611;1710;20808;15570.1;1;556;-2.14748e+09;-1.25741e+06;0;0;0;0;0;0;903157402;928296424;81195689
1923;8.16237e-15;-612;1710;20808;15570.1;1;556;-2.14748e+09;-1.25502e+06;0;0;0;0;0;0;903255412;928415924;81237101
1924;8.16237e-15;-612;1710;20808;15570.1;1;556;-2.14748e+09;-1.25265e+06;-1;0;0;0;-1;0;903353231;928535208;81278448
1925;8.16237e-15;-612;1710;20808;15570.1;1;556;-2.14748e+09;-1.25027e+06;-1;0;0;0;-1;0;903450860;928654277;81319730
1926;8.16237e-15;-612;1710;20808;15570.1;1;556;-2.14748e+09;-1.2479e+06;-1;0;0;0;-1;0;903548299;928773131;81360947
1927;8.16237e-15;-612;1710;20808;15570.1;1;556;-2.14748e+09;-1.24554e+06;-1;0;0;0;-1;0;903645548;928891770;81402099
1928;8.16237e-15;-612;1710;20808;15570.1;1;556;-2.14748e+09;-1.24318e+06;-1;0;0;0;-1;0;903742609;929010196;81443187
1929;8.16237e-15;-612;1710;20808;15570.1;1;556;-2.14748e+09;-1.24082e+06;-1;0;0;0;-1;0;903839481;929128408;81484209
1930;8.16237e-15;-612;1710;20808;15570.1;1;556;-2.14748e+09;-1.23847e+06;-1;0;0;0;-1;0;903936164;929246406;81525168
1931;8.16237e-15;-613;1710;20808;15570.1;1;556;-2.14748e+09;-1.23613e+06;0;0;0;0;0;0;904032660;929364192;81566062
1932;8.16237e-15;-613;1710;20808;15570.1;1;556;-2.14748e+09;-1.23378e+06;-1;0;0;0;-1;0;904128968;929481765;81606891
1933;8.16237e-15;-613;1710;20808;15570.1;1;556;-2.14748e+09;-1.23145e+06;-1;0;0;0;-1;0;904225089;929599126;81647656
1934;8.16237e-15;-614;1710;20808;15570.1;1;556;-2.14748e+09;-1.22912e+06;0;0;0;0;0;0;904321023;929716276;81688357
1935;8.16237e-15;-614;1710;20808;15570.1;1;556;-2.14748e+09;-1.22679e+06;-1;0;0;0;-1;0;904416771;929833214;81728994
1936;8.16237e-15;-615;1710;20808;15570.1;1;556;-2.14748e+09;-1.22447e+06;0;0;0;0;0;0;904512333;929949941;81769566
1937;8.16237e-15;-616;1710;20808;15570.1;1;556;-2.14748e+09;-1.22215e+06;0;0;0;0;0;0;904607710;930066458;81810075
1938;8.16237e-15;-616;1710;20808;15570.1;1;556;-2.14748e+09;-1.21984e+06;-1;0;0;0;-1;0;904702901;930182764;81850519
1939;8.16237e-15;-616;1710;20808;15570.1;1;556;-2.14748e+09;-1.21753e+06;-1;0;0;0;-1;0;904797908;930298861;81890900
1940;8.16237e-15;-617;1710;20808;15570.1;1;556;-2.14748e+09;-1.21522e+06;0;0;0;0;0;0;904892730;930414749;81931217
1941;8.16237e-15;-618;1710;20808;15570.1;1;556;-2.14748e+09;-1.21293e+06;0;0;0;0;0;0;904987368;930530427;81971471
1942;8.16237e-15;-618;1710;20808;15570.1;1;556;-2.14748e+09;-1.21063e+06;-1;0;0;0;-1;0;905081823;930645897;82011661
1943;8.16237e-15;-619;1710;20808;15570.1;1;556;-2.14748e+09;-1.20834e+06;0;0;0;0;0;0;905176094;930761159;82051787
1944;8.16237e-15;-619;1710;20808;15570.1;1;556;-2.14748e+09;-1.20606e+06;-1;0;0;0;-1;0;905270183;930876213;82091850
1945;8.16237e-15;-620;1710;20808;15570.1;1;556;-2.14748e+09;-1.20377e+06;0;0;0;0;0;0;905364088;930991059;82131850
1946;8.16237e-15;-620;1710;20808;15570.1;1;556;-2.14748e+09;-1.2015e+06;-1;0;0;0;-1;0;905457812;931105698;82171786
1947;8.16237e-15;-620;1710;20808;15570.1;1;556;-2.14748e+09;-1.19923e+06;-1;0;0;0;-1;0;905551354;931220131;82211659
1948;8.16237e-15;-621;1710;20808;15570.1;1;556;-2.14748e+09;-1.19696e+06;0;0;0;0;0;0;905644715;931334357;82251469
1949;8.16237e-15;-622;1710;20808;15570.1;1;556;-2.14748e+09;-1.1947e+06;0;0;0;0;0;0;905737895;931448378;82291216
1950;8.16237e-15;-623;1710;20808;15570.1;1;556;-2.14748e+09;-1.19244e+06;0;0;0;0;0;0;905830894;931562193;82330900
1951;8.16237e-15;-624;1710;20808;15570.1;1;556;-2.14748e+09;-1.19018e+06;0;0;0;0;0;0;905923712;931675802;82370522
1952;8.16237e-15;-624;1710;20808;15570.1;1;556;-2.14748e+09;-1.18793e+06;-1;0;0;0;-1;0;906016351;931789207;82410080
1953;8.16237e-15;-624;1710;20808;15570.1;1;556;-2.14748e+09;-1.18569e+06;-1;0;0;0;-1;0;906108810;931902408;82449576
1954;8.16237e-15;-625;1710;20808;15570.1;1;556;-2.14748e+09;-1.18345e+06;0;0;0;0;0;0;906201091;932015404;82489009
1955;8.16237e-15;-626;1710;20808;15570.1;1;556;-2.14748e+09;-1.18121e+06;0;0;0;0;0;0;906293192;932128197;82528380
1956;8.16237e-15;-626;1710;20808;15570.1;1;556;-2.14748e+09;-1.17898e+06;-1;0;0;0;-1;0;906385115;932240786;82567688
1957;8.16237e-15;-626;1710;20808;15570.1;1;556;-2.14748e+09;-1.17675e+06;-1;0;0;0;-1;0;906476860;932353173;82606934
1958;8.16237e-15;-626;1710;20808;15570.1;1;556;-2.14748e+09;-1.17453e+06;-1;0;0;0;-1;0;906568428;932465357;82646117
1959;8.16237e-15;-626;1710;20808;15570.1;1;556;-2.14748e+09;-1.17231e+06;-1;0;0;0;-1;0;906659818;932577338;82685239
1960;8.16237e-15;-626;1710;20808;15570.1;1;556;-2.14748e+09;-1.1701e+06;-1;0;0;0;-1;0;906751031;932689118;82724298
1961;8.16237e-15;-626;1710;20808;15570.1;1;556;-2.14748e+09;-1.16789e+06;-1;0;0;0;-1;0;906842067;932800697;82763295
1962;8.16237e-15;-627;1710;20808;15570.1;1;556;-2.14748e+09;-1.16568e+06;0;0;0;0;0;0;906932927;932912074;82802230
1963;8.16237e-15;-628;1710;20808;15570.1;1;556;-2.14748e+09;-1.16348e+06;0;0;0;0;0;0;907023612;933023251;82841104
1964;8.16237e-15;-628;1710;20808;15570.1;1;556;-2.14748e+09;-1.16129e+06;-1;0;0;0;-1;0;907114121;933134227;82879915
1965;8.16237e-15;-628;1710;20808;15570.1;1;556;-2.14748e+09;-1.1591e+06;-1;0;0;0;-1;0;907204455;933245004;82918665
1966;8.16237e-15;-629;1710;20808;15570.1;1;556;-2.14748e+09;-1.15691e+06;0;0;0;0;0;0;907294614;933355581;82957353
1967;8.16237e-15;-630;1710;20808;15570.1;1;556;-2.14748e+09;-1.15472e+06;0;0;0;0;0;0;907384598;933465958;82995980
1968;8.16237e-15;-630;1710;20808;15570.1;1;556;-2.14748e+09;-1.15255e+06;-1;0;0;0;-1;0;907474409;933576137;83034545
1969;8.16237e-15;-630;1710;20808;15570.1;1;556;-2.14748e+09;-1.15037e+06;-1;0;0;0;-1;0;907564046;933686117;83073048
1970;8.16237e-15;-630;1710;20808;15570.1;1;556;-2.14748e+09;-1.1482e+06;-1;0;0;0;-1;0;907653509;933795899;83111491
1971;8.16237e-15;-630;1710;20808;15570.1;1;556;-2.14748e+09;-1.14604e+06;-1;0;0;0;-1;0;907742800;933905484;83149872
1972;8.16237e-15;-630;1710;20808;15570.1;1;556;-2.14748e+09;-1.14387e+06;-1;0;0;0;-1;0;907831918;934014871;83188192
1973;8.16237e-15;-631;1710;20808;15570.1;1;556;-2.14748e+09;-1.14172e+06;0;0;0;0;0;0;907920863;934124060;83226451
1974;8.16237e-15;-632;1710;20808;15570.1;1;556;-2.14748e+09;-1.13956e+06;0;0;0;0;0;0;908009637;934233054;83264649
1975;8.16237e-15;-633;1710;20808;15570.1;1;556;-2.14748e+09;-1.13741e+06;0;0;0;0;0;0;908098239;934341850;83302786
1976;8.16237e-15;-633;1710;20808;15570.1;1;556;-2.14748e+09;-1.13527e+06;-1;0;0;0;-1;0;908186670;934450451;83340862
1977;8.16237e-15;-634;1710;20808;15570.1;1;556;-2.14748e+09;-1.13313e+06;0;0;0;0;0;0;908274930;934558856;83378878
1978;8.16237e-15;-635;1710;20808;15570.1;1;556;-2.14748e+09;-1.13099e+06;0;0;0;0;0;0;908363020;934667066;83416833
1979;8.16237e-15;-636;1710;20808;15570.1;1;556;-2.14748e+09;-1.12886e+06;0;0;0;0;0;0;908450939;934775081;83454727
1980;8.16237e-15;-637;1710;20808;15570.1;1;556;-2.14748e+09;-1.12673e+06;0;0;0;0;0;0;908538689;934882902;83492561
1981;8.16237e-15;-638;1710;20808;15570.1;1;556;-2.14748e+09;-1.12461e+06;0;0;0;0;0;0;908626269;934990528;83530334
1982;8.16237e-15;-639;1710;20808;15570.1;1;556;-2.14748e+09;-1.12249e+06;0;0;0;0;0;0;908713680;935097960;83568047
1983;8.16237e-15;-639;1710;20808;15570.1;1;556;-2.14748e+09;-1.12037e+06;-1;0;0;0;-1;0;908800922;935205199;83605699
1984;8.16237e-15;-639;1710;20808;15570.1;1;556;-2.14748e+09;-1.11826e+06;-1;0;0;0;-1;0;908887996;935312245;83643292
1985;8.16237e-15;-639;1710;20808;15570.1;1;556;-2.14748e+09;-1.11616e+06;-1;0;0;0;-1;0;908974902;935419098;83680824
1986;8.16237e-15;-639;1710;20808;15570.1;1;556;-2.14748e+09;-1.11405e+06;-1;0;0;0;-1;0;909061640;935525759;83718297
1987;8.16237e-15;-639;1710;20808;15570.1;1;556;-2.14748e+09;-1.11196e+06;-1;0;0;0;-1;0;909148211;935632227;83755709
1988;8.16237e-15;-640;1710;20808;15570.1;1;556;-2.14748e+09;-1.10986e+06;0;0;0;0;0;0;909234614;935738504;83793061
1989;8.16237e-15;-640;1710;20808;15570.1;1;556;-2.14748e+09;-1.10777e+06;-1;0;0;0;-1;0;909320851;935844590;83830354
1990;8.16237e-15;-640;1710;20808;15570.1;1;556;-2.14748e+09;-1.10568e+06;-1;0;0;0;-1;0;909406922;935950484;83867587
1991;8.16237e-15;-640;1710;20808;15570.1;1;556;-2.14748e+09;-1.1036e+06;-1;0;0;0;-1;0;909492826;936056188;83904761
1992;8.16237e-15;-640;1710;20808;15570.1;1;556;-2.14748e+09;-1.10152e+06;-1;0;0;0;-1;0;909578565;936161701;83941874
1993;8.16237e-15;-641;1710;20808;15570.1;1;556;-2.14748e+09;-1.09945e+06;0;0;0;0;0;0;909664138;936267025;83978929
1994;8.16237e-15;-641;1710;20808;15570.1;1;556;-2.14748e+09;-1.09738e+06;-1;0;0;0;-1;0;909749546;936372159;84015924
1995;8.16237e-15;-641;1710;20808;15570.1;1;556;-2.14748e+09;-1.09532e+06;-1;0;0;0;-1;0;909834790;936477103;84052859
1996;8.16237e-15;-642;1710;20808;15570.1;1;556;-2.14748e+09;-1.09325e+06;0;0;0;0;0;0;909919870;936581859;84089736
1997;8.16237e-15;-642;1710;20808;15570.1;1;556;-2.14748e+09;-1.0912e+06;-1;0;0;0;-1;0;910004785;936686426;84126553
1998;8.16237e-15;-643;1710;20808;15570.1;1;556;-2.14748e+09;-1.08914e+06;0;0;0;0;0;0;910089537;936790805;84163311
1999;8.16237e-15;-643;1710;20808;15570.1;1;556;-2.14748e+09;-1.08709e+06;-1;0;0;0;-1;0;910174125;936894995;84200011
