step;volume;A_0;B_0;C;L;p;Compl;Aext;Bext;A_ingresso;A_uscita;B_ingresso;B_uscita;A_netto;B_netto;Avicino;Amedio;Alontano
0;4.18816e-15;391;374;96;10000;1;4;980;1000;527;133;508;135;394;373;980;2;0
1;4.18816e-15;380;367;98;10001;1;2;943;980;498;129;476;141;369;335;943;2;0
2;4.18879e-15;403;421;96;10002;1;4;909;961;509;179;486;190;330;296;909;5;0
3;4.18942e-15;413;453;91;10002;1;9;882;943;452;245;480;203;207;277;882;7;0
4;4.18942e-15;410;474;88;10002;1;12;857;925;400;221;481;222;179;259;857;7;0
5;4.18942e-15;437;460;89;10002;1;12;832;907;415;205;458;217;210;241;832;8;0
6;4.18942e-15;416;439;89;10002;1;13;808;890;399;205;453;237;194;216;808;8;0
7;4.18942e-15;399;394;89;10002;1;15;785;873;423;227;406;228;196;178;785;8;0
8;4.18942e-15;355;425;89;10002;1;16;763;857;383;198;425;192;185;233;763;7;0
9;4.18942e-15;357;463;89;10002;1;16;744;841;321;195;433;214;126;219;744;7;0
10;4.18942e-15;337;439;87;10003;1;18;723;826;371;182;407;236;189;171;723;7;0
11;4.19005e-15;363;413;89;10003;1;19;701;811;392;171;414;230;221;184;701;7;0
12;4.19005e-15;377;408;87;10005;1;21;680;796;373;179;439;211;194;228;680;6;0
13;4.19131e-15;346;372;88;10006;1;21;662;782;360;191;396;226;169;170;662;6;0
14;4.19195e-15;310;395;84;10006;1;25;644;768;326;151;392;198;175;194;644;6;0
15;4.19195e-15;316;360;80;10007;1;30;626;755;330;159;396;213;171;183;626;6;0
16;4.19258e-15;317;370;84;10007;1;29;611;741;301;156;385;189;145;196;611;6;0
17;4.19258e-15;341;391;88;10007;1;28;596;728;288;158;393;187;130;206;596;6;0
18;4.19258e-15;287;354;90;10007;1;27;583;716;286;176;354;202;110;152;583;6;0
19;4.19258e-15;269;337;84;10008;1;33;568;704;291;139;359;185;152;174;568;6;0
20;4.19321e-15;240;312;86;10008;1;32;555;692;271;157;350;181;114;169;555;6;0
21;4.19321e-15;273;354;92;10008;1;30;540;680;279;122;373;155;157;218;540;6;0
22;4.19321e-15;301;324;92;10009;1;30;528;669;242;131;345;181;111;164;528;6;0
23;4.19384e-15;272;330;91;10009;1;31;515;658;281;142;313;163;139;150;515;6;0
24;4.19384e-15;259;329;97;10009;1;28;503;647;263;130;336;149;133;187;503;6;0
25;4.19384e-15;235;315;98;10011;1;28;492;636;230;127;355;152;103;203;492;6;0
26;4.1951e-15;263;287;96;10011;1;30;480;626;240;109;301;174;131;127;480;6;0
27;4.1951e-15;263;277;94;10013;1;32;470;616;248;139;311;131;109;180;470;7;0
28;4.19637e-15;248;304;92;10014;1;34;461;606;212;124;293;133;88;160;461;7;0
29;4.197e-15;239;313;92;10015;1;34;453;596;210;147;291;143;63;148;453;7;0
30;4.19763e-15;228;285;92;10015;1;35;443;587;218;98;323;164;120;159;443;7;0
31;4.19763e-15;228;300;93;10015;1;35;432;578;251;116;283;126;135;157;432;8;0
32;4.19763e-15;212;288;93;10016;1;36;423;569;227;124;289;159;103;130;423;8;0
33;4.19826e-15;219;308;93;10016;1;36;413;560;217;91;278;125;126;153;413;8;0
34;4.19826e-15;223;282;91;10016;1;38;404;552;213;106;257;134;107;123;404;9;0
35;4.19826e-15;185;298;94;10017;1;37;396;544;221;117;302;138;104;164;396;9;0
36;4.1989e-15;204;243;95;10017;1;37;388;536;189;89;278;156;100;122;388;9;0
37;4.1989e-15;211;274;93;10017;1;39;380;528;208;111;272;131;97;141;380;10;0
38;4.1989e-15;199;259;96;10017;1;38;373;520;174;101;281;144;73;137;373;10;0
39;4.1989e-15;166;256;97;10019;1;38;367;513;176;93;261;123;83;138;367;10;0
40;4.20016e-15;175;241;96;10019;1;39;360;506;175;87;250;120;88;130;360;11;0
41;4.20016e-15;174;244;95;10020;1;40;353;499;181;84;251;126;97;125;353;11;0
42;4.20079e-15;160;264;95;10021;1;40;345;492;181;74;258;119;107;139;345;12;0
43;4.20142e-15;182;235;99;10023;1;38;339;485;174;94;274;136;80;138;339;12;0
44;4.20269e-15;178;246;99;10024;1;39;333;478;168;88;269;141;80;128;333;12;0
45;4.20332e-15;146;232;107;10026;1;35;327;472;178;92;232;124;86;108;327;13;0
46;4.20458e-15;162;216;109;10027;1;34;321;466;158;67;249;127;91;122;321;14;0
47;4.20522e-15;150;223;108;10027;1;35;315;460;173;76;218;93;97;125;315;14;0
48;4.20522e-15;156;241;111;10028;1;34;310;454;144;82;230;120;62;110;310;15;0
49;4.20585e-15;154;224;112;10028;1;34;305;448;158;75;250;122;83;128;305;15;0
50;4.20585e-15;161;205;111;10028;1;35;299;442;153;67;217;113;86;104;299;16;0
51;4.20585e-15;174;215;109;10030;1;37;295;437;149;79;199;105;70;94;295;16;0
52;4.20711e-15;150;181;109;10032;1;37;291;432;132;77;204;114;55;90;291;17;0
53;4.20838e-15;143;214;108;10032;1;38;286;426;137;60;217;94;77;123;286;17;0
54;4.20838e-15;145;212;109;10032;1;38;281;421;148;69;220;108;79;112;281;18;0
55;4.20838e-15;158;225;108;10032;1;39;277;416;134;67;186;100;67;86;277;18;0
56;4.20838e-15;151;220;109;10035;1;39;274;412;134;85;216;118;49;98;274;18;0
57;4.21028e-15;132;195;110;10036;1;40;270;407;132;70;207;104;62;103;270;19;0
58;4.21091e-15;149;183;112;10037;1;39;267;402;114;62;192;97;52;95;267;19;0
59;4.21154e-15;134;217;114;10038;1;38;265;398;117;83;223;99;34;124;265;20;0
60;4.21217e-15;128;174;116;10039;1;37;260;393;128;57;212;100;71;112;260;20;0
61;4.21281e-15;120;189;117;10041;1;37;256;389;143;61;181;86;82;95;256;21;0
62;4.21407e-15;120;190;117;10041;1;38;251;385;139;60;212;96;79;116;251;21;0
63;4.21407e-15;105;194;119;10042;1;37;247;381;134;59;177;92;75;85;247;22;0
64;4.21471e-15;114;184;120;10042;1;37;244;377;112;57;206;94;55;112;244;22;0
65;4.21471e-15;135;179;120;10044;1;38;242;373;118;66;203;102;52;101;242;23;0
66;4.21597e-15;127;185;122;10045;1;37;239;370;114;54;176;93;60;83;239;24;0
67;4.2166e-15;120;206;122;10046;1;37;236;366;115;67;202;90;48;112;236;24;0
68;4.21724e-15;130;193;123;10048;1;37;232;362;133;55;188;102;78;86;232;25;0
69;4.2185e-15;117;190;125;10049;1;36;230;359;112;60;185;93;52;92;230;26;0
70;4.21914e-15;109;192;127;10050;1;35;226;356;121;52;194;94;69;100;226;27;0
71;4.21977e-15;101;159;124;10050;1;38;223;352;119;60;164;79;59;85;223;26;0
72;4.21977e-15;119;158;127;10051;1;37;221;349;107;57;165;91;50;74;221;27;0
73;4.2204e-15;119;172;124;10051;1;40;219;346;108;60;155;93;48;62;219;28;0
74;4.2204e-15;105;175;125;10052;1;40;217;343;109;59;164;89;50;75;217;29;0
75;4.22103e-15;116;181;126;10055;1;40;213;340;117;49;186;95;68;91;213;30;0
76;4.22293e-15;114;179;126;10055;1;40;211;337;116;56;175;97;60;78;211;30;0
77;4.22293e-15;119;151;127;10056;1;40;208;335;116;52;171;74;64;97;208;31;0
78;4.22357e-15;117;165;126;10057;1;41;206;332;109;53;140;62;56;78;206;31;0
79;4.2242e-15;97;169;126;10059;1;42;204;329;110;62;170;79;48;91;204;31;0
80;4.22547e-15;109;184;126;10060;1;42;202;327;96;44;156;71;52;85;202;32;0
81;4.2261e-15;95;177;126;10061;1;42;199;324;94;38;171;76;56;95;199;33;0
82;4.22673e-15;114;150;123;10062;1;45;197;322;89;33;152;92;56;60;197;34;0
83;4.22737e-15;101;157;120;10063;1;48;195;319;92;41;167;63;51;104;195;35;0
84;4.228e-15;101;163;118;10063;1;50;194;317;95;62;164;76;33;88;194;35;0
85;4.228e-15;79;166;121;10064;1;49;191;315;112;48;141;90;64;51;191;36;0
86;4.22863e-15;82;176;123;10064;1;48;189;313;103;40;151;72;63;79;189;37;0
87;4.22863e-15;101;167;125;10065;1;47;187;311;95;36;166;93;59;73;187;37;0
88;4.22927e-15;87;156;125;10066;1;47;186;308;81;51;150;79;30;71;186;37;0
89;4.2299e-15;76;171;125;10067;1;47;185;306;82;42;155;82;40;73;185;38;0
90;4.23053e-15;75;154;129;10068;1;45;183;305;97;46;148;81;51;67;183;39;0
91;4.23117e-15;96;137;130;10068;1;45;182;303;82;52;165;64;30;101;182;40;0
92;4.23117e-15;95;130;128;10069;1;47;181;301;83;51;139;83;32;56;181;40;0
93;4.2318e-15;86;162;131;10071;1;46;181;299;85;63;159;76;22;83;181;41;0
94;4.23307e-15;90;163;133;10071;1;45;179;297;102;43;151;81;59;70;179;41;0
95;4.23307e-15;88;140;135;10071;1;44;177;296;93;45;142;75;48;67;177;42;0
96;4.23307e-15;101;148;135;10071;1;44;176;294;93;49;165;74;44;91;176;43;0
97;4.23307e-15;96;152;135;10071;1;44;174;292;102;49;128;72;53;56;174;43;0
98;4.23307e-15;87;145;139;10072;1;42;173;291;83;51;151;76;32;75;173;43;0
99;4.2337e-15;84;143;140;10074;1;42;172;289;94;39;140;60;55;80;172;44;0
100;4.23497e-15;95;156;140;10075;1;42;170;288;89;45;135;73;44;62;170;44;0
101;4.2356e-15;98;141;141;10077;1;42;168;286;92;36;152;79;56;73;168;46;0
102;4.23687e-15;86;136;143;10077;1;41;167;285;86;41;141;71;45;70;167;45;0
103;4.23687e-15;77;142;140;10078;1;45;167;284;68;45;148;81;23;67;167;46;0
104;4.23751e-15;75;124;138;10080;1;47;165;282;100;40;151;75;60;76;165;47;0
105;4.23877e-15;72;131;139;10082;1;47;164;281;76;41;160;69;35;91;164;47;0
106;4.24004e-15;82;127;145;10084;1;44;163;280;83;31;141;60;52;81;163;48;0
107;4.24131e-15;79;154;147;10086;1;43;162;279;78;39;133;59;39;74;162;49;0
108;4.24258e-15;59;135;149;10087;1;42;161;278;81;41;153;92;40;61;161;50;0
109;4.24321e-15;82;145;149;10089;1;42;161;277;68;42;127;54;26;73;161;50;0
110;4.24448e-15;79;166;151;10090;1;41;159;275;80;36;160;71;44;89;159;51;0
111;4.24511e-15;68;141;151;10092;1;41;159;274;73;36;127;98;37;29;159;51;0
112;4.24638e-15;67;137;151;10096;1;41;158;273;72;38;133;60;34;73;158;52;0
113;4.24892e-15;69;125;149;10097;1;43;157;272;82;44;152;63;38;89;157;53;0
114;4.24956e-15;90;113;146;10097;1;46;157;272;77;51;129;57;26;72;157;53;0
115;4.24956e-15;82;111;145;10097;1;47;156;271;75;38;113;62;37;51;156;54;0
116;4.24956e-15;80;117;147;10099;1;46;155;270;77;36;128;59;41;69;155;54;0
117;4.25082e-15;73;132;148;10101;1;46;154;269;79;39;141;63;40;78;154;55;0
118;4.25209e-15;73;133;149;10101;1;46;153;268;75;31;139;68;44;71;153;55;0
119;4.25209e-15;97;104;152;10102;1;45;152;267;79;33;124;69;46;55;152;56;0
120;4.25273e-15;98;126;154;10103;1;44;151;266;80;39;154;50;41;104;151;57;0
121;4.25336e-15;82;121;156;10105;1;43;150;266;87;46;125;63;41;62;150;57;0
122;4.25463e-15;91;125;158;10106;1;42;150;265;69;41;134;67;28;67;150;58;0
123;4.25527e-15;66;153;158;10107;1;42;150;264;61;50;117;62;11;55;150;58;0
124;4.2559e-15;66;135;160;10107;1;42;149;264;80;37;129;58;43;71;149;59;0
125;4.2559e-15;66;121;159;10109;1;43;149;263;70;38;128;76;32;52;149;59;0
126;4.25717e-15;71;128;158;10110;1;44;148;262;76;34;134;63;42;71;148;61;0
127;4.25781e-15;83;133;157;10111;1;45;146;262;96;31;116;53;65;63;146;60;0
128;4.25844e-15;65;142;162;10112;1;43;145;261;83;39;106;68;44;38;145;61;0
129;4.25908e-15;64;132;162;10116;1;43;144;261;82;33;102;78;49;24;144;61;0
130;4.26162e-15;73;147;164;10117;1;42;143;260;67;24;92;55;43;37;143;62;0
131;4.26225e-15;75;126;166;10117;1;41;142;260;68;31;118;69;37;49;142;62;0
132;4.26225e-15;63;143;169;10118;1;40;141;259;79;35;121;67;44;54;141;62;0
133;4.26289e-15;66;133;169;10120;1;40;141;259;62;31;141;62;31;79;141;63;0
134;4.26416e-15;71;127;169;10121;1;40;140;258;72;36;124;65;36;59;140;64;0
135;4.26479e-15;73;125;170;10124;1;40;140;258;78;34;133;61;44;72;140;64;0
136;4.2667e-15;66;131;169;10124;1;41;139;257;66;29;147;58;37;89;139;64;0
137;4.2667e-15;60;145;168;10124;1;42;139;257;53;36;133;75;17;58;139;64;0
138;4.2667e-15;72;150;168;10125;1;42;139;257;68;35;129;80;33;49;139;65;0
139;4.26733e-15;73;128;166;10126;1;44;140;256;61;44;131;70;17;61;140;66;0
140;4.26797e-15;66;137;168;10127;1;43;139;256;70;36;118;57;34;61;139;65;0
141;4.26861e-15;66;138;170;10127;1;42;138;255;71;30;125;53;41;72;138;66;0
142;4.26861e-15;71;124;176;10128;1;39;137;255;74;31;127;52;43;75;137;67;0
143;4.26924e-15;67;118;175;10129;1;40;138;255;64;40;120;77;24;43;138;68;0
144;4.26988e-15;62;120;174;10129;1;41;137;255;66;36;143;57;30;86;137;68;0
145;4.26988e-15;50;118;174;10130;1;41;136;254;79;25;120;78;54;42;136;69;0
146;4.27051e-15;59;113;173;10131;1;42;135;254;82;29;127;48;53;79;135;69;0
147;4.27115e-15;60;126;175;10131;1;41;134;254;64;26;131;53;38;78;134;68;0
148;4.27115e-15;58;121;175;10132;1;41;134;254;56;37;154;73;19;81;134;68;0
149;4.27178e-15;60;117;175;10132;1;41;134;253;68;27;126;69;41;57;134;69;0
150;4.27178e-15;59;113;177;10132;1;40;133;253;64;29;103;67;35;36;133;70;0
151;4.27178e-15;66;127;177;10136;1;40;132;253;76;27;137;62;49;75;132;71;0
152;4.27433e-15;73;141;179;10137;1;39;131;253;70;27;128;61;43;67;131;71;0
153;4.27496e-15;77;138;179;10138;1;39;131;253;79;35;102;60;44;42;131;72;0
154;4.2756e-15;69;135;180;10141;1;39;131;253;64;39;127;61;25;66;131;71;0
155;4.27751e-15;67;133;184;10142;1;37;131;252;58;39;132;59;19;73;131;71;0
156;4.27814e-15;57;137;183;10142;1;38;131;252;74;42;133;54;32;79;131;72;0
157;4.27814e-15;63;143;182;10143;1;39;131;252;64;31;122;69;33;53;131;72;0
158;4.27878e-15;67;135;186;10146;1;37;130;252;77;37;129;69;40;60;130;71;0
159;4.28069e-15;64;132;184;10147;1;40;130;252;64;31;129;65;33;64;130;72;0
160;4.28132e-15;52;133;184;10148;1;40;130;252;56;31;128;57;25;71;130;72;0
161;4.28196e-15;59;159;184;10151;1;40;130;252;55;23;140;53;32;87;130;73;0
162;4.28387e-15;60;136;184;10152;1;40;130;252;53;28;132;80;25;52;130;73;0
163;4.2845e-15;65;148;183;10152;1;41;129;252;58;16;121;57;42;64;129;74;0
164;4.2845e-15;74;152;180;10152;1;44;129;252;60;36;121;63;24;58;129;75;0
165;4.2845e-15;73;149;180;10152;1;44;129;252;77;36;130;66;41;64;129;75;0
166;4.2845e-15;71;159;184;10153;1;42;129;252;64;40;122;66;24;56;129;74;0
167;4.28514e-15;67;130;185;10153;1;42;128;252;64;28;131;93;36;38;128;74;0
168;4.28514e-15;58;124;186;10153;1;42;128;252;61;34;130;74;27;56;128;75;0
169;4.28514e-15;65;129;188;10155;1;41;128;252;61;29;132;69;32;63;128;75;0
170;4.28641e-15;65;120;188;10157;1;42;128;252;68;37;116;68;31;48;128;76;0
171;4.28768e-15;59;129;191;10160;1;41;127;252;80;35;137;71;45;66;127;75;0
172;4.28959e-15;47;106;193;10160;1;40;127;252;61;38;129;58;23;71;127;76;0
173;4.28959e-15;48;127;195;10161;1;39;127;252;58;24;145;67;34;78;127;77;0
174;4.29023e-15;69;132;195;10161;1;39;127;252;64;27;125;66;37;59;127;78;0
175;4.29023e-15;63;129;194;10161;1;40;127;252;57;34;123;55;23;68;127;79;0
176;4.29023e-15;64;130;191;10162;1;43;126;252;63;28;135;53;35;82;126;78;0
177;4.29087e-15;65;134;193;10163;1;43;126;252;54;28;140;68;26;72;126;78;0
178;4.2915e-15;60;124;194;10164;1;43;126;252;70;40;129;71;30;58;126;79;0
179;4.29214e-15;67;132;194;10165;1;43;126;252;69;27;118;72;42;46;126;80;0
180;4.29278e-15;69;119;194;10165;1;44;126;252;59;35;135;65;24;70;126;79;0
181;4.29278e-15;68;120;194;10165;1;44;126;252;60;37;104;59;23;45;126;79;0
182;4.29278e-15;68;130;199;10166;1;42;125;252;73;34;126;44;39;82;125;81;0
183;4.29341e-15;72;137;198;10168;1;43;126;252;52;30;140;68;22;72;126;82;0
184;4.29469e-15;61;125;201;10171;1;42;125;252;71;39;118;71;32;47;125;81;0
185;4.2966e-15;67;108;196;10171;1;47;125;253;67;29;118;54;38;64;125;82;0
186;4.2966e-15;68;105;196;10173;1;47;124;253;64;26;108;62;38;46;124;82;0
187;4.29787e-15;70;110;195;10174;1;48;125;253;46;32;140;62;14;78;125;82;0
188;4.29851e-15;60;121;196;10177;1;48;124;253;77;34;131;58;43;73;124;82;0
189;4.30042e-15;60;111;196;10179;1;48;124;253;51;20;125;54;31;71;124;84;0
190;4.30169e-15;59;99;197;10179;1;48;125;253;52;38;130;58;14;72;125;82;0
191;4.30169e-15;66;110;198;10180;1;48;124;253;73;28;146;62;45;84;124;83;0
192;4.30233e-15;69;111;199;10181;1;48;124;254;52;37;130;59;15;71;124;83;0
193;4.30297e-15;66;138;203;10181;1;46;124;254;62;32;126;65;30;61;124;84;0
194;4.30297e-15;53;122;208;10182;1;44;124;254;63;40;119;64;23;55;124;84;0
195;4.3036e-15;56;127;208;10183;1;44;124;254;60;31;123;53;29;70;124;84;0
196;4.30424e-15;50;124;210;10183;1;43;125;254;52;36;129;59;16;70;125;83;0
197;4.30424e-15;61;114;210;10184;1;43;124;254;64;30;121;56;34;65;124;83;0
198;4.30488e-15;65;132;211;10185;1;43;123;254;77;24;122;59;53;63;123;83;0
199;4.30552e-15;63;121;213;10186;1;42;123;255;59;36;154;71;23;83;123;84;0
200;4.30615e-15;51;133;215;10188;1;41;124;255;58;39;126;69;19;57;124;85;0
201;4.30743e-15;61;116;213;10189;1;43;123;255;68;24;121;76;44;45;123;85;0
202;4.30807e-15;76;137;213;10189;1;44;122;255;61;21;115;62;40;53;122;84;0
203;4.30807e-15;61;144;215;10190;1;43;122;255;69;45;109;55;24;54;122;85;0
204;4.3087e-15;60;138;214;10194;1;44;122;256;56;30;116;69;26;47;122;84;0
205;4.31125e-15;70;136;213;10196;1;45;122;256;55;27;124;62;28;62;122;85;0
206;4.31253e-15;69;118;212;10197;1;46;123;256;56;33;118;78;23;40;123;84;0
207;4.31317e-15;65;146;211;10198;1;47;122;256;64;24;126;57;40;69;122;84;0
208;4.3138e-15;71;137;212;10198;1;47;122;256;67;38;129;54;29;75;122;84;0
209;4.3138e-15;65;124;212;10198;1;47;122;257;48;30;141;81;18;60;122;85;0
210;4.3138e-15;65;121;218;10200;1;44;122;257;59;36;122;72;23;50;122;85;0
211;4.31508e-15;67;139;216;10202;1;46;122;257;49;25;129;53;24;76;122;86;0
212;4.31635e-15;71;124;216;10203;1;46;123;257;50;37;127;77;13;50;123;85;0
213;4.31699e-15;82;119;217;10204;1;46;123;258;62;40;115;75;22;40;123;85;0
214;4.31763e-15;64;132;219;10204;1;45;124;258;62;48;126;61;14;65;124;85;0
215;4.31763e-15;58;130;223;10206;1;43;124;258;50;26;152;64;24;88;124;86;0
216;4.31891e-15;62;113;223;10210;1;44;123;258;65;30;125;70;35;55;123;86;0
217;4.32146e-15;55;130;223;10212;1;44;123;258;68;31;141;54;37;87;123;85;0
218;4.32273e-15;53;107;224;10213;1;44;122;259;72;27;115;65;45;50;122;85;0
219;4.32337e-15;60;121;226;10216;1;43;121;259;63;29;116;51;34;65;121;87;0
220;4.32529e-15;55;127;225;10220;1;44;122;259;50;26;136;60;24;76;122;86;0
221;4.32784e-15;56;135;228;10224;1;43;122;259;49;28;135;55;21;80;122;87;0
222;4.3304e-15;58;124;228;10226;1;43;122;260;62;31;135;65;31;70;122;87;0
223;4.33167e-15;58;106;230;10228;1;42;121;260;61;26;119;70;35;49;121;87;0
224;4.33295e-15;51;127;233;10228;1;41;121;260;66;35;133;58;31;75;121;88;0
225;4.33295e-15;75;139;239;10228;1;38;121;260;50;19;139;55;31;84;121;87;0
226;4.33295e-15;65;117;241;10228;1;37;120;261;69;38;145;61;31;84;120;88;0
227;4.33295e-15;57;134;240;10228;1;38;120;261;58;29;139;61;29;78;120;87;0
228;4.33295e-15;58;133;240;10229;1;38;120;261;59;34;146;77;25;69;120;87;0
229;4.33359e-15;65;145;240;10230;1;38;120;261;59;26;118;55;33;63;120;89;0
230;4.33423e-15;70;141;240;10233;1;38;120;262;54;35;138;65;19;73;120;88;0
231;4.33614e-15;63;126;240;10234;1;38;122;262;41;38;121;79;3;42;122;87;0
232;4.33678e-15;61;131;246;10235;1;35;121;262;62;29;130;64;33;66;121;87;0
233;4.33742e-15;63;144;246;10239;1;35;121;263;56;30;134;62;26;72;121;88;0
234;4.33998e-15;57;137;248;10241;1;34;122;263;47;34;114;65;13;49;122;87;0
235;4.34125e-15;72;120;247;10243;1;35;121;263;66;30;155;71;36;84;121;88;0
236;4.34253e-15;55;109;245;10247;1;37;122;263;56;38;137;78;18;59;122;89;0
237;4.34509e-15;58;124;247;10247;1;36;122;264;58;39;123;68;19;55;122;88;0
238;4.34509e-15;52;115;247;10249;1;36;122;264;61;32;100;68;29;32;122;87;0
239;4.34637e-15;54;130;247;10251;1;36;122;264;54;42;150;53;12;97;122;89;0
240;4.34765e-15;55;120;246;10252;1;37;123;264;45;26;145;68;19;77;123;87;0
241;4.34829e-15;63;128;244;10255;1;39;122;265;58;22;120;62;36;58;122;88;0
242;4.3502e-15;61;135;246;10256;1;38;122;265;62;32;130;60;30;70;122;89;0
243;4.35084e-15;67;139;246;10258;1;38;122;265;62;33;148;77;29;71;122;89;0
244;4.35212e-15;55;126;247;10259;1;39;121;266;62;34;135;61;28;74;121;89;0
245;4.35276e-15;51;129;247;10263;1;39;121;266;57;25;136;69;32;67;121;90;0
246;4.35532e-15;48;129;251;10265;1;37;120;266;78;27;152;61;51;91;120;91;0
247;4.3566e-15;39;122;251;10267;1;37;119;266;65;19;122;65;46;57;119;90;0
248;4.35788e-15;53;130;251;10269;1;37;118;267;50;19;149;62;31;87;118;90;0
249;4.35916e-15;65;135;254;10270;1;36;118;267;62;30;145;55;32;90;118;91;0
250;4.3598e-15;56;133;253;10271;1;37;118;267;69;28;127;66;41;61;118;91;0
251;4.36044e-15;55;144;253;10272;1;37;117;268;62;25;152;55;37;97;117;89;0
252;4.36108e-15;60;136;256;10272;1;36;117;268;54;29;118;78;25;40;117;89;0
253;4.36108e-15;57;154;258;10274;1;36;117;268;57;29;131;67;28;64;117;89;0
254;4.36236e-15;67;142;258;10276;1;36;117;268;63;22;133;77;41;56;117;89;0
255;4.36364e-15;64;114;261;10278;1;35;117;269;53;26;128;75;27;53;117;89;0
256;4.36492e-15;52;129;262;10280;1;35;117;269;57;32;149;59;25;90;117;90;0
257;4.3662e-15;52;117;263;10285;1;35;118;269;40;33;123;65;7;58;118;90;0
258;4.3694e-15;58;137;263;10285;1;35;117;270;59;26;138;63;33;75;117;91;0
259;4.3694e-15;71;127;263;10287;1;35;117;270;67;29;121;74;38;47;117;90;0
260;4.37069e-15;59;130;263;10290;1;35;118;270;38;35;138;69;3;69;118;92;0
261;4.37261e-15;53;136;263;10291;1;35;118;271;66;35;141;74;31;67;118;91;0
262;4.37325e-15;65;147;263;10291;1;35;118;271;53;36;129;62;17;67;118;91;0
263;4.37325e-15;56;143;263;10291;1;35;118;271;68;36;115;62;32;53;118;92;0
264;4.37325e-15;64;137;263;10292;1;35;117;271;69;27;142;67;42;75;117;91;0
265;4.37389e-15;68;133;263;10297;1;36;117;272;67;35;141;59;32;82;117;92;0
266;4.37709e-15;66;136;265;10301;1;35;117;272;63;34;145;64;29;81;117;92;0
267;4.37966e-15;59;126;265;10302;1;35;117;272;61;33;142;78;28;64;117;92;0
268;4.3803e-15;54;139;267;10302;1;34;116;273;71;33;123;72;38;51;116;91;0
269;4.3803e-15;45;159;265;10304;1;36;116;273;62;25;137;73;37;64;116;92;0
270;4.38158e-15;71;140;266;10305;1;36;116;273;56;27;117;81;29;36;116;92;0
271;4.38222e-15;53;134;265;10306;1;37;116;274;59;35;151;70;24;81;116;94;1
272;4.38286e-15;41;122;265;10309;1;37;116;274;61;25;137;72;36;65;116;92;1
273;4.38478e-15;48;120;265;10309;1;37;116;274;56;30;140;68;26;72;116;93;1
274;4.38478e-15;53;120;264;10310;1;38;116;274;50;30;136;74;20;62;116;92;1
275;4.38543e-15;49;108;263;10312;1;39;116;275;57;27;116;72;30;44;116;94;1
276;4.38671e-15;62;136;266;10314;1;38;116;275;55;25;166;60;30;106;116;93;1
277;4.38799e-15;61;128;266;10315;1;38;116;275;55;27;134;74;28;60;116;94;1
278;4.38863e-15;55;138;264;10316;1;40;116;276;58;30;139;59;28;80;116;94;1
279;4.38927e-15;55;139;264;10316;1;40;117;276;46;38;113;81;8;32;117;94;1
280;4.38927e-15;65;148;263;10316;1;41;117;276;51;23;116;77;28;39;117;95;1
281;4.38927e-15;62;137;263;10318;1;41;116;277;61;24;149;66;37;83;116;95;1
282;4.39056e-15;59;150;267;10318;1;39;117;277;45;32;125;65;13;60;117;95;1
283;4.39056e-15;69;129;268;10318;1;39;117;277;52;27;129;74;25;55;117;94;1
284;4.39056e-15;58;131;268;10319;1;39;118;277;52;36;121;68;16;53;118;95;1
285;4.3912e-15;63;126;267;10320;1;40;117;278;59;27;127;75;32;52;117;96;1
286;4.39184e-15;64;127;267;10324;1;40;117;278;53;29;155;77;24;78;117;96;1
287;4.39441e-15;76;148;267;10324;1;40;117;278;61;26;141;58;35;83;117;96;1
288;4.39441e-15;57;134;267;10325;1;40;117;279;55;36;143;68;19;75;117;97;1
289;4.39505e-15;61;150;267;10325;1;40;117;279;58;25;161;69;33;92;117;98;1
290;4.39505e-15;56;136;268;10326;1;40;117;279;68;35;152;74;33;78;117;97;1
291;4.39569e-15;51;148;268;10328;1;40;116;280;56;27;145;60;29;85;116;98;1
292;4.39697e-15;49;176;269;10330;1;40;117;280;50;30;144;71;20;73;117;97;1
293;4.39826e-15;55;162;268;10333;1;41;117;280;61;33;131;82;28;49;117;96;1
294;4.40018e-15;66;153;270;10335;1;40;117;281;60;36;151;71;24;80;117;96;1
295;4.40147e-15;69;152;269;10337;1;41;117;281;64;37;147;71;27;76;117;96;1
296;4.40275e-15;68;143;268;10339;1;42;117;281;56;35;153;61;21;92;117;96;1
297;4.40403e-15;71;152;267;10339;1;44;117;281;63;37;144;68;26;76;117;96;1
298;4.40403e-15;63;152;266;10340;1;45;117;282;47;20;129;66;27;63;117;97;1
299;4.40468e-15;72;159;265;10343;1;46;116;282;68;25;152;80;43;72;116;97;1
300;4.4066e-15;79;142;263;10343;1;48;116;282;57;35;122;89;22;33;116;97;1
301;4.4066e-15;76;130;264;10344;1;48;117;283;57;40;133;76;17;57;117;97;1
302;4.40725e-15;62;136;264;10345;1;49;116;283;73;31;146;77;42;69;116;97;1
303;4.40789e-15;47;150;263;10347;1;50;116;283;54;26;151;64;28;87;116;97;1
304;4.40917e-15;53;153;264;10347;1;50;115;284;63;25;140;64;38;76;115;98;1
305;4.40917e-15;62;143;263;10349;1;51;114;284;65;25;134;57;40;77;114;98;1
306;4.41046e-15;48;133;263;10350;1;51;115;284;53;34;159;73;19;86;115;99;1
307;4.4111e-15;55;134;267;10351;1;49;115;285;57;30;163;72;27;91;115;98;1
308;4.41174e-15;57;122;270;10352;1;48;113;285;67;18;126;73;49;53;113;98;1
309;4.41239e-15;59;140;270;10353;1;48;114;285;55;31;136;67;24;69;114;98;1
310;4.41303e-15;68;136;276;10354;1;45;113;285;63;30;150;71;33;79;113;98;1
311;4.41367e-15;60;132;280;10354;1;43;113;286;61;37;146;59;24;87;113;98;1
312;4.41367e-15;76;159;278;10356;1;45;114;286;44;34;160;72;10;88;114;96;1
313;4.41496e-15;57;160;277;10358;1;46;114;286;57;34;141;78;23;63;114;97;1
314;4.41624e-15;62;153;279;10359;1;45;114;287;63;38;152;97;25;55;114;97;1
315;4.41688e-15;61;157;281;10360;1;45;114;287;63;25;161;73;38;88;114;97;1
316;4.41753e-15;67;150;281;10361;1;45;115;287;39;35;149;67;4;82;115;97;1
317;4.41817e-15;48;154;285;10362;1;43;115;288;48;34;133;75;14;58;115;98;1
318;4.41881e-15;58;161;283;10365;1;45;114;288;55;16;154;79;39;75;114;98;1
319;4.42074e-15;58;171;282;10366;1;46;115;288;48;30;129;79;18;50;115;98;1
320;4.42138e-15;56;153;281;10367;1;48;113;288;69;23;138;91;46;47;113;98;1
321;4.42203e-15;54;149;281;10367;1;48;113;289;52;28;128;62;24;66;113;98;1
322;4.42203e-15;47;156;280;10369;1;49;113;289;52;24;158;84;28;74;113;99;1
323;4.42331e-15;43;152;280;10371;1;49;114;289;43;27;142;80;16;62;114;99;1
324;4.4246e-15;55;166;280;10374;1;49;114;290;47;23;136;62;24;74;114;99;1
325;4.42653e-15;54;157;279;10375;1;50;113;290;56;30;157;82;26;75;113;98;1
326;4.42717e-15;45;127;280;10376;1;50;114;290;49;37;147;95;12;52;114;99;1
327;4.42782e-15;67;135;280;10377;1;50;113;291;55;21;138;65;34;73;113;98;1
328;4.42846e-15;58;144;278;10379;1;52;113;291;54;25;132;70;29;62;113;98;1
329;4.42975e-15;60;150;278;10380;1;52;112;291;63;30;160;69;33;91;112;97;1
330;4.43039e-15;61;175;277;10382;1;54;112;291;50;25;173;70;25;103;112;98;1
331;4.43168e-15;57;142;277;10383;1;54;113;292;48;32;143;91;16;52;113;98;1
332;4.43232e-15;54;129;275;10386;1;56;112;292;58;22;148;85;36;63;112;98;1
333;4.43425e-15;57;127;275;10386;1;56;111;292;61;27;154;56;34;98;111;99;1
334;4.43425e-15;47;140;275;10386;1;56;112;293;57;42;146;69;15;77;112;99;2
335;4.43425e-15;57;140;275;10388;1;56;112;293;50;27;141;75;23;66;112;99;2
336;4.43554e-15;56;156;276;10392;1;56;112;293;48;37;135;72;11;63;112;99;2
337;4.43811e-15;65;136;275;10393;1;57;111;294;67;27;160;90;40;70;111;99;2
338;4.43876e-15;56;149;281;10395;1;54;111;294;60;32;136;60;28;76;111;98;2
339;4.44004e-15;62;163;282;10400;1;54;110;294;58;20;156;69;38;87;110;98;2
340;4.44326e-15;54;170;285;10401;1;53;110;294;64;28;137;76;36;61;110;97;2
341;4.44391e-15;57;157;284;10405;1;54;110;295;48;31;134;87;17;47;110;98;2
342;4.44649e-15;49;165;282;10405;1;56;110;295;50;23;166;68;27;98;110;98;2
343;4.44649e-15;50;159;279;10406;1;59;109;295;63;25;152;61;38;91;109;97;2
344;4.44713e-15;60;133;279;10407;1;59;109;296;52;26;137;93;26;44;109;97;2
345;4.44777e-15;52;135;281;10407;1;58;109;296;47;29;144;85;18;59;109;98;2
346;4.44777e-15;50;151;280;10408;1;59;109;296;57;26;132;69;31;63;109;97;2
347;4.44842e-15;52;167;283;10408;1;58;108;297;56;27;158;76;29;82;108;97;2
348;4.44842e-15;48;173;282;10409;1;59;108;297;51;27;156;74;24;82;108;97;2
349;4.44906e-15;43;177;283;10409;1;59;108;297;59;26;144;74;33;70;108;97;2
350;4.44906e-15;48;143;288;10412;1;57;108;297;55;29;131;76;26;55;108;98;2
351;4.451e-15;60;140;290;10412;1;56;108;298;44;28;134;66;16;68;108;98;2
352;4.451e-15;57;141;290;10412;1;57;108;298;52;29;146;71;23;75;108;97;2
353;4.451e-15;75;141;289;10412;1;58;108;298;54;27;169;78;27;91;108;97;2
354;4.451e-15;60;143;288;10413;1;59;108;299;46;26;137;88;20;49;108;97;2
355;4.45164e-15;45;155;288;10416;1;59;108;299;48;30;161;79;18;82;108;97;2
356;4.45357e-15;51;159;289;10418;1;59;107;299;53;19;153;81;34;72;107;97;2
357;4.45486e-15;44;153;293;10421;1;57;108;299;44;31;150;82;13;68;108;97;2
358;4.4568e-15;49;146;295;10423;1;56;107;300;51;21;151;75;30;76;107;97;2
359;4.45809e-15;58;147;299;10424;1;54;107;300;50;23;147;80;27;67;107;97;2
360;4.45873e-15;58;134;300;10425;1;54;107;300;47;26;139;87;21;52;107;97;2
361;4.45938e-15;60;146;301;10428;1;54;107;301;48;20;157;74;28;83;107;97;2
362;4.46131e-15;42;150;302;10430;1;54;107;301;47;30;135;67;17;68;107;97;2
363;4.4626e-15;55;130;302;10433;1;54;106;301;58;22;167;86;36;81;106;97;2
364;4.46454e-15;47;159;301;10434;1;55;106;301;53;26;134;60;27;74;106;96;2
365;4.46518e-15;46;151;300;10435;1;56;105;302;56;21;123;75;35;48;105;97;2
366;4.46583e-15;50;152;302;10439;1;56;105;302;43;10;142;80;33;62;105;97;2
367;4.46841e-15;40;142;305;10440;1;55;105;302;50;24;151;79;26;72;105;97;2
368;4.46905e-15;54;148;307;10441;1;54;105;303;42;23;155;73;19;82;105;97;2
369;4.4697e-15;65;131;307;10443;1;54;104;303;58;21;153;61;37;92;104;97;2
370;4.47099e-15;54;140;308;10447;1;54;104;303;43;22;161;60;21;101;104;97;2
371;4.47357e-15;51;148;309;10454;1;54;104;303;55;26;166;84;29;82;104;97;2
372;4.47809e-15;60;136;309;10456;1;54;103;304;48;17;160;84;31;76;103;97;2
373;4.47938e-15;44;161;313;10456;1;52;103;304;56;29;151;68;27;83;103;97;2
374;4.47938e-15;50;165;311;10457;1;54;103;304;60;28;162;80;32;82;103;96;2
375;4.48003e-15;62;154;311;10458;1;54;103;305;47;23;134;84;24;50;103;95;2
376;4.48067e-15;49;141;310;10461;1;55;103;305;45;27;161;78;18;83;103;95;2
377;4.48261e-15;47;154;310;10462;1;55;103;305;50;23;144;75;27;69;103;96;2
378;4.48326e-15;63;153;313;10463;1;54;102;305;46;16;156;72;30;84;102;95;2
379;4.4839e-15;60;138;314;10466;1;54;102;306;52;25;166;83;27;83;102;95;2
380;4.48584e-15;63;149;314;10470;1;54;102;306;58;30;178;79;28;99;102;96;2
381;4.48843e-15;57;151;316;10473;1;53;102;306;55;33;166;74;22;92;102;96;2
382;4.49036e-15;51;148;316;10474;1;53;101;306;59;28;151;79;31;72;101;96;2
383;4.49101e-15;52;163;316;10475;1;53;101;307;60;29;157;86;31;71;101;95;2
384;4.49166e-15;50;156;317;10477;1;53;101;307;43;29;130;97;14;33;101;95;2
385;4.49295e-15;51;151;316;10478;1;54;101;307;46;26;141;68;20;73;101;94;2
386;4.4936e-15;47;154;317;10482;1;54;101;308;56;31;145;75;25;70;101;94;3
387;4.49618e-15;53;155;320;10482;1;53;102;308;41;27;148;67;14;81;102;94;3
388;4.49618e-15;51;172;321;10483;1;53;102;308;49;27;124;85;22;39;102;95;3
389;4.49683e-15;42;171;322;10485;1;54;102;308;40;30;151;92;10;59;102;95;3
390;4.49812e-15;52;150;322;10488;1;54;102;309;53;24;159;90;29;69;102;93;3
391;4.50006e-15;48;168;329;10490;1;51;102;309;52;25;173;79;27;94;102;94;3
392;4.50136e-15;44;149;331;10491;1;50;101;309;54;25;139;77;29;62;101;95;3
393;4.502e-15;49;139;334;10493;1;49;101;309;42;20;144;75;22;69;101;95;3
394;4.5033e-15;47;128;337;10494;1;48;100;310;56;14;138;73;42;65;100;95;3
395;4.50394e-15;53;136;337;10496;1;48;100;310;38;20;135;76;18;59;100;94;3
396;4.50524e-15;45;128;339;10500;1;47;100;310;51;23;150;71;28;79;100;95;3
397;4.50783e-15;49;140;339;10502;1;47;99;311;56;25;135;82;31;53;99;95;3
398;4.50912e-15;47;147;339;10502;1;48;99;311;50;26;160;76;24;84;99;95;3
399;4.50912e-15;56;176;340;10503;1;48;98;311;55;18;164;73;37;91;98;94;3
400;4.50977e-15;53;163;338;10506;1;50;99;311;44;28;153;73;16;80;99;93;3
401;4.51171e-15;51;169;339;10511;1;50;98;312;56;24;156;74;32;82;98;94;3
402;4.51495e-15;32;161;338;10512;1;52;98;312;36;19;172;84;17;88;98;94;3
403;4.5156e-15;38;164;339;10513;1;52;98;312;47;17;179;68;30;111;98;94;3
404;4.51624e-15;45;159;339;10519;1;52;98;312;48;19;153;73;29;80;98;93;3
405;4.52013e-15;50;153;338;10520;1;53;97;313;50;20;169;70;30;99;97;93;3
406;4.52078e-15;45;145;336;10521;1;56;97;313;47;27;143;85;20;58;97;93;3
407;4.52142e-15;46;161;338;10524;1;55;97;313;49;22;151;73;27;78;97;93;3
408;4.52337e-15;46;144;340;10526;1;54;96;314;56;14;179;83;42;96;96;93;3
409;4.52466e-15;46;148;344;10526;1;52;96;314;36;22;153;70;14;83;96;92;3
410;4.52466e-15;42;154;348;10529;1;50;96;314;52;15;165;76;37;89;96;92;3
411;4.52661e-15;50;164;348;10531;1;50;95;314;52;22;156;70;30;86;95;93;3
412;4.5279e-15;46;167;348;10534;1;50;95;315;49;28;138;74;21;64;95;92;3
413;4.52985e-15;39;168;348;10535;1;50;95;315;54;26;173;77;28;96;95;92;3
414;4.5305e-15;38;128;350;10538;1;49;95;315;45;23;193;103;22;90;95;91;3
415;4.53244e-15;47;149;352;10540;1;48;95;315;50;25;162;69;25;93;95;91;3
416;4.53374e-15;43;151;354;10543;1;47;94;316;50;25;173;78;25;95;94;90;3
417;4.53568e-15;48;156;353;10543;1;48;94;316;45;21;157;69;24;88;94;91;3
418;4.53568e-15;46;144;353;10544;1;48;93;316;60;22;153;87;38;66;93;90;3
419;4.53633e-15;54;169;353;10546;1;48;93;316;52;25;170;85;27;85;93;90;3
420;4.53763e-15;52;162;354;10549;1;48;93;317;42;27;177;79;15;98;93;90;3
421;4.53958e-15;65;152;360;10550;1;46;93;317;48;26;159;77;22;82;93;90;3
422;4.54023e-15;48;163;367;10552;1;43;94;317;36;23;168;69;13;99;94;89;3
423;4.54152e-15;50;181;367;10552;1;43;93;317;52;17;164;82;35;82;93;90;3
424;4.54152e-15;53;135;368;10555;1;44;94;318;37;27;156;78;10;78;94;90;3
425;4.54347e-15;51;160;368;10557;1;44;93;318;60;35;169;67;25;102;93;90;3
426;4.54477e-15;53;156;370;10559;1;43;93;318;53;26;162;80;27;82;93;91;3
427;4.54607e-15;49;136;370;10560;1;43;93;318;49;22;154;82;27;72;93;90;3
428;4.54671e-15;44;153;369;10562;1;44;93;319;44;23;154;72;21;82;93;90;3
429;4.54801e-15;46;148;369;10562;1;44;92;319;55;24;175;73;31;102;92;89;3
430;4.54801e-15;48;160;370;10562;1;44;91;319;51;21;156;78;30;78;91;89;3
431;4.54801e-15;44;167;369;10567;1;45;91;319;47;22;160;85;25;75;91;89;3
432;4.55126e-15;53;143;368;10570;1;46;91;320;37;15;151;86;22;65;91;88;3
433;4.55321e-15;47;147;368;10571;1;46;91;320;47;27;168;76;20;92;91;87;3
434;4.55386e-15;44;163;368;10573;1;46;91;320;48;18;160;79;30;81;91;87;4
435;4.55515e-15;50;171;370;10574;1;45;91;320;41;22;169;85;19;84;91;88;4
436;4.5558e-15;53;188;371;10578;1;45;90;321;49;16;166;87;33;79;90;87;4
437;4.5584e-15;53;168;370;10582;1;46;91;321;34;30;161;107;4;54;91;87;4
438;4.561e-15;57;155;370;10584;1;46;90;321;58;29;142;63;29;79;90;87;4
439;4.5623e-15;52;160;373;10586;1;45;90;321;51;22;154;72;29;82;90;86;4
440;4.5636e-15;40;160;372;10587;1;46;90;322;46;33;177;78;13;99;90;86;4
441;4.56425e-15;45;166;371;10587;1;47;89;322;48;18;154;85;30;69;89;85;4
442;4.56425e-15;40;168;376;10588;1;45;90;322;40;30;154;76;10;78;90;85;4
443;4.5649e-15;42;141;375;10588;1;46;90;322;35;20;185;86;15;99;90;85;4
444;4.5649e-15;53;154;374;10590;1;47;90;323;40;29;163;88;11;75;90;85;4
445;4.5662e-15;45;152;375;10590;1;47;90;323;56;27;149;79;29;70;90;85;4
446;4.5662e-15;33;174;375;10590;1;48;89;323;49;21;164;65;28;99;89;84;4
447;4.5662e-15;43;146;376;10593;1;48;89;323;44;19;177;87;25;90;89;84;4
448;4.56815e-15;37;174;376;10596;1;48;89;324;45;27;152;67;18;85;89;84;4
449;4.5701e-15;51;169;374;10601;1;50;88;324;48;24;174;87;24;87;88;83;4
450;4.57335e-15;46;168;374;10601;1;50;88;324;46;23;181;79;23;102;88;82;4
451;4.57335e-15;38;174;378;10602;1;48;88;324;47;27;168;83;20;85;88;82;4
452;4.574e-15;32;164;379;10605;1;48;87;325;50;15;151;81;35;70;87;81;4
453;4.57595e-15;43;185;379;10607;1;48;86;325;56;18;155;78;38;77;86;81;4
454;4.57725e-15;52;150;386;10610;1;45;86;325;37;24;163;83;13;80;86;81;4
455;4.57921e-15;38;165;386;10611;1;45;87;325;34;25;184;77;9;107;87;80;4
456;4.57986e-15;42;182;386;10613;1;45;86;326;52;16;126;86;36;40;86;80;4
457;4.58116e-15;41;180;390;10614;1;43;85;326;47;20;148;100;27;48;85;80;4
458;4.58181e-15;39;157;393;10617;1;42;84;326;52;14;184;83;38;101;84;81;4
459;4.58376e-15;43;174;394;10619;1;42;85;326;31;26;179;78;5;101;85;81;4
460;4.58506e-15;37;157;393;10620;1;44;85;327;36;20;173;88;16;85;85;80;4
461;4.58571e-15;33;149;397;10621;1;43;85;327;38;20;181;76;18;105;85;80;4
462;4.58636e-15;48;172;399;10622;1;42;85;327;44;21;159;71;23;88;85;79;4
463;4.58701e-15;47;155;398;10625;1;43;84;327;58;24;161;87;34;74;84;79;4
464;4.58897e-15;42;145;399;10626;1;44;84;328;43;22;172;84;21;88;84;79;4
465;4.58962e-15;39;172;399;10628;1;45;84;328;43;23;181;85;20;96;84;79;4
466;4.59092e-15;49;154;401;10628;1;45;83;328;50;27;170;93;23;77;83;79;4
467;4.59092e-15;50;153;399;10633;1;48;83;328;35;17;165;80;18;85;83;78;4
468;4.59418e-15;40;156;398;10634;1;49;83;328;40;21;181;86;19;95;83;78;4
469;4.59483e-15;36;164;399;10635;1;49;83;329;41;19;162;88;22;74;83;78;4
470;4.59548e-15;40;157;405;10638;1;46;82;329;45;17;171;84;28;87;82;78;4
471;4.59743e-15;31;140;407;10640;1;46;83;329;30;17;149;87;13;62;83;78;4
472;4.59874e-15;46;152;410;10644;1;45;83;329;32;17;162;83;15;79;83;78;4
473;4.60134e-15;56;167;408;10646;1;47;83;330;35;16;163;92;19;71;83;78;4
474;4.60265e-15;43;161;407;10647;1;48;83;330;35;23;158;88;12;70;83;77;4
475;4.6033e-15;43;166;410;10651;1;47;83;330;41;22;137;81;19;56;83;77;4
476;4.60591e-15;42;155;410;10654;1;48;83;330;29;17;153;79;12;74;83;77;4
477;4.60786e-15;56;158;410;10659;1;48;82;331;43;17;159;75;26;84;82;77;4
478;4.61112e-15;42;133;409;10661;1;49;82;331;44;24;175;96;20;79;82;76;4
479;4.61243e-15;50;162;410;10662;1;49;81;331;43;13;146;76;30;70;81;76;4
480;4.61308e-15;35;146;413;10662;1;48;81;331;49;24;185;92;25;93;81;76;4
481;4.61308e-15;35;165;414;10662;1;48;80;331;53;17;170;68;36;102;80;76;4
482;4.61308e-15;44;178;414;10665;1;48;80;332;30;20;177;67;10;110;80;75;4
483;4.61504e-15;41;182;420;10665;1;45;80;332;45;19;152;78;26;74;80;75;4
484;4.61504e-15;46;178;421;10668;1;45;80;332;34;13;167;91;21;76;80;75;5
485;4.61699e-15;46;167;420;10671;1;47;79;332;37;19;168;79;18;89;79;74;5
486;4.61895e-15;39;172;419;10672;1;48;80;333;34;27;178;84;7;94;80;74;5
487;4.6196e-15;30;163;422;10675;1;47;80;333;35;25;150;99;10;51;80;73;5
488;4.62156e-15;42;176;424;10675;1;46;80;333;32;15;166;87;17;79;80;74;5
489;4.62156e-15;48;182;422;10676;1;48;79;333;45;15;158;82;30;76;79;73;5
490;4.62221e-15;40;191;425;10679;1;48;79;333;43;16;156;80;27;76;79;74;5
491;4.62417e-15;47;204;425;10680;1;48;79;334;35;22;163;79;13;84;79;73;5
492;4.62482e-15;48;202;425;10681;1;48;79;334;41;21;176;98;20;78;79;72;5
493;4.62548e-15;44;162;427;10683;1;47;78;334;46;16;178;100;30;78;78;72;5
494;4.62678e-15;45;145;425;10689;1;49;78;334;37;23;157;89;14;68;78;71;5
495;4.6307e-15;41;164;429;10693;1;47;78;335;40;25;164;76;15;88;78;71;5
496;4.63331e-15;39;172;431;10695;1;46;78;335;40;20;150;64;20;86;78;71;5
497;4.63462e-15;36;183;429;10698;1;48;78;335;28;21;157;86;7;71;78;71;5
498;4.63658e-15;32;172;428;10701;1;49;78;335;33;15;177;95;18;82;78;71;5
499;4.63854e-15;34;171;431;10702;1;48;78;335;32;20;164;76;12;88;78;71;5
500;4.63919e-15;34;186;433;10703;1;47;78;336;43;15;182;85;28;97;78;69;5
501;4.63984e-15;32;178;433;10705;1;48;77;336;41;17;165;90;24;75;77;68;5
502;4.64115e-15;38;172;434;10706;1;48;77;336;30;19;157;81;11;76;77;68;5
503;4.64181e-15;37;180;437;10709;1;47;77;336;34;20;177;89;14;88;77;69;5
504;4.64377e-15;35;187;438;10710;1;47;77;337;44;20;165;93;24;72;77;68;5
505;4.64442e-15;46;181;440;10710;1;46;77;337;31;24;171;84;7;87;77;69;5
506;4.64442e-15;47;161;441;10712;1;46;77;337;45;20;174;96;25;78;77;68;5
507;4.64573e-15;33;154;439;10714;1;48;77;337;35;29;210;84;6;126;77;68;5
508;4.64703e-15;25;137;439;10716;1;48;76;337;52;13;179;80;39;99;76;68;5
509;4.64834e-15;29;165;439;10719;1;48;75;338;49;8;163;72;41;91;75;69;5
510;4.6503e-15;32;173;440;10719;1;48;74;338;40;15;172;75;25;97;74;69;5
511;4.6503e-15;27;167;441;10721;1;48;74;338;32;10;175;86;22;89;74;68;5
512;4.65161e-15;27;167;441;10724;1;48;74;338;36;12;166;89;24;77;74;68;5
513;4.65357e-15;27;142;442;10726;1;48;74;338;28;15;162;83;13;79;74;69;5
514;4.65488e-15;28;147;442;10728;1;48;74;339;36;23;174;69;13;105;74;69;5
515;4.65619e-15;29;156;448;10730;1;45;74;339;35;15;182;72;20;110;74;70;5
516;4.6575e-15;41;158;449;10732;1;45;73;339;43;17;180;89;26;91;73;70;5
517;4.65881e-15;40;171;448;10733;1;46;73;339;31;19;160;74;12;86;73;70;5
518;4.65946e-15;35;138;449;10737;1;46;73;340;44;15;168;81;29;87;73;71;5
519;4.66208e-15;35;175;450;10740;1;46;73;340;31;22;148;74;9;74;73;71;5
520;4.66404e-15;40;153;448;10742;1;48;73;340;37;21;156;94;16;62;73;70;5
521;4.66535e-15;35;159;449;10743;1;48;73;340;31;17;167;68;14;99;73;70;5
522;4.66601e-15;32;143;449;10744;1;48;73;340;34;19;200;83;15;117;73;70;5
523;4.66666e-15;33;150;449;10749;1;48;73;341;29;24;174;74;5;100;73;70;5
524;4.66994e-15;37;173;455;10751;1;45;73;341;32;16;153;78;16;75;73;69;5
525;4.67125e-15;25;206;454;10754;1;46;73;341;35;14;167;72;21;95;73;69;5
526;4.67321e-15;29;176;454;10754;1;46;72;341;42;14;170;87;28;83;72;69;5
527;4.67321e-15;22;171;455;10757;1;47;72;341;32;16;160;84;16;76;72;69;5
528;4.67518e-15;36;160;456;10761;1;47;72;342;36;20;164;77;16;87;72;68;5
529;4.6778e-15;31;152;455;10761;1;48;72;342;37;21;165;83;16;82;72;69;5
530;4.6778e-15;33;152;454;10763;1;49;72;342;33;14;187;88;19;99;72;68;5
531;4.67911e-15;43;175;456;10768;1;48;70;342;54;11;176;77;43;99;70;67;5
532;4.68239e-15;37;193;456;10771;1;48;71;342;30;21;190;79;9;111;71;67;5
533;4.68435e-15;42;180;460;10772;1;46;70;343;40;14;185;99;26;86;70;67;5
534;4.68501e-15;32;177;462;10777;1;45;70;343;32;18;175;83;14;92;70;67;5
535;4.68829e-15;38;176;466;10781;1;43;70;343;36;21;171;85;15;86;70;67;5
536;4.69091e-15;27;168;471;10782;1;41;70;343;41;20;179;85;21;94;70;67;5
537;4.69157e-15;40;186;470;10783;1;42;69;343;39;15;169;82;24;87;69;67;5
538;4.69222e-15;38;149;470;10785;1;42;69;344;35;17;170;103;18;67;69;68;6
539;4.69353e-15;45;165;472;10789;1;41;69;344;28;15;164;77;13;87;69;69;6
540;4.69616e-15;41;182;472;10791;1;41;69;344;28;14;200;85;14;115;69;68;6
541;4.69747e-15;41;177;474;10793;1;40;69;344;29;21;175;92;8;83;69;69;6
542;4.69878e-15;43;152;477;10793;1;39;70;344;34;23;182;78;11;104;70;68;6
543;4.69878e-15;40;171;475;10797;1;41;69;345;45;20;185;76;25;109;69;69;6
544;4.70141e-15;25;189;477;10804;1;40;69;345;31;25;177;97;6;80;69;69;6
545;4.706e-15;25;174;476;10809;1;41;69;345;40;11;160;101;29;59;69;69;6
546;4.70929e-15;30;165;475;10810;1;42;68;345;36;14;155;81;22;74;68;68;6
547;4.70994e-15;36;170;476;10811;1;42;68;345;25;9;146;83;16;63;68;68;6
548;4.7106e-15;30;169;481;10814;1;40;69;346;25;24;133;81;1;52;69;67;6
549;4.71257e-15;35;169;479;10817;1;42;68;346;31;15;175;96;16;79;68;68;6
550;4.71454e-15;23;177;480;10820;1;42;68;346;34;18;184;76;16;108;68;68;6
551;4.71651e-15;24;154;480;10821;1;42;68;346;35;17;153;90;18;63;68;67;6
552;4.71717e-15;20;170;478;10824;1;44;67;346;41;13;175;92;28;83;67;66;6
553;4.71914e-15;26;162;480;10827;1;43;67;347;26;14;171;95;12;76;67;66;6
554;4.72111e-15;27;158;481;10829;1;43;67;347;36;16;192;104;20;88;67;66;6
555;4.72243e-15;36;174;481;10831;1;43;67;347;30;10;203;68;20;135;67;66;6
556;4.72374e-15;39;179;483;10833;1;43;67;347;28;18;158;84;10;74;67;66;6
557;4.72506e-15;29;191;482;10835;1;44;67;347;31;14;167;84;17;83;67;65;6
558;4.72637e-15;33;179;488;10841;1;41;66;348;40;15;184;81;25;103;66;64;6
559;4.73032e-15;32;191;487;10843;1;42;66;348;32;12;166;88;20;78;66;65;6
560;4.73163e-15;36;181;488;10845;1;42;66;348;26;13;176;96;13;80;66;64;6
561;4.73295e-15;38;171;486;10848;1;44;66;348;32;21;176;93;11;83;66;64;6
562;4.73492e-15;35;175;486;10852;1;44;65;348;36;12;163;83;24;80;65;63;6
563;4.73755e-15;32;178;489;10856;1;43;65;349;29;16;178;93;13;85;65;63;6
564;4.74019e-15;32;190;487;10859;1;45;416;-3156;29;14;167;74;15;93;416;414;6
565;4.74216e-15;32;189;487;10859;1;45;1764;-13129;0;0;-1;0;0;-1;1764;1761;6
566;4.74216e-15;32;189;487;10859;1;45;5004;-32041;1;0;-1;0;1;-1;5004;5001;6
567;4.74216e-15;32;189;487;10859;1;45;11232;-61929;0;0;-1;0;0;-1;11232;11230;6
568;4.74216e-15;32;183;487;10859;1;45;21712;-104444;1;0;-1;0;1;-1;21712;21710;6
569;4.74216e-15;32;182;487;10859;1;45;37837;-160890;0;0;-1;0;0;-1;37837;37834;6
570;4.74216e-15;32;181;487;10859;1;45;61099;-232265;0;0;-1;0;0;-1;61099;61096;6
571;4.74216e-15;32;179;487;10859;1;45;93064;-319298;0;0;-1;0;0;-1;93064;93061;6
572;4.74216e-15;32;178;487;10859;1;45;135348;-422480;0;0;-1;0;0;-1;135348;135345;6
573;4.74216e-15;33;177;487;10859;1;45;189593;-542095;0;0;-1;0;0;-1;189593;189590;6
574;4.74216e-15;33;176;487;10859;1;45;257453;-678242;0;0;-1;0;0;-1;257453;257450;6
575;4.74216e-15;35;175;487;10859;1;45;340574;-830863;0;0;-1;0;0;-1;340574;340572;6
576;4.74216e-15;35;175;487;10859;1;45;440587;-999765;0;0;-1;0;0;-1;440587;440584;6
577;4.74216e-15;37;175;487;10859;1;45;559086;-1.18464e+06;0;0;-1;0;0;-1;559086;559083;6
578;4.74216e-15;37;174;487;10859;1;45;697627;-1.38506e+06;0;0;-1;0;0;-1;697627;697624;6
579;4.74216e-15;37;174;487;10859;1;45;857717;-1.60055e+06;0;0;-1;0;0;-1;857717;857715;6
580;4.74216e-15;37;172;487;10859;1;45;1.04081e+06;-1.83053e+06;1;0;-1;0;1;-1;1040806;1040803;6
581;4.74216e-15;41;169;487;10859;1;45;1.24828e+06;-2.07438e+06;0;0;-1;0;0;-1;1248279;1248276;6
582;4.74216e-15;41;169;487;10859;1;45;1.48146e+06;-2.33143e+06;0;0;-1;0;0;-1;1481457;1481455;6
583;4.74216e-15;41;168;487;10859;1;45;1.74159e+06;-2.60097e+06;0;0;-1;0;0;-1;1741590;1741587;6
584;4.74216e-15;41;168;487;10859;1;45;2.02985e+06;-2.88227e+06;1;0;-1;0;1;-1;2029853;2029850;6
585;4.74216e-15;43;165;487;10859;1;45;2.34735e+06;-3.17458e+06;2;0;-1;0;2;-1;2347347;2347344;6
586;4.74216e-15;44;161;487;10859;1;45;2.6951e+06;-3.47713e+06;4;0;-1;0;4;-1;2695095;2695092;6
587;4.74216e-15;44;159;487;10859;1;45;3.07404e+06;-3.78914e+06;2;0;-1;0;2;-1;3074045;3074042;6
588;4.74216e-15;45;154;487;10859;1;45;3.48506e+06;-4.10984e+06;2;0;-1;0;2;-1;3485064;3485062;6
589;4.74216e-15;45;154;487;10859;1;45;3.92895e+06;-4.43846e+06;0;0;-1;0;0;-1;3928947;3928944;6
590;4.74216e-15;45;152;487;10859;1;45;4.40641e+06;-4.77425e+06;0;0;-1;0;0;-1;4406407;4406404;6
591;4.74216e-15;45;152;487;10859;1;45;4.91809e+06;-5.11643e+06;0;0;-1;0;0;-1;4918086;4918083;6
592;4.74216e-15;46;150;487;10859;1;45;5.46455e+06;-5.46428e+06;0;0;-1;0;0;-1;5464550;5464547;7
593;4.74216e-15;47;149;487;10859;1;45;6.04629e+06;-5.81708e+06;2;0;-1;0;2;-1;6046293;6046291;7
594;4.74216e-15;47;149;487;10859;1;45;6.66374e+06;-6.17412e+06;0;0;-1;0;0;-1;6663741;6663738;7
595;4.74216e-15;47;149;487;10859;1;45;7.31725e+06;-6.53471e+06;0;0;-1;0;0;-1;7317248;7317245;7
596;4.74216e-15;47;148;487;10859;1;45;8.0071e+06;-6.89821e+06;0;0;-1;0;0;-1;8007105;8007102;7
597;4.74216e-15;48;148;487;10859;1;45;8.73354e+06;-7.26396e+06;0;0;-1;0;0;-1;8733537;8733534;7
598;4.74216e-15;49;148;487;10859;1;45;9.49671e+06;-7.63137e+06;2;0;-1;0;2;-1;9496710;9496707;8
599;4.74216e-15;52;147;487;10859;1;45;1.02967e+07;-7.99984e+06;1;0;-1;0;1;-1;10296729;10296727;8
600;4.74216e-15;55;147;487;10859;1;45;1.11336e+07;-8.3688e+06;4;0;-1;0;4;-1;11133645;11133642;9
601;4.74216e-15;55;147;487;10859;1;45;1.20075e+07;-8.73772e+06;1;0;-1;0;1;-1;12007452;12007450;9
602;4.74216e-15;56;145;487;10859;1;45;1.29181e+07;-9.10608e+06;1;0;-1;0;1;-1;12918097;12918094;10
603;4.74216e-15;57;145;487;10859;1;45;1.38655e+07;-9.4734e+06;0;0;-1;0;0;-1;13865473;13865471;11
604;4.74216e-15;61;144;487;10859;1;45;1.48494e+07;-9.83923e+06;1;0;-1;0;1;-1;14849432;14849430;12
605;4.74216e-15;64;144;487;10859;1;45;1.58698e+07;-1.02031e+07;2;0;-1;0;2;-1;15869779;15869777;13
606;4.74216e-15;65;143;487;10859;1;45;1.69263e+07;-1.05646e+07;2;0;-1;0;2;-1;16926279;16926277;15
607;4.74216e-15;65;143;487;10859;1;45;1.80187e+07;-1.09234e+07;0;0;-1;0;0;-1;18018659;18018657;17
608;4.74216e-15;65;143;487;10859;1;45;1.91466e+07;-1.12791e+07;0;0;-1;0;0;-1;19146609;19146607;19
609;4.74216e-15;66;142;487;10859;1;45;2.03098e+07;-1.16314e+07;1;0;-1;0;1;-1;20309783;20309782;22
610;4.74216e-15;67;140;487;10859;1;45;2.15078e+07;-1.19799e+07;1;0;-1;0;1;-1;21507808;21507806;25
611;4.74216e-15;67;140;487;10859;1;45;2.27403e+07;-1.23243e+07;0;0;-1;0;0;-1;22740277;22740275;29
612;4.74216e-15;68;140;487;10859;1;45;2.40068e+07;-1.26644e+07;1;0;-1;0;1;-1;24006757;24006756;33
613;4.74216e-15;68;140;487;10859;1;45;2.53068e+07;-1.3e+07;0;0;-1;0;0;-1;25306792;25306791;39
614;4.74216e-15;68;139;487;10859;1;45;2.66399e+07;-1.33307e+07;0;0;-1;0;0;-1;26639899;26639898;45
615;4.74216e-15;68;139;487;10859;1;45;2.80056e+07;-1.36564e+07;1;0;-1;0;1;-1;28005576;28005576;52
616;4.74216e-15;69;139;487;10859;1;45;2.94033e+07;-1.39769e+07;1;0;-1;0;1;-1;29403302;29403302;60
617;4.74216e-15;73;138;487;10859;1;45;3.08325e+07;-1.4292e+07;6;0;-1;0;6;-1;30832536;30832537;69
618;4.74216e-15;76;137;487;10859;1;45;3.22927e+07;-1.46015e+07;1;0;-1;0;1;-1;32292724;32292725;79
619;4.74216e-15;77;136;487;10859;1;45;3.37833e+07;-1.49053e+07;0;0;-1;0;0;-1;33783295;33783296;91
620;4.74216e-15;78;136;487;10859;1;45;3.53037e+07;-1.52034e+07;3;0;-1;0;3;-1;35303666;35303669;105
621;4.74216e-15;84;136;487;10859;1;45;3.68532e+07;-1.54954e+07;6;0;-1;0;6;-1;36853245;36853247;121
622;4.74216e-15;87;135;487;10859;1;45;3.84314e+07;-1.57814e+07;3;0;-1;0;3;-1;38431426;38431429;138
623;4.74216e-15;90;134;487;10859;1;45;4.00376e+07;-1.60614e+07;0;0;-1;0;0;-1;40037598;40037603;158
624;4.74216e-15;90;133;487;10859;1;45;4.16711e+07;-1.63351e+07;0;0;-1;0;0;-1;41671142;41671148;180
625;4.74216e-15;101;129;487;10859;1;45;4.33314e+07;-1.66025e+07;12;0;-1;0;12;-1;43331432;43331439;205
626;4.74216e-15;103;128;487;10859;1;45;4.50178e+07;-1.68637e+07;1;0;-1;0;1;-1;45017839;45017848;233
627;4.74216e-15;103;128;487;10859;1;45;4.67297e+07;-1.71185e+07;0;0;-1;0;0;-1;46729729;46729739;264
628;4.74216e-15;106;127;487;10859;1;45;4.84665e+07;-1.7367e+07;0;0;-1;0;0;-1;48466466;48466476;299
629;4.74216e-15;106;127;487;10859;1;45;5.02274e+07;-1.76091e+07;1;0;-1;0;1;-1;50227410;50227423;338
630;4.74216e-15;108;127;487;10859;1;45;5.20119e+07;-1.78448e+07;3;0;-1;0;3;-1;52011925;52011940;381
631;4.74216e-15;110;126;487;10859;1;45;5.38194e+07;-1.80741e+07;4;0;-1;0;4;-1;53819371;53819388;429
632;4.74216e-15;110;126;487;10859;1;45;5.56491e+07;-1.8297e+07;1;0;-1;0;1;-1;55649111;55649131;481
633;4.74216e-15;110;126;487;10859;1;45;5.75005e+07;-1.85136e+07;2;0;-1;0;2;-1;57500510;57500531;539
634;4.74216e-15;110;125;487;10859;1;45;5.93729e+07;-1.87239e+07;1;0;-1;0;1;-1;59372932;59372957;603
635;4.74216e-15;110;125;487;10859;1;45;6.12658e+07;-1.89278e+07;0;0;-1;0;0;-1;61265750;61265777;674
636;4.74216e-15;120;121;487;10859;1;45;6.31783e+07;-1.91255e+07;8;0;-1;0;8;-1;63178335;63178365;751
637;4.74216e-15;122;120;487;10859;1;45;6.51101e+07;-1.93169e+07;5;0;-1;0;5;-1;65110065;65110100;835
638;4.74216e-15;126;119;487;10859;1;45;6.70603e+07;-1.95022e+07;0;0;-1;0;0;-1;67060324;67060363;927
639;4.74216e-15;126;119;487;10859;1;45;6.90285e+07;-1.96814e+07;0;0;-1;0;0;-1;69028499;69028543;1028
640;4.74216e-15;146;112;487;10859;1;45;7.1014e+07;-1.98545e+07;23;0;-1;0;23;-1;71013983;71014033;1137
641;4.74216e-15;148;111;487;10859;1;45;7.30162e+07;-2.00216e+07;4;0;-1;0;4;-1;73016177;73016233;1257
642;4.74216e-15;148;110;487;10859;1;45;7.50345e+07;-2.01827e+07;1;0;-1;0;1;-1;75034487;75034549;1386
643;4.74216e-15;148;110;487;10859;1;45;7.70683e+07;-2.0338e+07;1;0;-1;0;1;-1;77068327;77068396;1527
644;4.74216e-15;151;108;487;10859;1;45;7.91171e+07;-2.04875e+07;5;0;-1;0;5;-1;79117118;79117193;1680
645;4.74216e-15;151;107;487;10859;1;45;8.11803e+07;-2.06313e+07;4;0;-1;0;4;-1;81180287;81180369;1844
646;4.74216e-15;156;105;487;10859;1;45;8.32573e+07;-2.07695e+07;7;0;-1;0;7;-1;83257270;83257361;2022
647;4.74216e-15;156;105;487;10859;1;45;8.53475e+07;-2.09021e+07;1;0;-1;0;1;-1;85347512;85347613;2215
648;4.74216e-15;159;104;487;10859;1;45;8.74505e+07;-2.10292e+07;5;0;-1;0;5;-1;87450466;87450575;2422
649;4.74216e-15;161;104;487;10859;1;45;8.95656e+07;-2.11509e+07;1;0;-1;0;1;-1;89565591;89565711;2644
650;4.74216e-15;167;103;487;10859;1;45;9.16924e+07;-2.12673e+07;8;0;-1;0;8;-1;91692358;91692490;2884
651;4.74216e-15;171;103;487;10859;1;45;9.38302e+07;-2.13785e+07;4;0;-1;0;4;-1;93830245;93830389;3141
652;4.74216e-15;171;103;487;10859;1;45;9.59787e+07;-2.14846e+07;0;0;-1;0;0;-1;95978738;95978895;3417
653;4.74216e-15;174;101;487;10859;1;45;9.81373e+07;-2.15856e+07;2;0;-1;0;2;-1;98137335;98137506;3712
654;4.74216e-15;176;101;487;10859;1;45;1.00306e+08;-2.16817e+07;4;0;-1;0;4;-1;100305538;100305725;4028
655;4.74216e-15;180;99;487;10859;1;45;1.02483e+08;-2.17729e+07;1;0;-1;0;1;-1;102482865;102483067;4366
656;4.74216e-15;180;99;487;10859;1;45;1.04669e+08;-2.18593e+07;0;0;-1;0;0;-1;104668836;104669056;4726
657;4.74216e-15;182;99;487;10859;1;45;1.06863e+08;-2.19411e+07;1;0;-1;0;1;-1;106862986;106863224;5111
658;4.74216e-15;184;97;487;10859;1;45;1.09065e+08;-2.20183e+07;4;0;-1;0;4;-1;109064855;109065113;5521
659;4.74216e-15;192;94;487;10859;1;45;1.11274e+08;-2.2091e+07;5;0;-1;0;5;-1;111273995;111274274;5957
660;4.74216e-15;195;93;487;10859;1;45;1.1349e+08;-2.21593e+07;5;0;-1;0;5;-1;113489966;113490268;6421
661;4.74216e-15;202;92;487;10859;1;45;1.15712e+08;-2.22233e+07;3;0;-1;0;3;-1;115712338;115712664;6914
662;4.74216e-15;205;92;487;10859;1;45;1.17941e+08;-2.22831e+07;3;0;-1;0;3;-1;117940689;117941040;7438
663;4.74216e-15;210;91;487;10859;1;45;1.20175e+08;-2.23388e+07;7;0;-1;0;7;-1;120174606;120174985;7993
664;4.74216e-15;214;89;487;10859;1;45;1.22414e+08;-2.23904e+07;4;0;-1;0;4;-1;122413688;122414096;8581
665;4.74216e-15;215;89;487;10859;1;45;1.24658e+08;-2.24381e+07;5;0;-1;0;5;-1;124657539;124657977;9204
666;4.74216e-15;216;87;487;10859;1;45;1.26906e+08;-2.2482e+07;3;0;-1;0;3;-1;126905774;126906246;9862
667;4.74216e-15;241;83;487;10859;1;45;1.29158e+08;-2.25221e+07;26;0;-1;0;26;-1;129158017;129158524;10559
668;4.74216e-15;255;81;487;10859;1;45;1.31414e+08;-2.25585e+07;5;0;-1;0;5;-1;131413902;131414446;11294
669;4.74216e-15;255;81;487;10859;1;45;1.33673e+08;-2.25913e+07;1;0;-1;0;1;-1;133673070;133673651;12070
670;4.74216e-15;264;79;487;10859;1;45;1.35935e+08;-2.26206e+07;18;0;-1;0;18;-1;135935168;135935792;12889
671;4.74216e-15;270;78;487;10859;1;45;1.382e+08;-2.26465e+07;1;0;-1;0;1;-1;138199859;138200525;13751
672;4.74216e-15;294;77;487;10859;1;45;1.40467e+08;-2.26691e+07;14;0;-1;0;14;-1;140466807;140467519;14659
673;4.74216e-15;296;77;487;10859;1;45;1.42736e+08;-2.26884e+07;1;0;-1;0;1;-1;142735689;142736449;15614
674;4.74216e-15;308;77;487;10859;1;45;1.45006e+08;-2.27046e+07;13;0;-1;0;13;-1;145006187;145006998;16619
675;4.74216e-15;308;77;487;10859;1;45;1.47278e+08;-2.27177e+07;0;0;-1;0;0;-1;147277994;147278859;17674
676;4.74216e-15;312;76;487;10859;1;45;1.49551e+08;-2.27278e+07;3;0;-1;0;3;-1;149550810;149551731;18782
677;4.74216e-15;322;75;487;10859;1;45;1.51824e+08;-2.27349e+07;10;0;-1;0;10;-1;151824342;151825322;19944
678;4.74216e-15;336;71;487;10859;1;45;1.54098e+08;-2.27393e+07;18;0;-1;0;18;-1;154098305;154099348;21163
679;4.74216e-15;341;71;487;10859;1;45;1.56372e+08;-2.27408e+07;2;0;-1;0;2;-1;156372424;156373533;22441
680;4.74216e-15;343;71;487;10859;1;45;1.58646e+08;-2.27397e+07;2;0;-1;0;2;-1;158646429;158647607;23779
681;4.74216e-15;346;70;487;10859;1;45;1.6092e+08;-2.27359e+07;6;0;-1;0;6;-1;160920057;160921308;25179
682;4.74216e-15;346;70;487;10859;1;45;1.63193e+08;-2.27296e+07;0;0;-1;0;0;-1;163193056;163194382;26643
683;4.74216e-15;350;70;487;10859;1;45;1.65465e+08;-2.27208e+07;4;0;-1;0;4;-1;165465176;165466582;28174
684;4.74216e-15;362;70;487;10859;1;45;1.67736e+08;-2.27096e+07;13;0;-1;0;13;-1;167736178;167737668;29773
685;4.74216e-15;362;69;487;10859;1;45;1.70006e+08;-2.26961e+07;4;0;-1;0;4;-1;170005829;170007407;31443
686;4.74216e-15;365;68;487;10859;1;45;1.72274e+08;-2.26803e+07;5;0;-1;0;5;-1;172273901;172275571;33185
687;4.74216e-15;365;68;487;10859;1;45;1.7454e+08;-2.26624e+07;1;0;-1;0;1;-1;174540177;174541942;35002
688;4.74216e-15;368;66;487;10859;1;45;1.76804e+08;-2.26423e+07;5;0;-1;0;5;-1;176804441;176806306;36896
689;4.74216e-15;376;65;487;10859;1;45;1.79066e+08;-2.26201e+07;6;0;-1;0;6;-1;179066487;179068456;38870
690;4.74216e-15;379;65;487;10859;1;45;1.81326e+08;-2.25959e+07;4;0;-1;0;4;-1;181326114;181328193;40924
691;4.74216e-15;385;64;487;10859;1;45;1.83583e+08;-2.25698e+07;7;0;-1;0;7;-1;183583128;183585322;43063
692;4.74216e-15;392;63;487;10859;1;45;1.85837e+08;-2.25418e+07;6;0;-1;0;6;-1;185837342;185839654;45287
693;4.74216e-15;396;63;487;10859;1;45;1.88089e+08;-2.25119e+07;3;0;-1;0;3;-1;188088571;188091008;47600
694;4.74216e-15;413;61;487;10859;1;45;1.90337e+08;-2.24803e+07;14;0;-1;0;14;-1;190336640;190339206;50003
695;4.74216e-15;414;60;487;10859;1;45;1.92581e+08;-2.2447e+07;1;0;-1;0;1;-1;192581378;192584079;52499
696;4.74216e-15;418;59;487;10859;1;45;1.94823e+08;-2.2412e+07;7;0;-1;0;7;-1;194822618;194825460;55091
697;4.74216e-15;421;59;487;10859;1;45;1.9706e+08;-2.23755e+07;8;0;-1;0;8;-1;197060202;197063191;57780
698;4.74216e-15;431;59;487;10859;1;45;1.99294e+08;-2.23373e+07;10;0;-1;0;10;-1;199293975;199297116;60569
699;4.74216e-15;446;58;487;10859;1;45;2.01524e+08;-2.22977e+07;8;0;-1;0;8;-1;201523786;201527085;63461
700;4.74216e-15;474;53;487;10859;1;45;2.03749e+08;-2.22567e+07;25;0;-1;0;25;-1;203749491;203752956;66458
701;4.74216e-15;475;53;487;10859;1;45;2.05971e+08;-2.22142e+07;2;0;-1;0;2;-1;205970953;205974588;69562
702;4.74216e-15;482;52;487;10859;1;45;2.08188e+08;-2.21704e+07;5;0;-1;0;5;-1;208188036;208191848;72776
703;4.74216e-15;485;51;487;10859;1;45;2.10401e+08;-2.21253e+07;7;0;-1;0;7;-1;210400609;210404606;76103
704;4.74216e-15;490;51;487;10859;1;45;2.12609e+08;-2.2079e+07;4;0;-1;0;4;-1;212608547;212612737;79544
705;4.74216e-15;516;50;487;10859;1;45;2.14812e+08;-2.20315e+07;13;0;-1;0;13;-1;214811731;214816119;83103
706;4.74216e-15;528;50;487;10859;1;45;2.1701e+08;-2.19827e+07;10;0;-1;0;10;-1;217010043;217014638;86781
707;4.74216e-15;531;50;487;10859;1;45;2.19203e+08;-2.19329e+07;3;0;-1;0;3;-1;219203372;219208180;90583
708;4.74216e-15;552;48;487;10859;1;45;2.21392e+08;-2.1882e+07;19;0;-1;0;19;-1;221391609;221396640;94509
709;4.74216e-15;560;47;487;10859;1;45;2.23575e+08;-2.183e+07;10;0;-1;0;10;-1;223574652;223579913;98563
710;4.74216e-15;560;47;487;10859;1;45;2.25752e+08;-2.17771e+07;0;0;-1;0;0;-1;225752401;225757899;102747
711;4.74216e-15;563;46;487;10859;1;45;2.27925e+08;-2.17232e+07;6;0;-1;0;6;-1;227924759;227930504;107063
712;4.74216e-15;567;46;487;10859;1;45;2.30092e+08;-2.16684e+07;4;0;-1;0;4;-1;230091635;230097636;111516
713;4.74216e-15;582;45;487;10859;1;45;2.32253e+08;-2.16127e+07;17;0;-1;0;17;-1;232252940;232259205;116106
714;4.74216e-15;612;44;487;10859;1;45;2.34409e+08;-2.15561e+07;50;0;-1;0;50;-1;234408588;234415128;120836
715;4.74216e-15;630;44;487;10859;1;45;2.36559e+08;-2.14988e+07;13;0;-1;0;13;-1;236558502;236565325;125710
716;4.74216e-15;650;44;487;10859;1;45;2.38703e+08;-2.14406e+07;20;0;-1;0;20;-1;238702602;238709718;130730
717;4.74216e-15;656;43;487;10859;1;45;2.40841e+08;-2.13817e+07;1;0;-1;0;1;-1;240840814;240848231;135898
718;4.74216e-15;675;43;487;10859;1;45;2.42973e+08;-2.13221e+07;10;0;-1;0;10;-1;242973066;242980795;141217
719;4.74216e-15;676;43;487;10859;1;45;2.45099e+08;-2.12619e+07;1;0;-1;0;1;-1;245099291;245107342;146689
720;4.74216e-15;682;43;487;10859;1;45;2.47219e+08;-2.12009e+07;6;0;-1;0;6;-1;247219423;247227805;152318
721;4.74216e-15;683;43;487;10859;1;45;2.49333e+08;-2.11394e+07;1;0;-1;0;1;-1;249333401;249342126;158106
722;4.74216e-15;689;41;487;10859;1;45;2.51441e+08;-2.10773e+07;8;0;-1;0;8;-1;251441166;251450244;164055
723;4.74216e-15;698;41;487;10859;1;45;2.53543e+08;-2.10146e+07;8;0;-1;0;8;-1;253542662;253552105;170168
724;4.74216e-15;710;41;487;10859;1;45;2.55638e+08;-2.09513e+07;6;0;-1;0;6;-1;255637835;255647654;176448
725;4.74216e-15;745;37;487;10859;1;45;2.57727e+08;-2.08876e+07;32;0;-1;0;32;-1;257726633;257736841;182897
726;4.74216e-15;785;35;487;10859;1;45;2.59809e+08;-2.08234e+07;51;0;-1;0;51;-1;259809009;259819619;189519
727;4.74216e-15;788;35;487;10859;1;45;2.61885e+08;-2.07587e+07;2;0;-1;0;2;-1;261884921;261895942;196315
728;4.74216e-15;798;34;487;10859;1;45;2.63954e+08;-2.06936e+07;12;0;-1;0;12;-1;263954323;263965767;203288
729;4.74216e-15;807;34;487;10859;1;45;2.66017e+08;-2.06281e+07;16;0;-1;0;16;-1;266017174;266029054;210440
730;4.74216e-15;823;34;487;10859;1;45;2.68073e+08;-2.05622e+07;9;0;-1;0;9;-1;268073436;268085764;217776
731;4.74216e-15;826;34;487;10859;1;45;2.70123e+08;-2.0496e+07;3;0;-1;0;3;-1;270123074;270135864;225296
732;4.74216e-15;829;34;487;10859;1;45;2.72166e+08;-2.04294e+07;8;0;-1;0;8;-1;272166054;272179319;233003
733;4.74216e-15;855;34;487;10859;1;45;2.74202e+08;-2.03625e+07;16;0;-1;0;16;-1;274202342;274216097;240901
734;4.74216e-15;862;33;487;10859;1;45;2.76232e+08;-2.02953e+07;7;0;-1;0;7;-1;276231911;276246169;248991
735;4.74216e-15;868;33;487;10859;1;45;2.78255e+08;-2.02278e+07;1;0;-1;0;1;-1;278254734;278269508;257276
736;4.74216e-15;868;33;487;10859;1;45;2.80271e+08;-2.01601e+07;1;0;-1;0;1;-1;280270783;280286089;265760
737;4.74216e-15;886;30;487;10859;1;45;2.8228e+08;-2.00921e+07;26;0;-1;0;26;-1;282280034;282295887;274443
738;4.74216e-15;890;30;487;10859;1;45;2.84282e+08;-2.00239e+07;5;0;-1;0;5;-1;284282468;284298879;283329
739;4.74216e-15;898;30;487;10859;1;45;2.86278e+08;-1.99556e+07;6;0;-1;0;6;-1;286278063;286295049;292420
740;4.74216e-15;899;30;487;10859;1;45;2.88267e+08;-1.9887e+07;4;0;-1;0;4;-1;288266801;288284379;301719
741;4.74216e-15;905;30;487;10859;1;45;2.90249e+08;-1.98183e+07;2;0;-1;0;2;-1;290248665;290266850;311229
742;4.74216e-15;906;30;487;10859;1;45;2.92224e+08;-1.97494e+07;3;0;-1;0;3;-1;292223641;292242449;320950
743;4.74216e-15;949;25;487;10859;1;45;2.94192e+08;-1.96803e+07;45;0;-1;0;45;-1;294191713;294211162;330887
744;4.74216e-15;952;25;487;10859;1;45;2.96153e+08;-1.96112e+07;3;0;-1;0;3;-1;296152872;296172978;341042
745;4.74216e-15;954;25;487;10859;1;45;2.98107e+08;-1.9542e+07;2;0;-1;0;2;-1;298107108;298127886;351416
746;4.74216e-15;1057;17;487;10859;1;45;3.00054e+08;-1.94726e+07;105;0;-1;0;105;-1;300054405;300075878;362013
747;4.74216e-15;1117;15;487;10859;1;45;3.01995e+08;-1.94032e+07;48;0;-1;0;48;-1;301994764;302016944;372834
748;4.74216e-15;1118;15;487;10859;1;45;3.03928e+08;-1.93338e+07;2;0;-1;0;2;-1;303928179;303951083;383883
749;4.74216e-15;1170;13;487;10859;1;45;3.05855e+08;-1.92642e+07;27;0;-1;0;27;-1;305854640;305878287;395161
750;4.74216e-15;1188;13;487;10859;1;45;3.07774e+08;-1.91947e+07;16;0;-1;0;16;-1;307774146;307798554;406670
751;4.74216e-15;1201;13;487;10859;1;45;3.09687e+08;-1.91251e+07;13;0;-1;0;13;-1;309686695;309711881;418414
752;4.74216e-15;1217;13;487;10859;1;45;3.11592e+08;-1.90555e+07;18;0;-1;0;18;-1;311592283;311618268;430393
753;4.74216e-15;1218;13;487;10859;1;45;3.13491e+08;-1.89859e+07;2;0;-1;0;2;-1;313490914;313517714;442612
754;4.74216e-15;1220;13;487;10859;1;45;3.15383e+08;-1.89163e+07;0;0;-1;0;0;-1;315382586;315410223;455071
755;4.74216e-15;1242;12;487;10859;1;45;3.17267e+08;-1.88468e+07;21;0;-1;0;21;-1;317267301;317295789;467773
756;4.74216e-15;1256;12;487;10859;1;45;3.19145e+08;-1.87772e+07;15;0;-1;0;15;-1;319145063;319174428;480720
757;4.74216e-15;1273;12;487;10859;1;45;3.21016e+08;-1.87077e+07;15;0;-1;0;15;-1;321015877;321046139;493915
758;4.74216e-15;1293;10;487;10859;1;45;3.2288e+08;-1.86383e+07;16;0;-1;0;16;-1;322879747;322910924;507359
759;4.74216e-15;1310;9;487;10859;1;45;3.24737e+08;-1.85689e+07;13;0;-1;0;13;-1;324736679;324768795;521055
760;4.74216e-15;1349;5;487;10859;1;45;3.26587e+08;-1.84996e+07;30;0;-1;0;30;-1;326586680;326619756;535005
761;4.74216e-15;1371;2;487;10859;1;45;3.2843e+08;-1.84304e+07;20;0;-1;0;20;-1;328429759;328463815;549210
762;4.74216e-15;1371;1;487;10859;1;45;3.30266e+08;-1.83613e+07;1;0;-1;0;1;-1;330265925;330300983;563674
763;4.74216e-15;1386;1;487;10859;1;45;3.32095e+08;-1.82922e+07;8;0;-1;0;8;-1;332095186;332131267;578397
764;4.74216e-15;1386;-1.13687e-13;487;10859;1;45;3.33918e+08;-1.82233e+07;1;0;0;0;1;0;333917553;333954680;593382
765;4.74216e-15;1387;-1.13687e-13;487;10859;1;45;3.35733e+08;-1.81544e+07;0;0;0;0;0;0;335733037;335771231;608631
766;4.74216e-15;1387;-1.13687e-13;487;10859;1;45;3.37542e+08;-1.80857e+07;1;0;0;0;1;0;337541650;337580934;624146
767;4.74216e-15;1388;-1.13687e-13;487;10859;1;45;3.39343e+08;-1.80171e+07;0;0;0;0;0;0;339343403;339383802;639929
768;4.74216e-15;1388;-1.13687e-13;487;10859;1;45;3.41138e+08;-1.79487e+07;1;0;0;0;1;0;341138311;341179849;655982
769;4.74216e-15;1389;-1.13687e-13;487;10859;1;45;3.42926e+08;-1.78804e+07;0;0;0;0;0;0;342926388;342969088;672306
770;4.74216e-15;1390;-1.13687e-13;487;10859;1;45;3.44708e+08;-1.78122e+07;0;0;0;0;0;0;344707647;344751533;688904
771;4.74216e-15;1391;-1.13687e-13;487;10859;1;45;3.46482e+08;-1.77442e+07;0;0;0;0;0;0;346482103;346527201;705776
772;4.74216e-15;1392;-1.13687e-13;487;10859;1;45;3.4825e+08;-1.76763e+07;0;0;0;0;0;0;348249773;348296107;722926
773;4.74216e-15;1393;-1.13687e-13;487;10859;1;45;3.50011e+08;-1.76086e+07;0;0;0;0;0;0;350010673;350058267;740355
774;4.74216e-15;1393;-1.13687e-13;487;10859;1;45;3.51765e+08;-1.75411e+07;1;0;0;0;1;0;351764818;351813700;758065
775;4.74216e-15;1394;-1.13687e-13;487;10859;1;45;3.53512e+08;-1.74737e+07;0;0;0;0;0;0;353512228;353562421;776057
776;4.74216e-15;1395;-1.13687e-13;487;10859;1;45;3.55253e+08;-1.74065e+07;0;0;0;0;0;0;355252919;355304449;794333
777;4.74216e-15;1396;-1.13687e-13;487;10859;1;45;3.56987e+08;-1.73395e+07;0;0;0;0;0;0;356986909;357039803;812894
778;4.74216e-15;1397;-1.13687e-13;487;10859;1;45;3.58714e+08;-1.72727e+07;0;0;0;0;0;0;358714217;358768501;831743
779;4.74216e-15;1398;-1.13687e-13;487;10859;1;45;3.60435e+08;-1.72061e+07;0;0;0;0;0;0;360434863;360490564;850881
780;4.74216e-15;1399;-1.13687e-13;487;10859;1;45;3.62149e+08;-1.71396e+07;0;0;0;0;0;0;362148866;362206011;870309
781;4.74216e-15;1399;-1.13687e-13;487;10859;1;45;3.63856e+08;-1.70734e+07;1;0;0;0;1;0;363856245;363914861;890030
782;4.74216e-15;1400;-1.13687e-13;487;10859;1;45;3.65557e+08;-1.70074e+07;0;0;0;0;0;0;365557022;365617139;910044
783;4.74216e-15;1400;-1.13687e-13;487;10859;1;45;3.67251e+08;-1.69416e+07;1;0;0;0;1;0;367251217;367312864;930353
784;4.74216e-15;1400;-1.13687e-13;487;10859;1;45;3.68939e+08;-1.68759e+07;1;0;0;0;1;0;368938851;369002055;950959
785;4.74216e-15;1401;-1.13687e-13;487;10859;1;45;3.7062e+08;-1.68105e+07;0;0;0;0;0;0;370619945;370684736;971863
786;4.74216e-15;1401;-1.13687e-13;487;10859;1;45;3.72295e+08;-1.67454e+07;1;0;0;0;1;0;372294521;372360929;993066
787;4.74216e-15;1401;-1.13687e-13;487;10859;1;45;3.73963e+08;-1.66804e+07;1;0;0;0;1;0;373962601;374030654;1014570
788;4.74216e-15;1402;-1.13687e-13;487;10859;1;45;3.75624e+08;-1.66157e+07;0;0;0;0;0;0;375624207;375693936;1036377
789;4.74216e-15;1402;-1.13687e-13;487;10859;1;45;3.77279e+08;-1.65512e+07;1;0;0;0;1;0;377279363;377350797;1058486
790;4.74216e-15;1403;-1.13687e-13;487;10859;1;45;3.78928e+08;-1.64869e+07;0;0;0;0;0;0;378928090;379001260;1080901
791;4.74216e-15;1403;-1.13687e-13;487;10859;1;45;3.8057e+08;-1.64228e+07;1;0;0;0;1;0;380570412;380645349;1103622
792;4.74216e-15;1403;-1.13687e-13;487;10859;1;45;3.82206e+08;-1.6359e+07;1;0;0;0;1;0;382206352;382283086;1126650
793;4.74216e-15;1404;-1.13687e-13;487;10859;1;45;3.83836e+08;-1.62954e+07;0;0;0;0;0;0;383835934;383914497;1149986
794;4.74216e-15;1405;-1.13687e-13;487;10859;1;45;3.85459e+08;-1.62321e+07;0;0;0;0;0;0;385459182;385539605;1173632
795;4.74216e-15;1405;-1.13687e-13;487;10859;1;45;3.87076e+08;-1.6169e+07;1;0;0;0;1;0;387076119;387158435;1197589
796;4.74216e-15;1405;-1.13687e-13;487;10859;1;45;3.88687e+08;-1.61061e+07;0;0;-1;0;0;-1;388686769;388771010;1221858
797;4.74216e-15;1406;-1.13687e-13;487;10859;1;45;3.90291e+08;-1.60435e+07;0;0;0;0;0;0;390291158;390377356;1246440
798;4.74216e-15;1406;-1.13687e-13;487;10859;1;45;3.91889e+08;-1.59811e+07;1;0;0;0;1;0;391889309;391977498;1271336
799;4.74216e-15;1406;-1.13687e-13;487;10859;1;45;3.93481e+08;-1.5919e+07;1;0;0;0;1;0;393481247;393571459;1296548
800;4.74216e-15;1406;-1.13687e-13;487;10859;1;45;3.95067e+08;-1.58571e+07;1;0;0;0;1;0;395066997;395159266;1322075
801;4.74216e-15;1407;-1.13687e-13;487;10859;1;45;3.96647e+08;-1.57955e+07;0;0;0;0;0;0;396646584;396740944;1347920
802;4.74216e-15;1408;-1.13687e-13;487;10859;1;45;3.9822e+08;-1.57341e+07;0;0;0;0;0;0;398220032;398316518;1374083
803;4.74216e-15;1408;-1.13687e-13;487;10859;1;45;3.99787e+08;-1.5673e+07;1;0;0;0;1;0;399787368;399886013;1400565
804;4.74216e-15;1408;-1.13687e-13;487;10859;1;45;4.01349e+08;-1.56121e+07;1;0;0;0;1;0;401348616;401449456;1427367
805;4.74216e-15;1409;-1.13687e-13;487;10859;1;45;4.02904e+08;-1.55515e+07;0;0;0;0;0;0;402903802;403006871;1454489
806;4.74216e-15;1409;-1.13687e-13;487;10859;1;45;4.04453e+08;-1.54911e+07;1;0;0;0;1;0;404452951;404558285;1481934
807;4.74216e-15;1410;-1.13687e-13;487;10859;1;45;4.05996e+08;-1.5431e+07;0;0;0;0;0;0;405996089;406103724;1509700
808;4.74216e-15;1410;-1.13687e-13;487;10859;1;45;4.07533e+08;-1.53711e+07;0;0;-1;0;0;-1;407533241;407643213;1537790
809;4.74216e-15;1410;-1.13687e-13;487;10859;1;45;4.09064e+08;-1.53115e+07;1;0;0;0;1;0;409064433;409176778;1566204
810;4.74216e-15;1410;-1.13687e-13;487;10859;1;45;4.1059e+08;-1.52522e+07;1;0;0;0;1;0;410589692;410704447;1594943
811;4.74216e-15;1411;-1.13687e-13;487;10859;1;45;4.12109e+08;-1.51931e+07;0;0;0;0;0;0;412109042;412226243;1624007
812;4.74216e-15;1411;-1.13687e-13;487;10859;1;45;4.13623e+08;-1.51343e+07;1;0;0;0;1;0;413622509;413742195;1653397
813;4.74216e-15;1412;-1.13687e-13;487;10859;1;45;4.1513e+08;-1.50757e+07;0;0;0;0;0;0;415130121;415252328;1683114
814;4.74216e-15;1413;-1.13687e-13;487;10859;1;45;4.16632e+08;-1.50174e+07;0;0;0;0;0;0;416631901;416756668;1713158
815;4.74216e-15;1414;-1.13687e-13;487;10859;1;45;4.18128e+08;-1.49594e+07;0;0;0;0;0;0;418127878;418255242;1743530
816;4.74216e-15;1415;-1.13687e-13;487;10859;1;45;4.19618e+08;-1.49016e+07;0;0;0;0;0;0;419618075;419748076;1774231
817;4.74216e-15;1416;-1.13687e-13;487;10859;1;45;4.21103e+08;-1.48441e+07;0;0;0;0;0;0;421102521;421235197;1805260
818;4.74216e-15;1417;-1.13687e-13;487;10859;1;45;4.22581e+08;-1.47868e+07;0;0;0;0;0;0;422581239;422716630;1836619
819;4.74216e-15;1418;-1.13687e-13;487;10859;1;45;4.24054e+08;-1.47298e+07;0;0;0;0;0;0;424054258;424192402;1868308
820;4.74216e-15;1418;-1;487;10859;1;45;4.25522e+08;-1.4673e+07;0;0;0;0;0;0;425521602;425662539;1900328
821;4.74216e-15;1418;-1;487;10859;1;45;4.26983e+08;-1.46166e+07;1;0;0;0;1;0;426983297;427127068;1932678
822;4.74216e-15;1418;-1;487;10859;1;45;4.28439e+08;-1.45603e+07;1;0;0;0;1;0;428439370;428586015;1965360
823;4.74216e-15;1418;-1;487;10859;1;45;4.2989e+08;-1.45044e+07;1;0;0;0;1;0;429889847;430039407;1998373
824;4.74216e-15;1419;-1;487;10859;1;45;4.31335e+08;-1.44487e+07;0;0;0;0;0;0;431334754;431487269;2031719
825;4.74216e-15;1420;-1;487;10859;1;45;4.32774e+08;-1.43932e+07;0;0;0;0;0;0;432774116;432929628;2065396
826;4.74216e-15;1421;-1;487;10859;1;45;4.34208e+08;-1.4338e+07;0;0;0;0;0;0;434207960;434366510;2099407
827;4.74216e-15;1421;-1;487;10859;1;45;4.35636e+08;-1.42831e+07;1;0;0;0;1;0;435636312;435797942;2133750
828;4.74216e-15;1422;-1;487;10859;1;45;4.37059e+08;-1.42285e+07;0;0;0;0;0;0;437059197;437223949;2168426
829;4.74216e-15;1422;-1;487;10859;1;45;4.38477e+08;-1.4174e+07;1;0;0;0;1;0;438476641;438644557;2203436
830;4.74216e-15;1423;-1;487;10859;1;45;4.39889e+08;-1.41199e+07;0;0;0;0;0;0;439888670;440059794;2238779
831;4.74216e-15;1424;-1;487;10859;1;45;4.41295e+08;-1.4066e+07;0;0;0;0;0;0;441295310;441469684;2274456
832;4.74216e-15;1424;-1;487;10859;1;45;4.42697e+08;-1.40124e+07;1;0;0;0;1;0;442696587;442874255;2310467
833;4.74216e-15;1425;-1;487;10859;1;45;4.44093e+08;-1.3959e+07;0;0;0;0;0;0;444092525;444273531;2346812
834;4.74216e-15;1425;-1;487;10859;1;45;4.45483e+08;-1.39059e+07;1;0;0;0;1;0;445483152;445667538;2383491
835;4.74216e-15;1425;-1;487;10859;1;45;4.46868e+08;-1.3853e+07;1;0;0;0;1;0;446868492;447056303;2420504
836;4.74216e-15;1426;-1;487;10859;1;45;4.48249e+08;-1.38004e+07;0;0;0;0;0;0;448248570;448439852;2457851
837;4.74216e-15;1426;-1;487;10859;1;45;4.49623e+08;-1.3748e+07;1;0;0;0;1;0;449623413;449818209;2495533
838;4.74216e-15;1426;-1;487;10859;1;45;4.50993e+08;-1.36959e+07;1;0;0;0;1;0;450993045;451191401;2533549
839;4.74216e-15;1427;-1;487;10859;1;45;4.52357e+08;-1.36441e+07;0;0;0;0;0;0;452357493;452559453;2571899
840;4.74216e-15;1428;-1;487;10859;1;45;4.53717e+08;-1.35925e+07;0;0;0;0;0;0;453716780;453922391;2610583
841;4.74216e-15;1428;-1;487;10859;1;45;4.55071e+08;-1.35411e+07;1;0;0;0;1;0;455070933;455280240;2649602
842;4.74216e-15;1429;-1;487;10859;1;45;4.5642e+08;-1.349e+07;0;0;0;0;0;0;456419975;456633025;2688954
843;4.74216e-15;1430;-1;487;10859;1;45;4.57764e+08;-1.34392e+07;0;0;0;0;0;0;457763934;457980772;2728641
844;4.74216e-15;1431;-1;487;10859;1;45;4.59103e+08;-1.33886e+07;0;0;0;0;0;0;459102832;459323506;2768661
845;4.74216e-15;1431;-1;487;10859;1;45;4.60437e+08;-1.33382e+07;1;0;0;0;1;0;460436695;460661252;2809015
846;4.74216e-15;1431;-1;487;10859;1;45;4.61766e+08;-1.32881e+07;1;0;0;0;1;0;461765548;461994034;2849703
847;4.74216e-15;1431;-1;487;10859;1;45;4.63089e+08;-1.32383e+07;1;0;0;0;1;0;463089415;463321879;2890723
848;4.74216e-15;1432;-1;487;10859;1;45;4.64408e+08;-1.31887e+07;0;0;0;0;0;0;464408321;464644810;2932077
849;4.74216e-15;1432;-1;487;10859;1;45;4.65722e+08;-1.31393e+07;1;0;0;0;1;0;465722291;465962853;2973764
850;4.74216e-15;1433;-1;487;10859;1;45;4.67031e+08;-1.30902e+07;0;0;0;0;0;0;467031348;467276032;3015783
851;4.74216e-15;1434;-1;487;10859;1;45;4.68336e+08;-1.30413e+07;0;0;0;0;0;0;468335518;468584372;3058135
852;4.74216e-15;1435;-1;487;10859;1;45;4.69635e+08;-1.29927e+07;0;0;0;0;0;0;469634823;469887897;3100818
853;4.74216e-15;1435;-1;487;10859;1;45;4.70929e+08;-1.29443e+07;1;0;0;0;1;0;470929289;471186631;3143833
854;4.74216e-15;1436;-1;487;10859;1;45;4.72219e+08;-1.28961e+07;0;0;0;0;0;0;472218940;472480599;3187180
855;4.74216e-15;1437;-1;487;10859;1;45;4.73504e+08;-1.28482e+07;0;0;0;0;0;0;473503799;473769825;3230858
856;4.74216e-15;1438;-1;487;10859;1;45;4.74784e+08;-1.28005e+07;0;0;0;0;0;0;474783890;475054334;3274866
857;4.74216e-15;1439;-1;487;10859;1;45;4.76059e+08;-1.27531e+07;0;0;0;0;0;0;476059236;476334148;3319204
858;4.74216e-15;1439;-1;487;10859;1;45;4.7733e+08;-1.27059e+07;1;0;0;0;1;0;477329862;477609292;3363873
859;4.74216e-15;1440;-1;487;10859;1;45;4.78596e+08;-1.26589e+07;0;0;0;0;0;0;478595792;478879789;3408870
860;4.74216e-15;1440;-2;487;10859;1;45;4.79857e+08;-1.26122e+07;0;0;0;0;0;0;479857047;480145664;3454197
861;4.74216e-15;1441;-2;487;10859;1;45;4.81114e+08;-1.25657e+07;0;0;0;0;0;0;481113652;481406940;3499852
862;4.74216e-15;1441;-2;487;10859;1;45;4.82366e+08;-1.25194e+07;1;0;0;0;1;0;482365630;482663640;3545835
863;4.74216e-15;1441;-2;487;10859;1;45;4.83613e+08;-1.24733e+07;1;0;0;0;1;0;483613004;483915788;3592145
864;4.74216e-15;1441;-2;487;10859;1;45;4.84856e+08;-1.24275e+07;1;0;0;0;1;0;484855796;485163407;3638783
865;4.74216e-15;1442;-2;487;10859;1;45;4.86094e+08;-1.23819e+07;0;0;0;0;0;0;486094031;486406520;3685746
866;4.74216e-15;1443;-2;487;10859;1;45;4.87328e+08;-1.23366e+07;0;0;0;0;0;0;487327730;487645149;3733036
867;4.74216e-15;1443;-2;487;10859;1;45;4.88557e+08;-1.22915e+07;1;0;0;0;1;0;488556917;488879319;3780651
868;4.74216e-15;1443;-2;487;10859;1;45;4.89782e+08;-1.22466e+07;1;0;0;0;1;0;489781613;490109051;3828591
869;4.74216e-15;1444;-2;487;10859;1;45;4.91002e+08;-1.22019e+07;0;0;0;0;0;0;491001841;491334369;3876854
870;4.74216e-15;1444;-2;487;10859;1;45;4.92218e+08;-1.21574e+07;1;0;0;0;1;0;492217624;492555295;3925441
871;4.74216e-15;1445;-2;487;10859;1;45;4.93429e+08;-1.21132e+07;0;0;0;0;0;0;493428984;493771851;3974351
872;4.74216e-15;1445;-2;487;10859;1;45;4.94636e+08;-1.20692e+07;1;0;0;0;1;0;494635943;494984060;4023583
873;4.74216e-15;1446;-2;487;10859;1;45;4.95839e+08;-1.20254e+07;0;0;0;0;0;0;495838523;496191944;4073137
874;4.74216e-15;1446;-2;487;10859;1;45;4.97037e+08;-1.19818e+07;1;0;0;0;1;0;497036746;497395526;4123011
875;4.74216e-15;1447;-2;487;10859;1;45;4.98231e+08;-1.19385e+07;0;0;0;0;0;0;498230633;498594826;4173206
876;4.74216e-15;1448;-2;487;10859;1;45;4.9942e+08;-1.18953e+07;0;0;0;0;0;0;499420207;499789868;4223720
877;4.74216e-15;1449;-2;487;10859;1;45;5.00605e+08;-1.18524e+07;0;0;0;0;0;0;500605489;500980672;4274552
878;4.74216e-15;1449;-2;487;10859;1;45;5.01786e+08;-1.18097e+07;1;0;0;0;1;0;501786500;502167262;4325703
879;4.74216e-15;1449;-2;487;10859;1;45;5.02963e+08;-1.17672e+07;1;0;0;0;1;0;502963261;503349657;4377170
880;4.74216e-15;1449;-2;487;10859;1;45;5.04136e+08;-1.17249e+07;1;0;0;0;1;0;504135795;504527880;4428954
881;4.74216e-15;1449;-2;487;10859;1;45;5.05304e+08;-1.16829e+07;1;0;0;0;1;0;505304121;505701952;4481054
882;4.74216e-15;1449;-2;487;10859;1;45;5.06468e+08;-1.1641e+07;1;0;0;0;1;0;506468262;506871894;4533468
883;4.74216e-15;1449;-2;487;10859;1;45;5.07628e+08;-1.15994e+07;1;0;0;0;1;0;507628238;508037727;4586197
884;4.74216e-15;1450;-2;487;10859;1;45;5.08784e+08;-1.15579e+07;0;0;0;0;0;0;508784069;509199473;4639238
885;4.74216e-15;1450;-2;487;10859;1;45;5.09936e+08;-1.15167e+07;1;0;0;0;1;0;509935777;510357152;4692592
886;4.74216e-15;1451;-2;487;10859;1;45;5.11083e+08;-1.14756e+07;0;0;0;0;0;0;511083382;511510785;4746258
887;4.74216e-15;1451;-2;487;10859;1;45;5.12227e+08;-1.14348e+07;1;0;0;0;1;0;512226905;512660392;4800234
888;4.74216e-15;1451;-2;487;10859;1;45;5.13366e+08;-1.13942e+07;1;0;0;0;1;0;513366365;513805994;4854519
889;4.74216e-15;1452;-2;487;10859;1;45;5.14502e+08;-1.13538e+07;0;0;0;0;0;0;514501783;514947613;4909114
890;4.74216e-15;1452;-2;487;10859;1;45;5.15633e+08;-1.13136e+07;1;0;0;0;1;0;515633179;516085266;4964016
891;4.74216e-15;1452;-2;487;10859;1;45;5.16761e+08;-1.12735e+07;1;0;0;0;1;0;516760573;517218977;5019226
892;4.74216e-15;1452;-2;487;10859;1;45;5.17884e+08;-1.12337e+07;1;0;0;0;1;0;517883986;518348763;5074741
893;4.74216e-15;1452;-2;487;10859;1;45;5.19003e+08;-1.11941e+07;1;0;0;0;1;0;519003436;519474645;5130562
894;4.74216e-15;1453;-2;487;10859;1;45;5.20119e+08;-1.11547e+07;0;0;0;0;0;0;520118944;520596644;5186687
895;4.74216e-15;1454;-2;487;10859;1;45;5.21231e+08;-1.11154e+07;0;0;0;0;0;0;521230528;521714778;5243115
896;4.74216e-15;1455;-2;487;10859;1;45;5.22338e+08;-1.10764e+07;0;0;0;0;0;0;522338210;522829068;5299846
897;4.74216e-15;1455;-2;487;10859;1;45;5.23442e+08;-1.10376e+07;1;0;0;0;1;0;523442007;523939532;5356878
898;4.74216e-15;1456;-2;487;10859;1;45;5.24542e+08;-1.09989e+07;0;0;0;0;0;0;524541939;525046191;5414210
899;4.74216e-15;1457;-2;487;10859;1;45;5.25638e+08;-1.09605e+07;0;0;0;0;0;0;525638025;526149064;5471842
900;4.74216e-15;1457;-2;487;10859;1;45;5.2673e+08;-1.09222e+07;1;0;0;0;1;0;526730284;527248169;5529772
901;4.74216e-15;1457;-2;487;10859;1;45;5.27819e+08;-1.08841e+07;1;0;0;0;1;0;527818736;528343527;5587999
902;4.74216e-15;1457;-2;487;10859;1;45;5.28903e+08;-1.08462e+07;1;0;0;0;1;0;528903398;529435155;5646523
903;4.74216e-15;1458;-2;487;10859;1;45;5.29984e+08;-1.08085e+07;0;0;0;0;0;0;529984291;530523073;5705342
904;4.74216e-15;1458;-2;487;10859;1;45;5.31061e+08;-1.0771e+07;1;0;0;0;1;0;531061431;531607300;5764455
905;4.74216e-15;1458;-2;487;10859;1;45;5.32135e+08;-1.07337e+07;1;0;0;0;1;0;532134838;532687854;5823861
906;4.74216e-15;1458;-2;487;10859;1;45;5.33205e+08;-1.06965e+07;1;0;0;0;1;0;533204529;533764753;5883559
907;4.74216e-15;1459;-2;487;10859;1;45;5.34271e+08;-1.06596e+07;0;0;0;0;0;0;534270524;534838017;5943548
908;4.74216e-15;1459;-3;487;10859;1;45;5.35333e+08;-1.06228e+07;0;0;0;0;0;0;535332841;535907663;6003828
909;4.74216e-15;1459;-4;487;10859;1;45;5.36391e+08;-1.05862e+07;0;0;0;0;0;0;536391497;536973710;6064396
910;4.74216e-15;1459;-4;487;10859;1;45;5.37447e+08;-1.05497e+07;1;0;0;0;1;0;537446510;538036176;6125252
911;4.74216e-15;1459;-4;487;10859;1;45;5.38498e+08;-1.05135e+07;1;0;0;0;1;0;538497899;539095078;6186394
912;4.74216e-15;1460;-4;487;10859;1;45;5.39546e+08;-1.04774e+07;0;0;0;0;0;0;539545680;540150435;6247822
913;4.74216e-15;1460;-4;487;10859;1;45;5.4059e+08;-1.04415e+07;1;0;0;0;1;0;540589872;541202265;6309535
914;4.74216e-15;1460;-4;487;10859;1;45;5.4163e+08;-1.04058e+07;1;0;0;0;1;0;541630493;542250584;6371531
915;4.74216e-15;1460;-4;487;10859;1;45;5.42668e+08;-1.03703e+07;1;0;0;0;1;0;542667558;543295411;6433809
916;4.74216e-15;1461;-4;487;10859;1;45;5.43701e+08;-1.03349e+07;0;0;0;0;0;0;543701087;544336764;6496368
917;4.74216e-15;1461;-4;487;10859;1;45;5.44731e+08;-1.02997e+07;1;0;0;0;1;0;544731095;545374658;6559206
918;4.74216e-15;1461;-4;487;10859;1;45;5.45758e+08;-1.02647e+07;1;0;0;0;1;0;545757601;546409113;6622324
919;4.74216e-15;1462;-4;487;10859;1;45;5.46781e+08;-1.02298e+07;0;0;0;0;0;0;546780621;547440144;6685719
920;4.74216e-15;1462;-4;487;10859;1;45;5.478e+08;-1.01951e+07;0;0;-1;0;0;-1;547800172;548467770;6749391
921;4.74216e-15;1463;-4;487;10859;1;45;5.48816e+08;-1.01606e+07;0;0;0;0;0;0;548816270;549492006;6813337
922;4.74216e-15;1463;-4;487;10859;1;45;5.49829e+08;-1.01262e+07;1;0;0;0;1;0;549828934;550512870;6877558
923;4.74216e-15;1464;-4;487;10859;1;45;5.50838e+08;-1.0092e+07;0;0;0;0;0;0;550838178;551530379;6942052
924;4.74216e-15;1464;-4;487;10859;1;45;5.51844e+08;-1.0058e+07;1;0;0;0;1;0;551844020;552544548;7006817
925;4.74216e-15;1465;-4;487;10859;1;45;5.52846e+08;-1.00242e+07;0;0;0;0;0;0;552846477;553555395;7071853
926;4.74216e-15;1465;-4;487;10859;1;45;5.53846e+08;-9.99046e+06;1;0;0;0;1;0;553845563;554562937;7137158
927;4.74216e-15;1465;-4;487;10859;1;45;5.54841e+08;-9.95693e+06;1;0;0;0;1;0;554841296;555567188;7202731
928;4.74216e-15;1466;-4;487;10859;1;45;5.55834e+08;-9.92356e+06;0;0;0;0;0;0;555833692;556568167;7268571
929;4.74216e-15;1466;-4;487;10859;1;45;5.56823e+08;-9.89034e+06;1;0;0;0;1;0;556822767;557565888;7334676
930;4.74216e-15;1466;-4;487;10859;1;45;5.57809e+08;-9.85729e+06;1;0;0;0;1;0;557808536;558560368;7401046
931;4.74216e-15;1467;-4;487;10859;1;45;5.58791e+08;-9.8244e+06;0;0;0;0;0;0;558791016;559551622;7467679
932;4.74216e-15;1467;-4;487;10859;1;45;5.5977e+08;-9.79166e+06;1;0;0;0;1;0;559770222;560539668;7534574
933;4.74216e-15;1467;-4;487;10859;1;45;5.60746e+08;-9.75908e+06;1;0;0;0;1;0;560746169;561524519;7601730
934;4.74216e-15;1467;-4;487;10859;1;45;5.61719e+08;-9.72665e+06;1;0;0;0;1;0;561718874;562506193;7669145
935;4.74216e-15;1468;-4;487;10859;1;45;5.62688e+08;-9.69438e+06;0;0;0;0;0;0;562688352;563484704;7736819
936;4.74216e-15;1469;-4;487;10859;1;45;5.63655e+08;-9.66226e+06;0;0;0;0;0;0;563654618;564460069;7804749
937;4.74216e-15;1469;-4;487;10859;1;45;5.64618e+08;-9.63029e+06;1;0;0;0;1;0;564617688;565432301;7872935
938;4.74216e-15;1470;-4;487;10859;1;45;5.65578e+08;-9.59848e+06;0;0;0;0;0;0;565577576;566401418;7941376
939;4.74216e-15;1471;-4;487;10859;1;45;5.66534e+08;-9.56681e+06;0;0;0;0;0;0;566534297;567367433;8010070
940;4.74216e-15;1472;-4;487;10859;1;45;5.67488e+08;-9.5353e+06;0;0;0;0;0;0;567487868;568330362;8079015
941;4.74216e-15;1472;-4;487;10859;1;45;5.68438e+08;-9.50394e+06;1;0;0;0;1;0;568438301;569290220;8148212
942;4.74216e-15;1473;-4;487;10859;1;45;5.69386e+08;-9.47272e+06;0;0;0;0;0;0;569385614;570247022;8217657
943;4.74216e-15;1473;-4;487;10859;1;45;5.7033e+08;-9.44165e+06;1;0;0;0;1;0;570329819;571200782;8287351
944;4.74216e-15;1474;-4;487;10859;1;45;5.71271e+08;-9.41072e+06;0;0;0;0;0;0;571270932;572151516;8357292
945;4.74216e-15;1474;-4;487;10859;1;45;5.72209e+08;-9.37995e+06;1;0;0;0;1;0;572208966;573099238;8427478
946;4.74216e-15;1475;-4;487;10859;1;45;5.73144e+08;-9.34931e+06;0;0;0;0;0;0;573143938;574043962;8497909
947;4.74216e-15;1475;-4;487;10859;1;45;5.74076e+08;-9.31882e+06;1;0;0;0;1;0;574075861;574985703;8568583
948;4.74216e-15;1475;-4;487;10859;1;45;5.75005e+08;-9.28848e+06;1;0;0;0;1;0;575004748;575924476;8639498
949;4.74216e-15;1475;-4;487;10859;1;45;5.75931e+08;-9.25827e+06;1;0;0;0;1;0;575930616;576860294;8710654
950;4.74216e-15;1476;-4;487;10859;1;45;5.76853e+08;-9.2282e+06;0;0;0;0;0;0;576853477;577793172;8782049
951;4.74216e-15;1476;-4;487;10859;1;45;5.77773e+08;-9.19828e+06;1;0;0;0;1;0;577773345;578723123;8853681
952;4.74216e-15;1477;-4;487;10859;1;45;5.7869e+08;-9.1685e+06;0;0;0;0;0;0;578690235;579650163;8925551
953;4.74216e-15;1477;-4;487;10859;1;45;5.79604e+08;-9.13885e+06;1;0;0;0;1;0;579604160;580574304;8997655
954;4.74216e-15;1477;-4;487;10859;1;45;5.80515e+08;-9.10934e+06;1;0;0;0;1;0;580515134;581495561;9069994
955;4.74216e-15;1478;-4;487;10859;1;45;5.81423e+08;-9.07997e+06;0;0;0;0;0;0;581423171;582413947;9142565
956;4.74216e-15;1479;-4;487;10859;1;45;5.82328e+08;-9.05073e+06;0;0;0;0;0;0;582328285;583329476;9215367
957;4.74216e-15;1480;-4;487;10859;1;45;5.8323e+08;-9.02163e+06;0;0;0;0;0;0;583230488;584242162;9288400
958;4.74216e-15;1481;-4;487;10859;1;45;5.8413e+08;-8.99266e+06;0;0;0;0;0;0;584129794;585152018;9361661
959;4.74216e-15;1481;-4;487;10859;1;45;5.85026e+08;-8.96383e+06;1;0;0;0;1;0;585026217;586059057;9435149
960;4.74216e-15;1481;-4;487;10859;1;45;5.8592e+08;-8.93512e+06;1;0;0;0;1;0;585919770;586963293;9508864
961;4.74216e-15;1481;-4;487;10859;1;45;5.8681e+08;-8.90656e+06;1;0;0;0;1;0;586810467;587864739;9582804
962;4.74216e-15;1482;-4;487;10859;1;45;5.87698e+08;-8.87812e+06;0;0;0;0;0;0;587698319;588763408;9656967
963;4.74216e-15;1483;-4;487;10859;1;45;5.88583e+08;-8.84981e+06;0;0;0;0;0;0;588583340;589659314;9731352
964;4.74216e-15;1483;-4;487;10859;1;45;5.89466e+08;-8.82163e+06;1;0;0;0;1;0;589465544;590552469;9805958
965;4.74216e-15;1483;-4;487;10859;1;45;5.90345e+08;-8.79358e+06;1;0;0;0;1;0;590344943;591442886;9880784
966;4.74216e-15;1484;-4;487;10859;1;45;5.91222e+08;-8.76566e+06;0;0;0;0;0;0;591221549;592330578;9955828
967;4.74216e-15;1484;-4;487;10859;1;45;5.92095e+08;-8.73786e+06;1;0;0;0;1;0;592095376;593215558;10031088
968;4.74216e-15;1484;-4;487;10859;1;45;5.92966e+08;-8.7102e+06;1;0;0;0;1;0;592966436;594097838;10106565
969;4.74216e-15;1484;-4;487;10859;1;45;5.93835e+08;-8.68265e+06;1;0;0;0;1;0;593834742;594977432;10182256
970;4.74216e-15;1484;-4;487;10859;1;45;5.947e+08;-8.65524e+06;1;0;0;0;1;0;594700306;595854351;10258159
971;4.74216e-15;1485;-4;487;10859;1;45;5.95563e+08;-8.62794e+06;0;0;0;0;0;0;595563141;596728608;10334275
972;4.74216e-15;1485;-4;487;10859;1;45;5.96423e+08;-8.60077e+06;1;0;0;0;1;0;596423258;597600216;10410600
973;4.74216e-15;1485;-4;487;10859;1;45;5.97281e+08;-8.57372e+06;1;0;0;0;1;0;597280671;598469187;10487135
974;4.74216e-15;1485;-4;487;10859;1;45;5.98135e+08;-8.5468e+06;1;0;0;0;1;0;598135391;599335532;10563878
975;4.74216e-15;1486;-4;487;10859;1;45;5.98987e+08;-8.51999e+06;0;0;0;0;0;0;598987431;600199265;10640827
976;4.74216e-15;1487;-4;487;10859;1;45;5.99837e+08;-8.49331e+06;0;0;0;0;0;0;599836802;601060396;10717981
977;4.74216e-15;1487;-4;487;10859;1;45;6.00684e+08;-8.46674e+06;1;0;0;0;1;0;600683517;601918939;10795338
978;4.74216e-15;1488;-4;487;10859;1;45;6.01528e+08;-8.4403e+06;0;0;0;0;0;0;601527587;602774905;10872898
979;4.74216e-15;1488;-4;487;10859;1;45;6.02369e+08;-8.41397e+06;1;0;0;0;1;0;602369025;603628306;10950660
980;4.74216e-15;1489;-4;487;10859;1;45;6.03208e+08;-8.38776e+06;0;0;0;0;0;0;603207841;604479154;11028621
981;4.74216e-15;1490;-4;487;10859;1;45;6.04044e+08;-8.36166e+06;0;0;0;0;0;0;604044048;605327460;11106781
982;4.74216e-15;1491;-4;487;10859;1;45;6.04878e+08;-8.33569e+06;0;0;0;0;0;0;604877658;606173237;11185138
983;4.74216e-15;1492;-4;487;10859;1;45;6.05709e+08;-8.30983e+06;0;0;0;0;0;0;605708681;607016495;11263690
984;4.74216e-15;1492;-4;487;10859;1;45;6.06537e+08;-8.28408e+06;1;0;0;0;1;0;606537129;607857246;11342438
985;4.74216e-15;1492;-4;487;10859;1;45;6.07363e+08;-8.25844e+06;1;0;0;0;1;0;607363015;608695501;11421378
986;4.74216e-15;1492;-4;487;10859;1;45;6.08186e+08;-8.23292e+06;0;0;-1;0;0;-1;608186348;609531273;11500511
987;4.74216e-15;1492;-4;487;10859;1;45;6.09007e+08;-8.20752e+06;1;0;0;0;1;0;609007140;610364571;11579834
988;4.74216e-15;1492;-4;487;10859;1;45;6.09825e+08;-8.18222e+06;1;0;0;0;1;0;609825403;611195408;11659347
989;4.74216e-15;1492;-4;487;10859;1;45;6.10641e+08;-8.15704e+06;1;0;0;0;1;0;610641148;612023795;11739047
990;4.74216e-15;1492;-4;487;10859;1;45;6.11454e+08;-8.13197e+06;1;0;0;0;1;0;611454385;612849742;11818935
991;4.74216e-15;1493;-4;487;10859;1;45;6.12265e+08;-8.107e+06;0;0;0;0;0;0;612265126;613673261;11899008
992;4.74216e-15;1493;-4;487;10859;1;45;6.13073e+08;-8.08215e+06;1;0;0;0;1;0;613073382;614494362;11979265
993;4.74216e-15;1494;-4;487;10859;1;45;6.13879e+08;-8.0574e+06;0;0;0;0;0;0;613879163;615313057;12059704
994;4.74216e-15;1495;-4;487;10859;1;45;6.14682e+08;-8.03277e+06;0;0;0;0;0;0;614682481;616129356;12140326
995;4.74216e-15;1495;-4;487;10859;1;45;6.15483e+08;-8.00824e+06;1;0;0;0;1;0;615483345;616943270;12221127
996;4.74216e-15;1496;-4;487;10859;1;45;6.16282e+08;-7.98382e+06;0;0;0;0;0;0;616281768;617754809;12302108
997;4.74216e-15;1496;-4;487;10859;1;45;6.17078e+08;-7.9595e+06;1;0;0;0;1;0;617077758;618563985;12383266
998;4.74216e-15;1496;-4;487;10859;1;45;6.17871e+08;-7.93529e+06;1;0;0;0;1;0;617871328;619370807;12464600
999;4.74216e-15;1497;-4;487;10859;1;45;6.18662e+08;-7.91118e+06;0;0;0;0;0;0;618662487;620175287;12546110
1000;4.74216e-15;1497;-4;487;10859;1;45;6.19451e+08;-7.88718e+06;1;0;0;0;1;0;619451246;620977435;12627793
1001;4.74216e-15;1498;-4;487;10859;1;45;6.20238e+08;-7.86328e+06;0;0;0;0;0;0;620237615;621777261;12709649
1002;4.74216e-15;1499;-4;487;10859;1;45;6.21022e+08;-7.83949e+06;0;0;0;0;0;0;621021604;622574775;12791676
1003;4.74216e-15;1500;-4;487;10859;1;45;6.21803e+08;-7.8158e+06;0;0;0;0;0;0;621803225;623369987;12873873
1004;4.74216e-15;1500;-4;487;10859;1;45;6.22582e+08;-7.79221e+06;1;0;0;0;1;0;622582486;624162908;12956239
1005;4.74216e-15;1501;-4;487;10859;1;45;6.23359e+08;-7.76872e+06;0;0;0;0;0;0;623359398;624953549;13038772
1006;4.74216e-15;1501;-4;487;10859;1;45;6.24134e+08;-7.74533e+06;1;0;0;0;1;0;624133972;625741918;13121471
1007;4.74216e-15;1501;-4;487;10859;1;45;6.24906e+08;-7.72204e+06;1;0;0;0;1;0;624906216;626528026;13204334
1008;4.74216e-15;1501;-4;487;10859;1;45;6.25676e+08;-7.69885e+06;1;0;0;0;1;0;625676142;627311882;13287362
1009;4.74216e-15;1502;-4;487;10859;1;45;6.26444e+08;-7.67576e+06;0;0;0;0;0;0;626443759;628093498;13370552
1010;4.74216e-15;1503;-4;487;10859;1;45;6.27209e+08;-7.65277e+06;0;0;0;0;0;0;627209076;628872882;13453902
1011;4.74216e-15;1504;-4;487;10859;1;45;6.27972e+08;-7.62987e+06;0;0;0;0;0;0;627972104;629650044;13537413
1012;4.74216e-15;1504;-4;487;10859;1;45;6.28733e+08;-7.60708e+06;1;0;0;0;1;0;628732853;630424994;13621081
1013;4.74216e-15;1505;-4;487;10859;1;45;6.29491e+08;-7.58438e+06;0;0;0;0;0;0;629491331;631197741;13704908
1014;4.74216e-15;1505;-4;487;10859;1;45;6.30248e+08;-7.56177e+06;1;0;0;0;1;0;630247549;631968296;13788890
1015;4.74216e-15;1506;-4;487;10859;1;45;6.31002e+08;-7.53926e+06;0;0;0;0;0;0;631001516;632736667;13873026
1016;4.74216e-15;1507;-4;487;10859;1;45;6.31753e+08;-7.51685e+06;0;0;0;0;0;0;631753242;633502865;13957316
1017;4.74216e-15;1507;-4;487;10859;1;45;6.32503e+08;-7.49453e+06;1;0;0;0;1;0;632502735;634266897;14041759
1018;4.74216e-15;1507;-4;487;10859;1;45;6.3325e+08;-7.4723e+06;1;0;0;0;1;0;633250006;635028775;14126352
1019;4.74216e-15;1507;-4;487;10859;1;45;6.33995e+08;-7.45017e+06;1;0;0;0;1;0;633995064;635788507;14211095
1020;4.74216e-15;1508;-4;487;10859;1;45;6.34738e+08;-7.42813e+06;0;0;0;0;0;0;634737918;636546102;14295987
1021;4.74216e-15;1509;-4;487;10859;1;45;6.35479e+08;-7.40618e+06;0;0;0;0;0;0;635478577;637301570;14381025
1022;4.74216e-15;1510;-4;487;10859;1;45;6.36217e+08;-7.38433e+06;0;0;0;0;0;0;636217051;638054919;14466210
1023;4.74216e-15;1510;-4;487;10859;1;45;6.36953e+08;-7.36256e+06;1;0;0;0;1;0;636953348;638806159;14551539
1024;4.74216e-15;1510;-4;487;10859;1;45;6.37687e+08;-7.34089e+06;1;0;0;0;1;0;637687478;639555299;14637012
1025;4.74216e-15;1511;-4;487;10859;1;45;6.38419e+08;-7.31931e+06;0;0;0;0;0;0;638419449;640302347;14722628
1026;4.74216e-15;1511;-4;487;10859;1;45;6.39149e+08;-7.29781e+06;1;0;0;0;1;0;639149271;641047313;14808384
1027;4.74216e-15;1512;-4;487;10859;1;45;6.39877e+08;-7.27641e+06;0;0;0;0;0;0;639876953;641790205;14894280
1028;4.74216e-15;1513;-4;487;10859;1;45;6.40603e+08;-7.25509e+06;0;0;0;0;0;0;640602503;642531033;14980315
1029;4.74216e-15;1514;-4;487;10859;1;45;6.41326e+08;-7.23386e+06;0;0;0;0;0;0;641325930;643269805;15066487
1030;4.74216e-15;1515;-4;487;10859;1;45;6.42047e+08;-7.21272e+06;0;0;0;0;0;0;642047243;644006529;15152796
1031;4.74216e-15;1515;-4;487;10859;1;45;6.42766e+08;-7.19167e+06;1;0;0;0;1;0;642766450;644741215;15239239
1032;4.74216e-15;1515;-4;487;10859;1;45;6.43484e+08;-7.1707e+06;1;0;0;0;1;0;643483561;645473871;15325816
1033;4.74216e-15;1516;-4;487;10859;1;45;6.44199e+08;-7.14982e+06;0;0;0;0;0;0;644198584;646204505;15412526
1034;4.74216e-15;1517;-4;487;10859;1;45;6.44912e+08;-7.12902e+06;0;0;0;0;0;0;644911527;646933126;15499367
1035;4.74216e-15;1517;-4;487;10859;1;45;6.45622e+08;-7.10831e+06;1;0;0;0;1;0;645622399;647659743;15586339
1036;4.74216e-15;1518;-4;487;10859;1;45;6.46331e+08;-7.08769e+06;0;0;0;0;0;0;646331209;648384363;15673439
1037;4.74216e-15;1518;-4;487;10859;1;45;6.47038e+08;-7.06714e+06;1;0;0;0;1;0;647037964;649106996;15760667
1038;4.74216e-15;1518;-4;487;10859;1;45;6.47743e+08;-7.04669e+06;1;0;0;0;1;0;647742674;649827649;15848022
1039;4.74216e-15;1518;-4;487;10859;1;45;6.48445e+08;-7.02631e+06;1;0;0;0;1;0;648445346;650546331;15935502
1040;4.74216e-15;1519;-4;487;10859;1;45;6.49146e+08;-7.00602e+06;0;0;0;0;0;0;649145989;651263049;16023107
1041;4.74216e-15;1519;-4;487;10859;1;45;6.49845e+08;-6.98581e+06;1;0;0;0;1;0;649844611;651977813;16110834
1042;4.74216e-15;1520;-4;487;10859;1;45;6.50541e+08;-6.96568e+06;0;0;0;0;0;0;650541220;652690630;16198683
1043;4.74216e-15;1520;-4;487;10859;1;45;6.51236e+08;-6.94563e+06;1;0;0;0;1;0;651235824;653401508;16286654
1044;4.74216e-15;1521;-4;487;10859;1;45;6.51928e+08;-6.92567e+06;0;0;0;0;0;0;651928432;654110456;16374743
1045;4.74216e-15;1521;-4;487;10859;1;45;6.52619e+08;-6.90578e+06;1;0;0;0;1;0;652619051;654817480;16462951
1046;4.74216e-15;1522;-4;487;10859;1;45;6.53308e+08;-6.88598e+06;0;0;0;0;0;0;653307690;655522590;16551277
1047;4.74216e-15;1523;-4;487;10859;1;45;6.53994e+08;-6.86625e+06;0;0;0;0;0;0;653994356;656225793;16639718
1048;4.74216e-15;1523;-4;487;10859;1;45;6.54679e+08;-6.84661e+06;1;0;0;0;1;0;654679058;656927096;16728275
1049;4.74216e-15;1524;-4;487;10859;1;45;6.55362e+08;-6.82704e+06;0;0;0;0;0;0;655361803;657626508;16816945
1050;4.74216e-15;1524;-4;487;10859;1;45;6.56043e+08;-6.80755e+06;1;0;0;0;1;0;656042598;658324037;16905728
1051;4.74216e-15;1524;-4;487;10859;1;45;6.56721e+08;-6.78813e+06;1;0;0;0;1;0;656721453;659019689;16994622
1052;4.74216e-15;1525;-4;487;10859;1;45;6.57398e+08;-6.7688e+06;0;0;0;0;0;0;657398374;659713473;17083627
1053;4.74216e-15;1526;-4;487;10859;1;45;6.58073e+08;-6.74954e+06;0;0;0;0;0;0;658073369;660405397;17172740
1054;4.74216e-15;1527;-4;487;10859;1;45;6.58746e+08;-6.73036e+06;0;0;0;0;0;0;658746446;661095467;17261962
1055;4.74216e-15;1528;-4;487;10859;1;45;6.59418e+08;-6.71125e+06;0;0;0;0;0;0;659417613;661783692;17351291
1056;4.74216e-15;1529;-4;487;10859;1;45;6.60087e+08;-6.69222e+06;0;0;0;0;0;0;660086876;662470078;17440726
1057;4.74216e-15;1529;-4;487;10859;1;45;6.60754e+08;-6.67327e+06;1;0;0;0;1;0;660754244;663154634;17530266
1058;4.74216e-15;1529;-4;487;10859;1;45;6.6142e+08;-6.65439e+06;1;0;0;0;1;0;661419724;663837366;17619909
1059;4.74216e-15;1530;-4;487;10859;1;45;6.62083e+08;-6.63559e+06;0;0;0;0;0;0;662083324;664518282;17709654
1060;4.74216e-15;1531;-4;487;10859;1;45;6.62745e+08;-6.61685e+06;0;0;0;0;0;0;662745050;665197389;17799501
1061;4.74216e-15;1532;-4;487;10859;1;45;6.63405e+08;-6.5982e+06;0;0;0;0;0;0;663404911;665874696;17889449
1062;4.74216e-15;1533;-4;487;10859;1;45;6.64063e+08;-6.57961e+06;0;0;0;0;0;0;664062913;666550207;17979495
1063;4.74216e-15;1534;-4;487;10859;1;45;6.64719e+08;-6.5611e+06;0;0;0;0;0;0;664719064;667223932;18069640
1064;4.74216e-15;1535;-4;487;10859;1;45;6.65373e+08;-6.54266e+06;0;0;0;0;0;0;665373371;667895877;18159881
1065;4.74216e-15;1536;-4;487;10859;1;45;6.66026e+08;-6.52429e+06;0;0;0;0;0;0;666025842;668566049;18250218
1066;4.74216e-15;1537;-4;487;10859;1;45;6.66676e+08;-6.506e+06;0;0;0;0;0;0;666676483;669234455;18340651
1067;4.74216e-15;1538;-4;487;10859;1;45;6.67325e+08;-6.48777e+06;0;0;0;0;0;0;667325301;669901102;18431177
1068;4.74216e-15;1538;-4;487;10859;1;45;6.67972e+08;-6.46962e+06;1;0;0;0;1;0;667972304;670565997;18521795
1069;4.74216e-15;1539;-4;487;10859;1;45;6.68617e+08;-6.45153e+06;0;0;0;0;0;0;668617498;671229148;18612505
1070;4.74216e-15;1539;-4;487;10859;1;45;6.69261e+08;-6.43352e+06;1;0;0;0;1;0;669260892;671890561;18703306
1071;4.74216e-15;1539;-4;487;10859;1;45;6.69902e+08;-6.41558e+06;1;0;0;0;1;0;669902490;672550242;18794196
1072;4.74216e-15;1540;-4;487;10859;1;45;6.70542e+08;-6.3977e+06;0;0;0;0;0;0;670542302;673208199;18885175
1073;4.74216e-15;1540;-4;487;10859;1;45;6.7118e+08;-6.3799e+06;1;0;0;0;1;0;671180333;673864439;18976240
1074;4.74216e-15;1540;-4;487;10859;1;45;6.71817e+08;-6.36216e+06;1;0;0;0;1;0;671816590;674518968;19067392
1075;4.74216e-15;1541;-4;487;10859;1;45;6.72451e+08;-6.34449e+06;0;0;0;0;0;0;672451080;675171793;19158630
1076;4.74216e-15;1542;-4;487;10859;1;45;6.73084e+08;-6.32689e+06;0;0;0;0;0;0;673083811;675822920;19249951
1077;4.74216e-15;1542;-4;487;10859;1;45;6.73715e+08;-6.30936e+06;1;0;0;0;1;0;673714788;676472357;19341356
1078;4.74216e-15;1543;-4;487;10859;1;45;6.74344e+08;-6.29189e+06;0;0;0;0;0;0;674344018;677120109;19432842
1079;4.74216e-15;1544;-4;487;10859;1;45;6.74972e+08;-6.27449e+06;0;0;0;0;0;0;674971508;677766184;19524410
1080;4.74216e-15;1545;-4;487;10859;1;45;6.75597e+08;-6.25716e+06;0;0;0;0;0;0;675597265;678410588;19616058
1081;4.74216e-15;1546;-4;487;10859;1;45;6.76221e+08;-6.23989e+06;0;0;0;0;0;0;676221296;679053327;19707784
1082;4.74216e-15;1547;-4;487;10859;1;45;6.76844e+08;-6.22269e+06;0;0;0;0;0;0;676843606;679694408;19799589
1083;4.74216e-15;1547;-4;487;10859;1;45;6.77464e+08;-6.20555e+06;1;0;0;0;1;0;677464202;680333837;19891470
1084;4.74216e-15;1547;-4;487;10859;1;45;6.78083e+08;-6.18848e+06;1;0;0;0;1;0;678083092;680971621;19983428
1085;4.74216e-15;1547;-4;487;10859;1;45;6.787e+08;-6.17148e+06;1;0;0;0;1;0;678700281;681607765;20075460
1086;4.74216e-15;1548;-4;487;10859;1;45;6.79316e+08;-6.15453e+06;0;0;0;0;0;0;679315775;682242277;20167566
1087;4.74216e-15;1548;-4;487;10859;1;45;6.7993e+08;-6.13765e+06;1;0;0;0;1;0;679929582;682875162;20259745
1088;4.74216e-15;1548;-4;487;10859;1;45;6.80542e+08;-6.12084e+06;1;0;0;0;1;0;680541707;683506427;20351996
1089;4.74216e-15;1549;-4;487;10859;1;45;6.81152e+08;-6.10409e+06;0;0;0;0;0;0;681152157;684136078;20444318
1090;4.74216e-15;1549;-4;487;10859;1;45;6.81761e+08;-6.0874e+06;1;0;0;0;1;0;681760939;684764121;20536710
1091;4.74216e-15;1550;-4;487;10859;1;45;6.82368e+08;-6.07077e+06;0;0;0;0;0;0;682368057;685390563;20629171
1092;4.74216e-15;1551;-4;487;10859;1;45;6.82974e+08;-6.05421e+06;0;0;0;0;0;0;682973520;686015408;20721700
1093;4.74216e-15;1551;-4;487;10859;1;45;6.83577e+08;-6.03771e+06;1;0;0;0;1;0;683577332;686638664;20814295
1094;4.74216e-15;1552;-4;487;10859;1;45;6.8418e+08;-6.02127e+06;0;0;0;0;0;0;684179500;687260337;20906957
1095;4.74216e-15;1552;-4;487;10859;1;45;6.8478e+08;-6.00489e+06;1;0;0;0;1;0;684780030;687880432;20999684
1096;4.74216e-15;1553;-4;487;10859;1;45;6.85379e+08;-5.98857e+06;0;0;0;0;0;0;685378929;688498955;21092474
1097;4.74216e-15;1554;-4;487;10859;1;45;6.85976e+08;-5.97232e+06;0;0;0;0;0;0;685976202;689115912;21185328
1098;4.74216e-15;1554;-4;487;10859;1;45;6.86572e+08;-5.95612e+06;1;0;0;0;1;0;686571855;689731310;21278244
1099;4.74216e-15;1555;-4;487;10859;1;45;6.87166e+08;-5.93998e+06;0;0;0;0;0;0;687165894;690345154;21371221
1100;4.74216e-15;1556;-4;487;10859;1;45;6.87758e+08;-5.9239e+06;0;0;0;0;0;0;687758326;690957450;21464258
1101;4.74216e-15;1556;-4;487;10859;1;45;6.88349e+08;-5.90789e+06;1;0;0;0;1;0;688349156;691568203;21557354
1102;4.74216e-15;1557;-4;487;10859;1;45;6.88938e+08;-5.89193e+06;0;0;0;0;0;0;688938391;692177420;21650509
1103;4.74216e-15;1557;-4;487;10859;1;45;6.89526e+08;-5.87603e+06;1;0;0;0;1;0;689526035;692785106;21743721
1104;4.74216e-15;1557;-5;487;10859;1;45;6.90112e+08;-5.86019e+06;0;0;0;0;0;0;690112095;693391267;21836990
1105;4.74216e-15;1557;-5;487;10859;1;45;6.90697e+08;-5.84441e+06;1;0;0;0;1;0;690696577;693995908;21930314
1106;4.74216e-15;1557;-5;487;10859;1;45;6.91279e+08;-5.82868e+06;1;0;0;0;1;0;691279486;694599036;22023692
1107;4.74216e-15;1557;-5;487;10859;1;45;6.91861e+08;-5.81301e+06;1;0;0;0;1;0;691860829;695200656;22117124
1108;4.74216e-15;1557;-5;487;10859;1;45;6.92441e+08;-5.7974e+06;1;0;0;0;1;0;692440611;695800773;22210609
1109;4.74216e-15;1558;-5;487;10859;1;45;6.93019e+08;-5.78185e+06;0;0;0;0;0;0;693018837;696399393;22304146
1110;4.74216e-15;1558;-5;487;10859;1;45;6.93596e+08;-5.76635e+06;1;0;0;0;1;0;693595514;696996522;22397734
1111;4.74216e-15;1559;-5;487;10859;1;45;6.94171e+08;-5.75092e+06;0;0;0;0;0;0;694170647;697592165;22491371
1112;4.74216e-15;1560;-5;487;10859;1;45;6.94744e+08;-5.73553e+06;0;0;0;0;0;0;694744242;698186327;22585058
1113;4.74216e-15;1561;-5;487;10859;1;45;6.95316e+08;-5.7202e+06;0;0;0;0;0;0;695316303;698779014;22678793
1114;4.74216e-15;1561;-5;487;10859;1;45;6.95887e+08;-5.70493e+06;1;0;0;0;1;0;695886838;699370232;22772575
1115;4.74216e-15;1562;-5;487;10859;1;45;6.96456e+08;-5.68971e+06;0;0;0;0;0;0;696455851;699959985;22866404
1116;4.74216e-15;1562;-5;487;10859;1;45;6.97023e+08;-5.67455e+06;1;0;0;0;1;0;697023348;700548279;22960278
1117;4.74216e-15;1563;-5;487;10859;1;45;6.97589e+08;-5.65944e+06;0;0;0;0;0;0;697589334;701135120;23054196
1118;4.74216e-15;1564;-5;487;10859;1;45;6.98154e+08;-5.64439e+06;0;0;0;0;0;0;698153814;701720512;23148159
1119;4.74216e-15;1564;-5;487;10859;1;45;6.98717e+08;-5.62939e+06;1;0;0;0;1;0;698716795;702304462;23242164
1120;4.74216e-15;1564;-5;487;10859;1;45;6.99278e+08;-5.61445e+06;1;0;0;0;1;0;699278282;702886973;23336211
1121;4.74216e-15;1564;-5;487;10859;1;45;6.99838e+08;-5.59956e+06;1;0;0;0;1;0;699838279;703468052;23430300
1122;4.74216e-15;1565;-5;487;10859;1;45;7.00397e+08;-5.58472e+06;0;0;0;0;0;0;700396793;704047704;23524428
1123;4.74216e-15;1565;-5;487;10859;1;45;7.00954e+08;-5.56994e+06;1;0;0;0;1;0;700953828;704625933;23618596
1124;4.74216e-15;1565;-5;487;10859;1;45;7.01509e+08;-5.55521e+06;1;0;0;0;1;0;701509390;705202745;23712803
1125;4.74216e-15;1566;-5;487;10859;1;45;7.02063e+08;-5.54053e+06;0;0;0;0;0;0;702063484;705778145;23807047
1126;4.74216e-15;1566;-5;487;10859;1;45;7.02616e+08;-5.5259e+06;1;0;0;0;1;0;702616116;706352139;23901328
1127;4.74216e-15;1567;-5;487;10859;1;45;7.03167e+08;-5.51133e+06;0;0;0;0;0;0;703167290;706924730;23995645
1128;4.74216e-15;1568;-5;487;10859;1;45;7.03717e+08;-5.4968e+06;0;0;0;0;0;0;703717012;707495924;24089997
1129;4.74216e-15;1569;-5;487;10859;1;45;7.04265e+08;-5.48233e+06;0;0;0;0;0;0;704265286;708065727;24184383
1130;4.74216e-15;1569;-5;487;10859;1;45;7.04812e+08;-5.46791e+06;1;0;0;0;1;0;704812119;708634142;24278803
1131;4.74216e-15;1569;-5;487;10859;1;45;7.05358e+08;-5.45354e+06;1;0;0;0;1;0;705357515;709201176;24373256
1132;4.74216e-15;1569;-5;487;10859;1;45;7.05901e+08;-5.43922e+06;1;0;0;0;1;0;705901479;709766832;24467740
1133;4.74216e-15;1569;-6;487;10859;1;45;7.06444e+08;-5.42496e+06;0;0;0;0;0;0;706444016;710331117;24562255
1134;4.74216e-15;1569;-6;487;10859;1;45;7.06985e+08;-5.41074e+06;1;0;0;0;1;0;706985132;710894033;24656801
1135;4.74216e-15;1570;-6;487;10859;1;45;7.07525e+08;-5.39657e+06;0;0;0;0;0;0;707524831;711455588;24751375
1136;4.74216e-15;1571;-6;487;10859;1;45;7.08063e+08;-5.38246e+06;0;0;0;0;0;0;708063118;712015785;24845979
1137;4.74216e-15;1571;-6;487;10859;1;45;7.086e+08;-5.36839e+06;1;0;0;0;1;0;708599998;712574629;24940610
1138;4.74216e-15;1571;-6;487;10859;1;45;7.09135e+08;-5.35437e+06;1;0;0;0;1;0;709135477;713132125;25035268
1139;4.74216e-15;1571;-6;487;10859;1;45;7.0967e+08;-5.3404e+06;1;0;0;0;1;0;709669559;713688277;25129952
1140;4.74216e-15;1572;-6;487;10859;1;45;7.10202e+08;-5.32648e+06;0;0;0;0;0;0;710202248;714243091;25224661
1141;4.74216e-15;1572;-6;487;10859;1;45;7.10734e+08;-5.31261e+06;1;0;0;0;1;0;710733550;714796570;25319395
1142;4.74216e-15;1573;-6;487;10859;1;45;7.11263e+08;-5.29878e+06;0;0;0;0;0;0;711263470;715348721;25414153
1143;4.74216e-15;1573;-6;487;10859;1;45;7.11792e+08;-5.28501e+06;1;0;0;0;1;0;711792013;715899547;25508934
1144;4.74216e-15;1574;-6;487;10859;1;45;7.12319e+08;-5.27128e+06;0;0;0;0;0;0;712319182;716449053;25603737
1145;4.74216e-15;1575;-6;487;10859;1;45;7.12845e+08;-5.2576e+06;0;0;0;0;0;0;712844984;716997243;25698561
1146;4.74216e-15;1576;-6;487;10859;1;45;7.13369e+08;-5.24397e+06;0;0;0;0;0;0;713369423;717544123;25793406
1147;4.74216e-15;1577;-6;487;10859;1;45;7.13893e+08;-5.23038e+06;0;0;0;0;0;0;713892502;718089696;25888271
1148;4.74216e-15;1578;-6;487;10859;1;45;7.14414e+08;-5.21684e+06;0;0;0;0;0;0;714414229;718633967;25983155
1149;4.74216e-15;1579;-6;487;10859;1;45;7.14935e+08;-5.20335e+06;0;0;0;0;0;0;714934605;719176941;26078057
1150;4.74216e-15;1579;-6;487;10859;1;45;7.15454e+08;-5.18991e+06;1;0;0;0;1;0;715453638;719718623;26172977
1151;4.74216e-15;1580;-6;487;10859;1;45;7.15971e+08;-5.17651e+06;0;0;0;0;0;0;715971330;720259016;26267914
1152;4.74216e-15;1581;-6;487;10859;1;45;7.16488e+08;-5.16316e+06;0;0;0;0;0;0;716487687;720798125;26362867
1153;4.74216e-15;1582;-6;487;10859;1;45;7.17003e+08;-5.14985e+06;0;0;0;0;0;0;717002714;721335954;26457835
1154;4.74216e-15;1583;-6;487;10859;1;45;7.17516e+08;-5.13659e+06;0;0;0;0;0;0;717516414;721872508;26552818
1155;4.74216e-15;1584;-6;487;10859;1;45;7.18029e+08;-5.12337e+06;0;0;0;0;0;0;718028793;722407792;26647814
1156;4.74216e-15;1585;-6;487;10859;1;45;7.1854e+08;-5.1102e+06;0;0;0;0;0;0;718539855;722941809;26742824
1157;4.74216e-15;1585;-6;487;10859;1;45;7.1905e+08;-5.09707e+06;1;0;0;0;1;0;719049604;723474564;26837846
1158;4.74216e-15;1586;-6;487;10859;1;45;7.19558e+08;-5.08399e+06;0;0;0;0;0;0;719558045;724006061;26932880
1159;4.74216e-15;1586;-6;487;10859;1;45;7.20065e+08;-5.07096e+06;1;0;0;0;1;0;720065182;724536305;27027924
1160;4.74216e-15;1586;-6;487;10859;1;45;7.20571e+08;-5.05796e+06;1;0;0;0;1;0;720571020;725065300;27122979
1161;4.74216e-15;1586;-6;487;10859;1;45;7.21076e+08;-5.04502e+06;1;0;0;0;1;0;721075563;725593049;27218044
1162;4.74216e-15;1587;-6;487;10859;1;45;7.21579e+08;-5.03211e+06;0;0;0;0;0;0;721578816;726119558;27313117
1163;4.74216e-15;1587;-6;487;10859;1;45;7.22081e+08;-5.01925e+06;1;0;0;0;1;0;722080783;726644830;27408198
1164;4.74216e-15;1587;-6;487;10859;1;45;7.22581e+08;-5.00643e+06;1;0;0;0;1;0;722581468;727168869;27503287
1165;4.74216e-15;1587;-6;487;10859;1;45;7.23081e+08;-4.99366e+06;1;0;0;0;1;0;723080876;727691680;27598382
1166;4.74216e-15;1587;-6;487;10859;1;45;7.23579e+08;-4.98093e+06;1;0;0;0;1;0;723579010;728213267;27693484
1167;4.74216e-15;1588;-6;487;10859;1;45;7.24076e+08;-4.96824e+06;0;0;0;0;0;0;724075876;728733634;27788590
1168;4.74216e-15;1588;-6;487;10859;1;45;7.24571e+08;-4.9556e+06;1;0;0;0;1;0;724571478;729252786;27883701
1169;4.74216e-15;1589;-6;487;10859;1;45;7.25066e+08;-4.943e+06;0;0;0;0;0;0;725065819;729770725;27978817
1170;4.74216e-15;1589;-6;487;10859;1;45;7.25559e+08;-4.93044e+06;1;0;0;0;1;0;725558904;730287456;28073935
1171;4.74216e-15;1589;-6;487;10859;1;45;7.26051e+08;-4.91792e+06;1;0;0;0;1;0;726050738;730802984;28169056
1172;4.74216e-15;1589;-6;487;10859;1;45;7.26541e+08;-4.90544e+06;1;0;0;0;1;0;726541324;731317311;28264178
1173;4.74216e-15;1589;-6;487;10859;1;45;7.27031e+08;-4.89301e+06;1;0;0;0;1;0;727030666;731830443;28359302
1174;4.74216e-15;1589;-6;487;10859;1;45;7.27519e+08;-4.88061e+06;1;0;0;0;1;0;727518769;732342383;28454426
1175;4.74216e-15;1589;-6;487;10859;1;45;7.28006e+08;-4.86826e+06;1;0;0;0;1;0;728005637;732853135;28549551
1176;4.74216e-15;1589;-6;487;10859;1;45;7.28491e+08;-4.85595e+06;1;0;0;0;1;0;728491274;733362703;28644674
1177;4.74216e-15;1589;-6;487;10859;1;45;7.28976e+08;-4.84368e+06;1;0;0;0;1;0;728975684;733871091;28739796
1178;4.74216e-15;1590;-6;487;10859;1;45;7.29459e+08;-4.83145e+06;0;0;0;0;0;0;729458871;734378303;28834916
1179;4.74216e-15;1591;-6;487;10859;1;45;7.29941e+08;-4.81926e+06;0;0;0;0;0;0;729940839;734884343;28930033
1180;4.74216e-15;1592;-6;487;10859;1;45;7.30422e+08;-4.80712e+06;0;0;0;0;0;0;730421593;735389214;29025146
1181;4.74216e-15;1592;-6;487;10859;1;45;7.30901e+08;-4.79501e+06;1;0;0;0;1;0;730901136;735892921;29120256
1182;4.74216e-15;1592;-6;487;10859;1;45;7.31379e+08;-4.78294e+06;1;0;0;0;1;0;731379471;736395466;29215360
1183;4.74216e-15;1593;-6;487;10859;1;45;7.31857e+08;-4.77091e+06;0;0;0;0;0;0;731856605;736896855;29310460
1184;4.74216e-15;1593;-6;487;10859;1;45;7.32333e+08;-4.75893e+06;1;0;0;0;1;0;732332539;737397091;29405553
1185;4.74216e-15;1593;-7;487;10859;1;45;7.32807e+08;-4.74698e+06;0;0;0;0;0;0;732807279;737896177;29500640
1186;4.74216e-15;1593;-7;487;10859;1;45;7.33281e+08;-4.73507e+06;1;0;0;0;1;0;733280827;738394117;29595719
1187;4.74216e-15;1593;-7;487;10859;1;45;7.33753e+08;-4.7232e+06;1;0;0;0;1;0;733753189;738890916;29690791
1188;4.74216e-15;1594;-7;487;10859;1;45;7.34224e+08;-4.71137e+06;0;0;0;0;0;0;734224367;739386576;29785854
1189;4.74216e-15;1595;-7;487;10859;1;45;7.34694e+08;-4.69957e+06;0;0;0;0;0;0;734694366;739881101;29880908
1190;4.74216e-15;1595;-7;487;10859;1;45;7.35163e+08;-4.68782e+06;1;0;0;0;1;0;735163190;740374496;29975952
1191;4.74216e-15;1595;-7;487;10859;1;45;7.35631e+08;-4.6761e+06;1;0;0;0;1;0;735630842;740866764;30070986
1192;4.74216e-15;1596;-7;487;10859;1;45;7.36097e+08;-4.66443e+06;0;0;0;0;0;0;736097327;741357907;30166009
1193;4.74216e-15;1597;-7;487;10859;1;45;7.36563e+08;-4.65279e+06;0;0;0;0;0;0;736562647;741847931;30261021
1194;4.74216e-15;1598;-7;487;10859;1;45;7.37027e+08;-4.64118e+06;0;0;0;0;0;0;737026808;742336838;30356020
1195;4.74216e-15;1598;-7;487;10859;1;45;7.3749e+08;-4.62962e+06;1;0;0;0;1;0;737489812;742824633;30451006
1196;4.74216e-15;1599;-7;487;10859;1;45;7.37952e+08;-4.6181e+06;0;0;0;0;0;0;737951663;743311318;30545979
1197;4.74216e-15;1599;-7;487;10859;1;45;7.38412e+08;-4.60661e+06;1;0;0;0;1;0;738412366;743796898;30640939
1198;4.74216e-15;1600;-7;487;10859;1;45;7.38872e+08;-4.59516e+06;0;0;0;0;0;0;738871923;744281375;30735883
1199;4.74216e-15;1601;-7;487;10859;1;45;7.3933e+08;-4.58374e+06;0;0;0;0;0;0;739330339;744764754;30830813
1200;4.74216e-15;1601;-7;487;10859;1;45;7.39788e+08;-4.57236e+06;1;0;0;0;1;0;739787617;745247037;30925726
1201;4.74216e-15;1601;-7;487;10859;1;45;7.40244e+08;-4.56102e+06;1;0;0;0;1;0;740243761;745728229;31020624
1202;4.74216e-15;1602;-7;487;10859;1;45;7.40699e+08;-4.54972e+06;0;0;0;0;0;0;740698775;746208333;31115505
1203;4.74216e-15;1602;-7;487;10859;1;45;7.41153e+08;-4.53845e+06;1;0;0;0;1;0;741152661;746687352;31210368
1204;4.74216e-15;1603;-7;487;10859;1;45;7.41605e+08;-4.52722e+06;0;0;0;0;0;0;741605425;747165289;31305213
1205;4.74216e-15;1603;-7;487;10859;1;45;7.42057e+08;-4.51602e+06;1;0;0;0;1;0;742057069;747642149;31400040
1206;4.74216e-15;1604;-7;487;10859;1;45;7.42508e+08;-4.50486e+06;0;0;0;0;0;0;742507597;748117934;31494847
1207;4.74216e-15;1605;-7;487;10859;1;45;7.42957e+08;-4.49374e+06;0;0;0;0;0;0;742957013;748592648;31589635
1208;4.74216e-15;1605;-7;487;10859;1;45;7.43405e+08;-4.48265e+06;1;0;0;0;1;0;743405319;749066294;31684403
1209;4.74216e-15;1606;-7;487;10859;1;45;7.43853e+08;-4.4716e+06;0;0;0;0;0;0;743852521;749538876;31779150
1210;4.74216e-15;1606;-7;487;10859;1;45;7.44299e+08;-4.46058e+06;1;0;0;0;1;0;744298620;750010397;31873875
1211;4.74216e-15;1607;-7;487;10859;1;45;7.44744e+08;-4.44959e+06;0;0;0;0;0;0;744743622;750480860;31968579
1212;4.74216e-15;1608;-7;487;10859;1;45;7.45188e+08;-4.43865e+06;0;0;0;0;0;0;745187528;750950268;32063260
1213;4.74216e-15;1609;-7;487;10859;1;45;7.4563e+08;-4.42773e+06;0;0;0;0;0;0;745630344;751418626;32157918
1214;4.74216e-15;1610;-7;487;10859;1;45;7.46072e+08;-4.41686e+06;0;0;0;0;0;0;746072071;751885935;32252553
1215;4.74216e-15;1611;-7;487;10859;1;45;7.46513e+08;-4.40601e+06;0;0;0;0;0;0;746512714;752352200;32347164
1216;4.74216e-15;1612;-7;487;10859;1;45;7.46952e+08;-4.3952e+06;0;0;0;0;0;0;746952276;752817424;32441750
1217;4.74216e-15;1613;-7;487;10859;1;45;7.47391e+08;-4.38443e+06;0;0;0;0;0;0;747390761;753281609;32536311
1218;4.74216e-15;1614;-7;487;10859;1;45;7.47828e+08;-4.37368e+06;0;0;0;0;0;0;747828172;753744760;32630846
1219;4.74216e-15;1615;-7;487;10859;1;45;7.48265e+08;-4.36298e+06;0;0;0;0;0;0;748264511;754206878;32725356
1220;4.74216e-15;1615;-7;487;10859;1;45;7.487e+08;-4.3523e+06;1;0;0;0;1;0;748699784;754667969;32819838
1221;4.74216e-15;1616;-7;487;10859;1;45;7.49134e+08;-4.34166e+06;0;0;0;0;0;0;749133992;755128034;32914294
1222;4.74216e-15;1617;-7;487;10859;1;45;7.49567e+08;-4.33106e+06;0;0;0;0;0;0;749567140;755587076;33008721
1223;4.74216e-15;1617;-7;487;10859;1;45;7.49999e+08;-4.32048e+06;1;0;0;0;1;0;749999230;756045100;33103121
1224;4.74216e-15;1618;-7;487;10859;1;45;7.5043e+08;-4.30994e+06;0;0;0;0;0;0;750430267;756502107;33197492
1225;4.74216e-15;1618;-7;487;10859;1;45;7.5086e+08;-4.29944e+06;1;0;0;0;1;0;750860253;756958102;33291833
1226;4.74216e-15;1618;-7;487;10859;1;45;7.51289e+08;-4.28896e+06;1;0;0;0;1;0;751289191;757413087;33386145
1227;4.74216e-15;1619;-7;487;10859;1;45;7.51717e+08;-4.27852e+06;0;0;0;0;0;0;751717085;757867066;33480427
1228;4.74216e-15;1620;-7;487;10859;1;45;7.52144e+08;-4.26811e+06;0;0;0;0;0;0;752143939;758320041;33574678
1229;4.74216e-15;1621;-7;487;10859;1;45;7.5257e+08;-4.25774e+06;0;0;0;0;0;0;752569755;758772015;33668898
1230;4.74216e-15;1621;-7;487;10859;1;45;7.52995e+08;-4.24739e+06;1;0;0;0;1;0;752994536;759222992;33763086
1231;4.74216e-15;1621;-7;487;10859;1;45;7.53418e+08;-4.23708e+06;1;0;0;0;1;0;753418286;759672975;33857242
1232;4.74216e-15;1621;-7;487;10859;1;45;7.53841e+08;-4.2268e+06;1;0;0;0;1;0;753841008;760121966;33951365
1233;4.74216e-15;1621;-7;487;10859;1;45;7.54263e+08;-4.21656e+06;1;0;0;0;1;0;754262706;760569968;34045455
1234;4.74216e-15;1622;-7;487;10859;1;45;7.54683e+08;-4.20634e+06;0;0;0;0;0;0;754683382;761016985;34139512
1235;4.74216e-15;1622;-7;487;10859;1;45;7.55103e+08;-4.19616e+06;1;0;0;0;1;0;755103039;761463020;34233534
1236;4.74216e-15;1622;-7;487;10859;1;45;7.55522e+08;-4.186e+06;1;0;0;0;1;0;755521682;761908075;34327522
1237;4.74216e-15;1622;-7;487;10859;1;45;7.55939e+08;-4.17588e+06;1;0;0;0;1;0;755939312;762352154;34421475
1238;4.74216e-15;1623;-7;487;10859;1;45;7.56356e+08;-4.16579e+06;0;0;0;0;0;0;756355933;762795259;34515393
1239;4.74216e-15;1623;-7;487;10859;1;45;7.56772e+08;-4.15573e+06;1;0;0;0;1;0;756771548;763237393;34609274
1240;4.74216e-15;1623;-7;487;10859;1;45;7.57186e+08;-4.1457e+06;1;0;0;0;1;0;757186161;763678560;34703119
1241;4.74216e-15;1623;-7;487;10859;1;45;7.576e+08;-4.13571e+06;1;0;0;0;1;0;757599773;764118761;34796927
1242;4.74216e-15;1623;-7;487;10859;1;45;7.58012e+08;-4.12574e+06;1;0;0;0;1;0;758012390;764558001;34890698
1243;4.74216e-15;1623;-7;487;10859;1;45;7.58424e+08;-4.1158e+06;1;0;0;0;1;0;758424012;764996281;34984431
1244;4.74216e-15;1623;-7;487;10859;1;45;7.58835e+08;-4.1059e+06;1;0;0;0;1;0;758834644;765433605;35078126
1245;4.74216e-15;1624;-7;487;10859;1;45;7.59244e+08;-4.09602e+06;0;0;0;0;0;0;759244289;765869976;35171783
1246;4.74216e-15;1625;-7;487;10859;1;45;7.59653e+08;-4.08618e+06;0;0;0;0;0;0;759652949;766305396;35265400
1247;4.74216e-15;1626;-7;487;10859;1;45;7.60061e+08;-4.07636e+06;0;0;0;0;0;0;760060627;766739868;35358977
1248;4.74216e-15;1626;-7;487;10859;1;45;7.60467e+08;-4.06658e+06;1;0;0;0;1;0;760467328;767173396;35452515
1249;4.74216e-15;1626;-7;487;10859;1;45;7.60873e+08;-4.05683e+06;1;0;0;0;1;0;760873052;767605981;35546012
1250;4.74216e-15;1626;-7;487;10859;1;45;7.61278e+08;-4.0471e+06;1;0;0;0;1;0;761277804;768037626;35639468
1251;4.74216e-15;1627;-7;487;10859;1;45;7.61682e+08;-4.03741e+06;0;0;0;0;0;0;761681587;768468335;35732884
1252;4.74216e-15;1627;-7;487;10859;1;45;7.62084e+08;-4.02774e+06;1;0;0;0;1;0;762084403;768898111;35826257
1253;4.74216e-15;1628;-7;487;10859;1;45;7.62486e+08;-4.0181e+06;0;0;0;0;0;0;762486256;769326955;35919588
1254;4.74216e-15;1628;-7;487;10859;1;45;7.62887e+08;-4.0085e+06;1;0;0;0;1;0;762887147;769754870;36012877
1255;4.74216e-15;1629;-7;487;10859;1;45;7.63287e+08;-3.99892e+06;0;0;0;0;0;0;763287081;770181860;36106123
1256;4.74216e-15;1630;-7;487;10859;1;45;7.63686e+08;-3.98937e+06;0;0;0;0;0;0;763686060;770607927;36199325
1257;4.74216e-15;1631;-7;487;10859;1;45;7.64084e+08;-3.97985e+06;0;0;0;0;0;0;764084087;771033073;36292484
1258;4.74216e-15;1631;-7;487;10859;1;45;7.64481e+08;-3.97036e+06;1;0;0;0;1;0;764481165;771457302;36385598
1259;4.74216e-15;1631;-7;487;10859;1;45;7.64877e+08;-3.96089e+06;1;0;0;0;1;0;764877296;771880617;36478668
1260;4.74216e-15;1631;-7;487;10859;1;45;7.65272e+08;-3.95146e+06;1;0;0;0;1;0;765272484;772303018;36571692
1261;4.74216e-15;1632;-7;487;10859;1;45;7.65667e+08;-3.94205e+06;0;0;0;0;0;0;765666731;772724510;36664672
1262;4.74216e-15;1633;-7;487;10859;1;45;7.6606e+08;-3.93267e+06;0;0;0;0;0;0;766060041;773145096;36757605
1263;4.74216e-15;1633;-7;487;10859;1;45;7.66452e+08;-3.92332e+06;1;0;0;0;1;0;766452415;773564777;36850492
1264;4.74216e-15;1634;-7;487;10859;1;45;7.66844e+08;-3.914e+06;0;0;0;0;0;0;766843858;773983556;36943333
1265;4.74216e-15;1634;-7;487;10859;1;45;7.67234e+08;-3.90471e+06;1;0;0;0;1;0;767234371;774401436;37036127
1266;4.74216e-15;1635;-7;487;10859;1;45;7.67624e+08;-3.89544e+06;0;0;0;0;0;0;767623957;774818419;37128873
1267;4.74216e-15;1636;-7;487;10859;1;45;7.68013e+08;-3.8862e+06;0;0;0;0;0;0;768012620;775234509;37221571
1268;4.74216e-15;1637;-7;487;10859;1;45;7.684e+08;-3.87699e+06;0;0;0;0;0;0;768400361;775649707;37314221
1269;4.74216e-15;1637;-7;487;10859;1;45;7.68787e+08;-3.86781e+06;1;0;0;0;1;0;768787185;776064016;37406823
1270;4.74216e-15;1638;-7;487;10859;1;45;7.69173e+08;-3.85866e+06;0;0;0;0;0;0;769173092;776477439;37499376
1271;4.74216e-15;1638;-7;487;10859;1;45;7.69558e+08;-3.84953e+06;1;0;0;0;1;0;769558087;776889978;37591879
1272;4.74216e-15;1638;-7;487;10859;1;45;7.69942e+08;-3.84043e+06;1;0;0;0;1;0;769942172;777301636;37684333
1273;4.74216e-15;1639;-7;487;10859;1;45;7.70325e+08;-3.83135e+06;0;0;0;0;0;0;770325349;777712415;37776737
1274;4.74216e-15;1639;-7;487;10859;1;45;7.70708e+08;-3.8223e+06;1;0;0;0;1;0;770707622;778122319;37869090
1275;4.74216e-15;1639;-7;487;10859;1;45;7.71089e+08;-3.81328e+06;1;0;0;0;1;0;771088992;778531348;37961393
1276;4.74216e-15;1640;-7;487;10859;1;45;7.71469e+08;-3.80429e+06;0;0;0;0;0;0;771469464;778939506;38053644
1277;4.74216e-15;1640;-7;487;10859;1;45;7.71849e+08;-3.79532e+06;1;0;0;0;1;0;771849038;779346796;38145844
1278;4.74216e-15;1640;-7;487;10859;1;45;7.72228e+08;-3.78638e+06;1;0;0;0;1;0;772227718;779753219;38237992
1279;4.74216e-15;1640;-7;487;10859;1;45;7.72606e+08;-3.77747e+06;1;0;0;0;1;0;772605507;780158778;38330088
1280;4.74216e-15;1640;-7;487;10859;1;45;7.72982e+08;-3.76858e+06;1;0;0;0;1;0;772982407;780563476;38422131
1281;4.74216e-15;1641;-7;487;10859;1;45;7.73358e+08;-3.75972e+06;0;0;0;0;0;0;773358422;780967315;38514121
1282;4.74216e-15;1642;-7;487;10859;1;45;7.73734e+08;-3.75088e+06;0;0;0;0;0;0;773733552;781370298;38606058
1283;4.74216e-15;1643;-7;487;10859;1;45;7.74108e+08;-3.74207e+06;0;0;0;0;0;0;774107802;781772426;38697941
1284;4.74216e-15;1643;-7;487;10859;1;45;7.74481e+08;-3.73329e+06;1;0;0;0;1;0;774481173;782173703;38789771
1285;4.74216e-15;1644;-7;487;10859;1;45;7.74854e+08;-3.72453e+06;0;0;0;0;0;0;774853668;782574131;38881545
1286;4.74216e-15;1645;-7;487;10859;1;45;7.75225e+08;-3.7158e+06;0;0;0;0;0;0;775225290;782973711;38973266
1287;4.74216e-15;1645;-7;487;10859;1;45;7.75596e+08;-3.70709e+06;1;0;0;0;1;0;775596042;783372447;39064931
1288;4.74216e-15;1645;-7;487;10859;1;45;7.75966e+08;-3.69841e+06;1;0;0;0;1;0;775965925;783770341;39156541
1289;4.74216e-15;1645;-7;487;10859;1;45;7.76335e+08;-3.68975e+06;1;0;0;0;1;0;776334942;784167395;39248095
1290;4.74216e-15;1645;-7;487;10859;1;45;7.76703e+08;-3.68112e+06;1;0;0;0;1;0;776703097;784563611;39339593
1291;4.74216e-15;1645;-7;487;10859;1;45;7.7707e+08;-3.67252e+06;1;0;0;0;1;0;777070391;784958992;39431035
1292;4.74216e-15;1645;-7;487;10859;1;45;7.77437e+08;-3.66394e+06;1;0;0;0;1;0;777436827;785353541;39522420
1293;4.74216e-15;1645;-7;487;10859;1;45;7.77802e+08;-3.65538e+06;1;0;0;0;1;0;777802408;785747258;39613749
1294;4.74216e-15;1646;-7;487;10859;1;45;7.78167e+08;-3.64685e+06;0;0;0;0;0;0;778167135;786140148;39705019
1295;4.74216e-15;1646;-7;487;10859;1;45;7.78531e+08;-3.63835e+06;1;0;0;0;1;0;778531012;786532212;39796233
1296;4.74216e-15;1646;-7;487;10859;1;45;7.78894e+08;-3.62986e+06;1;0;0;0;1;0;778894041;786923452;39887388
1297;4.74216e-15;1646;-7;487;10859;1;45;7.79256e+08;-3.62141e+06;1;0;0;0;1;0;779256224;787313870;39978485
1298;4.74216e-15;1647;-7;487;10859;1;45;7.79618e+08;-3.61298e+06;0;0;0;0;0;0;779617564;787703470;40069523
1299;4.74216e-15;1647;-7;487;10859;1;45;7.79978e+08;-3.60457e+06;1;0;0;0;1;0;779978064;788092252;40160503
1300;4.74216e-15;1648;-7;487;10859;1;45;7.80338e+08;-3.59619e+06;0;0;0;0;0;0;780337724;788480220;40251423
1301;4.74216e-15;1649;-7;487;10859;1;45;7.80697e+08;-3.58783e+06;0;0;0;0;0;0;780696550;788867376;40342284
1302;4.74216e-15;1649;-7;487;10859;1;45;7.81055e+08;-3.57949e+06;1;0;0;0;1;0;781054541;789253721;40433085
1303;4.74216e-15;1649;-7;487;10859;1;45;7.81412e+08;-3.57118e+06;1;0;0;0;1;0;781411702;789639259;40523826
1304;4.74216e-15;1650;-7;487;10859;1;45;7.81768e+08;-3.56289e+06;0;0;0;0;0;0;781768033;790023991;40614507
1305;4.74216e-15;1651;-7;487;10859;1;45;7.82124e+08;-3.55463e+06;0;0;0;0;0;0;782123539;790407919;40705126
1306;4.74216e-15;1652;-7;487;10859;1;45;7.82478e+08;-3.54639e+06;0;0;0;0;0;0;782478220;790791046;40795685
1307;4.74216e-15;1653;-7;487;10859;1;45;7.82832e+08;-3.53818e+06;0;0;0;0;0;0;782832080;791173374;40886183
1308;4.74216e-15;1654;-7;487;10859;1;45;7.83185e+08;-3.52998e+06;0;0;0;0;0;0;783185121;791554905;40976618
1309;4.74216e-15;1655;-7;487;10859;1;45;7.83537e+08;-3.52182e+06;0;0;0;0;0;0;783537345;791935641;41066992
1310;4.74216e-15;1655;-7;487;10859;1;45;7.83889e+08;-3.51367e+06;1;0;0;0;1;0;783888754;792315585;41157304
1311;4.74216e-15;1656;-7;487;10859;1;45;7.84239e+08;-3.50555e+06;0;0;0;0;0;0;784239351;792694738;41247553
1312;4.74216e-15;1657;-7;487;10859;1;45;7.84589e+08;-3.49745e+06;0;0;0;0;0;0;784589139;793073102;41337740
1313;4.74216e-15;1658;-7;487;10859;1;45;7.84938e+08;-3.48937e+06;0;0;0;0;0;0;784938119;793450681;41427864
1314;4.74216e-15;1659;-7;487;10859;1;45;7.85286e+08;-3.48132e+06;0;0;0;0;0;0;785286293;793827475;41517924
1315;4.74216e-15;1659;-7;487;10859;1;45;7.85634e+08;-3.47329e+06;1;0;0;0;1;0;785633664;794203487;41607920
1316;4.74216e-15;1659;-7;487;10859;1;45;7.8598e+08;-3.46528e+06;1;0;0;0;1;0;785980235;794578720;41697853
1317;4.74216e-15;1659;-7;487;10859;1;45;7.86326e+08;-3.4573e+06;1;0;0;0;1;0;786326008;794953175;41787722
1318;4.74216e-15;1660;-7;487;10859;1;45;7.86671e+08;-3.44934e+06;0;0;0;0;0;0;786670984;795326854;41877526
1319;4.74216e-15;1660;-7;487;10859;1;45;7.87015e+08;-3.4414e+06;1;0;0;0;1;0;787015166;795699759;41967266
1320;4.74216e-15;1661;-7;487;10859;1;45;7.87359e+08;-3.43348e+06;0;0;0;0;0;0;787358557;796071893;42056940
1321;4.74216e-15;1662;-7;487;10859;1;45;7.87701e+08;-3.42559e+06;0;0;0;0;0;0;787701158;796443257;42146550
1322;4.74216e-15;1662;-7;487;10859;1;45;7.88043e+08;-3.41772e+06;1;0;0;0;1;0;788042973;796813854;42236094
1323;4.74216e-15;1663;-7;487;10859;1;45;7.88384e+08;-3.40987e+06;0;0;0;0;0;0;788384002;797183686;42325572
1324;4.74216e-15;1664;-7;487;10859;1;45;7.88724e+08;-3.40204e+06;0;0;0;0;0;0;788724249;797552754;42414984
1325;4.74216e-15;1664;-7;487;10859;1;45;7.89064e+08;-3.39424e+06;1;0;0;0;1;0;789063715;797921061;42504330
1326;4.74216e-15;1665;-7;487;10859;1;45;7.89402e+08;-3.38645e+06;0;0;0;0;0;0;789402403;798288609;42593610
1327;4.74216e-15;1666;-7;487;10859;1;45;7.8974e+08;-3.37869e+06;0;0;0;0;0;0;789740314;798655400;42682823
1328;4.74216e-15;1667;-7;487;10859;1;45;7.90077e+08;-3.37095e+06;0;0;0;0;0;0;790077452;799021435;42771969
1329;4.74216e-15;1668;-7;487;10859;1;45;7.90414e+08;-3.36324e+06;0;0;0;0;0;0;790413818;799386717;42861047
1330;4.74216e-15;1668;-7;487;10859;1;45;7.90749e+08;-3.35554e+06;1;0;0;0;1;0;790749415;799751248;42950058
1331;4.74216e-15;1668;-7;487;10859;1;45;7.91084e+08;-3.34787e+06;1;0;0;0;1;0;791084244;800115029;43039001
1332;4.74216e-15;1668;-7;487;10859;1;45;7.91418e+08;-3.34021e+06;1;0;0;0;1;0;791418307;800478064;43127877
1333;4.74216e-15;1668;-7;487;10859;1;45;7.91752e+08;-3.33258e+06;1;0;0;0;1;0;791751608;800840353;43216684
1334;4.74216e-15;1669;-7;487;10859;1;45;7.92084e+08;-3.32497e+06;0;0;0;0;0;0;792084148;801201898;43305422
1335;4.74216e-15;1669;-7;487;10859;1;45;7.92416e+08;-3.31738e+06;1;0;0;0;1;0;792415928;801562702;43394092
1336;4.74216e-15;1670;-7;487;10859;1;45;7.92747e+08;-3.30982e+06;0;0;0;0;0;0;792746952;801922767;43482693
1337;4.74216e-15;1671;-7;487;10859;1;45;7.93077e+08;-3.30227e+06;0;0;0;0;0;0;793077222;802282094;43571225
1338;4.74216e-15;1672;-7;487;10859;1;45;7.93407e+08;-3.29474e+06;0;0;0;0;0;0;793406739;802640686;43659687
1339;4.74216e-15;1673;-7;487;10859;1;45;7.93736e+08;-3.28724e+06;0;0;0;0;0;0;793735505;802998544;43748080
1340;4.74216e-15;1674;-7;487;10859;1;45;7.94064e+08;-3.27976e+06;0;0;0;0;0;0;794063524;803355670;43836403
1341;4.74216e-15;1674;-7;487;10859;1;45;7.94391e+08;-3.27229e+06;1;0;0;0;1;0;794390795;803712066;43924656
1342;4.74216e-15;1675;-7;487;10859;1;45;7.94717e+08;-3.26485e+06;0;0;0;0;0;0;794717323;804067735;44012838
1343;4.74216e-15;1676;-7;487;10859;1;45;7.95043e+08;-3.25743e+06;0;0;0;0;0;0;795043109;804422677;44100950
1344;4.74216e-15;1676;-7;487;10859;1;45;7.95368e+08;-3.25003e+06;1;0;0;0;1;0;795368154;804776895;44188991
1345;4.74216e-15;1676;-7;487;10859;1;45;7.95692e+08;-3.24265e+06;1;0;0;0;1;0;795692462;805130391;44276961
1346;4.74216e-15;1677;-7;487;10859;1;45;7.96016e+08;-3.23529e+06;0;0;0;0;0;0;796016033;805483167;44364860
1347;4.74216e-15;1678;-7;487;10859;1;45;7.96339e+08;-3.22795e+06;0;0;0;0;0;0;796338871;805835224;44452688
1348;4.74216e-15;1679;-7;487;10859;1;45;7.96661e+08;-3.22063e+06;0;0;0;0;0;0;796660977;806186564;44540444
1349;4.74216e-15;1679;-7;487;10859;1;45;7.96982e+08;-3.21333e+06;1;0;0;0;1;0;796982353;806537190;44628128
1350;4.74216e-15;1680;-7;487;10859;1;45;7.97303e+08;-3.20606e+06;0;0;0;0;0;0;797303001;806887102;44715740
1351;4.74216e-15;1681;-7;487;10859;1;45;7.97623e+08;-3.1988e+06;0;0;0;0;0;0;797622923;807236304;44803279
1352;4.74216e-15;1681;-7;487;10859;1;45;7.97942e+08;-3.19156e+06;1;0;0;0;1;0;797942121;807584796;44890746
1353;4.74216e-15;1681;-7;487;10859;1;45;7.98261e+08;-3.18434e+06;1;0;0;0;1;0;798260598;807932580;44978141
1354;4.74216e-15;1682;-7;487;10859;1;45;7.98578e+08;-3.17714e+06;0;0;0;0;0;0;798578354;808279659;45065463
1355;4.74216e-15;1682;-7;487;10859;1;45;7.98895e+08;-3.16996e+06;1;0;0;0;1;0;798895393;808626034;45152711
1356;4.74216e-15;1682;-7;487;10859;1;45;7.99212e+08;-3.1628e+06;1;0;0;0;1;0;799211715;808971707;45239887
1357;4.74216e-15;1683;-7;487;10859;1;45;7.99527e+08;-3.15566e+06;0;0;0;0;0;0;799527324;809316680;45326988
1358;4.74216e-15;1684;-7;487;10859;1;45;7.99842e+08;-3.14854e+06;0;0;0;0;0;0;799842221;809660954;45414017
1359;4.74216e-15;1685;-7;487;10859;1;45;8.00156e+08;-3.14144e+06;0;0;0;0;0;0;800156407;810004532;45500971
1360;4.74216e-15;1686;-7;487;10859;1;45;8.0047e+08;-3.13436e+06;0;0;0;0;0;0;800469886;810347415;45587851
1361;4.74216e-15;1687;-7;487;10859;1;45;8.00783e+08;-3.1273e+06;0;0;0;0;0;0;800782658;810689604;45674657
1362;4.74216e-15;1688;-7;487;10859;1;45;8.01095e+08;-3.12026e+06;0;0;0;0;0;0;801094726;811031102;45761388
1363;4.74216e-15;1688;-7;487;10859;1;45;8.01406e+08;-3.11323e+06;1;0;0;0;1;0;801406092;811371911;45848045
1364;4.74216e-15;1688;-7;487;10859;1;45;8.01717e+08;-3.10623e+06;1;0;0;0;1;0;801716757;811712031;45934627
1365;4.74216e-15;1688;-7;487;10859;1;45;8.02027e+08;-3.09924e+06;1;0;0;0;1;0;802026724;812051466;46021134
1366;4.74216e-15;1689;-7;487;10859;1;45;8.02336e+08;-3.09227e+06;0;0;0;0;0;0;802335994;812390216;46107566
1367;4.74216e-15;1689;-7;487;10859;1;45;8.02645e+08;-3.08533e+06;1;0;0;0;1;0;802644569;812728283;46193923
1368;4.74216e-15;1690;-7;487;10859;1;45;8.02952e+08;-3.0784e+06;0;0;0;0;0;0;802952452;813065670;46280203
1369;4.74216e-15;1690;-7;487;10859;1;45;8.0326e+08;-3.07149e+06;1;0;0;0;1;0;803259644;813402377;46366409
1370;4.74216e-15;1690;-7;487;10859;1;45;8.03566e+08;-3.0646e+06;1;0;0;0;1;0;803566146;813738407;46452538
1371;4.74216e-15;1690;-7;487;10859;1;45;8.03872e+08;-3.05773e+06;1;0;0;0;1;0;803871961;814073761;46538591
1372;4.74216e-15;1690;-7;487;10859;1;45;8.04177e+08;-3.05087e+06;1;0;0;0;1;0;804177091;814408441;46624568
1373;4.74216e-15;1690;-7;487;10859;1;45;8.04482e+08;-3.04404e+06;1;0;0;0;1;0;804481538;814742448;46710468
1374;4.74216e-15;1691;-7;487;10859;1;45;8.04785e+08;-3.03722e+06;0;0;0;0;0;0;804785302;815075785;46796292
1375;4.74216e-15;1691;-7;487;10859;1;45;8.05088e+08;-3.03042e+06;1;0;0;0;1;0;805088387;815408452;46882039
1376;4.74216e-15;1691;-7;487;10859;1;45;8.05391e+08;-3.02364e+06;1;0;0;0;1;0;805390794;815740452;46967709
1377;4.74216e-15;1691;-7;487;10859;1;45;8.05693e+08;-3.01688e+06;1;0;0;0;1;0;805692525;816071787;47053302
1378;4.74216e-15;1691;-7;487;10859;1;45;8.05994e+08;-3.01014e+06;1;0;0;0;1;0;805993581;816402457;47138818
1379;4.74216e-15;1691;-7;487;10859;1;45;8.06294e+08;-3.00341e+06;1;0;0;0;1;0;806293965;816732465;47224256
1380;4.74216e-15;1691;-7;487;10859;1;45;8.06594e+08;-2.99671e+06;1;0;0;0;1;0;806593678;817061813;47309617
1381;4.74216e-15;1691;-7;487;10859;1;45;8.06893e+08;-2.99002e+06;1;0;0;0;1;0;806892723;817390501;47394900
1382;4.74216e-15;1691;-7;487;10859;1;45;8.07191e+08;-2.98335e+06;1;0;0;0;1;0;807191100;817718532;47480104
1383;4.74216e-15;1692;-7;487;10859;1;45;8.07489e+08;-2.97669e+06;0;0;0;0;0;0;807488812;818045907;47565231
1384;4.74216e-15;1693;-7;487;10859;1;45;8.07786e+08;-2.97006e+06;0;0;0;0;0;0;807785860;818372627;47650280
1385;4.74216e-15;1693;-7;487;10859;1;45;8.08082e+08;-2.96344e+06;1;0;0;0;1;0;808082247;818698695;47735250
1386;4.74216e-15;1693;-7;487;10859;1;45;8.08378e+08;-2.95684e+06;1;0;0;0;1;0;808377973;819024113;47820142
1387;4.74216e-15;1694;-7;487;10859;1;45;8.08673e+08;-2.95026e+06;0;0;0;0;0;0;808673042;819348880;47904955
1388;4.74216e-15;1695;-7;487;10859;1;45;8.08967e+08;-2.94369e+06;0;0;0;0;0;0;808967453;819673000;47989689
1389;4.74216e-15;1695;-7;487;10859;1;45;8.09261e+08;-2.93714e+06;1;0;0;0;1;0;809261211;819996474;48074344
1390;4.74216e-15;1696;-7;487;10859;1;45;8.09554e+08;-2.93062e+06;0;0;0;0;0;0;809554315;820319303;48158920
1391;4.74216e-15;1696;-7;487;10859;1;45;8.09847e+08;-2.9241e+06;1;0;0;0;1;0;809846768;820641490;48243417
1392;4.74216e-15;1696;-7;487;10859;1;45;8.10139e+08;-2.91761e+06;1;0;0;0;1;0;810138571;820963034;48327834
1393;4.74216e-15;1697;-7;487;10859;1;45;8.1043e+08;-2.91113e+06;0;0;0;0;0;0;810429727;821283940;48412172
1394;4.74216e-15;1697;-7;487;10859;1;45;8.1072e+08;-2.90467e+06;1;0;0;0;1;0;810720236;821604206;48496430
1395;4.74216e-15;1698;-7;487;10859;1;45;8.1101e+08;-2.89823e+06;0;0;0;0;0;0;811010102;821923836;48580608
1396;4.74216e-15;1699;-7;487;10859;1;45;8.11299e+08;-2.8918e+06;0;0;0;0;0;0;811299324;822242831;48664706
1397;4.74216e-15;1700;-7;487;10859;1;45;8.11588e+08;-2.88539e+06;0;0;0;0;0;0;811587906;822561193;48748724
1398;4.74216e-15;1701;-7;487;10859;1;45;8.11876e+08;-2.879e+06;0;0;0;0;0;0;811875849;822878922;48832662
1399;4.74216e-15;1702;-7;487;10859;1;45;8.12163e+08;-2.87262e+06;0;0;0;0;0;0;812163154;823196021;48916519
1400;4.74216e-15;1702;-7;487;10859;1;45;8.1245e+08;-2.86627e+06;1;0;0;0;1;0;812449823;823512491;49000296
1401;4.74216e-15;1703;-7;487;10859;1;45;8.12736e+08;-2.85992e+06;0;0;0;0;0;0;812735858;823828333;49083992
1402;4.74216e-15;1704;-7;487;10859;1;45;8.13021e+08;-2.8536e+06;0;0;0;0;0;0;813021260;824143549;49167607
1403;4.74216e-15;1705;-7;487;10859;1;45;8.13306e+08;-2.84729e+06;0;0;0;0;0;0;813306032;824458142;49251142
1404;4.74216e-15;1706;-7;487;10859;1;45;8.1359e+08;-2.841e+06;0;0;0;0;0;0;813590175;824772111;49334595
1405;4.74216e-15;1707;-7;487;10859;1;45;8.13874e+08;-2.83472e+06;0;0;0;0;0;0;813873690;825085459;49417967
1406;4.74216e-15;1708;-7;487;10859;1;45;8.14157e+08;-2.82846e+06;0;0;0;0;0;0;814156579;825398187;49501258
1407;4.74216e-15;1708;-7;487;10859;1;45;8.14439e+08;-2.82222e+06;1;0;0;0;1;0;814438844;825710296;49584467
1408;4.74216e-15;1708;-7;487;10859;1;45;8.1472e+08;-2.816e+06;1;0;0;0;1;0;814720486;826021789;49667595
1409;4.74216e-15;1708;-7;487;10859;1;45;8.15002e+08;-2.80979e+06;1;0;0;0;1;0;815001508;826332666;49750641
1410;4.74216e-15;1708;-7;487;10859;1;45;8.15282e+08;-2.8036e+06;1;0;0;0;1;0;815281910;826642930;49833606
1411;4.74216e-15;1709;-7;487;10859;1;45;8.15562e+08;-2.79742e+06;0;0;0;0;0;0;815561695;826952581;49916488
1412;4.74216e-15;1710;-7;487;10859;1;45;8.15841e+08;-2.79126e+06;0;0;0;0;0;0;815840863;827261621;49999288
1413;4.74216e-15;1710;-7;487;10859;1;45;8.16119e+08;-2.78511e+06;1;0;0;0;1;0;816119418;827570051;50082007
1414;4.74216e-15;1710;-7;487;10859;1;45;8.16397e+08;-2.77899e+06;1;0;0;0;1;0;816397359;827877874;50164643
1415;4.74216e-15;1711;-7;487;10859;1;45;8.16675e+08;-2.77287e+06;0;0;0;0;0;0;816674689;828185090;50247196
1416;4.74216e-15;1711;-7;487;10859;1;45;8.16951e+08;-2.76678e+06;1;0;0;0;1;0;816951409;828491701;50329667
1417;4.74216e-15;1711;-7;487;10859;1;45;8.17228e+08;-2.7607e+06;1;0;0;0;1;0;817227522;828797708;50412056
1418;4.74216e-15;1711;-7;487;10859;1;45;8.17503e+08;-2.75463e+06;1;0;0;0;1;0;817503028;829103113;50494362
1419;4.74216e-15;1712;-7;487;10859;1;45;8.17778e+08;-2.74858e+06;0;0;0;0;0;0;817777929;829407917;50576585
1420;4.74216e-15;1713;-7;487;10859;1;45;8.18052e+08;-2.74255e+06;0;0;0;0;0;0;818052227;829712122;50658725
1421;4.74216e-15;1713;-7;487;10859;1;45;8.18326e+08;-2.73653e+06;1;0;0;0;1;0;818325923;830015729;50740782
1422;4.74216e-15;1713;-7;487;10859;1;45;8.18599e+08;-2.73053e+06;1;0;0;0;1;0;818599019;830318739;50822755
1423;4.74216e-15;1713;-7;487;10859;1;45;8.18872e+08;-2.72455e+06;1;0;0;0;1;0;818871517;830621154;50904646
1424;4.74216e-15;1714;-7;487;10859;1;45;8.19143e+08;-2.71858e+06;0;0;0;0;0;0;819143417;830922976;50986453
1425;4.74216e-15;1714;-7;487;10859;1;45;8.19415e+08;-2.71262e+06;1;0;0;0;1;0;819414722;831224205;51068177
1426;4.74216e-15;1715;-7;487;10859;1;45;8.19685e+08;-2.70668e+06;0;0;0;0;0;0;819685433;831524844;51149817
1427;4.74216e-15;1715;-7;487;10859;1;45;8.19956e+08;-2.70076e+06;1;0;0;0;1;0;819955552;831824893;51231374
1428;4.74216e-15;1716;-7;487;10859;1;45;8.20225e+08;-2.69485e+06;0;0;0;0;0;0;820225079;832124354;51312847
1429;4.74216e-15;1717;-7;487;10859;1;45;8.20494e+08;-2.68896e+06;0;0;0;0;0;0;820494018;832423228;51394236
1430;4.74216e-15;1718;-7;487;10859;1;45;8.20762e+08;-2.68308e+06;0;0;0;0;0;0;820762368;832721517;51475541
1431;4.74216e-15;1718;-7;487;10859;1;45;8.2103e+08;-2.67722e+06;1;0;0;0;1;0;821030133;833019222;51556762
1432;4.74216e-15;1719;-7;487;10859;1;45;8.21297e+08;-2.67137e+06;0;0;0;0;0;0;821297312;833316345;51637899
1433;4.74216e-15;1720;-7;487;10859;1;45;8.21564e+08;-2.66554e+06;0;0;0;0;0;0;821563909;833612886;51718952
1434;4.74216e-15;1721;-7;487;10859;1;45;8.2183e+08;-2.65972e+06;0;0;0;0;0;0;821829923;833908847;51799920
1435;4.74216e-15;1722;-7;487;10859;1;45;8.22095e+08;-2.65391e+06;0;0;0;0;0;0;822095357;834204231;51880804
1436;4.74216e-15;1722;-7;487;10859;1;45;8.2236e+08;-2.64813e+06;1;0;0;0;1;0;822360213;834499037;51961604
1437;4.74216e-15;1723;-7;487;10859;1;45;8.22624e+08;-2.64235e+06;0;0;0;0;0;0;822624491;834793267;52042319
1438;4.74216e-15;1723;-7;487;10859;1;45;8.22888e+08;-2.6366e+06;1;0;0;0;1;0;822888193;835086923;52122949
1439;4.74216e-15;1723;-7;487;10859;1;45;8.23151e+08;-2.63085e+06;1;0;0;0;1;0;823151322;835380006;52203495
1440;4.74216e-15;1724;-7;487;10859;1;45;8.23414e+08;-2.62512e+06;0;0;0;0;0;0;823413877;835672517;52283955
1441;4.74216e-15;1724;-7;487;10859;1;45;8.23676e+08;-2.61941e+06;1;0;0;0;1;0;823675861;835964458;52364331
1442;4.74216e-15;1724;-7;487;10859;1;45;8.23937e+08;-2.61371e+06;1;0;0;0;1;0;823937275;836255830;52444622
1443;4.74216e-15;1724;-7;487;10859;1;45;8.24198e+08;-2.60803e+06;1;0;0;0;1;0;824198120;836546634;52524828
1444;4.74216e-15;1725;-7;487;10859;1;45;8.24458e+08;-2.60236e+06;0;0;0;0;0;0;824458399;836836871;52604949
1445;4.74216e-15;1725;-7;487;10859;1;45;8.24718e+08;-2.5967e+06;1;0;0;0;1;0;824718112;837126544;52684984
1446;4.74216e-15;1726;-7;487;10859;1;45;8.24977e+08;-2.59106e+06;0;0;0;0;0;0;824977261;837415653;52764934
1447;4.74216e-15;1726;-7;487;10859;1;45;8.25236e+08;-2.58543e+06;1;0;0;0;1;0;825235847;837704199;52844799
1448;4.74216e-15;1727;-7;487;10859;1;45;8.25494e+08;-2.57982e+06;0;0;0;0;0;0;825493872;837992184;52924578
1449;4.74216e-15;1728;-7;487;10859;1;45;8.25751e+08;-2.57422e+06;0;0;0;0;0;0;825751337;838279610;53004272
1450;4.74216e-15;1729;-7;487;10859;1;45;8.26008e+08;-2.56864e+06;0;0;0;0;0;0;826008244;838566477;53083880
1451;4.74216e-15;1729;-7;487;10859;1;45;8.26265e+08;-2.56307e+06;1;0;0;0;1;0;826264594;838852786;53163402
1452;4.74216e-15;1730;-7;487;10859;1;45;8.2652e+08;-2.55752e+06;0;0;0;0;0;0;826520388;839138540;53242839
1453;4.74216e-15;1731;-7;487;10859;1;45;8.26776e+08;-2.55198e+06;0;0;0;0;0;0;826775629;839423739;53322190
1454;4.74216e-15;1731;-7;487;10859;1;45;8.2703e+08;-2.54645e+06;1;0;0;0;1;0;827030316;839708385;53401455
1455;4.74216e-15;1731;-7;487;10859;1;45;8.27284e+08;-2.54094e+06;1;0;0;0;1;0;827284453;839992478;53480634
1456;4.74216e-15;1732;-7;487;10859;1;45;8.27538e+08;-2.53544e+06;0;0;0;0;0;0;827538039;840276020;53559726
1457;4.74216e-15;1732;-7;487;10859;1;45;8.27791e+08;-2.52995e+06;1;0;0;0;1;0;827791077;840559013;53638733
1458;4.74216e-15;1732;-7;487;10859;1;45;8.28044e+08;-2.52448e+06;1;0;0;0;1;0;828043568;840841458;53717654
1459;4.74216e-15;1732;-7;487;10859;1;45;8.28296e+08;-2.51902e+06;1;0;0;0;1;0;828295513;841123356;53796489
1460;4.74216e-15;1732;-7;487;10859;1;45;8.28547e+08;-2.51358e+06;1;0;0;0;1;0;828546914;841404707;53875237
1461;4.74216e-15;1733;-7;487;10859;1;45;8.28798e+08;-2.50815e+06;0;0;0;0;0;0;828797772;841685515;53953899
1462;4.74216e-15;1734;-7;487;10859;1;45;8.29048e+08;-2.50273e+06;0;0;0;0;0;0;829048088;841965778;54032474
1463;4.74216e-15;1734;-7;487;10859;1;45;8.29298e+08;-2.49733e+06;1;0;0;0;1;0;829297864;842245500;54110963
1464;4.74216e-15;1735;-7;487;10859;1;45;8.29547e+08;-2.49194e+06;0;0;0;0;0;0;829547101;842524681;54189366
1465;4.74216e-15;1735;-7;487;10859;1;45;8.29796e+08;-2.48657e+06;1;0;0;0;1;0;829795801;842803322;54267681
1466;4.74216e-15;1735;-7;487;10859;1;45;8.30044e+08;-2.48121e+06;1;0;0;0;1;0;830043965;843081425;54345911
1467;4.74216e-15;1736;-7;487;10859;1;45;8.30292e+08;-2.47586e+06;0;0;0;0;0;0;830291593;843358991;54424053
1468;4.74216e-15;1736;-7;487;10859;1;45;8.30539e+08;-2.47052e+06;1;0;0;0;1;0;830538689;843636021;54502109
1469;4.74216e-15;1736;-7;487;10859;1;45;8.30785e+08;-2.4652e+06;1;0;0;0;1;0;830785252;843912516;54580078
1470;4.74216e-15;1736;-7;487;10859;1;45;8.31031e+08;-2.4599e+06;1;0;0;0;1;0;831031284;844188478;54657960
1471;4.74216e-15;1737;-7;487;10859;1;45;8.31277e+08;-2.4546e+06;0;0;0;0;0;0;831276788;844463907;54735755
1472;4.74216e-15;1738;-7;487;10859;1;45;8.31522e+08;-2.44932e+06;0;0;0;0;0;0;831521763;844738805;54813463
1473;4.74216e-15;1738;-7;487;10859;1;45;8.31766e+08;-2.44405e+06;1;0;0;0;1;0;831766211;845013174;54891085
1474;4.74216e-15;1739;-7;487;10859;1;45;8.3201e+08;-2.4388e+06;0;0;0;0;0;0;832010133;845287013;54968619
1475;4.74216e-15;1740;-7;487;10859;1;45;8.32254e+08;-2.43356e+06;0;0;0;0;0;0;832253532;845560326;55046066
1476;4.74216e-15;1740;-7;487;10859;1;45;8.32496e+08;-2.42833e+06;1;0;0;0;1;0;832496408;845833112;55123426
1477;4.74216e-15;1740;-7;487;10859;1;45;8.32739e+08;-2.42311e+06;1;0;0;0;1;0;832738762;846105372;55200698
1478;4.74216e-15;1740;-7;487;10859;1;45;8.32981e+08;-2.41791e+06;1;0;0;0;1;0;832980596;846377109;55277884
1479;4.74216e-15;1740;-7;487;10859;1;45;8.33222e+08;-2.41272e+06;1;0;0;0;1;0;833221911;846648324;55354982
1480;4.74216e-15;1741;-7;487;10859;1;45;8.33463e+08;-2.40755e+06;0;0;0;0;0;0;833462709;846919016;55431993
1481;4.74216e-15;1742;-7;487;10859;1;45;8.33703e+08;-2.40238e+06;0;0;0;0;0;0;833702990;847189188;55508916
1482;4.74216e-15;1742;-7;487;10859;1;45;8.33943e+08;-2.39723e+06;1;0;0;0;1;0;833942756;847458841;55585752
1483;4.74216e-15;1743;-7;487;10859;1;45;8.34182e+08;-2.3921e+06;0;0;0;0;0;0;834182009;847727976;55662501
1484;4.74216e-15;1744;-7;487;10859;1;45;8.34421e+08;-2.38697e+06;0;0;0;0;0;0;834420749;847996595;55739161
1485;4.74216e-15;1744;-7;487;10859;1;45;8.34659e+08;-2.38186e+06;1;0;0;0;1;0;834658978;848264697;55815735
1486;4.74216e-15;1744;-7;487;10859;1;45;8.34897e+08;-2.37676e+06;1;0;0;0;1;0;834896696;848532285;55892221
1487;4.74216e-15;1745;-7;487;10859;1;45;8.35134e+08;-2.37167e+06;0;0;0;0;0;0;835133907;848799359;55968619
1488;4.74216e-15;1745;-7;487;10859;1;45;8.35371e+08;-2.3666e+06;1;0;0;0;1;0;835370610;849065921;56044929
1489;4.74216e-15;1746;-7;487;10859;1;45;8.35607e+08;-2.36154e+06;0;0;0;0;0;0;835606806;849331972;56121152
1490;4.74216e-15;1747;-7;487;10859;1;45;8.35842e+08;-2.35649e+06;0;0;0;0;0;0;835842498;849597513;56197287
1491;4.74216e-15;1748;-7;487;10859;1;45;8.36078e+08;-2.35145e+06;0;0;0;0;0;0;836077686;849862545;56273335
1492;4.74216e-15;1749;-7;487;10859;1;45;8.36312e+08;-2.34643e+06;0;0;0;0;0;0;836312372;850127070;56349294
1493;4.74216e-15;1750;-7;487;10859;1;45;8.36547e+08;-2.34142e+06;0;0;0;0;0;0;836546557;850391088;56425166
1494;4.74216e-15;1750;-7;487;10859;1;45;8.3678e+08;-2.33642e+06;1;0;0;0;1;0;836780242;850654600;56500950
1495;4.74216e-15;1751;-7;487;10859;1;45;8.37013e+08;-2.33143e+06;0;0;0;0;0;0;837013428;850917608;56576646
1496;4.74216e-15;1752;-7;487;10859;1;45;8.37246e+08;-2.32646e+06;0;0;0;0;0;0;837246117;851180113;56652254
1497;4.74216e-15;1753;-7;487;10859;1;45;8.37478e+08;-2.3215e+06;0;0;0;0;0;0;837478310;851442116;56727774
1498;4.74216e-15;1753;-7;487;10859;1;45;8.3771e+08;-2.31655e+06;1;0;0;0;1;0;837710007;851703617;56803206
1499;4.74216e-15;1754;-7;487;10859;1;45;8.37941e+08;-2.31161e+06;0;0;0;0;0;0;837941211;851964619;56878550
1500;4.74216e-15;1754;-7;487;10859;1;45;8.38172e+08;-2.30668e+06;1;0;0;0;1;0;838171923;852225122;56953806
1501;4.74216e-15;1755;-7;487;10859;1;45;8.38402e+08;-2.30177e+06;0;0;0;0;0;0;838402143;852485128;57028973
1502;4.74216e-15;1756;-7;487;10859;1;45;8.38632e+08;-2.29687e+06;0;0;0;0;0;0;838631873;852744637;57104053
1503;4.74216e-15;1757;-7;487;10859;1;45;8.38861e+08;-2.29198e+06;0;0;0;0;0;0;838861114;853003650;57179045
1504;4.74216e-15;1758;-7;487;10859;1;45;8.3909e+08;-2.2871e+06;0;0;0;0;0;0;839089868;853262169;57253948
1505;4.74216e-15;1759;-7;487;10859;1;45;8.39318e+08;-2.28224e+06;0;0;0;0;0;0;839318135;853520195;57328764
1506;4.74216e-15;1759;-7;487;10859;1;45;8.39546e+08;-2.27739e+06;1;0;0;0;1;0;839545916;853777729;57403491
1507;4.74216e-15;1759;-7;487;10859;1;45;8.39773e+08;-2.27255e+06;1;0;0;0;1;0;839773214;854034771;57478130
1508;4.74216e-15;1760;-7;487;10859;1;45;8.4e+08;-2.26772e+06;0;0;0;0;0;0;840000028;854291323;57552681
1509;4.74216e-15;1761;-7;487;10859;1;45;8.40226e+08;-2.2629e+06;0;0;0;0;0;0;840226361;854547387;57627143
1510;4.74216e-15;1762;-7;487;10859;1;45;8.40452e+08;-2.25809e+06;0;0;0;0;0;0;840452214;854802963;57701517
1511;4.74216e-15;1763;-7;487;10859;1;45;8.40678e+08;-2.2533e+06;0;0;0;0;0;0;840677587;855058051;57775803
1512;4.74216e-15;1764;-7;487;10859;1;45;8.40902e+08;-2.24852e+06;0;0;0;0;0;0;840902482;855312654;57850000
1513;4.74216e-15;1764;-7;487;10859;1;45;8.41127e+08;-2.24375e+06;1;0;0;0;1;0;841126900;855566773;57924110
1514;4.74216e-15;1764;-7;487;10859;1;45;8.41351e+08;-2.23899e+06;1;0;0;0;1;0;841350842;855820407;57998131
1515;4.74216e-15;1764;-7;487;10859;1;45;8.41574e+08;-2.23424e+06;1;0;0;0;1;0;841574309;856073560;58072063
1516;4.74216e-15;1765;-7;487;10859;1;45;8.41797e+08;-2.22951e+06;0;0;0;0;0;0;841797303;856326230;58145907
1517;4.74216e-15;1766;-7;487;10859;1;45;8.4202e+08;-2.22478e+06;0;0;0;0;0;0;842019824;856578420;58219663
1518;4.74216e-15;1766;-7;487;10859;1;45;8.42242e+08;-2.22007e+06;1;0;0;0;1;0;842241874;856830131;58293330
1519;4.74216e-15;1766;-7;487;10859;1;45;8.42463e+08;-2.21537e+06;1;0;0;0;1;0;842463454;857081363;58366909
1520;4.74216e-15;1767;-7;487;10859;1;45;8.42685e+08;-2.21068e+06;0;0;0;0;0;0;842684565;857332119;58440400
1521;4.74216e-15;1768;-7;487;10859;1;45;8.42905e+08;-2.206e+06;0;0;0;0;0;0;842905209;857582397;58513802
1522;4.74216e-15;1768;-7;487;10859;1;45;8.43125e+08;-2.20134e+06;1;0;0;0;1;0;843125385;857832201;58587115
1523;4.74216e-15;1768;-7;487;10859;1;45;8.43345e+08;-2.19668e+06;1;0;0;0;1;0;843345096;858081530;58660340
1524;4.74216e-15;1769;-7;487;10859;1;45;8.43564e+08;-2.19204e+06;0;0;0;0;0;0;843564343;858330386;58733477
1525;4.74216e-15;1770;-7;487;10859;1;45;8.43783e+08;-2.1874e+06;0;0;0;0;0;0;843783127;858578770;58806525
1526;4.74216e-15;1771;-7;487;10859;1;45;8.44001e+08;-2.18278e+06;0;0;0;0;0;0;844001448;858826683;58879485
1527;4.74216e-15;1772;-7;487;10859;1;45;8.44219e+08;-2.17817e+06;0;0;0;0;0;0;844219309;859074126;58952356
1528;4.74216e-15;1773;-7;487;10859;1;45;8.44437e+08;-2.17357e+06;0;0;0;0;0;0;844436709;859321100;59025138
1529;4.74216e-15;1773;-7;487;10859;1;45;8.44654e+08;-2.16899e+06;1;0;0;0;1;0;844653651;859567605;59097833
1530;4.74216e-15;1774;-7;487;10859;1;45;8.4487e+08;-2.16441e+06;0;0;0;0;0;0;844870135;859813644;59170438
1531;4.74216e-15;1775;-7;487;10859;1;45;8.45086e+08;-2.15984e+06;0;0;0;0;0;0;845086162;860059216;59242955
1532;4.74216e-15;1776;-7;487;10859;1;45;8.45302e+08;-2.15529e+06;0;0;0;0;0;0;845301734;860304324;59315384
1533;4.74216e-15;1776;-7;487;10859;1;45;8.45517e+08;-2.15075e+06;1;0;0;0;1;0;845516852;860548967;59387724
1534;4.74216e-15;1776;-7;487;10859;1;45;8.45732e+08;-2.14621e+06;1;0;0;0;1;0;845731517;860793147;59459975
1535;4.74216e-15;1777;-7;487;10859;1;45;8.45946e+08;-2.14169e+06;0;0;0;0;0;0;845945729;861036865;59532138
1536;4.74216e-15;1778;-7;487;10859;1;45;8.46159e+08;-2.13718e+06;0;0;0;0;0;0;846159490;861280123;59604213
1537;4.74216e-15;1778;-7;487;10859;1;45;8.46373e+08;-2.13268e+06;1;0;0;0;1;0;846372801;861522920;59676199
1538;4.74216e-15;1778;-7;487;10859;1;45;8.46586e+08;-2.12819e+06;1;0;0;0;1;0;846585664;861765258;59748096
1539;4.74216e-15;1779;-7;487;10859;1;45;8.46798e+08;-2.12371e+06;0;0;0;0;0;0;846798078;862007138;59819905
1540;4.74216e-15;1780;-7;487;10859;1;45;8.4701e+08;-2.11925e+06;0;0;0;0;0;0;847010046;862248560;59891625
1541;4.74216e-15;1781;-7;487;10859;1;45;8.47222e+08;-2.11479e+06;0;0;0;0;0;0;847221568;862489527;59963257
1542;4.74216e-15;1782;-7;487;10859;1;45;8.47433e+08;-2.11034e+06;0;0;0;0;0;0;847432646;862730039;60034800
1543;4.74216e-15;1782;-7;487;10859;1;45;8.47643e+08;-2.10591e+06;1;0;0;0;1;0;847643280;862970096;60106255
1544;4.74216e-15;1783;-7;487;10859;1;45;8.47853e+08;-2.10148e+06;0;0;0;0;0;0;847853471;863209700;60177621
1545;4.74216e-15;1783;-7;487;10859;1;45;8.48063e+08;-2.09707e+06;1;0;0;0;1;0;848063221;863448852;60248899
1546;4.74216e-15;1783;-7;487;10859;1;45;8.48273e+08;-2.09267e+06;1;0;0;0;1;0;848272531;863687553;60320088
1547;4.74216e-15;1783;-7;487;10859;1;45;8.48481e+08;-2.08827e+06;1;0;0;0;1;0;848481402;863925803;60391188
1548;4.74216e-15;1784;-7;487;10859;1;45;8.4869e+08;-2.08389e+06;0;0;0;0;0;0;848689834;864163604;60462201
1549;4.74216e-15;1784;-7;487;10859;1;45;8.48898e+08;-2.07952e+06;1;0;0;0;1;0;848897829;864400957;60533124
1550;4.74216e-15;1784;-7;487;10859;1;45;8.49105e+08;-2.07516e+06;1;0;0;0;1;0;849105388;864637862;60603959
1551;4.74216e-15;1785;-7;487;10859;1;45;8.49313e+08;-2.07081e+06;0;0;0;0;0;0;849312512;864874320;60674706
1552;4.74216e-15;1786;-7;487;10859;1;45;8.49519e+08;-2.06647e+06;0;0;0;0;0;0;849519202;865110334;60745364
1553;4.74216e-15;1787;-7;487;10859;1;45;8.49725e+08;-2.06214e+06;0;0;0;0;0;0;849725459;865345902;60815934
1554;4.74216e-15;1787;-7;487;10859;1;45;8.49931e+08;-2.05782e+06;1;0;0;0;1;0;849931284;865581027;60886415
1555;4.74216e-15;1787;-7;487;10859;1;45;8.50137e+08;-2.05351e+06;1;0;0;0;1;0;850136678;865815709;60956808
1556;4.74216e-15;1788;-7;487;10859;1;45;8.50342e+08;-2.04921e+06;0;0;0;0;0;0;850341642;866049950;61027112
1557;4.74216e-15;1789;-7;487;10859;1;45;8.50546e+08;-2.04492e+06;0;0;0;0;0;0;850546177;866283749;61097328
1558;4.74216e-15;1789;-7;487;10859;1;45;8.5075e+08;-2.04064e+06;1;0;0;0;1;0;850750285;866517109;61167456
1559;4.74216e-15;1789;-7;487;10859;1;45;8.50954e+08;-2.03637e+06;1;0;0;0;1;0;850953965;866750030;61237495
1560;4.74216e-15;1789;-7;487;10859;1;45;8.51157e+08;-2.03212e+06;1;0;0;0;1;0;851157220;866982513;61307446
1561;4.74216e-15;1790;-7;487;10859;1;45;8.5136e+08;-2.02787e+06;0;0;0;0;0;0;851360050;867214558;61377308
1562;4.74216e-15;1790;-7;487;10859;1;45;8.51562e+08;-2.02363e+06;1;0;0;0;1;0;851562456;867446168;61447082
1563;4.74216e-15;1791;-7;487;10859;1;45;8.51764e+08;-2.0194e+06;0;0;0;0;0;0;851764439;867677342;61516768
1564;4.74216e-15;1792;-7;487;10859;1;45;8.51966e+08;-2.01518e+06;0;0;0;0;0;0;851966001;867908082;61586365
1565;4.74216e-15;1792;-7;487;10859;1;45;8.52167e+08;-2.01098e+06;1;0;0;0;1;0;852167142;868138388;61655875
1566;4.74216e-15;1792;-7;487;10859;1;45;8.52368e+08;-2.00678e+06;1;0;0;0;1;0;852367863;868368262;61725295
1567;4.74216e-15;1793;-7;487;10859;1;45;8.52568e+08;-2.00259e+06;0;0;0;0;0;0;852568165;868597705;61794628
1568;4.74216e-15;1794;-7;487;10859;1;45;8.52768e+08;-1.99841e+06;0;0;0;0;0;0;852768049;868826716;61863872
1569;4.74216e-15;1795;-7;487;10859;1;45;8.52968e+08;-1.99424e+06;0;0;0;0;0;0;852967517;869055298;61933028
1570;4.74216e-15;1796;-7;487;10859;1;45;8.53167e+08;-1.99009e+06;0;0;0;0;0;0;853166569;869283451;62002096
1571;4.74216e-15;1797;-7;487;10859;1;45;8.53365e+08;-1.98594e+06;0;0;0;0;0;0;853365206;869511176;62071075
1572;4.74216e-15;1797;-7;487;10859;1;45;8.53563e+08;-1.9818e+06;1;0;0;0;1;0;853563429;869738474;62139967
1573;4.74216e-15;1798;-7;487;10859;1;45;8.53761e+08;-1.97767e+06;0;0;0;0;0;0;853761239;869965346;62208770
1574;4.74216e-15;1799;-7;487;10859;1;45;8.53959e+08;-1.97355e+06;0;0;0;0;0;0;853958637;870191792;62277485
1575;4.74216e-15;1800;-7;487;10859;1;45;8.54156e+08;-1.96944e+06;0;0;0;0;0;0;854155624;870417814;62346112
1576;4.74216e-15;1800;-7;487;10859;1;45;8.54352e+08;-1.96534e+06;1;0;0;0;1;0;854352202;870643413;62414651
1577;4.74216e-15;1801;-7;487;10859;1;45;8.54548e+08;-1.96125e+06;0;0;0;0;0;0;854548370;870868589;62483102
1578;4.74216e-15;1802;-7;487;10859;1;45;8.54744e+08;-1.95717e+06;0;0;0;0;0;0;854744131;871093343;62551465
1579;4.74216e-15;1802;-7;487;10859;1;45;8.54939e+08;-1.9531e+06;1;0;0;0;1;0;854939484;871317676;62619739
1580;4.74216e-15;1802;-7;487;10859;1;45;8.55134e+08;-1.94904e+06;1;0;0;0;1;0;855134431;871541589;62687926
1581;4.74216e-15;1802;-7;487;10859;1;45;8.55329e+08;-1.94499e+06;1;0;0;0;1;0;855328973;871765084;62756025
1582;4.74216e-15;1803;-7;487;10859;1;45;8.55523e+08;-1.94095e+06;0;0;0;0;0;0;855523111;871988159;62824035
1583;4.74216e-15;1804;-7;487;10859;1;45;8.55717e+08;-1.93691e+06;0;0;0;0;0;0;855716846;872210818;62891958
1584;4.74216e-15;1805;-7;487;10859;1;45;8.5591e+08;-1.93289e+06;0;0;0;0;0;0;855910178;872433060;62959793
1585;4.74216e-15;1806;-7;487;10859;1;45;8.56103e+08;-1.92888e+06;0;0;0;0;0;0;856103109;872654887;63027540
1586;4.74216e-15;1806;-7;487;10859;1;45;8.56296e+08;-1.92487e+06;1;0;0;0;1;0;856295640;872876298;63095199
1587;4.74216e-15;1806;-7;487;10859;1;45;8.56488e+08;-1.92088e+06;1;0;0;0;1;0;856487771;873097296;63162771
1588;4.74216e-15;1807;-7;487;10859;1;45;8.5668e+08;-1.91689e+06;0;0;0;0;0;0;856679504;873317881;63230254
1589;4.74216e-15;1808;-7;487;10859;1;45;8.56871e+08;-1.91292e+06;0;0;0;0;0;0;856870839;873538053;63297650
1590;4.74216e-15;1809;-7;487;10859;1;45;8.57062e+08;-1.90895e+06;0;0;0;0;0;0;857061777;873757814;63364958
1591;4.74216e-15;1809;-7;487;10859;1;45;8.57252e+08;-1.90499e+06;1;0;0;0;1;0;857252320;873977165;63432178
1592;4.74216e-15;1809;-7;487;10859;1;45;8.57442e+08;-1.90105e+06;1;0;0;0;1;0;857442468;874196106;63499311
1593;4.74216e-15;1809;-7;487;10859;1;45;8.57632e+08;-1.89711e+06;1;0;0;0;1;0;857632222;874414638;63566356
1594;4.74216e-15;1809;-7;487;10859;1;45;8.57822e+08;-1.89318e+06;1;0;0;0;1;0;857821582;874632763;63633313
1595;4.74216e-15;1810;-7;487;10859;1;45;8.58011e+08;-1.88926e+06;0;0;0;0;0;0;858010551;874850480;63700183
1596;4.74216e-15;1811;-7;487;10859;1;45;8.58199e+08;-1.88535e+06;0;0;0;0;0;0;858199129;875067791;63766965
1597;4.74216e-15;1812;-7;487;10859;1;45;8.58387e+08;-1.88144e+06;0;0;0;0;0;0;858387317;875284696;63833659
1598;4.74216e-15;1813;-7;487;10859;1;45;8.58575e+08;-1.87755e+06;0;0;0;0;0;0;858575115;875501197;63900266
1599;4.74216e-15;1814;-7;487;10859;1;45;8.58763e+08;-1.87367e+06;0;0;0;0;0;0;858762525;875717295;63966786
1600;4.74216e-15;1815;-7;487;10859;1;45;8.5895e+08;-1.86979e+06;0;0;0;0;0;0;858949548;875932989;64033218
1601;4.74216e-15;1815;-7;487;10859;1;45;8.59136e+08;-1.86593e+06;1;0;0;0;1;0;859136184;876148281;64099563
1602;4.74216e-15;1815;-7;487;10859;1;45;8.59322e+08;-1.86207e+06;1;0;0;0;1;0;859322434;876363172;64165820
1603;4.74216e-15;1815;-7;487;10859;1;45;8.59508e+08;-1.85822e+06;1;0;0;0;1;0;859508299;876577663;64231990
1604;4.74216e-15;1815;-7;487;10859;1;45;8.59694e+08;-1.85438e+06;1;0;0;0;1;0;859693781;876791754;64298073
1605;4.74216e-15;1815;-7;487;10859;1;45;8.59879e+08;-1.85055e+06;1;0;0;0;1;0;859878879;877005446;64364069
1606;4.74216e-15;1816;-7;487;10859;1;45;8.60064e+08;-1.84673e+06;0;0;0;0;0;0;860063596;877218741;64429977
1607;4.74216e-15;1817;-7;487;10859;1;45;8.60248e+08;-1.84292e+06;0;0;0;0;0;0;860247931;877431638;64495798
1608;4.74216e-15;1817;-7;487;10859;1;45;8.60432e+08;-1.83912e+06;1;0;0;0;1;0;860431886;877644139;64561532
1609;4.74216e-15;1817;-7;487;10859;1;45;8.60615e+08;-1.83532e+06;1;0;0;0;1;0;860615461;877856244;64627179
1610;4.74216e-15;1818;-7;487;10859;1;45;8.60799e+08;-1.83154e+06;0;0;0;0;0;0;860798658;878067955;64692738
1611;4.74216e-15;1818;-7;487;10859;1;45;8.60981e+08;-1.82776e+06;1;0;0;0;1;0;860981477;878279271;64758211
1612;4.74216e-15;1819;-7;487;10859;1;45;8.61164e+08;-1.82399e+06;0;0;0;0;0;0;861163920;878490195;64823597
1613;4.74216e-15;1819;-7;487;10859;1;45;8.61346e+08;-1.82023e+06;1;0;0;0;1;0;861345986;878700726;64888895
1614;4.74216e-15;1819;-7;487;10859;1;45;8.61528e+08;-1.81648e+06;1;0;0;0;1;0;861527678;878910866;64954107
1615;4.74216e-15;1820;-7;487;10859;1;45;8.61709e+08;-1.81274e+06;0;0;0;0;0;0;861708995;879120615;65019232
1616;4.74216e-15;1821;-7;487;10859;1;45;8.6189e+08;-1.80901e+06;0;0;0;0;0;0;861889939;879329974;65084270
1617;4.74216e-15;1822;-7;487;10859;1;45;8.62071e+08;-1.80528e+06;0;0;0;0;0;0;862070510;879538945;65149221
1618;4.74216e-15;1823;-7;487;10859;1;45;8.62251e+08;-1.80156e+06;0;0;0;0;0;0;862250710;879747527;65214086
1619;4.74216e-15;1824;-7;487;10859;1;45;8.62431e+08;-1.79786e+06;0;0;0;0;0;0;862430539;879955721;65278863
1620;4.74216e-15;1824;-7;487;10859;1;45;8.6261e+08;-1.79416e+06;1;0;0;0;1;0;862609998;880163529;65343554
1621;4.74216e-15;1824;-7;487;10859;1;45;8.62789e+08;-1.79047e+06;1;0;0;0;1;0;862789088;880370950;65408159
1622;4.74216e-15;1825;-7;487;10859;1;45;8.62968e+08;-1.78679e+06;0;0;0;0;0;0;862967810;880577987;65472676
1623;4.74216e-15;1826;-7;487;10859;1;45;8.63146e+08;-1.78311e+06;0;0;0;0;0;0;863146165;880784639;65537107
1624;4.74216e-15;1827;-7;487;10859;1;45;8.63324e+08;-1.77945e+06;0;0;0;0;0;0;863324153;880990908;65601452
1625;4.74216e-15;1827;-7;487;10859;1;45;8.63502e+08;-1.77579e+06;1;0;0;0;1;0;863501775;881196794;65665710
1626;4.74216e-15;1828;-7;487;10859;1;45;8.63679e+08;-1.77214e+06;0;0;0;0;0;0;863679033;881402298;65729882
1627;4.74216e-15;1829;-7;487;10859;1;45;8.63856e+08;-1.7685e+06;0;0;0;0;0;0;863855927;881607420;65793967
1628;4.74216e-15;1830;-7;487;10859;1;45;8.64032e+08;-1.76487e+06;0;0;0;0;0;0;864032457;881812163;65857966
1629;4.74216e-15;1830;-7;487;10859;1;45;8.64209e+08;-1.76125e+06;1;0;0;0;1;0;864208625;882016525;65921879
1630;4.74216e-15;1831;-7;487;10859;1;45;8.64384e+08;-1.75764e+06;0;0;0;0;0;0;864384432;882220509;65985705
1631;4.74216e-15;1831;-7;487;10859;1;45;8.6456e+08;-1.75403e+06;1;0;0;0;1;0;864559878;882424114;66049445
1632;4.74216e-15;1832;-7;487;10859;1;45;8.64735e+08;-1.75043e+06;0;0;0;0;0;0;864734965;882627342;66113099
1633;4.74216e-15;1833;-7;487;10859;1;45;8.6491e+08;-1.74684e+06;0;0;0;0;0;0;864909692;882830193;66176667
1634;4.74216e-15;1833;-7;487;10859;1;45;8.65084e+08;-1.74326e+06;1;0;0;0;1;0;865084062;883032669;66240149
1635;4.74216e-15;1833;-7;487;10859;1;45;8.65258e+08;-1.73969e+06;1;0;0;0;1;0;865258073;883234769;66303545
1636;4.74216e-15;1833;-7;487;10859;1;45;8.65432e+08;-1.73612e+06;1;0;0;0;1;0;865431729;883436495;66366855
1637;4.74216e-15;1833;-7;487;10859;1;45;8.65605e+08;-1.73256e+06;1;0;0;0;1;0;865605029;883637848;66430079
1638;4.74216e-15;1833;-7;487;10859;1;45;8.65778e+08;-1.72901e+06;1;0;0;0;1;0;865777973;883838827;66493217
1639;4.74216e-15;1834;-7;487;10859;1;45;8.65951e+08;-1.72547e+06;0;0;0;0;0;0;865950564;884039435;66556269
1640;4.74216e-15;1835;-7;487;10859;1;45;8.66123e+08;-1.72194e+06;0;0;0;0;0;0;866122802;884239671;66619235
1641;4.74216e-15;1835;-7;487;10859;1;45;8.66295e+08;-1.71842e+06;1;0;0;0;1;0;866294687;884439537;66682116
1642;4.74216e-15;1835;-7;487;10859;1;45;8.66466e+08;-1.7149e+06;1;0;0;0;1;0;866466220;884639033;66744911
1643;4.74216e-15;1836;-7;487;10859;1;45;8.66637e+08;-1.71139e+06;0;0;0;0;0;0;866637403;884838159;66807620
1644;4.74216e-15;1836;-7;487;10859;1;45;8.66808e+08;-1.70789e+06;1;0;0;0;1;0;866808235;885036918;66870243
1645;4.74216e-15;1836;-7;487;10859;1;45;8.66979e+08;-1.7044e+06;1;0;0;0;1;0;866978719;885235308;66932781
1646;4.74216e-15;1837;-7;487;10859;1;45;8.67149e+08;-1.70091e+06;0;0;0;0;0;0;867148854;885433332;66995234
1647;4.74216e-15;1837;-7;487;10859;1;45;8.67319e+08;-1.69744e+06;1;0;0;0;1;0;867318641;885630990;67057601
1648;4.74216e-15;1837;-7;487;10859;1;45;8.67488e+08;-1.69397e+06;1;0;0;0;1;0;867488081;885828282;67119883
1649;4.74216e-15;1837;-7;487;10859;1;45;8.67657e+08;-1.69051e+06;1;0;0;0;1;0;867657176;886025210;67182079
1650;4.74216e-15;1838;-7;487;10859;1;45;8.67826e+08;-1.68706e+06;0;0;0;0;0;0;867825925;886221773;67244191
1651;4.74216e-15;1838;-7;487;10859;1;45;8.67994e+08;-1.68361e+06;1;0;0;0;1;0;867994329;886417974;67306216
1652;4.74216e-15;1838;-7;487;10859;1;45;8.68162e+08;-1.68017e+06;1;0;0;0;1;0;868162390;886613812;67368157
1653;4.74216e-15;1838;-7;487;10859;1;45;8.6833e+08;-1.67675e+06;1;0;0;0;1;0;868330108;886809288;67430013
1654;4.74216e-15;1838;-7;487;10859;1;45;8.68497e+08;-1.67332e+06;1;0;0;0;1;0;868497484;887004403;67491783
1655;4.74216e-15;1838;-7;487;10859;1;45;8.68665e+08;-1.66991e+06;1;0;0;0;1;0;868664518;887199158;67553468
1656;4.74216e-15;1839;-7;487;10859;1;45;8.68831e+08;-1.6665e+06;0;0;0;0;0;0;868831212;887393553;67615069
1657;4.74216e-15;1840;-7;487;10859;1;45;8.68998e+08;-1.66311e+06;0;0;0;0;0;0;868997566;887587590;67676584
1658;4.74216e-15;1840;-7;487;10859;1;45;8.69164e+08;-1.65972e+06;1;0;0;0;1;0;869163581;887781268;67738015
1659;4.74216e-15;1840;-7;487;10859;1;45;8.69329e+08;-1.65633e+06;1;0;0;0;1;0;869329258;887974589;67799361
1660;4.74216e-15;1840;-7;487;10859;1;45;8.69495e+08;-1.65296e+06;1;0;0;0;1;0;869494597;888167553;67860622
1661;4.74216e-15;1840;-7;487;10859;1;45;8.6966e+08;-1.64959e+06;1;0;0;0;1;0;869659599;888360161;67921798
1662;4.74216e-15;1840;-7;487;10859;1;45;8.69824e+08;-1.64623e+06;1;0;0;0;1;0;869824266;888552414;67982890
1663;4.74216e-15;1841;-7;487;10859;1;45;8.69989e+08;-1.64288e+06;0;0;0;0;0;0;869988597;888744312;68043897
1664;4.74216e-15;1841;-7;487;10859;1;45;8.70153e+08;-1.63953e+06;1;0;0;0;1;0;870152594;888935857;68104820
1665;4.74216e-15;1841;-7;487;10859;1;45;8.70316e+08;-1.6362e+06;1;0;0;0;1;0;870316257;889127048;68165658
1666;4.74216e-15;1842;-7;487;10859;1;45;8.7048e+08;-1.63287e+06;0;0;0;0;0;0;870479587;889317886;68226412
1667;4.74216e-15;1843;-7;487;10859;1;45;8.70643e+08;-1.62955e+06;0;0;0;0;0;0;870642585;889508373;68287081
1668;4.74216e-15;1844;-7;487;10859;1;45;8.70805e+08;-1.62623e+06;0;0;0;0;0;0;870805252;889698509;68347666
1669;4.74216e-15;1845;-7;487;10859;1;45;8.70968e+08;-1.62292e+06;0;0;0;0;0;0;870967588;889888295;68408166
1670;4.74216e-15;1846;-7;487;10859;1;45;8.7113e+08;-1.61962e+06;0;0;0;0;0;0;871129594;890077730;68468583
1671;4.74216e-15;1847;-7;487;10859;1;45;8.71291e+08;-1.61633e+06;0;0;0;0;0;0;871291270;890266817;68528915
1672;4.74216e-15;1848;-7;487;10859;1;45;8.71453e+08;-1.61305e+06;0;0;0;0;0;0;871452619;890455556;68589164
1673;4.74216e-15;1849;-7;487;10859;1;45;8.71614e+08;-1.60977e+06;0;0;0;0;0;0;871613639;890643946;68649328
1674;4.74216e-15;1849;-7;487;10859;1;45;8.71774e+08;-1.6065e+06;1;0;0;0;1;0;871774333;890831990;68709408
1675;4.74216e-15;1849;-7;487;10859;1;45;8.71935e+08;-1.60324e+06;1;0;0;0;1;0;871934700;891019688;68769404
1676;4.74216e-15;1850;-7;487;10859;1;45;8.72095e+08;-1.59998e+06;0;0;0;0;0;0;872094742;891207040;68829317
1677;4.74216e-15;1851;-7;487;10859;1;45;8.72254e+08;-1.59674e+06;0;0;0;0;0;0;872254459;891394048;68889146
1678;4.74216e-15;1851;-7;487;10859;1;45;8.72414e+08;-1.59349e+06;1;0;0;0;1;0;872413852;891580711;68948891
1679;4.74216e-15;1851;-7;487;10859;1;45;8.72573e+08;-1.59026e+06;1;0;0;0;1;0;872572921;891767030;69008552
1680;4.74216e-15;1851;-7;487;10859;1;45;8.72732e+08;-1.58704e+06;1;0;0;0;1;0;872731668;891953007;69068130
1681;4.74216e-15;1852;-7;487;10859;1;45;8.7289e+08;-1.58382e+06;0;0;0;0;0;0;872890094;892138642;69127624
1682;4.74216e-15;1852;-7;487;10859;1;45;8.73048e+08;-1.58061e+06;1;0;0;0;1;0;873048198;892323935;69187034
1683;4.74216e-15;1853;-7;487;10859;1;45;8.73206e+08;-1.5774e+06;0;0;0;0;0;0;873205981;892508887;69246361
1684;4.74216e-15;1853;-7;487;10859;1;45;8.73363e+08;-1.5742e+06;1;0;0;0;1;0;873363445;892693500;69305605
1685;4.74216e-15;1854;-7;487;10859;1;45;8.73521e+08;-1.57102e+06;0;0;0;0;0;0;873520590;892877772;69364766
1686;4.74216e-15;1855;-7;487;10859;1;45;8.73677e+08;-1.56783e+06;0;0;0;0;0;0;873677417;893061707;69423843
1687;4.74216e-15;1855;-7;487;10859;1;45;8.73834e+08;-1.56466e+06;1;0;0;0;1;0;873833926;893245302;69482837
1688;4.74216e-15;1856;-7;487;10859;1;45;8.7399e+08;-1.56149e+06;0;0;0;0;0;0;873990118;893428561;69541748
1689;4.74216e-15;1857;-7;487;10859;1;45;8.74146e+08;-1.55833e+06;0;0;0;0;0;0;874145995;893611483;69600576
1690;4.74216e-15;1857;-7;487;10859;1;45;8.74302e+08;-1.55517e+06;1;0;0;0;1;0;874301555;893794068;69659321
1691;4.74216e-15;1858;-7;487;10859;1;45;8.74457e+08;-1.55203e+06;0;0;0;0;0;0;874456801;893976319;69717983
1692;4.74216e-15;1859;-7;487;10859;1;45;8.74612e+08;-1.54888e+06;0;0;0;0;0;0;874611733;894158234;69776562
1693;4.74216e-15;1860;-7;487;10859;1;45;8.74766e+08;-1.54575e+06;0;0;0;0;0;0;874766352;894339815;69835058
1694;4.74216e-15;1861;-7;487;10859;1;45;8.74921e+08;-1.54263e+06;0;0;0;0;0;0;874920658;894521063;69893471
1695;4.74216e-15;1861;-7;487;10859;1;45;8.75075e+08;-1.53951e+06;1;0;0;0;1;0;875074652;894701978;69951802
1696;4.74216e-15;1862;-7;487;10859;1;45;8.75228e+08;-1.5364e+06;0;0;0;0;0;0;875228335;894882561;70010050
1697;4.74216e-15;1862;-7;487;10859;1;45;8.75382e+08;-1.53329e+06;1;0;0;0;1;0;875381708;895062812;70068216
1698;4.74216e-15;1862;-7;487;10859;1;45;8.75535e+08;-1.53019e+06;1;0;0;0;1;0;875534770;895242732;70126299
1699;4.74216e-15;1862;-7;487;10859;1;45;8.75688e+08;-1.5271e+06;1;0;0;0;1;0;875687524;895422322;70184300
1700;4.74216e-15;1862;-7;487;10859;1;45;8.7584e+08;-1.52401e+06;1;0;0;0;1;0;875839969;895601583;70242218
1701;4.74216e-15;1863;-7;487;10859;1;45;8.75992e+08;-1.52094e+06;0;0;0;0;0;0;875992106;895780514;70300054
1702;4.74216e-15;1864;-7;487;10859;1;45;8.76144e+08;-1.51787e+06;0;0;0;0;0;0;876143936;895959118;70357808
1703;4.74216e-15;1864;-7;487;10859;1;45;8.76295e+08;-1.5148e+06;1;0;0;0;1;0;876295460;896137394;70415479
1704;4.74216e-15;1865;-7;487;10859;1;45;8.76447e+08;-1.51175e+06;0;0;0;0;0;0;876446678;896315342;70473069
1705;4.74216e-15;1866;-7;487;10859;1;45;8.76598e+08;-1.5087e+06;0;0;0;0;0;0;876597591;896492965;70530576
1706;4.74216e-15;1866;-7;487;10859;1;45;8.76748e+08;-1.50565e+06;1;0;0;0;1;0;876748200;896670261;70588001
1707;4.74216e-15;1867;-7;487;10859;1;45;8.76899e+08;-1.50262e+06;0;0;0;0;0;0;876898505;896847233;70645345
1708;4.74216e-15;1868;-7;487;10859;1;45;8.77049e+08;-1.49959e+06;0;0;0;0;0;0;877048507;897023880;70702607
1709;4.74216e-15;1869;-7;487;10859;1;45;8.77198e+08;-1.49656e+06;0;0;0;0;0;0;877198207;897200203;70759787
1710;4.74216e-15;1870;-7;487;10859;1;45;8.77348e+08;-1.49355e+06;0;0;0;0;0;0;877347605;897376203;70816885
1711;4.74216e-15;1871;-7;487;10859;1;45;8.77497e+08;-1.49054e+06;0;0;0;0;0;0;877496702;897551881;70873901
1712;4.74216e-15;1872;-7;487;10859;1;45;8.77645e+08;-1.48753e+06;0;0;0;0;0;0;877645499;897727237;70930836
1713;4.74216e-15;1873;-7;487;10859;1;45;8.77794e+08;-1.48454e+06;0;0;0;0;0;0;877793996;897902271;70987690
1714;4.74216e-15;1874;-7;487;10859;1;45;8.77942e+08;-1.48155e+06;0;0;0;0;0;0;877942194;898076985;71044462
1715;4.74216e-15;1874;-7;487;10859;1;45;8.7809e+08;-1.47856e+06;1;0;0;0;1;0;878090094;898251379;71101152
1716;4.74216e-15;1874;-7;487;10859;1;45;8.78238e+08;-1.47559e+06;1;0;0;0;1;0;878237696;898425453;71157761
1717;4.74216e-15;1874;-7;487;10859;1;45;8.78385e+08;-1.47262e+06;1;0;0;0;1;0;878385001;898599208;71214289
1718;4.74216e-15;1875;-7;487;10859;1;45;8.78532e+08;-1.46965e+06;0;0;0;0;0;0;878532010;898772645;71270736
1719;4.74216e-15;1876;-7;487;10859;1;45;8.78679e+08;-1.4667e+06;0;0;0;0;0;0;878678723;898945765;71327102
1720;4.74216e-15;1876;-7;487;10859;1;45;8.78825e+08;-1.46375e+06;1;0;0;0;1;0;878825141;899118568;71383387
1721;4.74216e-15;1877;-7;487;10859;1;45;8.78971e+08;-1.4608e+06;0;0;0;0;0;0;878971265;899291054;71439591
1722;4.74216e-15;1877;-7;487;10859;1;45;8.79117e+08;-1.45786e+06;1;0;0;0;1;0;879117095;899463225;71495713
1723;4.74216e-15;1877;-7;487;10859;1;45;8.79263e+08;-1.45493e+06;1;0;0;0;1;0;879262632;899635081;71551755
1724;4.74216e-15;1877;-7;487;10859;1;45;8.79408e+08;-1.45201e+06;1;0;0;0;1;0;879407876;899806622;71607717
1725;4.74216e-15;1877;-7;487;10859;1;45;8.79553e+08;-1.44909e+06;1;0;0;0;1;0;879552829;899977849;71663597
1726;4.74216e-15;1877;-7;487;10859;1;45;8.79697e+08;-1.44618e+06;1;0;0;0;1;0;879697490;900148763;71719397
1727;4.74216e-15;1878;-7;487;10859;1;45;8.79842e+08;-1.44328e+06;0;0;0;0;0;0;879841861;900319364;71775117
1728;4.74216e-15;1878;-7;487;10859;1;45;8.79986e+08;-1.44038e+06;1;0;0;0;1;0;879985943;900489653;71830755
1729;4.74216e-15;1879;-7;487;10859;1;45;8.8013e+08;-1.43748e+06;0;0;0;0;0;0;880129735;900659631;71886314
1730;4.74216e-15;1880;-7;487;10859;1;45;8.80273e+08;-1.4346e+06;0;0;0;0;0;0;880273238;900829298;71941792
1731;4.74216e-15;1881;-7;487;10859;1;45;8.80416e+08;-1.43172e+06;0;0;0;0;0;0;880416454;900998655;71997190
1732;4.74216e-15;1881;-7;487;10859;1;45;8.80559e+08;-1.42885e+06;1;0;0;0;1;0;880559382;901167702;72052508
1733;4.74216e-15;1882;-7;487;10859;1;45;8.80702e+08;-1.42598e+06;0;0;0;0;0;0;880702023;901336440;72107745
1734;4.74216e-15;1882;-7;487;10859;1;45;8.80844e+08;-1.42312e+06;1;0;0;0;1;0;880844379;901504870;72162902
1735;4.74216e-15;1883;-7;487;10859;1;45;8.80986e+08;-1.42026e+06;0;0;0;0;0;0;880986449;901672992;72217980
1736;4.74216e-15;1884;-7;487;10859;1;45;8.81128e+08;-1.41742e+06;0;0;0;0;0;0;881128234;901840806;72272977
1737;4.74216e-15;1884;-7;487;10859;1;45;8.8127e+08;-1.41458e+06;1;0;0;0;1;0;881269735;902008314;72327895
1738;4.74216e-15;1884;-7;487;10859;1;45;8.81411e+08;-1.41174e+06;1;0;0;0;1;0;881410953;902175516;72382733
1739;4.74216e-15;1884;-7;487;10859;1;45;8.81552e+08;-1.40891e+06;1;0;0;0;1;0;881551887;902342412;72437491
1740;4.74216e-15;1885;-7;487;10859;1;45;8.81693e+08;-1.40609e+06;0;0;0;0;0;0;881692540;902509004;72492170
1741;4.74216e-15;1886;-7;487;10859;1;45;8.81833e+08;-1.40327e+06;0;0;0;0;0;0;881832910;902675291;72546769
1742;4.74216e-15;1887;-7;487;10859;1;45;8.81973e+08;-1.40046e+06;0;0;0;0;0;0;881973000;902841274;72601288
1743;4.74216e-15;1888;-7;487;10859;1;45;8.82113e+08;-1.39766e+06;0;0;0;0;0;0;882112809;903006954;72655728
1744;4.74216e-15;1889;-7;487;10859;1;45;8.82252e+08;-1.39486e+06;0;0;0;0;0;0;882252339;903172332;72710089
1745;4.74216e-15;1890;-7;487;10859;1;45;8.82392e+08;-1.39207e+06;0;0;0;0;0;0;882391589;903337408;72764370
1746;4.74216e-15;1890;-7;487;10859;1;45;8.82531e+08;-1.38928e+06;1;0;0;0;1;0;882530560;903502182;72818573
1747;4.74216e-15;1890;-7;487;10859;1;45;8.82669e+08;-1.3865e+06;1;0;0;0;1;0;882669254;903666656;72872696
1748;4.74216e-15;1891;-7;487;10859;1;45;8.82808e+08;-1.38373e+06;0;0;0;0;0;0;882807670;903830829;72926740
1749;4.74216e-15;1891;-7;487;10859;1;45;8.82946e+08;-1.38096e+06;1;0;0;0;1;0;882945809;903994703;72980705
1750;4.74216e-15;1892;-7;487;10859;1;45;8.83084e+08;-1.3782e+06;0;0;0;0;0;0;883083673;904158278;73034591
1751;4.74216e-15;1892;-7;487;10859;1;45;8.83221e+08;-1.37544e+06;1;0;0;0;1;0;883221260;904321554;73088398
1752;4.74216e-15;1893;-7;487;10859;1;45;8.83359e+08;-1.37269e+06;0;0;0;0;0;0;883358573;904484532;73142127
1753;4.74216e-15;1894;-7;487;10859;1;45;8.83496e+08;-1.36995e+06;0;0;0;0;0;0;883495611;904647213;73195777
1754;4.74216e-15;1894;-7;487;10859;1;45;8.83632e+08;-1.36721e+06;1;0;0;0;1;0;883632376;904809597;73249348
1755;4.74216e-15;1894;-7;487;10859;1;45;8.83769e+08;-1.36448e+06;1;0;0;0;1;0;883768867;904971685;73302841
1756;4.74216e-15;1894;-7;487;10859;1;45;8.83905e+08;-1.36175e+06;1;0;0;0;1;0;883905086;905133478;73356255
1757;4.74216e-15;1894;-7;487;10859;1;45;8.84041e+08;-1.35903e+06;1;0;0;0;1;0;884041033;905294975;73409591
1758;4.74216e-15;1894;-7;487;10859;1;45;8.84177e+08;-1.35632e+06;1;0;0;0;1;0;884176709;905456178;73462848
1759;4.74216e-15;1894;-7;487;10859;1;45;8.84312e+08;-1.35361e+06;1;0;0;0;1;0;884312113;905617087;73516028
1760;4.74216e-15;1894;-7;487;10859;1;45;8.84447e+08;-1.35091e+06;1;0;0;0;1;0;884447248;905777702;73569129
1761;4.74216e-15;1894;-7;487;10859;1;45;8.84582e+08;-1.34821e+06;1;0;0;0;1;0;884582113;905938025;73622152
1762;4.74216e-15;1895;-7;487;10859;1;45;8.84717e+08;-1.34552e+06;0;0;0;0;0;0;884716709;906098055;73675097
1763;4.74216e-15;1895;-7;487;10859;1;45;8.84851e+08;-1.34284e+06;1;0;0;0;1;0;884851036;906257794;73727964
1764;4.74216e-15;1896;-7;487;10859;1;45;8.84985e+08;-1.34016e+06;0;0;0;0;0;0;884985096;906417242;73780753
1765;4.74216e-15;1896;-7;487;10859;1;45;8.85119e+08;-1.33749e+06;1;0;0;0;1;0;885118888;906576399;73833464
1766;4.74216e-15;1896;-7;487;10859;1;45;8.85252e+08;-1.33482e+06;1;0;0;0;1;0;885252414;906735266;73886098
1767;4.74216e-15;1897;-7;487;10859;1;45;8.85386e+08;-1.33216e+06;0;0;0;0;0;0;885385674;906893843;73938654
1768;4.74216e-15;1898;-7;487;10859;1;45;8.85519e+08;-1.3295e+06;0;0;0;0;0;0;885518668;907052132;73991132
1769;4.74216e-15;1899;-7;487;10859;1;45;8.85651e+08;-1.32686e+06;0;0;0;0;0;0;885651397;907210132;74043533
1770;4.74216e-15;1900;-7;487;10859;1;45;8.85784e+08;-1.32421e+06;0;0;0;0;0;0;885783862;907367845;74095856
1771;4.74216e-15;1900;-7;487;10859;1;45;8.85916e+08;-1.32157e+06;1;0;0;0;1;0;885916063;907525270;74148102
1772;4.74216e-15;1901;-7;487;10859;1;45;8.86048e+08;-1.31894e+06;0;0;0;0;0;0;886048000;907682408;74200271
1773;4.74216e-15;1901;-7;487;10859;1;45;8.8618e+08;-1.31632e+06;1;0;0;0;1;0;886179675;907839261;74252363
1774;4.74216e-15;1902;-7;487;10859;1;45;8.86311e+08;-1.31369e+06;0;0;0;0;0;0;886311088;907995827;74304377
1775;4.74216e-15;1903;-7;487;10859;1;45;8.86442e+08;-1.31108e+06;0;0;0;0;0;0;886442240;908152109;74356315
1776;4.74216e-15;1903;-7;487;10859;1;45;8.86573e+08;-1.30847e+06;1;0;0;0;1;0;886573131;908308106;74408175
1777;4.74216e-15;1903;-7;487;10859;1;45;8.86704e+08;-1.30587e+06;1;0;0;0;1;0;886703761;908463819;74459959
1778;4.74216e-15;1904;-7;487;10859;1;45;8.86834e+08;-1.30327e+06;0;0;0;0;0;0;886834131;908619249;74511666
1779;4.74216e-15;1905;-7;487;10859;1;45;8.86964e+08;-1.30068e+06;0;0;0;0;0;0;886964242;908774396;74563296
1780;4.74216e-15;1906;-7;487;10859;1;45;8.87094e+08;-1.29809e+06;0;0;0;0;0;0;887094095;908929260;74614849
1781;4.74216e-15;1906;-7;487;10859;1;45;8.87224e+08;-1.29551e+06;1;0;0;0;1;0;887223689;909083843;74666326
1782;4.74216e-15;1906;-7;487;10859;1;45;8.87353e+08;-1.29293e+06;1;0;0;0;1;0;887353026;909238144;74717727
1783;4.74216e-15;1906;-7;487;10859;1;45;8.87482e+08;-1.29036e+06;1;0;0;0;1;0;887482105;909392165;74769050
1784;4.74216e-15;1906;-7;487;10859;1;45;8.87611e+08;-1.2878e+06;1;0;0;0;1;0;887610928;909545905;74820298
1785;4.74216e-15;1906;-7;487;10859;1;45;8.87739e+08;-1.28524e+06;1;0;0;0;1;0;887739496;909699366;74871469
1786;4.74216e-15;1907;-7;487;10859;1;45;8.87868e+08;-1.28268e+06;0;0;0;0;0;0;887867808;909852547;74922564
1787;4.74216e-15;1907;-7;487;10859;1;45;8.87996e+08;-1.28014e+06;1;0;0;0;1;0;887995865;910005450;74973583
1788;4.74216e-15;1907;-7;487;10859;1;45;8.88124e+08;-1.27759e+06;1;0;0;0;1;0;888123668;910158075;75024526
1789;4.74216e-15;1908;-7;487;10859;1;45;8.88251e+08;-1.27506e+06;0;0;0;0;0;0;888251217;910310422;75075393
1790;4.74216e-15;1908;-7;487;10859;1;45;8.88379e+08;-1.27252e+06;1;0;0;0;1;0;888378513;910462493;75126184
1791;4.74216e-15;1908;-7;487;10859;1;45;8.88506e+08;-1.27e+06;1;0;0;0;1;0;888505557;910614286;75176899
1792;4.74216e-15;1908;-7;487;10859;1;45;8.88632e+08;-1.26748e+06;1;0;0;0;1;0;888632348;910765804;75227539
1793;4.74216e-15;1908;-7;487;10859;1;45;8.88759e+08;-1.26496e+06;1;0;0;0;1;0;888758888;910917046;75278102
1794;4.74216e-15;1909;-7;487;10859;1;45;8.88885e+08;-1.26245e+06;0;0;0;0;0;0;888885177;911068013;75328591
1795;4.74216e-15;1910;-7;487;10859;1;45;8.89011e+08;-1.25995e+06;0;0;0;0;0;0;889011215;911218706;75379003
1796;4.74216e-15;1911;-7;487;10859;1;45;8.89137e+08;-1.25745e+06;0;0;0;0;0;0;889137004;911369125;75429341
1797;4.74216e-15;1912;-7;487;10859;1;45;8.89263e+08;-1.25496e+06;0;0;0;0;0;0;889262543;911519271;75479603
1798;4.74216e-15;1913;-7;487;10859;1;45;8.89388e+08;-1.25247e+06;0;0;0;0;0;0;889387833;911669144;75529789
1799;4.74216e-15;1913;-7;487;10859;1;45;8.89513e+08;-1.24998e+06;1;0;0;0;1;0;889512875;911818744;75579901
1800;4.74216e-15;1913;-7;487;10859;1;45;8.89638e+08;-1.24751e+06;1;0;0;0;1;0;889637670;911968073;75629937
1801;4.74216e-15;1913;-7;487;10859;1;45;8.89762e+08;-1.24504e+06;1;0;0;0;1;0;889762217;912117130;75679899
1802;4.74216e-15;1914;-7;487;10859;1;45;8.89887e+08;-1.24257e+06;0;0;0;0;0;0;889886517;912265916;75729785
1803;4.74216e-15;1915;-7;487;10859;1;45;8.90011e+08;-1.24011e+06;0;0;0;0;0;0;890010572;912414433;75779597
1804;4.74216e-15;1915;-7;487;10859;1;45;8.90134e+08;-1.23765e+06;1;0;0;0;1;0;890134380;912562679;75829333
1805;4.74216e-15;1916;-7;487;10859;1;45;8.90258e+08;-1.2352e+06;0;0;0;0;0;0;890257944;912710656;75878996
1806;4.74216e-15;1916;-7;487;10859;1;45;8.90381e+08;-1.23275e+06;1;0;0;0;1;0;890381263;912858364;75928583
1807;4.74216e-15;1916;-7;487;10859;1;45;8.90504e+08;-1.23031e+06;1;0;0;0;1;0;890504338;913005805;75978096
1808;4.74216e-15;1917;-7;487;10859;1;45;8.90627e+08;-1.22788e+06;0;0;0;0;0;0;890627169;913152977;76027534
1809;4.74216e-15;1917;-7;487;10859;1;45;8.9075e+08;-1.22545e+06;1;0;0;0;1;0;890749757;913299882;76076898
1810;4.74216e-15;1917;-7;487;10859;1;45;8.90872e+08;-1.22302e+06;1;0;0;0;1;0;890872103;913446520;76126188
1811;4.74216e-15;1918;-7;487;10859;1;45;8.90994e+08;-1.2206e+06;0;0;0;0;0;0;890994207;913592893;76175403
1812;4.74216e-15;1918;-7;487;10859;1;45;8.91116e+08;-1.21819e+06;1;0;0;0;1;0;891116070;913738999;76224544
1813;4.74216e-15;1918;-7;487;10859;1;45;8.91238e+08;-1.21578e+06;1;0;0;0;1;0;891237691;913884840;76273611
1814;4.74216e-15;1919;-7;487;10859;1;45;8.91359e+08;-1.21338e+06;0;0;0;0;0;0;891359072;914030417;76322605
1815;4.74216e-15;1920;-7;487;10859;1;45;8.9148e+08;-1.21098e+06;0;0;0;0;0;0;891480214;914175729;76371524
1816;4.74216e-15;1920;-7;487;10859;1;45;8.91601e+08;-1.20858e+06;1;0;0;0;1;0;891601116;914320777;76420369
1817;4.74216e-15;1921;-7;487;10859;1;45;8.91722e+08;-1.20619e+06;0;0;0;0;0;0;891721779;914465563;76469141
1818;4.74216e-15;1922;-7;487;10859;1;45;8.91842e+08;-1.20381e+06;0;0;0;0;0;0;891842203;914610085;76517839
1819;4.74216e-15;1923;-7;487;10859;1;45;8.91962e+08;-1.20143e+06;0;0;0;0;0;0;891962390;914754346;76566463
1820;4.74216e-15;1924;-7;487;10859;1;45;8.92082e+08;-1.19906e+06;0;0;0;0;0;0;892082340;914898344;76615014
1821;4.74216e-15;1925;-7;487;10859;1;45;8.92202e+08;-1.19669e+06;0;0;0;0;0;0;892202052;915042082;76663491
1822;4.74216e-15;1926;-7;487;10859;1;45;8.92322e+08;-1.19433e+06;0;0;0;0;0;0;892321529;915185558;76711895
1823;4.74216e-15;1927;-7;487;10859;1;45;8.92441e+08;-1.19197e+06;0;0;0;0;0;0;892440769;915328774;76760226
1824;4.74216e-15;1927;-7;487;10859;1;45;8.9256e+08;-1.18961e+06;1;0;0;0;1;0;892559774;915471731;76808483
1825;4.74216e-15;1927;-7;487;10859;1;45;8.92679e+08;-1.18727e+06;1;0;0;0;1;0;892678544;915614428;76856668
1826;4.74216e-15;1927;-7;487;10859;1;45;8.92797e+08;-1.18492e+06;1;0;0;0;1;0;892797080;915756867;76904779
1827;4.74216e-15;1927;-7;487;10859;1;45;8.92915e+08;-1.18258e+06;1;0;0;0;1;0;892915383;915899047;76952817
1828;4.74216e-15;1927;-7;487;10859;1;45;8.93033e+08;-1.18025e+06;1;0;0;0;1;0;893033451;916040969;77000783
1829;4.74216e-15;1928;-7;487;10859;1;45;8.93151e+08;-1.17792e+06;0;0;0;0;0;0;893151287;916182634;77048675
1830;4.74216e-15;1928;-7;487;10859;1;45;8.93269e+08;-1.1756e+06;1;0;0;0;1;0;893268891;916324042;77096495
1831;4.74216e-15;1929;-7;487;10859;1;45;8.93386e+08;-1.17328e+06;0;0;0;0;0;0;893386263;916465194;77144243
1832;4.74216e-15;1929;-7;487;10859;1;45;8.93503e+08;-1.17097e+06;1;0;0;0;1;0;893503404;916606090;77191917
1833;4.74216e-15;1930;-7;487;10859;1;45;8.9362e+08;-1.16866e+06;0;0;0;0;0;0;893620313;916746730;77239520
1834;4.74216e-15;1930;-7;487;10859;1;45;8.93737e+08;-1.16636e+06;1;0;0;0;1;0;893736993;916887115;77287049
1835;4.74216e-15;1930;-7;487;10859;1;45;8.93853e+08;-1.16406e+06;1;0;0;0;1;0;893853442;917027246;77334507
1836;4.74216e-15;1931;-7;487;10859;1;45;8.9397e+08;-1.16176e+06;0;0;0;0;0;0;893969662;917167123;77381892
1837;4.74216e-15;1932;-7;487;10859;1;45;8.94086e+08;-1.15948e+06;0;0;0;0;0;0;894085653;917306747;77429205
1838;4.74216e-15;1933;-7;487;10859;1;45;8.94201e+08;-1.15719e+06;0;0;0;0;0;0;894201416;917446117;77476446
1839;4.74216e-15;1934;-7;487;10859;1;45;8.94317e+08;-1.15491e+06;0;0;0;0;0;0;894316951;917585235;77523615
1840;4.74216e-15;1934;-7;487;10859;1;45;8.94432e+08;-1.15264e+06;1;0;0;0;1;0;894432259;917724101;77570712
1841;4.74216e-15;1935;-7;487;10859;1;45;8.94547e+08;-1.15037e+06;0;0;0;0;0;0;894547339;917862715;77617738
1842;4.74216e-15;1936;-7;487;10859;1;45;8.94662e+08;-1.1481e+06;0;0;0;0;0;0;894662193;918001078;77664691
1843;4.74216e-15;1937;-7;487;10859;1;45;8.94777e+08;-1.14584e+06;0;0;0;0;0;0;894776821;918139190;77711573
1844;4.74216e-15;1938;-7;487;10859;1;45;8.94891e+08;-1.14359e+06;0;0;0;0;0;0;894891224;918277053;77758383
1845;4.74216e-15;1939;-7;487;10859;1;45;8.95005e+08;-1.14134e+06;0;0;0;0;0;0;895005402;918414665;77805122
1846;4.74216e-15;1940;-7;487;10859;1;45;8.95119e+08;-1.13909e+06;0;0;0;0;0;0;895119355;918552028;77851789
1847;4.74216e-15;1940;-7;487;10859;1;45;8.95233e+08;-1.13685e+06;1;0;0;0;1;0;895233084;918689143;77898385
1848;4.74216e-15;1940;-7;487;10859;1;45;8.95347e+08;-1.13462e+06;1;0;0;0;1;0;895346589;918826009;77944910
1849;4.74216e-15;1940;-7;487;10859;1;45;8.9546e+08;-1.13238e+06;1;0;0;0;1;0;895459871;918962627;77991363
1850;4.74216e-15;1941;-7;487;10859;1;45;8.95573e+08;-1.13016e+06;0;0;0;0;0;0;895572931;919098998;78037746
1851;4.74216e-15;1942;-7;487;10859;1;45;8.95686e+08;-1.12794e+06;0;0;0;0;0;0;895685768;919235121;78084057
1852;4.74216e-15;1942;-7;487;10859;1;45;8.95798e+08;-1.12572e+06;1;0;0;0;1;0;895798384;919370999;78130297
1853;4.74216e-15;1942;-7;487;10859;1;45;8.95911e+08;-1.12351e+06;1;0;0;0;1;0;895910778;919506630;78176467
1854;4.74216e-15;1942;-7;487;10859;1;45;8.96023e+08;-1.1213e+06;1;0;0;0;1;0;896022952;919642016;78222566
1855;4.74216e-15;1943;-7;487;10859;1;45;8.96135e+08;-1.1191e+06;0;0;0;0;0;0;896134905;919777157;78268594
1856;4.74216e-15;1944;-7;487;10859;1;45;8.96247e+08;-1.1169e+06;0;0;0;0;0;0;896246639;919912053;78314551
1857;4.74216e-15;1945;-7;487;10859;1;45;8.96358e+08;-1.1147e+06;0;0;0;0;0;0;896358153;920046704;78360438
1858;4.74216e-15;1945;-7;487;10859;1;45;8.96469e+08;-1.11252e+06;1;0;0;0;1;0;896469448;920181113;78406254
1859;4.74216e-15;1945;-7;487;10859;1;45;8.96581e+08;-1.11033e+06;1;0;0;0;1;0;896580525;920315277;78452000
1860;4.74216e-15;1945;-7;487;10859;1;45;8.96691e+08;-1.10815e+06;1;0;0;0;1;0;896691384;920449199;78497676
1861;4.74216e-15;1945;-7;487;10859;1;45;8.96802e+08;-1.10598e+06;1;0;0;0;1;0;896802025;920582879;78543282
1862;4.74216e-15;1945;-7;487;10859;1;45;8.96912e+08;-1.1038e+06;1;0;0;0;1;0;896912449;920716317;78588817
1863;4.74216e-15;1946;-7;487;10859;1;45;8.97023e+08;-1.10164e+06;0;0;0;0;0;0;897022657;920849513;78634282
1864;4.74216e-15;1947;-7;487;10859;1;45;8.97133e+08;-1.09948e+06;0;0;0;0;0;0;897132648;920982468;78679678
1865;4.74216e-15;1947;-7;487;10859;1;45;8.97242e+08;-1.09732e+06;1;0;0;0;1;0;897242424;921115183;78725003
1866;4.74216e-15;1948;-7;487;10859;1;45;8.97352e+08;-1.09517e+06;0;0;0;0;0;0;897351984;921247658;78770259
1867;4.74216e-15;1949;-7;487;10859;1;45;8.97461e+08;-1.09302e+06;0;0;0;0;0;0;897461330;921379892;78815445
1868;4.74216e-15;1949;-7;487;10859;1;45;8.9757e+08;-1.09088e+06;1;0;0;0;1;0;897570461;921511888;78860561
1869;4.74216e-15;1949;-7;487;10859;1;45;8.97679e+08;-1.08874e+06;1;0;0;0;1;0;897679379;921643645;78905608
1870;4.74216e-15;1950;-7;487;10859;1;45;8.97788e+08;-1.0866e+06;0;0;0;0;0;0;897788083;921775163;78950585
1871;4.74216e-15;1951;-7;487;10859;1;45;8.97897e+08;-1.08447e+06;0;0;0;0;0;0;897896574;921906444;78995493
1872;4.74216e-15;1952;-7;487;10859;1;45;8.98005e+08;-1.08235e+06;0;0;0;0;0;0;898004853;922037487;79040331
1873;4.74216e-15;1952;-7;487;10859;1;45;8.98113e+08;-1.08023e+06;1;0;0;0;1;0;898112919;922168293;79085101
1874;4.74216e-15;1952;-7;487;10859;1;45;8.98221e+08;-1.07811e+06;1;0;0;0;1;0;898220774;922298863;79129801
1875;4.74216e-15;1952;-7;487;10859;1;45;8.98328e+08;-1.076e+06;1;0;0;0;1;0;898328418;922429197;79174432
1876;4.74216e-15;1953;-7;487;10859;1;45;8.98436e+08;-1.07389e+06;0;0;0;0;0;0;898435850;922559294;79218994
1877;4.74216e-15;1954;-7;487;10859;1;45;8.98543e+08;-1.07179e+06;0;0;0;0;0;0;898543073;922689157;79263487
1878;4.74216e-15;1954;-7;487;10859;1;45;8.9865e+08;-1.06969e+06;1;0;0;0;1;0;898650086;922818785;79307911
1879;4.74216e-15;1954;-7;487;10859;1;45;8.98757e+08;-1.0676e+06;1;0;0;0;1;0;898756889;922948178;79352267
1880;4.74216e-15;1955;-7;487;10859;1;45;8.98863e+08;-1.0655e+06;0;0;0;0;0;0;898863483;923077338;79396554
1881;4.74216e-15;1955;-7;487;10859;1;45;8.9897e+08;-1.06342e+06;1;0;0;0;1;0;898969869;923206264;79440772
1882;4.74216e-15;1955;-7;487;10859;1;45;8.99076e+08;-1.06134e+06;1;0;0;0;1;0;899076047;923334956;79484922
1883;4.74216e-15;1956;-7;487;10859;1;45;8.99182e+08;-1.05926e+06;0;0;0;0;0;0;899182017;923463417;79529004
1884;4.74216e-15;1957;-7;487;10859;1;45;8.99288e+08;-1.05719e+06;0;0;0;0;0;0;899287779;923591645;79573017
1885;4.74216e-15;1957;-7;487;10859;1;45;8.99393e+08;-1.05512e+06;1;0;0;0;1;0;899393335;923719641;79616962
1886;4.74216e-15;1958;-7;487;10859;1;45;8.99499e+08;-1.05306e+06;0;0;0;0;0;0;899498685;923847406;79660838
1887;4.74216e-15;1959;-7;487;10859;1;45;8.99604e+08;-1.051e+06;0;0;0;0;0;0;899603828;923974940;79704647
1888;4.74216e-15;1959;-7;487;10859;1;45;8.99709e+08;-1.04894e+06;1;0;0;0;1;0;899708766;924102243;79748388
1889;4.74216e-15;1960;-7;487;10859;1;45;8.99813e+08;-1.04689e+06;0;0;0;0;0;0;899813499;924229317;79792060
1890;4.74216e-15;1961;-7;487;10859;1;45;8.99918e+08;-1.04485e+06;0;0;0;0;0;0;899918028;924356160;79835665
1891;4.74216e-15;1962;-7;487;10859;1;45;9.00022e+08;-1.0428e+06;0;0;0;0;0;0;900022352;924482775;79879202
1892;4.74216e-15;1963;-7;487;10859;1;45;9.00126e+08;-1.04077e+06;0;0;0;0;0;0;900126472;924609161;79922672
1893;4.74216e-15;1963;-7;487;10859;1;45;9.0023e+08;-1.03873e+06;1;0;0;0;1;0;900230389;924735318;79966073
1894;4.74216e-15;1963;-7;487;10859;1;45;9.00334e+08;-1.0367e+06;1;0;0;0;1;0;900334104;924861248;80009408
1895;4.74216e-15;1964;-7;487;10859;1;45;9.00438e+08;-1.03468e+06;0;0;0;0;0;0;900437615;924986950;80052674
1896;4.74216e-15;1965;-7;487;10859;1;45;9.00541e+08;-1.03266e+06;0;0;0;0;0;0;900540925;925112425;80095874
1897;4.74216e-15;1966;-7;487;10859;1;45;9.00644e+08;-1.03064e+06;0;0;0;0;0;0;900644032;925237673;80139006
1898;4.74216e-15;1967;-7;487;10859;1;45;9.00747e+08;-1.02863e+06;0;0;0;0;0;0;900746939;925362695;80182071
1899;4.74216e-15;1968;-7;487;10859;1;45;9.0085e+08;-1.02662e+06;0;0;0;0;0;0;900849645;925487491;80225069
1900;4.74216e-15;1969;-7;487;10859;1;45;9.00952e+08;-1.02461e+06;0;0;0;0;0;0;900952150;925612062;80268000
1901;4.74216e-15;1969;-7;487;10859;1;45;9.01054e+08;-1.02262e+06;1;0;0;0;1;0;901054456;925736408;80310864
1902;4.74216e-15;1969;-7;487;10859;1;45;9.01157e+08;-1.02062e+06;1;0;0;0;1;0;901156561;925860529;80353661
1903;4.74216e-15;1969;-7;487;10859;1;45;9.01258e+08;-1.01863e+06;1;0;0;0;1;0;901258468;925984426;80396391
1904;4.74216e-15;1970;-7;487;10859;1;45;9.0136e+08;-1.01664e+06;0;0;0;0;0;0;901360176;926108099;80439055
1905;4.74216e-15;1970;-7;487;10859;1;45;9.01462e+08;-1.01466e+06;1;0;0;0;1;0;901461685;926231549;80481652
1906;4.74216e-15;1971;-7;487;10859;1;45;9.01563e+08;-1.01268e+06;0;0;0;0;0;0;901562997;926354776;80524183
1907;4.74216e-15;1971;-7;487;10859;1;45;9.01664e+08;-1.0107e+06;1;0;0;0;1;0;901664111;926477781;80566647
1908;4.74216e-15;1971;-7;487;10859;1;45;9.01765e+08;-1.00873e+06;1;0;0;0;1;0;901765028;926600563;80609044
1909;4.74216e-15;1971;-7;487;10859;1;45;9.01866e+08;-1.00677e+06;1;0;0;0;1;0;901865749;926723124;80651376
1910;4.74216e-15;1972;-7;487;10859;1;45;9.01966e+08;-1.0048e+06;0;0;0;0;0;0;901966273;926845463;80693641
1911;4.74216e-15;1973;-7;487;10859;1;45;9.02067e+08;-1.00284e+06;0;0;0;0;0;0;902066601;926967582;80735840
1912;4.74216e-15;1974;-7;487;10859;1;45;9.02167e+08;-1.00089e+06;0;0;0;0;0;0;902166734;927089480;80777973
1913;4.74216e-15;1974;-7;487;10859;1;45;9.02267e+08;-998940;1;0;0;0;1;0;902266672;927211158;80820040
1914;4.74216e-15;1975;-7;487;10859;1;45;9.02366e+08;-996994;0;0;0;0;0;0;902366415;927332616;80862041
1915;4.74216e-15;1975;-7;487;10859;1;45;9.02466e+08;-995052;1;0;0;0;1;0;902465964;927453855;80903976
1916;4.74216e-15;1976;-7;487;10859;1;45;9.02565e+08;-993113;0;0;0;0;0;0;902565319;927574876;80945846
1917;4.74216e-15;1977;-7;487;10859;1;45;9.02664e+08;-991179;0;0;0;0;0;0;902664481;927695677;80987650
1918;4.74216e-15;1978;-7;487;10859;1;45;9.02763e+08;-989249;0;0;0;0;0;0;902763450;927816261;81029389
1919;4.74216e-15;1979;-7;487;10859;1;45;9.02862e+08;-987323;0;0;0;0;0;0;902862226;927936627;81071062
1920;4.74216e-15;1979;-7;487;10859;1;45;9.02961e+08;-985401;1;0;0;0;1;0;902960810;928056776;81112669
1921;4.74216e-15;1979;-7;487;10859;1;45;9.03059e+08;-983482;1;0;0;0;1;0;903059202;928176709;81154212
1922;4.74216e-15;1979;-7;487;10859;1;45;9.03157e+08;-981568;1;0;0;0;1;0;903157402;928296424;81195689
1923;4.74216e-15;1979;-7;487;10859;1;45;9.03255e+08;-979658;1;0;0;0;1;0;903255412;928415924;81237101
1924;4.74216e-15;1980;-7;487;10859;1;45;9.03353e+08;-977752;0;0;0;0;0;0;903353231;928535208;81278448
1925;4.74216e-15;1981;-7;487;10859;1;45;9.03451e+08;-975849;0;0;0;0;0;0;903450860;928654277;81319730
1926;4.74216e-15;1982;-7;487;10859;1;45;9.03548e+08;-973951;0;0;0;0;0;0;903548299;928773131;81360947
1927;4.74216e-15;1983;-7;487;10859;1;45;9.03646e+08;-972057;0;0;0;0;0;0;903645548;928891770;81402099
1928;4.74216e-15;1984;-7;487;10859;1;45;9.03743e+08;-970166;0;0;0;0;0;0;903742609;929010196;81443187
1929;4.74216e-15;1985;-7;487;10859;1;45;9.03839e+08;-968280;0;0;0;0;0;0;903839481;929128408;81484209
1930;4.74216e-15;1985;-7;487;10859;1;45;9.03936e+08;-966397;1;0;0;0;1;0;903936164;929246406;81525168
1931;4.74216e-15;1986;-7;487;10859;1;45;9.04033e+08;-964518;0;0;0;0;0;0;904032660;929364192;81566062
1932;4.74216e-15;1986;-7;487;10859;1;45;9.04129e+08;-962643;1;0;0;0;1;0;904128968;929481765;81606891
1933;4.74216e-15;1986;-7;487;10859;1;45;9.04225e+08;-960772;1;0;0;0;1;0;904225089;929599126;81647656
1934;4.74216e-15;1986;-7;487;10859;1;45;9.04321e+08;-958905;1;0;0;0;1;0;904321023;929716276;81688357
1935;4.74216e-15;1987;-7;487;10859;1;45;9.04417e+08;-957042;0;0;0;0;0;0;904416771;929833214;81728994
1936;4.74216e-15;1988;-7;487;10859;1;45;9.04512e+08;-955183;0;0;0;0;0;0;904512333;929949941;81769566
1937;4.74216e-15;1988;-7;487;10859;1;45;9.04608e+08;-953327;1;0;0;0;1;0;904607710;930066458;81810075
1938;4.74216e-15;1988;-7;487;10859;1;45;9.04703e+08;-951475;1;0;0;0;1;0;904702901;930182764;81850519
1939;4.74216e-15;1989;-7;487;10859;1;45;9.04798e+08;-949628;0;0;0;0;0;0;904797908;930298861;81890900
1940;4.74216e-15;1990;-7;487;10859;1;45;9.04893e+08;-947784;0;0;0;0;0;0;904892730;930414749;81931217
1941;4.74216e-15;1991;-7;487;10859;1;45;9.04987e+08;-945943;0;0;0;0;0;0;904987368;930530427;81971471
1942;4.74216e-15;1991;-7;487;10859;1;45;9.05082e+08;-944107;1;0;0;0;1;0;905081823;930645897;82011661
1943;4.74216e-15;1992;-7;487;10859;1;45;9.05176e+08;-942274;0;0;0;0;0;0;905176094;930761159;82051787
1944;4.74216e-15;1992;-7;487;10859;1;45;9.0527e+08;-940445;1;0;0;0;1;0;905270183;930876213;82091850
1945;4.74216e-15;1992;-7;487;10859;1;45;9.05364e+08;-938620;1;0;0;0;1;0;905364088;930991059;82131850
1946;4.74216e-15;1992;-7;487;10859;1;45;9.05458e+08;-936799;1;0;0;0;1;0;905457812;931105698;82171786
1947;4.74216e-15;1993;-7;487;10859;1;45;9.05551e+08;-934982;0;0;0;0;0;0;905551354;931220131;82211659
1948;4.74216e-15;1994;-7;487;10859;1;45;9.05645e+08;-933168;0;0;0;0;0;0;905644715;931334357;82251469
1949;4.74216e-15;1995;-7;487;10859;1;45;9.05738e+08;-931358;0;0;0;0;0;0;905737895;931448378;82291216
1950;4.74216e-15;1995;-7;487;10859;1;45;9.05831e+08;-929551;1;0;0;0;1;0;905830894;931562193;82330900
1951;4.74216e-15;1995;-7;487;10859;1;45;9.05924e+08;-927749;1;0;0;0;1;0;905923712;931675802;82370522
1952;4.74216e-15;1995;-7;487;10859;1;45;9.06016e+08;-925950;1;0;0;0;1;0;906016351;931789207;82410080
1953;4.74216e-15;1995;-7;487;10859;1;45;9.06109e+08;-924155;1;0;0;0;1;0;906108810;931902408;82449576
1954;4.74216e-15;1996;-7;487;10859;1;45;9.06201e+08;-922363;0;0;0;0;0;0;906201091;932015404;82489009
1955;4.74216e-15;1996;-7;487;10859;1;45;9.06293e+08;-920576;1;0;0;0;1;0;906293192;932128197;82528380
1956;4.74216e-15;1997;-7;487;10859;1;45;9.06385e+08;-918792;0;0;0;0;0;0;906385115;932240786;82567688
1957;4.74216e-15;1998;-7;487;10859;1;45;9.06477e+08;-917011;0;0;0;0;0;0;906476860;932353173;82606934
1958;4.74216e-15;1999;-7;487;10859;1;45;9.06568e+08;-915235;0;0;0;0;0;0;906568428;932465357;82646117
1959;4.74216e-15;2000;-7;487;10859;1;45;9.0666e+08;-913461;0;0;0;0;0;0;906659818;932577338;82685239
1960;4.74216e-15;2000;-7;487;10859;1;45;9.06751e+08;-911692;1;0;0;0;1;0;906751031;932689118;82724298
1961;4.74216e-15;2000;-7;487;10859;1;45;9.06842e+08;-909926;1;0;0;0;1;0;906842067;932800697;82763295
1962;4.74216e-15;2000;-7;487;10859;1;45;9.06933e+08;-908164;1;0;0;0;1;0;906932927;932912074;82802230
1963;4.74216e-15;2001;-7;487;10859;1;45;9.07024e+08;-906406;0;0;0;0;0;0;907023612;933023251;82841104
1964;4.74216e-15;2001;-7;487;10859;1;45;9.07114e+08;-904651;1;0;0;0;1;0;907114121;933134227;82879915
1965;4.74216e-15;2001;-7;487;10859;1;45;9.07204e+08;-902899;1;0;0;0;1;0;907204455;933245004;82918665
1966;4.74216e-15;2001;-7;487;10859;1;45;9.07295e+08;-901152;1;0;0;0;1;0;907294614;933355581;82957353
1967;4.74216e-15;2001;-7;487;10859;1;45;9.07385e+08;-899408;1;0;0;0;1;0;907384598;933465958;82995980
1968;4.74216e-15;2002;-7;487;10859;1;45;9.07474e+08;-897667;0;0;0;0;0;0;907474409;933576137;83034545
1969;4.74216e-15;2002;-7;487;10859;1;45;9.07564e+08;-895930;1;0;0;0;1;0;907564046;933686117;83073048
1970;4.74216e-15;2002;-7;487;10859;1;45;9.07654e+08;-894197;1;0;0;0;1;0;907653509;933795899;83111491
1971;4.74216e-15;2002;-7;487;10859;1;45;9.07743e+08;-892467;1;0;0;0;1;0;907742800;933905484;83149872
1972;4.74216e-15;2002;-7;487;10859;1;45;9.07832e+08;-890741;1;0;0;0;1;0;907831918;934014871;83188192
1973;4.74216e-15;2002;-7;487;10859;1;45;9.07921e+08;-889018;1;0;0;0;1;0;907920863;934124060;83226451
1974;4.74216e-15;2002;-7;487;10859;1;45;9.0801e+08;-887299;1;0;0;0;1;0;908009637;934233054;83264649
1975;4.74216e-15;2003;-7;487;10859;1;45;9.08098e+08;-885583;0;0;0;0;0;0;908098239;934341850;83302786
1976;4.74216e-15;2003;-7;487;10859;1;45;9.08187e+08;-883871;1;0;0;0;1;0;908186670;934450451;83340862
1977;4.74216e-15;2004;-7;487;10859;1;45;9.08275e+08;-882162;0;0;0;0;0;0;908274930;934558856;83378878
1978;4.74216e-15;2004;-7;487;10859;1;45;9.08363e+08;-880457;1;0;0;0;1;0;908363020;934667066;83416833
1979;4.74216e-15;2004;-7;487;10859;1;45;9.08451e+08;-878755;1;0;0;0;1;0;908450939;934775081;83454727
1980;4.74216e-15;2005;-7;487;10859;1;45;9.08539e+08;-877057;0;0;0;0;0;0;908538689;934882902;83492561
1981;4.74216e-15;2005;-7;487;10859;1;45;9.08626e+08;-875363;1;0;0;0;1;0;908626269;934990528;83530334
1982;4.74216e-15;2006;-7;487;10859;1;45;9.08714e+08;-873671;0;0;0;0;0;0;908713680;935097960;83568047
1983;4.74216e-15;2006;-7;487;10859;1;45;9.08801e+08;-871984;1;0;0;0;1;0;908800922;935205199;83605699
1984;4.74216e-15;2006;-7;487;10859;1;45;9.08888e+08;-870299;1;0;0;0;1;0;908887996;935312245;83643292
1985;4.74216e-15;2006;-7;487;10859;1;45;9.08975e+08;-868618;1;0;0;0;1;0;908974902;935419098;83680824
1986;4.74216e-15;2007;-7;487;10859;1;45;9.09062e+08;-866941;0;0;0;0;0;0;909061640;935525759;83718297
1987;4.74216e-15;2008;-7;487;10859;1;45;9.09148e+08;-865267;0;0;0;0;0;0;909148211;935632227;83755709
1988;4.74216e-15;2008;-7;487;10859;1;45;9.09235e+08;-863596;1;0;0;0;1;0;909234614;935738504;83793061
1989;4.74216e-15;2008;-7;487;10859;1;45;9.09321e+08;-861929;1;0;0;0;1;0;909320851;935844590;83830354
1990;4.74216e-15;2009;-7;487;10859;1;45;9.09407e+08;-860266;0;0;0;0;0;0;909406922;935950484;83867587
1991;4.74216e-15;2009;-7;487;10859;1;45;9.09493e+08;-858605;1;0;0;0;1;0;909492826;936056188;83904761
1992;4.74216e-15;2009;-7;487;10859;1;45;9.09579e+08;-856948;1;0;0;0;1;0;909578565;936161701;83941874
1993;4.74216e-15;2010;-7;487;10859;1;45;9.09664e+08;-855295;0;0;0;0;0;0;909664138;936267025;83978929
1994;4.74216e-15;2010;-7;487;10859;1;45;9.0975e+08;-853645;1;0;0;0;1;0;909749546;936372159;84015924
1995;4.74216e-15;2011;-7;487;10859;1;45;9.09835e+08;-851998;0;0;0;0;0;0;909834790;936477103;84052859
1996;4.74216e-15;2011;-7;487;10859;1;45;9.0992e+08;-850354;1;0;0;0;1;0;909919870;936581859;84089736
1997;4.74216e-15;2012;-7;487;10859;1;45;9.10005e+08;-848714;0;0;0;0;0;0;910004785;936686426;84126553
1998;4.74216e-15;2012;-7;487;10859;1;45;9.1009e+08;-847078;1;0;0;0;1;0;910089537;936790805;84163311
1999;4.74216e-15;2012;-7;487;10859;1;45;9.10174e+08;-845444;1;0;0;0;1;0;910174125;936894995;84200011
