step;volume;A_0;B_0;C;L;p;Compl;Aext;Bext;A_ingresso;A_uscita;B_ingresso;B_uscita;A_netto;B_netto;Avicino;Amedio;Alontano
0;4.18816e-15;371;361;97;10000;1;3;982;1000;501;145;434;135;356;299;982;2;0
1;4.18816e-15;361;379;100;10003;1;1;944;980;530;146;506;132;384;374;944;2;0
2;4.19005e-15;437;419;97;10003;1;4;913;961;472;213;495;228;259;267;913;6;0
3;4.19005e-15;429;478;94;10003;1;7;883;943;473;207;504;230;266;274;883;8;0
4;4.19005e-15;449;457;91;10003;1;10;856;925;438;204;472;238;234;234;856;9;0
5;4.19005e-15;415;444;89;10003;1;13;832;907;404;214;455;202;190;253;832;8;0
6;4.19005e-15;405;444;85;10004;1;17;808;890;418;231;471;213;187;258;808;8;0
7;4.19068e-15;419;419;87;10004;1;16;785;873;401;206;431;213;195;218;785;8;0
8;4.19068e-15;382;448;82;10005;1;21;765;857;371;228;426;211;143;215;765;7;0
9;4.19131e-15;385;426;80;10005;1;23;744;841;374;197;415;215;177;200;744;7;0
10;4.19131e-15;390;448;77;10005;1;26;723;826;364;184;374;218;180;156;723;7;0
11;4.19131e-15;351;453;75;10005;1;28;704;811;357;194;427;233;163;194;704;6;0
12;4.19131e-15;314;438;78;10006;1;27;685;796;363;196;411;216;167;195;685;6;0
13;4.19195e-15;376;441;81;10007;1;27;664;782;350;145;385;213;205;172;664;6;0
14;4.19258e-15;355;388;78;10007;1;30;649;768;308;195;411;208;113;203;649;6;0
15;4.19258e-15;345;373;83;10008;1;28;632;755;340;173;403;184;167;219;632;6;0
16;4.19321e-15;351;357;80;10008;1;31;616;741;307;174;370;182;133;188;616;6;0
17;4.19321e-15;297;366;81;10008;1;31;602;728;293;177;360;161;116;199;602;6;0
18;4.19321e-15;309;375;78;10009;1;34;586;716;293;140;349;167;153;182;586;6;0
19;4.19384e-15;325;343;80;10012;1;35;570;704;312;143;320;189;169;131;570;6;0
20;4.19574e-15;305;347;78;10012;1;37;556;692;294;155;372;217;139;155;556;6;0
21;4.19574e-15;276;343;78;10013;1;39;542;680;291;141;324;163;150;161;542;6;0
22;4.19637e-15;288;348;82;10013;1;38;529;669;263;127;326;159;136;167;529;6;0
23;4.19637e-15;296;332;86;10014;1;37;514;658;297;126;344;172;171;172;514;6;0
24;4.197e-15;266;317;86;10014;1;38;503;647;258;147;331;172;111;159;503;6;0
25;4.197e-15;239;300;88;10017;1;38;492;636;250;140;295;154;110;141;492;6;0
26;4.1989e-15;239;306;85;10019;1;41;479;626;252;109;330;145;143;185;479;6;0
27;4.20016e-15;247;319;88;10020;1;40;468;616;242;114;311;148;128;163;468;6;0
28;4.20079e-15;242;303;93;10022;1;38;458;606;230;126;297;149;104;148;458;7;0
29;4.20206e-15;240;286;92;10024;1;39;448;596;223;109;268;166;114;102;448;7;0
30;4.20332e-15;237;324;93;10024;1;39;439;587;217;114;272;146;103;126;439;7;0
31;4.20332e-15;199;315;93;10024;1;40;431;578;209;129;280;155;80;125;431;7;0
32;4.20332e-15;213;312;96;10026;1;40;421;569;222;95;271;165;127;106;421;8;0
33;4.20458e-15;206;268;100;10026;1;38;411;560;231;110;252;167;121;85;411;8;0
34;4.20458e-15;224;270;100;10026;1;39;403;552;188;107;248;144;81;104;403;8;0
35;4.20458e-15;211;261;97;10026;1;42;395;544;211;115;251;168;96;83;395;9;0
36;4.20458e-15;194;285;97;10026;1;42;389;536;165;98;277;125;67;152;389;9;0
37;4.20458e-15;210;263;103;10027;1;39;381;528;193;85;275;154;108;121;381;10;0
38;4.20522e-15;198;291;101;10028;1;41;373;520;194;98;249;127;96;122;373;10;0
39;4.20585e-15;192;247;104;10028;1;40;367;513;168;100;261;155;68;106;367;11;0
40;4.20585e-15;203;257;102;10030;1;42;360;506;186;88;259;124;98;135;360;11;0
41;4.20711e-15;194;254;103;10030;1;42;353;499;183;105;263;129;78;134;353;12;0
42;4.20711e-15;190;254;103;10031;1;42;347;492;166;86;254;146;80;108;347;12;0
43;4.20775e-15;198;247;103;10031;1;42;341;485;184;99;257;120;85;137;341;12;0
44;4.20775e-15;178;237;101;10033;1;44;335;478;182;93;262;124;89;138;335;13;0
45;4.20901e-15;159;254;100;10036;1;45;327;472;191;86;239;128;105;111;327;14;0
46;4.21091e-15;169;232;101;10036;1;45;321;466;171;71;234;118;100;116;321;14;0
47;4.21091e-15;157;234;105;10036;1;43;314;460;187;83;254;107;104;147;314;15;0
48;4.21091e-15;158;217;106;10036;1;44;309;454;161;83;257;108;78;149;309;15;0
49;4.21091e-15;151;221;111;10037;1;42;304;448;160;92;231;115;68;116;304;16;0
50;4.21154e-15;163;236;113;10037;1;42;301;442;133;90;219;99;43;120;301;17;0
51;4.21154e-15;144;213;113;10038;1;43;296;437;161;86;200;113;75;87;296;17;0
52;4.21217e-15;142;209;118;10039;1;41;291;432;152;75;211;99;77;112;291;18;0
53;4.21281e-15;145;220;119;10040;1;41;286;426;152;68;227;108;84;119;286;19;0
54;4.21344e-15;149;193;118;10040;1;42;282;421;134;67;197;126;67;71;282;19;0
55;4.21344e-15;156;179;120;10041;1;41;278;416;133;78;200;86;55;114;278;20;0
56;4.21407e-15;139;202;122;10042;1;40;274;412;145;75;235;89;70;146;274;20;0
57;4.21471e-15;129;224;123;10044;1;40;270;407;128;74;180;103;54;77;270;21;0
58;4.21597e-15;132;215;124;10044;1;40;265;402;145;52;202;115;93;87;265;21;0
59;4.21597e-15;125;193;123;10044;1;42;260;398;153;70;228;85;83;143;260;21;0
60;4.21597e-15;141;174;125;10045;1;41;256;393;144;61;169;104;83;65;256;21;0
61;4.2166e-15;135;180;127;10047;1;40;252;389;132;67;220;96;65;124;252;22;0
62;4.21787e-15;129;178;130;10047;1;39;249;385;126;58;191;87;68;104;249;22;0
63;4.21787e-15;140;182;130;10049;1;40;245;381;127;57;194;96;70;98;245;23;0
64;4.21914e-15;115;220;128;10050;1;42;243;377;110;75;187;81;35;106;243;24;0
65;4.21977e-15;106;196;131;10052;1;41;239;373;137;59;161;103;78;58;239;24;0
66;4.22103e-15;109;196;133;10052;1;40;235;370;134;53;198;84;81;114;235;25;0
67;4.22103e-15;120;167;133;10054;1;40;232;366;125;62;212;104;63;108;232;25;0
68;4.2223e-15;117;197;130;10055;1;43;229;362;134;70;183;88;64;95;229;26;0
69;4.22293e-15;106;189;133;10055;1;42;225;359;136;67;181;80;69;101;225;26;0
70;4.22293e-15;107;178;137;10055;1;40;222;356;117;51;182;107;66;75;222;26;0
71;4.22293e-15;112;194;136;10055;1;41;220;352;113;68;155;83;45;72;220;27;0
72;4.22293e-15;99;175;140;10055;1;39;217;349;113;48;173;91;65;82;217;28;0
73;4.22293e-15;120;154;140;10055;1;39;215;346;108;45;176;93;63;83;215;28;0
74;4.22293e-15;117;196;142;10055;1;38;214;343;87;60;164;72;27;92;214;29;0
75;4.22293e-15;115;194;143;10056;1;38;212;340;105;61;153;91;44;62;212;30;0
76;4.22357e-15;113;191;142;10059;1;39;207;337;136;37;178;86;99;92;207;30;0
77;4.22547e-15;115;192;143;10060;1;39;205;335;109;54;177;98;55;79;205;31;0
78;4.2261e-15;104;160;147;10060;1;37;203;332;101;53;166;92;48;74;203;31;0
79;4.2261e-15;82;168;147;10061;1;37;201;329;100;55;145;72;45;73;201;32;0
80;4.22673e-15;101;185;152;10062;1;35;199;327;102;47;179;92;55;87;199;33;0
81;4.22737e-15;109;164;150;10062;1;37;198;324;97;59;146;86;38;60;198;33;0
82;4.22737e-15;127;176;150;10065;1;37;195;322;108;43;172;84;65;88;195;33;0
83;4.22927e-15;121;181;149;10066;1;38;194;319;84;53;155;84;31;71;194;34;0
84;4.2299e-15;103;182;150;10066;1;39;193;317;101;54;152;77;47;75;193;34;0
85;4.2299e-15;101;151;149;10066;1;40;192;315;82;46;177;80;36;97;192;35;0
86;4.2299e-15;101;151;151;10066;1;39;189;313;104;50;171;89;54;82;189;36;0
87;4.2299e-15;96;171;153;10066;1;38;187;311;106;49;169;82;57;87;187;36;0
88;4.2299e-15;98;171;153;10068;1;38;186;308;86;40;169;62;46;107;186;37;0
89;4.23117e-15;91;168;156;10068;1;37;184;306;97;49;168;73;48;95;184;38;0
90;4.23117e-15;86;145;159;10069;1;36;183;305;88;43;153;75;45;78;183;38;0
91;4.2318e-15;87;140;160;10069;1;36;182;303;79;48;166;69;31;97;182;40;0
92;4.2318e-15;90;154;160;10070;1;36;181;301;81;41;168;75;40;93;181;40;0
93;4.23244e-15;91;137;160;10072;1;36;180;299;78;41;157;78;37;79;180;40;0
94;4.2337e-15;91;142;166;10075;1;33;179;297;84;48;152;57;36;95;179;40;0
95;4.2356e-15;93;154;167;10076;1;33;177;296;83;41;141;78;42;63;177;41;0
96;4.23624e-15;85;154;167;10077;1;33;175;294;91;38;143;62;53;81;175;41;0
97;4.23687e-15;81;164;169;10078;1;32;175;292;87;57;146;86;30;60;175;42;0
98;4.23751e-15;67;164;170;10078;1;32;173;291;93;47;146;69;46;77;173;43;0
99;4.23751e-15;90;170;170;10078;1;32;172;289;77;32;133;68;45;65;172;44;0
100;4.23751e-15;71;173;170;10078;1;33;171;288;89;48;139;91;41;48;171;44;0
101;4.23751e-15;74;149;171;10080;1;34;169;286;97;35;144;83;62;61;169;44;0
102;4.23877e-15;91;126;170;10081;1;35;167;285;91;38;131;77;53;54;167;45;0
103;4.23941e-15;87;137;169;10082;1;36;165;284;95;41;151;68;54;83;165;46;0
104;4.24004e-15;81;141;169;10084;1;36;164;282;85;40;130;71;45;59;164;46;0
105;4.24131e-15;74;142;168;10084;1;37;163;281;80;45;143;64;35;79;163;47;0
106;4.24131e-15;70;151;168;10085;1;38;162;280;81;40;134;72;41;62;162;47;0
107;4.24194e-15;80;134;168;10086;1;38;160;279;95;24;125;81;71;44;160;48;0
108;4.24258e-15;88;155;168;10087;1;39;159;278;75;38;141;59;37;82;159;49;0
109;4.24321e-15;78;137;167;10089;1;40;158;277;82;46;139;84;36;55;158;49;0
110;4.24448e-15;81;135;166;10089;1;41;157;275;77;37;129;67;40;62;157;49;0
111;4.24448e-15;58;151;169;10089;1;40;157;274;69;38;154;66;31;88;157;50;0
112;4.24448e-15;83;135;168;10090;1;41;155;273;87;23;127;76;64;51;155;51;0
113;4.24511e-15;78;125;167;10090;1;42;154;272;85;48;168;67;37;101;154;52;0
114;4.24511e-15;55;121;165;10091;1;44;153;272;84;43;135;68;41;67;153;52;0
115;4.24575e-15;53;132;164;10091;1;45;152;271;82;36;129;60;46;69;152;52;0
116;4.24575e-15;69;141;166;10092;1;44;151;270;72;29;146;66;43;80;151;53;0
117;4.24638e-15;68;129;165;10094;1;45;150;269;83;32;132;59;51;73;150;53;0
118;4.24765e-15;69;125;165;10095;1;45;149;268;67;26;142;68;41;74;149;54;0
119;4.24829e-15;78;140;165;10096;1;45;148;267;71;25;145;60;46;85;148;55;0
120;4.24892e-15;80;125;163;10097;1;47;148;266;66;42;142;65;24;77;148;56;0
121;4.24956e-15;85;137;163;10098;1;47;147;266;94;43;125;54;51;71;147;56;0
122;4.25019e-15;82;127;165;10098;1;46;146;265;84;46;164;69;38;95;146;57;0
123;4.25019e-15;58;136;164;10099;1;47;145;264;86;38;131;70;48;61;145;57;0
124;4.25082e-15;64;141;163;10099;1;49;144;264;80;25;132;80;55;52;144;57;0
125;4.25082e-15;70;138;163;10099;1;49;143;263;68;35;136;75;33;61;143;58;0
126;4.25082e-15;61;132;165;10101;1;48;144;262;57;40;125;70;17;55;144;58;0
127;4.25209e-15;82;144;169;10103;1;47;143;262;63;26;137;61;37;76;143;58;0
128;4.25336e-15;67;148;169;10103;1;47;143;261;81;42;147;88;39;59;143;59;0
129;4.25336e-15;68;135;169;10105;1;47;141;261;73;26;138;71;47;67;141;60;0
130;4.25463e-15;81;128;171;10108;1;46;140;260;73;25;125;60;48;65;140;60;0
131;4.25654e-15;72;121;171;10109;1;46;140;260;64;32;115;62;32;53;140;60;0
132;4.25717e-15;70;135;173;10110;1;46;139;259;80;35;124;66;45;58;139;60;0
133;4.25781e-15;84;141;174;10110;1;46;138;259;71;27;139;70;44;69;138;60;0
134;4.25781e-15;77;148;174;10111;1;46;139;258;66;43;132;56;23;76;139;61;0
135;4.25844e-15;61;132;176;10114;1;45;139;258;68;43;135;77;25;58;139;61;0
136;4.26035e-15;66;130;184;10114;1;41;138;257;71;37;124;67;34;57;138;62;0
137;4.26035e-15;58;122;185;10117;1;41;138;257;77;37;115;61;40;54;138;63;0
138;4.26225e-15;57;135;186;10118;1;41;137;257;68;35;107;63;33;44;137;63;0
139;4.26289e-15;73;132;188;10119;1;40;136;256;83;26;108;75;57;33;136;63;0
140;4.26352e-15;59;118;191;10121;1;39;136;256;67;34;117;66;33;51;136;63;0
141;4.26479e-15;57;104;193;10121;1;38;135;255;79;37;120;61;42;59;135;63;0
142;4.26479e-15;71;133;192;10124;1;40;134;255;70;28;119;52;42;67;134;64;0
143;4.2667e-15;79;125;192;10125;1;40;134;255;64;33;136;70;31;66;134;64;0
144;4.26733e-15;81;128;192;10126;1;41;134;255;60;36;118;55;24;63;134;64;0
145;4.26797e-15;73;133;192;10127;1;41;134;254;75;38;133;75;37;58;134;65;0
146;4.26861e-15;76;133;192;10130;1;41;134;254;66;35;113;60;31;53;134;65;0
147;4.27051e-15;64;106;192;10133;1;41;133;254;73;37;108;69;36;39;133;66;0
148;4.27242e-15;62;116;193;10134;1;41;133;254;73;36;137;71;37;66;133;66;0
149;4.27305e-15;71;112;192;10134;1;42;132;253;63;31;127;65;32;62;132;66;0
150;4.27305e-15;82;110;191;10134;1;43;132;253;74;28;122;53;46;69;132;68;0
151;4.27305e-15;71;120;191;10136;1;43;132;253;65;37;136;54;28;82;132;68;0
152;4.27433e-15;79;131;190;10136;1;44;130;253;80;20;132;51;60;81;130;68;0
153;4.27433e-15;75;123;190;10136;1;44;129;253;82;42;127;58;40;69;129;69;0
154;4.27433e-15;77;115;190;10139;1;44;129;253;72;34;106;58;38;48;129;69;0
155;4.27623e-15;66;109;189;10140;1;45;129;252;68;45;113;53;23;60;129;70;0
156;4.27687e-15;64;107;189;10141;1;45;130;252;57;35;119;61;22;58;130;70;0
157;4.27751e-15;68;129;192;10143;1;44;129;252;59;27;121;50;32;71;129;71;0
158;4.27878e-15;57;130;193;10143;1;45;129;252;69;35;113;60;34;53;129;72;0
159;4.27878e-15;62;134;192;10143;1;47;129;252;54;18;122;70;36;52;129;72;0
160;4.27878e-15;64;123;195;10143;1;46;128;252;69;30;128;74;39;54;128;73;0
161;4.27878e-15;60;117;195;10144;1;46;129;252;48;32;111;73;16;38;129;73;0
162;4.27941e-15;57;130;199;10145;1;44;129;252;53;39;125;60;14;65;129;74;0
163;4.28005e-15;51;145;198;10147;1;45;129;252;74;38;119;54;36;65;129;73;0
164;4.28132e-15;56;129;197;10147;1;46;129;252;46;26;136;61;20;75;129;73;0
165;4.28132e-15;66;135;198;10147;1;46;128;252;78;34;132;67;44;65;128;74;0
166;4.28132e-15;68;146;198;10147;1;46;129;252;65;40;144;61;25;83;129;74;0
167;4.28132e-15;63;117;198;10148;1;46;128;252;56;23;131;69;33;62;128;74;0
168;4.28196e-15;73;113;197;10149;1;47;128;252;55;27;113;54;28;59;128;75;0
169;4.28259e-15;51;128;197;10150;1;48;128;252;70;28;111;43;42;68;128;76;0
170;4.28323e-15;65;127;197;10151;1;48;127;252;70;26;131;60;44;71;127;76;0
171;4.28387e-15;61;146;199;10151;1;47;127;252;64;33;118;53;31;65;127;76;0
172;4.28387e-15;57;140;199;10152;1;47;126;252;64;30;127;64;34;63;126;77;0
173;4.2845e-15;50;117;198;10152;1;48;127;252;49;36;114;63;13;51;127;76;0
174;4.2845e-15;72;118;200;10153;1;47;126;252;62;17;135;59;45;76;126;76;0
175;4.28514e-15;70;126;200;10154;1;47;126;252;66;38;117;53;28;64;126;76;0
176;4.28577e-15;70;112;199;10156;1;48;126;252;67;42;121;59;25;62;126;77;0
177;4.28705e-15;57;119;199;10158;1;48;125;252;80;33;107;62;47;45;125;77;0
178;4.28832e-15;63;114;201;10160;1;47;125;252;57;30;130;61;27;69;125;77;0
179;4.28959e-15;59;130;199;10164;1;49;126;252;45;41;120;64;4;56;126;78;0
180;4.29214e-15;59;119;199;10165;1;49;126;252;69;25;111;66;44;45;126;79;0
181;4.29278e-15;58;126;198;10166;1;50;126;252;56;32;109;56;24;53;126;79;0
182;4.29341e-15;66;135;200;10167;1;49;126;252;60;34;128;66;26;62;126;80;0
183;4.29405e-15;68;116;200;10167;1;49;126;252;45;32;125;65;13;60;126;81;0
184;4.29405e-15;85;128;199;10167;1;50;127;252;57;33;124;55;24;69;127;79;0
185;4.29405e-15;71;138;200;10167;1;50;126;253;74;35;111;66;39;45;126;79;0
186;4.29405e-15;55;132;199;10169;1;51;125;253;68;34;120;67;34;53;125;79;0
187;4.29532e-15;74;126;201;10169;1;50;125;253;66;25;116;72;41;44;125;80;0
188;4.29532e-15;59;137;200;10172;1;51;125;253;51;31;108;66;20;42;125;79;0
189;4.29723e-15;58;146;200;10173;1;51;124;253;63;18;132;63;45;69;124;79;0
190;4.29787e-15;69;138;199;10173;1;52;124;253;56;29;129;74;27;55;124;79;0
191;4.29787e-15;57;124;198;10173;1;53;124;253;58;34;126;68;24;58;124;80;0
192;4.29787e-15;61;144;199;10173;1;53;124;254;57;34;111;64;23;47;124;80;0
193;4.29787e-15;59;131;197;10174;1;55;124;254;58;24;137;70;34;67;124;80;0
194;4.29851e-15;76;109;198;10178;1;55;124;254;55;26;126;67;29;59;124;80;0
195;4.30106e-15;59;113;200;10180;1;54;125;254;55;44;123;56;11;67;125;81;0
196;4.30233e-15;52;117;202;10182;1;54;124;254;67;29;136;68;38;68;124;81;0
197;4.3036e-15;68;134;210;10184;1;50;123;254;85;29;130;70;56;60;123;81;0
198;4.30488e-15;77;140;210;10186;1;50;123;254;47;31;133;61;16;72;123;82;0
199;4.30615e-15;62;129;211;10187;1;50;123;255;66;39;135;67;27;68;123;82;0
200;4.30679e-15;55;129;211;10189;1;51;124;255;54;39;149;58;15;91;124;82;0
201;4.30807e-15;59;133;213;10189;1;50;122;255;73;21;144;58;52;86;122;83;0
202;4.30807e-15;58;138;213;10189;1;50;123;255;48;28;134;62;20;72;123;83;0
203;4.30807e-15;59;134;216;10191;1;49;123;255;71;38;116;64;33;52;123;83;0
204;4.30934e-15;58;115;216;10191;1;50;122;256;62;30;140;56;32;84;122;84;0
205;4.30934e-15;58;126;215;10193;1;51;122;256;58;26;101;57;32;44;122;83;0
206;4.31062e-15;60;113;215;10194;1;51;122;256;60;25;130;59;35;71;122;85;0
207;4.31125e-15;68;114;214;10196;1;52;122;256;47;37;143;71;10;72;122;83;0
208;4.31253e-15;64;114;217;10198;1;51;122;256;55;26;151;64;29;87;122;82;0
209;4.3138e-15;61;104;219;10198;1;50;122;257;63;34;144;68;29;76;122;82;0
210;4.3138e-15;58;119;223;10201;1;48;122;257;64;34;150;59;30;91;122;82;0
211;4.31572e-15;57;127;225;10201;1;47;122;257;59;34;132;58;25;74;122;82;0
212;4.31572e-15;49;122;224;10203;1;48;122;257;59;28;114;68;31;46;122;83;0
213;4.31699e-15;63;121;224;10204;1;48;121;258;75;29;104;67;46;37;121;83;0
214;4.31763e-15;56;126;226;10204;1;47;121;258;62;32;134;67;30;67;121;83;0
215;4.31763e-15;61;119;225;10205;1;48;121;258;60;37;133;55;23;78;121;84;0
216;4.31827e-15;47;131;226;10205;1;48;120;258;65;28;132;60;37;72;120;83;0
217;4.31827e-15;64;134;227;10206;1;48;120;258;53;24;132;63;29;69;120;84;0
218;4.31891e-15;58;133;231;10207;1;46;120;259;62;31;137;71;31;66;120;84;0
219;4.31954e-15;55;140;230;10212;1;47;120;259;58;29;132;57;29;75;120;84;0
220;4.32273e-15;59;118;229;10213;1;48;121;259;50;32;121;76;18;45;121;84;0
221;4.32337e-15;46;111;233;10219;1;46;121;259;60;36;125;60;24;65;121;85;0
222;4.3272e-15;55;126;233;10220;1;46;120;260;66;26;105;54;40;51;120;86;0
223;4.32784e-15;58;152;233;10220;1;46;120;260;46;27;131;62;19;69;120;87;0
224;4.32784e-15;67;150;234;10223;1;46;121;260;45;25;112;78;20;34;121;88;0
225;4.32976e-15;63;148;233;10225;1;47;121;260;61;31;136;71;30;65;121;88;0
226;4.33103e-15;67;138;234;10226;1;47;121;261;48;39;144;72;9;72;121;90;0
227;4.33167e-15;66;128;234;10229;1;48;121;261;62;36;137;67;26;70;121;89;0
228;4.33359e-15;56;122;234;10230;1;50;121;261;56;28;155;61;28;94;121;90;0
229;4.33423e-15;51;136;234;10231;1;50;121;261;52;26;117;54;26;63;121;89;0
230;4.33487e-15;65;132;234;10233;1;50;121;262;60;26;139;78;34;61;121;91;0
231;4.33614e-15;63;144;234;10234;1;50;121;262;64;34;124;65;30;59;121;90;0
232;4.33678e-15;66;138;231;10237;1;53;121;262;56;33;144;74;23;70;121;90;0
233;4.3387e-15;57;135;231;10237;1;53;121;263;53;32;135;67;21;68;121;89;0
234;4.3387e-15;69;134;229;10237;1;55;121;263;54;36;129;68;18;61;121;89;0
235;4.3387e-15;58;108;231;10239;1;54;121;263;65;34;113;65;31;48;121;89;0
236;4.33998e-15;60;121;232;10241;1;54;120;263;77;33;146;62;44;84;120;89;0
237;4.34125e-15;70;135;231;10241;1;55;120;264;57;32;143;56;25;87;120;89;0
238;4.34125e-15;51;133;235;10244;1;53;120;264;54;33;143;52;21;91;120;91;0
239;4.34317e-15;57;134;237;10245;1;52;121;264;48;33;129;78;15;51;121;89;0
240;4.34381e-15;58;124;237;10246;1;52;121;264;53;28;119;57;25;62;121;89;0
241;4.34445e-15;51;148;237;10246;1;53;121;265;62;34;139;58;28;81;121;90;0
242;4.34445e-15;66;138;238;10250;1;53;120;265;70;27;134;73;43;61;120;91;0
243;4.34701e-15;49;137;240;10250;1;52;120;265;54;29;144;67;25;77;120;91;0
244;4.34701e-15;44;109;242;10251;1;51;120;266;52;26;146;66;26;80;120;92;0
245;4.34765e-15;55;110;244;10252;1;50;119;266;56;14;146;66;42;80;119;92;0
246;4.34829e-15;57;120;244;10256;1;50;119;266;56;29;143;53;27;90;119;94;0
247;4.35084e-15;68;128;245;10258;1;50;119;266;63;31;136;62;32;74;119;93;0
248;4.35212e-15;65;134;243;10258;1;53;119;267;63;32;157;65;31;92;119;92;0
249;4.35212e-15;64;118;243;10258;1;53;118;267;57;25;149;60;32;89;118;93;0
250;4.35212e-15;50;143;241;10261;1;55;118;267;67;29;124;54;38;70;118;93;0
251;4.35404e-15;53;130;245;10262;1;54;117;268;74;24;136;74;50;62;117;93;0
252;4.35468e-15;64;104;245;10263;1;54;116;268;67;30;133;78;37;55;116;93;0
253;4.35532e-15;55;115;243;10267;1;56;116;268;65;31;151;67;34;84;116;94;0
254;4.35788e-15;59;125;242;10269;1;57;115;268;65;24;137;54;41;83;115;92;0
255;4.35916e-15;50;120;241;10270;1;58;115;269;64;27;122;70;37;52;115;92;0
256;4.3598e-15;51;129;242;10271;1;58;115;269;52;26;155;59;26;96;115;91;0
257;4.36044e-15;56;130;243;10276;1;58;115;269;50;29;136;69;21;67;115;92;0
258;4.36364e-15;58;147;243;10276;1;58;116;270;59;39;136;75;20;61;116;93;0
259;4.36364e-15;58;151;247;10278;1;56;116;270;59;26;138;72;33;66;116;92;0
260;4.36492e-15;49;141;249;10280;1;55;116;270;48;37;125;95;11;30;116;94;0
261;4.3662e-15;64;140;250;10282;1;55;116;271;60;24;158;75;36;83;116;93;0
262;4.36748e-15;54;121;250;10282;1;55;116;271;61;27;152;74;34;78;116;94;0
263;4.36748e-15;55;131;249;10284;1;56;116;271;59;31;114;60;28;54;116;94;0
264;4.36876e-15;55;128;251;10287;1;55;116;271;53;25;150;77;28;73;116;94;0
265;4.37069e-15;50;132;249;10289;1;57;116;272;56;28;134;58;28;76;116;94;0
266;4.37197e-15;54;140;246;10289;1;60;116;272;58;28;148;76;30;72;116;95;0
267;4.37197e-15;58;129;246;10290;1;60;115;272;58;24;122;69;34;53;115;96;0
268;4.37261e-15;56;134;247;10293;1;60;115;273;45;19;129;66;26;63;115;95;0
269;4.37453e-15;58;127;246;10295;1;61;115;273;67;35;139;77;32;62;115;95;0
270;4.37581e-15;58;138;244;10296;1;63;115;273;67;32;128;66;35;62;115;95;0
271;4.37645e-15;56;127;244;10297;1;63;115;274;44;25;136;52;19;84;115;94;1
272;4.37709e-15;57;131;244;10298;1;63;116;274;47;26;137;62;21;75;116;95;1
273;4.37773e-15;58;136;246;10299;1;63;116;274;56;30;129;81;26;48;116;94;1
274;4.37837e-15;54;142;244;10301;1;65;115;274;66;28;140;74;38;66;115;94;1
275;4.37966e-15;40;154;247;10301;1;64;116;275;45;31;137;74;14;63;116;95;1
276;4.37966e-15;58;142;251;10302;1;62;115;275;63;19;136;78;44;58;115;95;1
277;4.3803e-15;74;125;253;10304;1;61;115;275;60;32;125;71;28;54;115;95;1
278;4.38158e-15;62;146;254;10306;1;61;115;276;62;35;152;70;27;82;115;96;1
279;4.38286e-15;58;143;256;10309;1;60;115;276;55;34;130;67;21;63;115;96;1
280;4.38478e-15;61;143;255;10310;1;61;116;276;51;25;128;81;26;47;116;96;1
281;4.38543e-15;54;162;254;10313;1;62;116;277;46;26;105;54;20;51;116;96;1
282;4.38735e-15;65;145;252;10313;1;64;115;277;55;20;126;85;35;41;115;95;1
283;4.38735e-15;54;130;250;10313;1;66;116;277;44;32;145;71;12;74;116;96;1
284;4.38735e-15;58;131;250;10314;1;66;117;277;42;38;153;70;4;83;117;96;1
285;4.38799e-15;55;139;252;10316;1;65;118;278;40;26;144;72;14;72;118;97;1
286;4.38927e-15;59;142;254;10317;1;64;118;278;56;26;142;63;30;79;118;97;1
287;4.38992e-15;56;137;254;10319;1;64;118;278;48;30;147;71;18;76;118;98;1
288;4.3912e-15;53;134;252;10321;1;66;118;279;56;37;119;62;19;57;118;98;1
289;4.39248e-15;57;125;253;10323;1;66;118;279;53;19;164;74;34;90;118;98;1
290;4.39376e-15;60;144;257;10323;1;64;117;279;66;28;121;52;38;69;117;98;1
291;4.39376e-15;55;129;256;10324;1;66;118;280;44;35;137;73;9;64;118;98;1
292;4.39441e-15;69;115;259;10327;1;65;118;280;64;31;144;65;33;79;118;98;1
293;4.39633e-15;70;120;261;10329;1;64;118;280;56;36;142;68;20;74;118;98;1
294;4.39761e-15;65;141;261;10330;1;64;118;281;66;42;157;63;24;94;118;98;1
295;4.39826e-15;61;159;262;10330;1;64;118;281;55;33;143;63;22;80;118;98;1
296;4.39826e-15;69;169;260;10330;1;66;117;281;68;29;127;70;39;57;117;98;1
297;4.39826e-15;57;143;265;10332;1;64;117;281;71;41;137;82;30;55;117;98;1
298;4.39954e-15;64;154;264;10333;1;66;118;282;47;34;119;81;13;38;118;98;1
299;4.40018e-15;65;141;264;10335;1;67;117;282;59;26;154;83;33;71;117;98;1
300;4.40147e-15;48;140;262;10336;1;69;117;282;59;34;136;69;25;67;117;98;1
301;4.40211e-15;51;133;268;10337;1;67;117;283;54;20;133;58;34;75;117;98;1
302;4.40275e-15;53;143;268;10337;1;68;116;283;62;24;151;64;38;87;116;98;1
303;4.40275e-15;43;137;264;10341;1;72;117;283;44;29;147;80;15;67;117;98;1
304;4.40532e-15;72;151;268;10343;1;71;117;284;52;31;128;55;21;73;117;98;1
305;4.4066e-15;56;167;272;10345;1;69;116;284;74;35;157;67;39;90;116;98;1
306;4.40789e-15;54;139;274;10347;1;68;116;284;66;31;134;83;35;51;116;98;1
307;4.40917e-15;37;148;275;10347;1;68;115;285;55;27;135;71;28;64;115;98;1
308;4.40917e-15;37;137;276;10348;1;68;115;285;48;22;113;74;26;39;115;97;1
309;4.40982e-15;51;125;277;10350;1;68;115;285;59;20;150;68;39;82;115;97;1
310;4.4111e-15;54;129;277;10353;1;68;115;285;48;28;142;68;20;74;115;97;1
311;4.41303e-15;52;153;277;10354;1;68;115;286;61;34;157;61;27;96;115;97;1
312;4.41367e-15;54;134;281;10355;1;66;114;286;71;33;145;75;38;70;114;97;1
313;4.41431e-15;68;130;283;10361;1;65;113;286;70;32;150;72;38;78;113;97;1
314;4.41817e-15;50;157;285;10363;1;64;113;287;55;25;129;60;30;69;113;96;1
315;4.41946e-15;54;141;284;10364;1;65;113;287;47;26;138;72;21;66;113;96;1
316;4.4201e-15;60;145;283;10366;1;66;113;287;53;29;150;76;24;74;113;95;1
317;4.42138e-15;61;132;282;10368;1;67;114;288;45;23;152;74;22;78;114;95;1
318;4.42267e-15;56;127;281;10369;1;68;114;288;48;30;140;73;18;67;114;96;1
319;4.42331e-15;57;122;281;10371;1;68;114;288;52;30;138;63;22;75;114;96;1
320;4.4246e-15;39;163;281;10373;1;69;114;288;47;31;154;60;16;94;114;96;1
321;4.42589e-15;50;156;283;10373;1;69;114;289;52;21;141;81;31;60;114;97;1
322;4.42589e-15;51;135;283;10375;1;69;113;289;63;26;145;81;37;64;113;97;1
323;4.42717e-15;59;123;283;10377;1;69;112;289;72;26;130;81;46;49;112;97;1
324;4.42846e-15;53;155;282;10381;1;70;112;290;58;26;142;65;32;77;112;97;1
325;4.43103e-15;52;141;282;10384;1;70;111;290;65;27;131;76;38;55;111;97;1
326;4.43296e-15;57;132;288;10385;1;67;111;290;54;26;134;78;28;56;111;97;1
327;4.43361e-15;50;161;288;10385;1;67;112;291;40;41;142;77;-1;65;112;96;1
328;4.43361e-15;52;164;287;10385;1;68;111;291;68;31;168;76;37;92;111;97;1
329;4.43361e-15;52;175;291;10386;1;66;112;291;38;33;147;73;5;74;112;96;1
330;4.43425e-15;43;151;298;10388;1;63;112;291;56;26;134;89;30;45;112;96;1
331;4.43554e-15;49;133;301;10388;1;62;112;292;48;21;155;74;27;81;112;97;1
332;4.43554e-15;53;132;298;10388;1;65;112;292;56;36;131;66;20;65;112;97;1
333;4.43554e-15;58;135;297;10388;1;66;111;292;62;19;138;57;43;81;111;97;1
334;4.43554e-15;64;143;306;10389;1;63;110;293;62;23;169;61;39;108;110;97;2
335;4.43618e-15;65;171;306;10390;1;64;110;293;55;31;139;66;24;73;110;97;2
336;4.43683e-15;58;125;307;10390;1;64;110;293;66;33;151;83;33;68;110;96;2
337;4.43683e-15;62;144;307;10392;1;65;109;294;62;30;141;63;32;78;109;96;2
338;4.43811e-15;59;131;309;10393;1;64;109;294;51;23;155;72;28;83;109;96;2
339;4.43876e-15;47;137;310;10395;1;64;109;294;48;31;140;69;17;71;109;97;2
340;4.44004e-15;51;144;310;10399;1;64;109;294;47;23;148;77;24;71;109;97;2
341;4.44262e-15;44;121;312;10402;1;64;109;295;45;25;154;89;20;65;109;97;2
342;4.44455e-15;53;132;311;10404;1;65;109;295;57;26;117;76;31;41;109;96;2
343;4.44584e-15;53;126;310;10405;1;66;108;295;60;22;142;72;38;70;108;95;2
344;4.44649e-15;52;131;312;10409;1;65;108;296;58;22;163;60;36;103;108;95;2
345;4.44906e-15;51;159;316;10409;1;63;108;296;53;37;156;66;16;90;108;95;2
346;4.44906e-15;40;149;318;10411;1;62;108;296;46;29;141;92;17;49;108;95;2
347;4.45035e-15;46;143;320;10412;1;62;108;297;57;22;165;67;35;98;108;95;2
348;4.451e-15;53;152;323;10414;1;61;108;297;39;28;135;67;11;68;108;95;2
349;4.45228e-15;45;155;321;10416;1;63;109;297;47;32;147;73;15;74;109;95;2
350;4.45357e-15;54;156;323;10419;1;62;108;297;52;19;124;74;33;50;108;95;2
351;4.45551e-15;46;147;325;10420;1;61;108;298;53;30;146;86;23;60;108;95;2
352;4.45615e-15;51;138;324;10421;1;62;107;298;63;17;146;79;46;67;107;96;2
353;4.4568e-15;55;141;326;10424;1;61;107;298;50;27;147;55;23;92;107;95;2
354;4.45873e-15;61;146;326;10425;1;61;106;299;66;26;154;75;40;79;106;95;2
355;4.45938e-15;46;148;329;10425;1;60;106;299;56;29;158;84;27;74;106;95;2
356;4.45938e-15;52;140;329;10425;1;60;105;299;55;23;162;79;32;83;105;94;2
357;4.45938e-15;39;135;328;10428;1;61;105;299;66;31;153;78;35;75;105;95;2
358;4.46131e-15;56;158;329;10430;1;61;105;300;43;26;147;67;17;80;105;95;2
359;4.4626e-15;51;154;326;10432;1;64;106;300;39;32;128;80;7;48;106;94;2
360;4.46389e-15;50;140;327;10432;1;64;105;300;67;25;149;86;42;63;105;93;2
361;4.46389e-15;46;154;329;10435;1;63;104;301;54;19;144;81;35;63;104;93;2
362;4.46583e-15;44;166;331;10436;1;62;104;301;46;23;136;73;23;63;104;93;2
363;4.46647e-15;51;153;334;10440;1;61;103;301;74;31;186;75;43;111;103;93;2
364;4.46905e-15;58;168;334;10442;1;61;103;301;51;23;140;79;28;61;103;93;2
365;4.47034e-15;46;153;334;10446;1;61;103;302;50;26;144;80;24;64;103;92;2
366;4.47292e-15;48;140;336;10448;1;61;103;302;57;29;185;62;28;123;103;93;2
367;4.47422e-15;43;131;336;10449;1;61;102;302;51;21;173;78;30;95;102;93;2
368;4.47486e-15;61;151;335;10451;1;62;102;303;51;19;151;66;32;85;102;93;2
369;4.47615e-15;51;132;338;10452;1;61;102;303;57;35;168;69;22;99;102;93;2
370;4.4768e-15;63;144;337;10455;1;62;102;303;52;32;154;69;20;85;102;94;2
371;4.47874e-15;56;128;336;10455;1;63;102;303;53;32;159;68;21;91;102;94;2
372;4.47874e-15;51;148;336;10457;1;63;102;304;62;27;131;73;35;58;102;95;2
373;4.48003e-15;52;147;341;10458;1;61;102;304;55;26;166;72;29;94;102;95;2
374;4.48067e-15;47;158;342;10461;1;61;102;304;50;29;147;73;21;74;102;95;2
375;4.48261e-15;40;169;343;10463;1;61;101;305;56;23;141;81;33;60;101;95;2
376;4.4839e-15;53;165;342;10465;1;62;101;305;47;18;159;82;29;77;101;95;2
377;4.48519e-15;58;164;342;10465;1;63;100;305;58;25;164;73;33;91;100;95;2
378;4.48519e-15;43;154;345;10468;1;62;101;305;41;36;150;82;5;68;101;95;2
379;4.48713e-15;48;142;347;10472;1;62;101;306;56;23;154;71;33;83;101;95;2
380;4.48972e-15;61;151;349;10473;1;62;101;306;56;24;134;70;32;64;101;95;2
381;4.49036e-15;56;169;350;10476;1;62;101;306;43;22;144;57;21;87;101;94;2
382;4.4923e-15;41;167;351;10479;1;62;101;306;46;29;163;79;17;84;101;94;2
383;4.49424e-15;52;173;351;10480;1;62;101;307;51;27;148;63;24;85;101;93;2
384;4.49489e-15;54;145;351;10482;1;62;101;307;44;33;183;87;11;96;101;93;2
385;4.49618e-15;43;167;350;10482;1;64;101;307;54;26;146;69;28;77;101;93;2
386;4.49618e-15;55;162;353;10484;1;63;101;308;46;24;142;67;22;75;101;93;3
387;4.49748e-15;42;169;352;10486;1;64;102;308;40;28;158;73;12;85;102;93;3
388;4.49877e-15;28;153;357;10490;1;62;102;308;49;30;150;84;19;66;102;93;3
389;4.50136e-15;46;153;359;10493;1;61;102;308;37;15;153;84;22;69;102;93;3
390;4.5033e-15;48;155;360;10495;1;61;102;309;43;30;193;82;13;111;102;92;3
391;4.50459e-15;43;159;359;10498;1;62;101;309;56;20;158;81;36;77;101;92;3
392;4.50653e-15;44;144;360;10501;1;62;101;309;52;31;157;77;21;80;101;91;3
393;4.50847e-15;50;150;360;10501;1;62;101;309;53;29;164;80;24;84;101;91;3
394;4.50847e-15;57;148;359;10501;1;63;100;310;52;19;170;70;33;100;100;91;3
395;4.50847e-15;59;160;361;10501;1;62;100;310;41;15;153;75;26;78;100;90;3
396;4.50847e-15;49;148;363;10502;1;61;99;310;54;21;139;80;33;59;99;90;3
397;4.50912e-15;46;150;361;10505;1;63;99;311;53;26;135;95;27;40;99;90;3
398;4.51106e-15;41;144;362;10508;1;63;99;311;59;25;150;75;34;75;99;90;3
399;4.51301e-15;38;155;365;10508;1;62;98;311;44;21;155;72;23;83;98;90;3
400;4.51301e-15;52;149;365;10509;1;62;98;311;48;25;147;92;23;55;98;90;3
401;4.51365e-15;50;152;365;10511;1;62;98;312;54;25;150;75;29;75;98;90;3
402;4.51495e-15;38;154;371;10515;1;59;98;312;50;21;148;65;29;83;98;90;3
403;4.51754e-15;49;154;371;10516;1;59;98;312;43;20;147;80;23;67;98;89;3
404;4.51819e-15;33;163;370;10517;1;60;98;312;46;24;158;76;22;82;98;90;3
405;4.51883e-15;40;150;372;10520;1;59;98;313;43;26;146;79;17;67;98;90;3
406;4.52078e-15;46;150;370;10522;1;61;98;313;48;27;154;80;21;74;98;91;3
407;4.52207e-15;52;152;371;10524;1;61;97;313;52;21;139;96;31;43;97;91;3
408;4.52337e-15;53;155;375;10526;1;59;97;314;45;22;160;73;23;87;97;91;3
409;4.52466e-15;47;162;376;10527;1;59;97;314;50;25;142;75;25;67;97;89;3
410;4.52531e-15;48;165;377;10533;1;59;96;314;60;20;157;82;40;75;96;89;3
411;4.5292e-15;60;168;382;10534;1;57;95;314;62;18;164;84;44;80;95;90;3
412;4.52985e-15;52;155;380;10535;1;59;95;315;51;24;162;71;27;91;95;89;3
413;4.5305e-15;37;178;378;10536;1;61;94;315;45;22;159;86;23;73;94;89;3
414;4.53115e-15;36;165;380;10538;1;60;94;315;44;18;148;78;26;70;94;88;3
415;4.53244e-15;38;165;379;10542;1;61;94;315;46;23;156;90;23;66;94;88;3
416;4.53504e-15;47;156;377;10543;1;63;94;316;42;18;151;69;24;82;94;89;3
417;4.53568e-15;49;159;379;10547;1;62;94;316;42;25;172;71;17;101;94;89;3
418;4.53828e-15;49;141;385;10547;1;60;94;316;41;21;158;81;20;77;94;88;3
419;4.53828e-15;38;151;391;10552;1;58;94;316;59;29;155;72;30;83;94;88;3
420;4.54152e-15;45;149;396;10554;1;56;93;317;49;22;156;78;27;78;93;88;3
421;4.54282e-15;39;149;396;10555;1;56;94;317;45;26;139;75;19;64;94;87;3
422;4.54347e-15;45;152;397;10562;1;56;93;317;54;20;184;76;34;108;93;88;3
423;4.54801e-15;45;142;399;10563;1;55;93;317;47;22;156;74;25;82;93;87;3
424;4.54866e-15;55;152;395;10564;1;59;92;318;44;19;168;63;25;105;92;87;3
425;4.54931e-15;42;172;397;10566;1;59;92;318;50;22;143;95;28;48;92;86;3
426;4.55061e-15;43;164;398;10569;1;59;91;318;51;15;157;82;36;75;91;86;3
427;4.55256e-15;43;160;397;10572;1;60;91;318;45;15;188;71;30;117;91;86;3
428;4.55451e-15;40;145;395;10574;1;62;91;319;37;22;151;74;15;77;91;86;3
429;4.5558e-15;50;167;391;10578;1;66;90;319;54;23;150;76;31;74;90;85;3
430;4.5584e-15;41;164;390;10582;1;68;90;319;42;18;143;76;24;67;90;85;3
431;4.561e-15;42;182;390;10584;1;68;91;319;34;24;163;71;10;92;91;85;3
432;4.5623e-15;36;176;389;10585;1;69;91;320;43;22;169;80;21;89;91;85;3
433;4.56295e-15;36;184;391;10590;1;68;91;320;35;23;144;72;12;72;91;84;3
434;4.5662e-15;30;184;392;10591;1;68;91;320;47;18;188;65;29;123;91;84;3
435;4.56685e-15;36;159;392;10594;1;68;90;320;41;17;147;99;24;48;90;83;4
436;4.5688e-15;35;134;392;10594;1;68;89;321;63;20;158;84;43;74;89;82;4
437;4.5688e-15;36;141;393;10597;1;68;89;321;34;21;166;89;13;77;89;82;4
438;4.57075e-15;31;130;396;10600;1;67;90;321;29;17;146;81;12;65;90;82;4
439;4.5727e-15;48;126;397;10602;1;67;89;321;34;8;148;73;26;75;89;83;4
440;4.574e-15;44;159;398;10603;1;67;90;322;42;25;151;77;17;74;90;83;4
441;4.57465e-15;40;180;402;10604;1;65;90;322;33;30;165;64;3;101;90;83;4
442;4.5753e-15;41;145;402;10606;1;65;90;322;48;25;160;105;23;55;90;83;4
443;4.5766e-15;28;142;401;10608;1;66;90;322;47;27;161;83;20;78;90;83;4
444;4.5779e-15;42;149;401;10608;1;66;89;323;51;12;169;75;39;94;89;83;4
445;4.5779e-15;51;163;401;10611;1;67;89;323;39;17;152;79;22;73;89;84;4
446;4.57986e-15;40;155;404;10614;1;66;89;323;39;25;162;85;14;77;89;83;4
447;4.58181e-15;33;146;408;10615;1;64;88;323;46;16;136;84;30;52;88;83;4
448;4.58246e-15;40;151;410;10618;1;63;89;324;31;21;173;67;10;106;89;83;4
449;4.58441e-15;35;162;409;10619;1;64;88;324;51;17;188;74;34;114;88;82;4
450;4.58506e-15;48;171;412;10622;1;63;87;324;49;17;141;79;32;62;87;82;4
451;4.58701e-15;36;185;411;10627;1;64;87;324;46;24;149;99;22;50;87;81;4
452;4.59027e-15;39;155;411;10629;1;64;86;325;44;17;171;81;27;90;86;80;4
453;4.59157e-15;38;177;417;10630;1;61;85;325;48;14;164;59;34;105;85;80;4
454;4.59222e-15;39;171;418;10632;1;61;85;325;48;22;158;75;26;83;85;80;4
455;4.59353e-15;46;159;417;10632;1;62;85;325;36;20;160;83;16;77;85;80;4
456;4.59353e-15;39;157;417;10636;1;63;85;326;40;23;144;83;17;61;85;80;4
457;4.59613e-15;32;134;417;10639;1;64;86;326;30;18;166;83;12;83;86;80;4
458;4.59809e-15;30;161;421;10642;1;63;86;326;36;22;175;65;14;110;86;79;4
459;4.60004e-15;38;160;426;10644;1;61;84;326;59;14;162;81;45;81;84;80;4
460;4.60134e-15;39;153;426;10648;1;62;83;327;50;14;171;94;36;77;83;80;4
461;4.60395e-15;52;147;427;10649;1;62;83;327;41;16;156;96;25;60;83;80;4
462;4.6046e-15;55;131;428;10654;1;62;83;327;44;21;167;81;23;86;83;80;4
463;4.60786e-15;47;151;428;10658;1;62;83;327;46;25;176;68;21;108;83;80;4
464;4.61047e-15;55;145;431;10660;1;61;82;328;49;16;152;78;33;74;82;80;4
465;4.61177e-15;33;162;434;10663;1;60;82;328;39;21;135;76;18;59;82;80;4
466;4.61373e-15;39;181;434;10666;1;60;82;328;37;14;157;76;23;81;82;80;4
467;4.61569e-15;47;177;435;10666;1;60;81;328;41;17;163;95;24;68;81;79;4
468;4.61569e-15;43;174;434;10667;1;61;81;328;41;22;170;89;19;81;81;78;4
469;4.61634e-15;47;169;436;10669;1;61;82;329;28;19;142;80;9;62;82;78;4
470;4.61764e-15;40;145;436;10671;1;61;82;329;37;28;163;83;9;80;82;78;4
471;4.61895e-15;37;168;435;10673;1;62;82;329;37;18;171;76;19;95;82;78;4
472;4.62025e-15;43;152;437;10676;1;61;81;329;45;14;157;89;31;68;81;78;4
473;4.62221e-15;52;159;438;10677;1;61;81;330;35;11;173;83;24;90;81;78;4
474;4.62286e-15;44;165;443;10677;1;59;82;330;34;27;171;83;7;88;82;78;4
475;4.62286e-15;37;168;441;10681;1;61;81;330;46;19;159;71;27;88;81;78;4
476;4.62548e-15;32;167;445;10684;1;59;81;330;31;16;151;71;15;80;81;78;4
477;4.62743e-15;35;136;450;10688;1;57;81;331;38;17;188;80;21;108;81;78;4
478;4.63005e-15;45;151;449;10690;1;58;81;331;35;20;159;77;15;82;81;78;4
479;4.63135e-15;40;181;451;10694;1;57;81;331;33;23;143;70;10;73;81;77;4
480;4.63396e-15;42;177;451;10697;1;58;81;331;40;17;156;93;23;63;81;77;4
481;4.63592e-15;47;178;454;10700;1;58;81;331;38;18;167;82;20;85;81;77;4
482;4.63788e-15;34;149;457;10702;1;57;80;332;47;22;146;83;25;63;80;77;4
483;4.63919e-15;35;162;459;10706;1;56;80;332;38;21;163;68;17;95;80;77;4
484;4.64181e-15;37;167;462;10707;1;55;80;332;40;16;161;89;24;72;80;77;5
485;4.64246e-15;45;163;460;10707;1;57;79;332;44;20;167;87;24;80;79;76;5
486;4.64246e-15;34;166;462;10711;1;56;79;333;50;29;171;84;21;87;79;75;5
487;4.64507e-15;40;181;458;10711;1;60;79;333;36;24;171;73;12;98;79;75;5
488;4.64507e-15;42;173;456;10716;1;62;80;333;25;23;193;94;2;99;80;75;5
489;4.64834e-15;41;161;459;10720;1;61;79;333;40;15;166;93;25;73;79;74;5
490;4.65096e-15;39;171;457;10723;1;63;79;333;43;15;182;93;28;89;79;74;5
491;4.65292e-15;43;151;458;10726;1;63;79;334;37;16;147;90;21;57;79;74;5
492;4.65488e-15;34;143;461;10727;1;62;78;334;41;15;179;79;26;100;78;75;5
493;4.65554e-15;35;166;460;10731;1;63;78;334;39;16;147;79;23;68;78;73;5
494;4.65815e-15;40;169;460;10732;1;63;78;334;43;29;196;72;14;124;78;73;5
495;4.65881e-15;45;167;467;10734;1;60;78;335;31;17;166;71;14;95;78;74;5
496;4.66012e-15;37;152;465;10735;1;62;78;335;42;26;165;83;16;82;78;73;5
497;4.66077e-15;45;166;465;10739;1;62;78;335;36;16;144;69;20;75;78;72;5
498;4.66339e-15;38;164;466;10740;1;63;77;335;44;21;164;84;23;80;77;72;5
499;4.66404e-15;44;164;468;10742;1;62;77;335;40;23;145;79;17;66;77;72;5
500;4.66535e-15;43;165;465;10744;1;65;77;336;40;19;152;86;21;66;77;73;5
501;4.66666e-15;38;159;462;10749;1;68;76;336;38;17;170;91;21;79;76;73;5
502;4.66994e-15;37;163;461;10751;1;69;76;336;42;19;148;89;23;59;76;72;5
503;4.67125e-15;46;183;461;10757;1;70;75;336;50;16;146;83;34;63;75;72;5
504;4.67518e-15;41;158;463;10758;1;69;75;337;35;18;168;113;17;55;75;72;5
505;4.67583e-15;43;185;462;10761;1;70;75;337;45;20;159;81;25;78;75;72;5
506;4.6778e-15;38;180;464;10763;1;69;74;337;42;19;167;95;23;72;74;73;5
507;4.67911e-15;31;171;467;10767;1;68;75;337;29;23;183;72;6;111;75;71;5
508;4.68173e-15;42;151;466;10769;1;69;75;337;39;20;185;75;19;110;75;72;5
509;4.68304e-15;32;178;470;10771;1;68;74;338;33;14;172;82;19;90;74;71;5
510;4.68435e-15;27;159;472;10772;1;67;74;338;45;13;156;103;32;53;74;72;5
511;4.68501e-15;39;179;475;10773;1;66;73;338;48;12;165;80;36;85;73;71;5
512;4.68566e-15;31;173;478;10776;1;65;72;338;42;19;180;94;23;86;72;71;5
513;4.68763e-15;25;161;478;10780;1;65;72;338;40;20;179;84;20;95;72;71;5
514;4.69025e-15;27;159;481;10781;1;64;72;339;32;14;187;92;18;95;72;71;5
515;4.69091e-15;32;157;483;10783;1;64;72;339;28;14;167;68;14;99;72;71;5
516;4.69222e-15;41;159;485;10786;1;63;72;339;28;11;180;81;17;99;72;70;5
517;4.69419e-15;30;169;486;10790;1;63;73;339;20;24;187;78;-4;109;73;71;5
518;4.69681e-15;23;190;485;10791;1;64;72;340;46;18;159;93;28;66;72;70;5
519;4.69747e-15;27;185;486;10794;1;64;71;340;43;11;153;93;32;60;71;71;5
520;4.69944e-15;31;165;485;10798;1;65;72;340;29;15;178;76;14;102;72;70;5
521;4.70206e-15;30;151;483;10798;1;67;71;340;38;16;164;96;22;68;71;70;5
522;4.70206e-15;34;166;481;10802;1;69;71;340;34;10;165;79;24;86;71;70;5
523;4.70469e-15;30;149;485;10808;1;67;70;341;40;14;192;82;26;110;70;69;5
524;4.70863e-15;25;167;487;10808;1;66;70;341;39;21;181;73;18;108;70;69;5
525;4.70863e-15;25;163;490;10812;1;65;70;341;36;19;162;85;17;77;70;69;5
526;4.71126e-15;32;165;491;10814;1;65;70;341;37;13;163;70;24;93;70;69;5
527;4.71257e-15;40;174;499;10817;1;61;69;341;38;12;177;85;26;92;69;68;5
528;4.71454e-15;40;186;499;10822;1;61;70;342;26;17;183;70;9;113;70;68;5
529;4.71783e-15;44;182;498;10826;1;62;70;342;31;21;189;95;10;94;70;67;5
530;4.72045e-15;40;176;497;10828;1;63;70;342;28;24;186;71;4;115;70;68;5
531;4.72177e-15;26;182;501;10831;1;61;70;342;52;23;189;90;29;99;70;68;5
532;4.72374e-15;20;162;503;10833;1;60;70;342;24;11;184;84;13;100;70;68;5
533;4.72506e-15;32;150;505;10837;1;60;69;343;45;10;178;84;35;94;69;68;5
534;4.72769e-15;21;155;509;10841;1;58;69;343;34;22;183;86;12;97;69;69;5
535;4.73032e-15;26;160;509;10845;1;59;69;343;28;7;180;94;21;86;69;69;5
536;4.73295e-15;37;170;513;10847;1;57;69;343;22;11;154;78;11;76;69;68;5
537;4.73426e-15;33;184;513;10851;1;58;68;343;46;21;163;85;25;78;68;68;5
538;4.7369e-15;33;176;512;10852;1;59;68;344;28;12;185;85;16;100;68;68;5
539;4.73755e-15;34;169;512;10852;1;59;68;344;28;12;150;96;16;54;68;69;6
540;4.73755e-15;36;176;511;10854;1;60;68;344;33;20;160;84;13;76;68;68;6
541;4.73887e-15;34;182;515;10855;1;59;68;344;33;21;171;79;12;92;68;67;6
542;4.73953e-15;45;172;521;10858;1;56;68;344;33;20;182;84;13;98;68;67;6
543;4.7415e-15;34;187;522;10861;1;56;68;345;36;17;173;89;19;84;68;67;6
544;4.74348e-15;25;184;524;10864;1;55;67;345;43;19;156;76;24;80;67;67;6
545;4.74545e-15;25;170;523;10869;1;56;68;345;26;22;166;84;4;82;68;67;6
546;4.74874e-15;40;161;525;10873;1;55;68;345;30;12;174;88;18;86;68;67;6
547;4.75138e-15;42;169;525;10881;1;55;68;345;36;22;168;85;14;83;68;66;6
548;4.75665e-15;45;179;524;10884;1;56;67;346;41;20;171;74;21;97;67;66;6
549;4.75863e-15;39;179;525;10885;1;56;67;346;35;17;170;83;18;87;67;66;6
550;4.75929e-15;25;170;529;10887;1;54;67;346;28;16;175;90;12;85;67;66;6
551;4.7606e-15;33;170;529;10890;1;55;67;346;31;8;170;96;23;74;67;66;6
552;4.76258e-15;34;162;531;10892;1;54;67;346;32;18;173;78;14;95;67;66;6
553;4.7639e-15;33;152;533;10895;1;53;66;347;27;11;166;88;16;78;66;65;6
554;4.76588e-15;35;147;539;10898;1;50;66;347;29;11;179;79;18;100;66;65;6
555;4.76786e-15;31;167;541;10904;1;49;66;347;35;21;159;75;14;84;66;65;6
556;4.77181e-15;39;193;540;10905;1;50;66;347;19;12;165;71;7;94;66;65;6
557;4.77247e-15;34;182;540;10908;1;50;66;347;36;20;177;82;16;95;66;65;6
558;4.77445e-15;41;191;542;10910;1;49;66;348;30;13;161;86;17;75;66;65;6
559;4.77577e-15;29;184;544;10912;1;48;66;348;39;20;206;104;19;102;66;64;6
560;4.77709e-15;27;181;543;10914;1;49;65;348;41;11;157;80;30;77;65;64;6
561;4.77841e-15;28;180;543;10915;1;49;65;348;33;20;176;97;13;79;65;64;6
562;4.77907e-15;34;158;542;10915;1;50;65;348;35;16;176;79;19;97;65;64;6
563;4.77907e-15;32;173;544;10919;1;49;64;349;29;10;166;71;19;95;64;63;6
564;4.78171e-15;35;152;544;10924;1;49;64;349;37;19;169;70;18;99;64;63;6
565;4.78501e-15;34;157;547;10926;1;48;64;349;33;20;162;72;13;90;64;63;6
566;4.78633e-15;35;173;547;10928;1;48;64;349;29;19;185;81;10;104;64;63;6
567;4.78765e-15;21;166;544;10929;1;51;239;-3156;31;9;159;89;22;70;239;238;6
568;4.78831e-15;21;166;544;10929;1;51;913;-13128;0;0;-1;0;0;-1;913;913;6
569;4.78831e-15;21;165;544;10929;1;51;2534;-32040;0;0;-1;0;0;-1;2534;2533;6
570;4.78831e-15;21;165;544;10929;1;51;5648;-61929;0;0;-1;0;0;-1;5648;5647;6
571;4.78831e-15;21;164;544;10929;1;51;10888;-104444;0;0;-1;0;0;-1;10888;10887;6
572;4.78831e-15;22;162;544;10929;1;51;18951;-160889;0;0;-1;0;0;-1;18951;18950;6
573;4.78831e-15;22;161;544;10929;1;51;30582;-232264;0;0;-1;0;0;-1;30582;30581;6
574;4.78831e-15;22;160;544;10929;1;51;46565;-319297;0;0;-1;0;0;-1;46565;46564;6
575;4.78831e-15;22;159;544;10929;1;51;67707;-422480;0;0;-1;0;0;-1;67707;67706;6
576;4.78831e-15;22;159;544;10929;1;51;94830;-542094;0;0;-1;0;0;-1;94830;94828;6
577;4.78831e-15;22;159;544;10929;1;51;128760;-678241;0;0;-1;0;0;-1;128760;128758;6
578;4.78831e-15;22;158;544;10929;1;51;170321;-830863;0;0;-1;0;0;-1;170321;170319;6
579;4.78831e-15;22;157;544;10929;1;51;220327;-999764;0;0;-1;0;0;-1;220327;220326;6
580;4.78831e-15;22;156;544;10929;1;51;279577;-1.18463e+06;0;0;-1;0;0;-1;279577;279575;6
581;4.78831e-15;22;156;544;10929;1;51;348848;-1.38506e+06;0;0;-1;0;0;-1;348848;348846;6
582;4.78831e-15;25;153;544;10929;1;51;428893;-1.60055e+06;1;0;-1;0;1;-1;428893;428891;6
583;4.78831e-15;26;147;544;10929;1;51;520437;-1.83053e+06;1;0;-1;0;1;-1;520437;520436;6
584;4.78831e-15;26;147;544;10929;1;51;624174;-2.07438e+06;0;0;-1;0;0;-1;624174;624173;6
585;4.78831e-15;28;142;544;10929;1;51;740763;-2.33143e+06;3;0;-1;0;3;-1;740763;740762;6
586;4.78831e-15;28;142;544;10929;1;51;870830;-2.60097e+06;0;0;-1;0;0;-1;870830;870828;6
587;4.78831e-15;28;142;544;10929;1;51;1.01496e+06;-2.88227e+06;0;0;-1;0;0;-1;1014962;1014960;6
588;4.78831e-15;30;141;544;10929;1;51;1.17371e+06;-3.17458e+06;0;0;-1;0;0;-1;1173709;1173707;6
589;4.78831e-15;30;140;544;10929;1;51;1.34758e+06;-3.47713e+06;0;0;-1;0;0;-1;1347583;1347581;6
590;4.78831e-15;30;140;544;10929;1;51;1.53706e+06;-3.78914e+06;0;0;-1;0;0;-1;1537058;1537056;6
591;4.78831e-15;30;140;544;10929;1;51;1.74257e+06;-4.10984e+06;1;0;-1;0;1;-1;1742568;1742566;6
592;4.78831e-15;31;140;544;10929;1;51;1.96451e+06;-4.43846e+06;0;0;-1;0;0;-1;1964509;1964508;6
593;4.78831e-15;31;140;544;10929;1;51;2.20324e+06;-4.77424e+06;2;0;-1;0;2;-1;2203240;2203238;6
594;4.78831e-15;31;139;544;10929;1;51;2.45908e+06;-5.11643e+06;1;0;-1;0;1;-1;2459079;2459077;6
595;4.78831e-15;31;137;544;10929;1;51;2.73231e+06;-5.46428e+06;0;0;-1;0;0;-1;2732311;2732309;6
596;4.78831e-15;31;136;544;10929;1;51;3.02318e+06;-5.81708e+06;2;0;-1;0;2;-1;3023183;3023181;7
597;4.78831e-15;32;135;544;10929;1;51;3.33191e+06;-6.17411e+06;0;0;-1;0;0;-1;3331907;3331905;7
598;4.78831e-15;32;135;544;10929;1;51;3.65866e+06;-6.53471e+06;0;0;-1;0;0;-1;3658661;3658659;7
599;4.78831e-15;32;135;544;10929;1;51;4.00359e+06;-6.89821e+06;0;0;-1;0;0;-1;4003589;4003587;7
600;4.78831e-15;33;134;544;10929;1;51;4.36681e+06;-7.26396e+06;1;0;-1;0;1;-1;4366806;4366804;7
601;4.78831e-15;33;132;544;10929;1;51;4.74839e+06;-7.63137e+06;0;0;-1;0;0;-1;4748392;4748390;7
602;4.78831e-15;33;132;544;10929;1;51;5.1484e+06;-7.99984e+06;1;0;-1;0;1;-1;5148402;5148400;7
603;4.78831e-15;33;132;544;10929;1;51;5.56686e+06;-8.3688e+06;0;0;-1;0;0;-1;5566860;5566858;8
604;4.78831e-15;35;128;544;10929;1;51;6.00376e+06;-8.73772e+06;0;0;-1;0;0;-1;6003764;6003762;8
605;4.78831e-15;35;127;544;10929;1;51;6.45909e+06;-9.10608e+06;0;0;-1;0;0;-1;6459086;6459085;8
606;4.78831e-15;36;124;544;10929;1;51;6.93278e+06;-9.4734e+06;0;0;-1;0;0;-1;6932775;6932773;9
607;4.78831e-15;36;124;544;10929;1;51;7.42476e+06;-9.83923e+06;0;0;-1;0;0;-1;7424755;7424753;9
608;4.78831e-15;36;123;544;10929;1;51;7.93493e+06;-1.02031e+07;0;0;-1;0;0;-1;7934928;7934927;10
609;4.78831e-15;36;122;544;10929;1;51;8.46318e+06;-1.05646e+07;0;0;-1;0;0;-1;8463179;8463177;11
610;4.78831e-15;36;122;544;10929;1;51;9.00937e+06;-1.09234e+07;1;0;-1;0;1;-1;9009369;9009367;12
611;4.78831e-15;36;122;544;10929;1;51;9.57334e+06;-1.12791e+07;0;0;-1;0;0;-1;9573344;9573342;13
612;4.78831e-15;36;122;544;10929;1;51;1.01549e+07;-1.16314e+07;0;0;-1;0;0;-1;10154931;10154930;14
613;4.78831e-15;39;119;544;10929;1;51;1.07539e+07;-1.19799e+07;1;0;-1;0;1;-1;10753944;10753942;16
614;4.78831e-15;39;118;544;10929;1;51;1.13702e+07;-1.23243e+07;2;0;-1;0;2;-1;11370178;11370177;18
615;4.78831e-15;39;118;544;10929;1;51;1.20034e+07;-1.26644e+07;0;0;-1;0;0;-1;12003419;12003418;20
616;4.78831e-15;41;117;544;10929;1;51;1.26534e+07;-1.3e+07;3;0;-1;0;3;-1;12653436;12653435;23
617;4.78831e-15;41;117;544;10929;1;51;1.332e+07;-1.33307e+07;0;0;-1;0;0;-1;13319990;13319989;26
618;4.78831e-15;41;117;544;10929;1;51;1.40028e+07;-1.36564e+07;3;0;-1;0;3;-1;14002829;14002828;29
619;4.78831e-15;41;117;544;10929;1;51;1.47017e+07;-1.39769e+07;0;0;-1;0;0;-1;14701692;14701692;33
620;4.78831e-15;44;117;544;10929;1;51;1.54163e+07;-1.4292e+07;0;0;-1;0;0;-1;15416310;15416309;38
621;4.78831e-15;44;117;544;10929;1;51;1.61464e+07;-1.46015e+07;0;0;-1;0;0;-1;16146404;16146404;43
622;4.78831e-15;44;117;544;10929;1;51;1.68917e+07;-1.49053e+07;0;0;-1;0;0;-1;16891690;16891690;49
623;4.78831e-15;44;117;544;10929;1;51;1.76519e+07;-1.52033e+07;0;0;-1;0;0;-1;17651876;17651876;56
624;4.78831e-15;46;116;544;10929;1;51;1.84267e+07;-1.54954e+07;2;0;-1;0;2;-1;18426665;18426666;64
625;4.78831e-15;46;115;544;10929;1;51;1.92158e+07;-1.57814e+07;0;0;-1;0;0;-1;19215756;19215757;72
626;4.78831e-15;46;115;544;10929;1;51;2.00188e+07;-1.60614e+07;0;0;-1;0;0;-1;20018843;20018844;82
627;4.78831e-15;49;114;544;10929;1;51;2.08356e+07;-1.63351e+07;0;0;-1;0;0;-1;20835615;20835617;93
628;4.78831e-15;55;108;544;10929;1;51;2.16658e+07;-1.66025e+07;4;0;-1;0;4;-1;21665760;21665763;106
629;4.78831e-15;55;107;544;10929;1;51;2.2509e+07;-1.68637e+07;0;0;-1;0;0;-1;22508964;22508967;120
630;4.78831e-15;55;107;544;10929;1;51;2.33649e+07;-1.71185e+07;0;0;-1;0;0;-1;23364909;23364913;136
631;4.78831e-15;57;106;544;10929;1;51;2.42333e+07;-1.7367e+07;0;0;-1;0;0;-1;24233278;24233283;153
632;4.78831e-15;58;106;544;10929;1;51;2.51138e+07;-1.76091e+07;0;0;-1;0;0;-1;25113751;25113756;172
633;4.78831e-15;61;103;544;10929;1;51;2.6006e+07;-1.78448e+07;4;0;-1;0;4;-1;26006008;26006015;194
634;4.78831e-15;63;102;544;10929;1;51;2.69097e+07;-1.80741e+07;0;0;-1;0;0;-1;26909732;26909740;218
635;4.78831e-15;63;102;544;10929;1;51;2.78246e+07;-1.8297e+07;0;0;-1;0;0;-1;27824602;27824611;244
636;4.78831e-15;64;98;544;10929;1;51;2.87503e+07;-1.85136e+07;5;0;-1;0;5;-1;28750301;28750312;273
637;4.78831e-15;64;98;544;10929;1;51;2.96865e+07;-1.87239e+07;1;0;-1;0;1;-1;29686513;29686525;305
638;4.78831e-15;64;98;544;10929;1;51;3.06329e+07;-1.89278e+07;2;0;-1;0;2;-1;30632922;30632935;340
639;4.78831e-15;67;96;544;10929;1;51;3.15892e+07;-1.91255e+07;3;0;-1;0;3;-1;31589215;31589230;379
640;4.78831e-15;69;94;544;10929;1;51;3.25551e+07;-1.93169e+07;5;0;-1;0;5;-1;32555080;32555098;421
641;4.78831e-15;69;93;544;10929;1;51;3.35302e+07;-1.95022e+07;3;0;-1;0;3;-1;33530210;33530230;467
642;4.78831e-15;69;93;544;10929;1;51;3.45143e+07;-1.96814e+07;1;0;-1;0;1;-1;34514298;34514320;517
643;4.78831e-15;69;93;544;10929;1;51;3.5507e+07;-1.98545e+07;0;0;-1;0;0;-1;35507041;35507065;572
644;4.78831e-15;74;93;544;10929;1;51;3.65081e+07;-2.00216e+07;6;0;-1;0;6;-1;36508138;36508166;632
645;4.78831e-15;79;91;544;10929;1;51;3.75173e+07;-2.01827e+07;5;0;-1;0;5;-1;37517293;37517324;697
646;4.78831e-15;83;89;544;10929;1;51;3.85342e+07;-2.0338e+07;4;0;-1;0;4;-1;38534214;38534248;767
647;4.78831e-15;88;87;544;10929;1;51;3.95586e+07;-2.04875e+07;4;0;-1;0;4;-1;39558609;39558647;843
648;4.78831e-15;88;87;544;10929;1;51;4.05902e+07;-2.06313e+07;1;0;-1;0;1;-1;40590194;40590236;926
649;4.78831e-15;88;87;544;10929;1;51;4.16287e+07;-2.07695e+07;1;0;-1;0;1;-1;41628686;41628732;1015
650;4.78831e-15;89;86;544;10929;1;51;4.26738e+07;-2.09021e+07;2;0;-1;0;2;-1;42673808;42673858;1111
651;4.78831e-15;91;86;544;10929;1;51;4.37253e+07;-2.10292e+07;1;0;-1;0;1;-1;43725285;43725340;1214
652;4.78831e-15;91;86;544;10929;1;51;4.47828e+07;-2.11509e+07;2;0;-1;0;2;-1;44782848;44782909;1326
653;4.78831e-15;110;78;544;10929;1;51;4.58462e+07;-2.12673e+07;11;0;-1;0;11;-1;45846232;45846298;1445
654;4.78831e-15;110;78;544;10929;1;51;4.69152e+07;-2.13785e+07;0;0;-1;0;0;-1;46915175;46915248;1574
655;4.78831e-15;110;78;544;10929;1;51;4.79894e+07;-2.14846e+07;0;0;-1;0;0;-1;47989423;47989502;1712
656;4.78831e-15;115;78;544;10929;1;51;4.90687e+07;-2.15856e+07;3;0;-1;0;3;-1;49068721;49068807;1860
657;4.78831e-15;117;78;544;10929;1;51;5.01528e+07;-2.16817e+07;1;0;-1;0;1;-1;50152824;50152917;2018
658;4.78831e-15;120;78;544;10929;1;51;5.12415e+07;-2.17729e+07;3;0;-1;0;3;-1;51241487;51241589;2186
659;4.78831e-15;120;78;544;10929;1;51;5.23345e+07;-2.18593e+07;1;0;-1;0;1;-1;52334473;52334584;2367
660;4.78831e-15;122;75;544;10929;1;51;5.34315e+07;-2.19411e+07;4;0;-1;0;4;-1;53431548;53431668;2559
661;4.78831e-15;123;75;544;10929;1;51;5.45325e+07;-2.20183e+07;1;0;-1;0;1;-1;54532483;54532613;2764
662;4.78831e-15;124;75;544;10929;1;51;5.56371e+07;-2.2091e+07;0;0;-1;0;0;-1;55637054;55637194;2982
663;4.78831e-15;124;73;544;10929;1;51;5.6745e+07;-2.21593e+07;2;0;-1;0;2;-1;56745040;56745192;3214
664;4.78831e-15;129;73;544;10929;1;51;5.78562e+07;-2.22233e+07;2;0;-1;0;2;-1;57856226;57856390;3461
665;4.78831e-15;129;73;544;10929;1;51;5.89704e+07;-2.22831e+07;0;0;-1;0;0;-1;58970402;58970579;3722
666;4.78831e-15;131;72;544;10929;1;51;6.00874e+07;-2.23388e+07;0;0;-1;0;0;-1;60087362;60087552;4000
667;4.78831e-15;135;72;544;10929;1;51;6.12069e+07;-2.23904e+07;0;0;-1;0;0;-1;61206903;61207107;4294
668;4.78831e-15;138;71;544;10929;1;51;6.23288e+07;-2.24381e+07;1;0;-1;0;1;-1;62328829;62329048;4605
669;4.78831e-15;146;69;544;10929;1;51;6.34529e+07;-2.2482e+07;6;0;-1;0;6;-1;63452947;63453183;4935
670;4.78831e-15;147;69;544;10929;1;51;6.45791e+07;-2.25221e+07;1;0;-1;0;1;-1;64579069;64579322;5283
671;4.78831e-15;155;68;544;10929;1;51;6.5707e+07;-2.25585e+07;5;0;-1;0;5;-1;65707012;65707284;5651
672;4.78831e-15;156;68;544;10929;1;51;6.68366e+07;-2.25913e+07;0;0;-1;0;0;-1;66836596;66836887;6039
673;4.78831e-15;156;68;544;10929;1;51;6.79676e+07;-2.26206e+07;2;0;-1;0;2;-1;67967647;67967958;6448
674;4.78831e-15;157;68;544;10929;1;51;6.91e+07;-2.26465e+07;0;0;-1;0;0;-1;69099992;69100325;6879
675;4.78831e-15;171;65;544;10929;1;51;7.02335e+07;-2.26691e+07;6;0;-1;0;6;-1;70233467;70233822;7333
676;4.78831e-15;184;59;544;10929;1;51;7.13679e+07;-2.26884e+07;11;0;-1;0;11;-1;71367907;71368288;7811
677;4.78831e-15;184;59;544;10929;1;51;7.25032e+07;-2.27046e+07;1;0;-1;0;1;-1;72503157;72503563;8313
678;4.78831e-15;186;58;544;10929;1;51;7.36391e+07;-2.27177e+07;4;0;-1;0;4;-1;73639061;73639493;8841
679;4.78831e-15;191;57;544;10929;1;51;7.47755e+07;-2.27278e+07;2;0;-1;0;2;-1;74775469;74775930;9395
680;4.78831e-15;200;55;544;10929;1;51;7.59122e+07;-2.27349e+07;3;0;-1;0;3;-1;75912236;75912726;9976
681;4.78831e-15;202;53;544;10929;1;51;7.70492e+07;-2.27393e+07;1;0;-1;0;1;-1;77049218;77049740;10585
682;4.78831e-15;206;51;544;10929;1;51;7.81863e+07;-2.27408e+07;8;0;-1;0;8;-1;78186278;78186832;11224
683;4.78831e-15;206;50;544;10929;1;51;7.93233e+07;-2.27397e+07;0;0;-1;0;0;-1;79323281;79323869;11893
684;4.78831e-15;210;47;544;10929;1;51;8.04601e+07;-2.27359e+07;4;0;-1;0;4;-1;80460095;80460720;12593
685;4.78831e-15;212;47;544;10929;1;51;8.15966e+07;-2.27296e+07;2;0;-1;0;2;-1;81596595;81597258;13325
686;4.78831e-15;214;45;544;10929;1;51;8.27327e+07;-2.27208e+07;3;0;-1;0;3;-1;82732656;82733358;14091
687;4.78831e-15;218;44;544;10929;1;51;8.38682e+07;-2.27096e+07;1;0;-1;0;1;-1;83868157;83868901;14890
688;4.78831e-15;218;44;544;10929;1;51;8.5003e+07;-2.26961e+07;0;0;-1;0;0;-1;85002983;85003771;15725
689;4.78831e-15;221;44;544;10929;1;51;8.6137e+07;-2.26803e+07;1;0;-1;0;1;-1;86137020;86137853;16596
690;4.78831e-15;226;42;544;10929;1;51;8.72702e+07;-2.26624e+07;8;0;-1;0;8;-1;87270158;87271039;17505
691;4.78831e-15;233;41;544;10929;1;51;8.84023e+07;-2.26423e+07;7;0;-1;0;7;-1;88402290;88403222;18452
692;4.78831e-15;233;41;544;10929;1;51;8.95333e+07;-2.26201e+07;0;0;-1;0;0;-1;89533314;89534297;19438
693;4.78831e-15;242;40;544;10929;1;51;9.06631e+07;-2.25959e+07;8;0;-1;0;8;-1;90663128;90664166;20466
694;4.78831e-15;243;39;544;10929;1;51;9.17916e+07;-2.25698e+07;3;0;-1;0;3;-1;91791635;91792731;21535
695;4.78831e-15;251;38;544;10929;1;51;9.29187e+07;-2.25418e+07;11;0;-1;0;11;-1;92918742;92919898;22647
696;4.78831e-15;252;37;544;10929;1;51;9.40444e+07;-2.25119e+07;3;0;-1;0;3;-1;94044357;94045575;23804
697;4.78831e-15;254;36;544;10929;1;51;9.51684e+07;-2.24803e+07;4;0;-1;0;4;-1;95168392;95169675;25005
698;4.78831e-15;269;32;544;10929;1;51;9.62908e+07;-2.2447e+07;15;0;-1;0;15;-1;96290761;96292112;26253
699;4.78831e-15;269;32;544;10929;1;51;9.74114e+07;-2.2412e+07;1;0;-1;0;1;-1;97411382;97412803;27549
700;4.78831e-15;280;30;544;10929;1;51;9.85302e+07;-2.23755e+07;7;0;-1;0;7;-1;98530174;98531668;28894
701;4.78831e-15;281;28;544;10929;1;51;9.96471e+07;-2.23373e+07;0;0;-1;0;0;-1;99647061;99648631;30288
702;4.78831e-15;282;28;544;10929;1;51;1.00762e+08;-2.22977e+07;2;0;-1;0;2;-1;100761967;100763617;31734
703;4.78831e-15;294;25;544;10929;1;51;1.01875e+08;-2.22567e+07;9;0;-1;0;9;-1;101874821;101876553;33233
704;4.78831e-15;297;24;544;10929;1;51;1.02986e+08;-2.22142e+07;1;0;-1;0;1;-1;102985552;102987370;34785
705;4.78831e-15;298;23;544;10929;1;51;1.04094e+08;-2.21704e+07;2;0;-1;0;2;-1;104094094;104096000;36392
706;4.78831e-15;298;23;544;10929;1;51;1.052e+08;-2.21253e+07;1;0;-1;0;1;-1;105200381;105202380;38055
707;4.78831e-15;309;22;544;10929;1;51;1.06304e+08;-2.2079e+07;11;0;-1;0;11;-1;106304350;106306446;39776
708;4.78831e-15;327;20;544;10929;1;51;1.07406e+08;-2.20315e+07;15;0;-1;0;15;-1;107405942;107408137;41555
709;4.78831e-15;332;20;544;10929;1;51;1.08505e+08;-2.19827e+07;2;0;-1;0;2;-1;108505098;108507397;43394
710;4.78831e-15;335;18;544;10929;1;51;1.09602e+08;-2.19329e+07;1;0;-1;0;1;-1;109601763;109604169;45295
711;4.78831e-15;347;17;544;10929;1;51;1.10696e+08;-2.1882e+07;11;0;-1;0;11;-1;110695882;110698399;47258
712;4.78831e-15;353;13;544;10929;1;51;1.11787e+08;-2.183e+07;7;0;-1;0;7;-1;111787404;111790036;49285
713;4.78831e-15;354;13;544;10929;1;51;1.12876e+08;-2.17771e+07;2;0;-1;0;2;-1;112876279;112879029;51377
714;4.78831e-15;355;12;544;10929;1;51;1.13962e+08;-2.17232e+07;4;0;-1;0;4;-1;113962459;113965331;53535
715;4.78831e-15;366;6;544;10929;1;51;1.15046e+08;-2.16684e+07;12;0;-1;0;12;-1;115045897;115048897;55762
716;4.78831e-15;366;6;544;10929;1;51;1.16127e+08;-2.16127e+07;0;0;-1;0;0;-1;116126550;116129683;58057
717;4.78831e-15;381;2;544;10929;1;51;1.17204e+08;-2.15561e+07;16;0;-1;0;16;-1;117204375;117207645;60422
718;4.78831e-15;381;2;544;10929;1;51;1.18279e+08;-2.14988e+07;1;0;-1;0;1;-1;118279333;118282744;62859
719;4.78831e-15;389;2;544;10929;1;51;1.19351e+08;-2.14406e+07;7;0;-1;0;7;-1;119351383;119354940;65369
720;4.78831e-15;402;1;544;10929;1;51;1.2042e+08;-2.13817e+07;7;0;-1;0;7;-1;120420489;120424197;67953
721;4.78831e-15;407;-1.13687e-13;544;10929;1;51;1.21487e+08;-2.13221e+07;3;0;0;0;3;0;121486616;121490479;70612
722;4.78831e-15;407;-1.13687e-13;544;10929;1;51;1.2255e+08;-2.12619e+07;1;0;0;0;1;0;122549729;122553753;73348
723;4.78831e-15;407;-1.13687e-13;544;10929;1;51;1.2361e+08;-2.12009e+07;1;0;0;0;1;0;123609795;123613985;76163
724;4.78831e-15;407;-1.13687e-13;544;10929;1;51;1.24667e+08;-2.11394e+07;1;0;0;0;1;0;124666785;124671146;79057
725;4.78831e-15;408;-1.13687e-13;544;10929;1;51;1.25721e+08;-2.10773e+07;0;0;0;0;0;0;125720668;125725205;82031
726;4.78831e-15;408;-1.13687e-13;544;10929;1;51;1.26771e+08;-2.10146e+07;1;0;0;0;1;0;126771416;126776136;85088
727;4.78831e-15;408;-1.13687e-13;544;10929;1;51;1.27819e+08;-2.09513e+07;0;0;-1;0;0;-1;127819003;127823911;88228
728;4.78831e-15;408;-1;544;10929;1;51;1.28863e+08;-2.08876e+07;0;0;0;0;0;0;128863404;128868505;91453
729;4.78831e-15;408;-1;544;10929;1;51;1.29905e+08;-2.08234e+07;1;0;0;0;1;0;129904594;129909895;94763
730;4.78831e-15;408;-2;544;10929;1;51;1.30943e+08;-2.07587e+07;0;0;0;0;0;0;130942550;130948056;98161
731;4.78831e-15;409;-2;544;10929;1;51;1.31977e+08;-2.06936e+07;0;0;0;0;0;0;131977251;131982970;101648
732;4.78831e-15;410;-2;544;10929;1;51;1.33009e+08;-2.06281e+07;0;0;0;0;0;0;133008677;133014614;105224
733;4.78831e-15;411;-2;544;10929;1;51;1.34037e+08;-2.05622e+07;0;0;0;0;0;0;134036809;134042970;108892
734;4.78831e-15;412;-2;544;10929;1;51;1.35062e+08;-2.0496e+07;0;0;0;0;0;0;135061629;135068021;112652
735;4.78831e-15;413;-2;544;10929;1;51;1.36083e+08;-2.04294e+07;0;0;0;0;0;0;136083119;136089749;116505
736;4.78831e-15;413;-2;544;10929;1;51;1.37101e+08;-2.03625e+07;1;0;0;0;1;0;137101264;137108138;120454
737;4.78831e-15;414;-2;544;10929;1;51;1.38116e+08;-2.02953e+07;0;0;0;0;0;0;138116049;138123175;124499
738;4.78831e-15;414;-2;544;10929;1;51;1.39127e+08;-2.02278e+07;1;0;0;0;1;0;139127460;139134845;128642
739;4.78831e-15;415;-2;544;10929;1;51;1.40135e+08;-2.01601e+07;0;0;0;0;0;0;140135485;140143135;132884
740;4.78831e-15;416;-2;544;10929;1;51;1.4114e+08;-2.00921e+07;0;0;0;0;0;0;141140112;141148035;137225
741;4.78831e-15;416;-2;544;10929;1;51;1.42141e+08;-2.00239e+07;1;0;0;0;1;0;142141329;142149532;141668
742;4.78831e-15;416;-3;544;10929;1;51;1.43139e+08;-1.99556e+07;0;0;0;0;0;0;143139127;143147618;146214
743;4.78831e-15;416;-3;544;10929;1;51;1.44133e+08;-1.9887e+07;1;0;0;0;1;0;144133496;144142284;150864
744;4.78831e-15;416;-3;544;10929;1;51;1.45124e+08;-1.98183e+07;1;0;0;0;1;0;145124429;145133520;155618
745;4.78831e-15;417;-3;544;10929;1;51;1.46112e+08;-1.97494e+07;0;0;0;0;0;0;146111917;146121319;160479
746;4.78831e-15;418;-3;544;10929;1;51;1.47096e+08;-1.96803e+07;0;0;0;0;0;0;147095954;147105676;165448
747;4.78831e-15;419;-3;544;10929;1;51;1.48077e+08;-1.96112e+07;0;0;0;0;0;0;148076534;148086584;170525
748;4.78831e-15;419;-3;544;10929;1;51;1.49054e+08;-1.9542e+07;0;0;-1;0;0;-1;149053653;149064038;175712
749;4.78831e-15;420;-3;544;10929;1;51;1.50027e+08;-1.94726e+07;0;0;0;0;0;0;150027304;150038035;181010
750;4.78831e-15;420;-3;544;10929;1;51;1.50997e+08;-1.94032e+07;1;0;0;0;1;0;150997485;151008569;186421
751;4.78831e-15;421;-3;544;10929;1;51;1.51964e+08;-1.93338e+07;0;0;0;0;0;0;151964192;151975638;191945
752;4.78831e-15;421;-3;544;10929;1;51;1.52927e+08;-1.92642e+07;1;0;0;0;1;0;152927424;152939241;197584
753;4.78831e-15;422;-3;544;10929;1;51;1.53887e+08;-1.91947e+07;0;0;0;0;0;0;153887177;153899375;203339
754;4.78831e-15;423;-3;544;10929;1;51;1.54843e+08;-1.91251e+07;0;0;0;0;0;0;154843452;154856039;209211
755;4.78831e-15;423;-3;544;10929;1;51;1.55796e+08;-1.90555e+07;1;0;0;0;1;0;155796247;155809233;215201
756;4.78831e-15;423;-3;544;10929;1;51;1.56746e+08;-1.89859e+07;1;0;0;0;1;0;156745562;156758957;221310
757;4.78831e-15;423;-3;544;10929;1;51;1.57691e+08;-1.89163e+07;0;0;-1;0;0;-1;157691398;157705212;227539
758;4.78831e-15;423;-3;544;10929;1;51;1.58634e+08;-1.88468e+07;0;0;-1;0;0;-1;158633756;158647998;233890
759;4.78831e-15;424;-3;544;10929;1;51;1.59573e+08;-1.87772e+07;0;0;0;0;0;0;159572638;159587318;240364
760;4.78831e-15;425;-3;544;10929;1;51;1.60508e+08;-1.87077e+07;0;0;0;0;0;0;160508045;160523174;246961
761;4.78831e-15;426;-3;544;10929;1;51;1.6144e+08;-1.86383e+07;0;0;0;0;0;0;161439981;161455567;253684
762;4.78831e-15;427;-3;544;10929;1;51;1.62368e+08;-1.85689e+07;0;0;0;0;0;0;162368447;162384503;260532
763;4.78831e-15;427;-3;544;10929;1;51;1.63293e+08;-1.84996e+07;1;0;0;0;1;0;163293449;163309984;267506
764;4.78831e-15;427;-3;544;10929;1;51;1.64215e+08;-1.84304e+07;1;0;0;0;1;0;164214989;164232014;274609
765;4.78831e-15;427;-3;544;10929;1;51;1.65133e+08;-1.83613e+07;1;0;0;0;1;0;165133072;165150598;281841
766;4.78831e-15;427;-3;544;10929;1;51;1.66048e+08;-1.82922e+07;1;0;0;0;1;0;166047702;166065741;289202
767;4.78831e-15;427;-4;544;10929;1;51;1.66959e+08;-1.82233e+07;0;0;0;0;0;0;166958886;166977448;296695
768;4.78831e-15;427;-4;544;10929;1;51;1.67867e+08;-1.81544e+07;0;0;-1;0;0;-1;167866628;167885724;304320
769;4.78831e-15;427;-4;544;10929;1;51;1.68771e+08;-1.80857e+07;1;0;0;0;1;0;168770934;168790577;312077
770;4.78831e-15;428;-4;544;10929;1;51;1.69672e+08;-1.80171e+07;0;0;0;0;0;0;169671811;169692012;319969
771;4.78831e-15;428;-5;544;10929;1;51;1.70569e+08;-1.79487e+07;0;0;0;0;0;0;170569266;170590035;327995
772;4.78831e-15;428;-5;544;10929;1;51;1.71463e+08;-1.78804e+07;1;0;0;0;1;0;171463304;171484655;336157
773;4.78831e-15;428;-5;544;10929;1;51;1.72354e+08;-1.78122e+07;1;0;0;0;1;0;172353933;172375878;344456
774;4.78831e-15;429;-5;544;10929;1;51;1.73241e+08;-1.77442e+07;0;0;0;0;0;0;173241162;173263712;352892
775;4.78831e-15;429;-5;544;10929;1;51;1.74125e+08;-1.76763e+07;1;0;0;0;1;0;174124997;174148165;361467
776;4.78831e-15;429;-5;544;10929;1;51;1.75005e+08;-1.76086e+07;0;0;-1;0;0;-1;175005447;175029246;370182
777;4.78831e-15;429;-5;544;10929;1;51;1.75883e+08;-1.75411e+07;0;0;-1;0;0;-1;175882520;175906962;379036
778;4.78831e-15;429;-5;544;10929;1;51;1.76756e+08;-1.74737e+07;1;0;0;0;1;0;176756225;176781323;388032
779;4.78831e-15;429;-5;544;10929;1;51;1.77627e+08;-1.74065e+07;1;0;0;0;1;0;177626570;177652338;397170
780;4.78831e-15;429;-5;544;10929;1;51;1.78494e+08;-1.73395e+07;1;0;0;0;1;0;178493566;178520015;406451
781;4.78831e-15;430;-5;544;10929;1;51;1.79357e+08;-1.72727e+07;0;0;0;0;0;0;179357220;179384365;415876
782;4.78831e-15;430;-5;544;10929;1;51;1.80218e+08;-1.72061e+07;1;0;0;0;1;0;180217543;180245398;425445
783;4.78831e-15;431;-5;544;10929;1;51;1.81075e+08;-1.71396e+07;0;0;0;0;0;0;181074545;181103122;435159
784;4.78831e-15;431;-5;544;10929;1;51;1.81928e+08;-1.70734e+07;1;0;0;0;1;0;181928235;181957549;445019
785;4.78831e-15;432;-5;544;10929;1;51;1.82779e+08;-1.70074e+07;0;0;0;0;0;0;182778623;182808688;455026
786;4.78831e-15;433;-5;544;10929;1;51;1.83626e+08;-1.69416e+07;0;0;0;0;0;0;183625721;183656550;465181
787;4.78831e-15;434;-5;544;10929;1;51;1.8447e+08;-1.68759e+07;0;0;0;0;0;0;184469538;184501146;475484
788;4.78831e-15;434;-5;544;10929;1;51;1.8531e+08;-1.68105e+07;1;0;0;0;1;0;185310085;185342486;485936
789;4.78831e-15;434;-5;544;10929;1;51;1.86147e+08;-1.67454e+07;1;0;0;0;1;0;186147373;186180582;496537
790;4.78831e-15;434;-5;544;10929;1;51;1.86981e+08;-1.66804e+07;1;0;0;0;1;0;186981414;187015445;507289
791;4.78831e-15;434;-5;544;10929;1;51;1.87812e+08;-1.66157e+07;1;0;0;0;1;0;187812217;187847086;518192
792;4.78831e-15;434;-5;544;10929;1;51;1.8864e+08;-1.65512e+07;1;0;0;0;1;0;188639795;188675517;529247
793;4.78831e-15;434;-5;544;10929;1;51;1.89464e+08;-1.64869e+07;1;0;0;0;1;0;189464159;189500748;540455
794;4.78831e-15;434;-5;544;10929;1;51;1.90285e+08;-1.64228e+07;1;0;0;0;1;0;190285320;190322793;551815
795;4.78831e-15;435;-5;544;10929;1;51;1.91103e+08;-1.6359e+07;0;0;0;0;0;0;191103291;191141662;563329
796;4.78831e-15;436;-5;544;10929;1;51;1.91918e+08;-1.62954e+07;0;0;0;0;0;0;191918082;191957367;574997
797;4.78831e-15;436;-5;544;10929;1;51;1.9273e+08;-1.62321e+07;1;0;0;0;1;0;192729706;192769921;586820
798;4.78831e-15;436;-5;544;10929;1;51;1.93538e+08;-1.6169e+07;1;0;0;0;1;0;193538174;193579336;598799
799;4.78831e-15;437;-5;544;10929;1;51;1.94343e+08;-1.61061e+07;0;0;0;0;0;0;194343500;194385624;610933
800;4.78831e-15;438;-5;544;10929;1;51;1.95146e+08;-1.60435e+07;0;0;0;0;0;0;195145695;195188797;623224
801;4.78831e-15;438;-5;544;10929;1;51;1.95945e+08;-1.59811e+07;1;0;0;0;1;0;195944770;195988868;635672
802;4.78831e-15;438;-5;544;10929;1;51;1.96741e+08;-1.5919e+07;1;0;0;0;1;0;196740740;196785849;648278
803;4.78831e-15;439;-5;544;10929;1;51;1.97534e+08;-1.58571e+07;0;0;0;0;0;0;197533615;197579753;661042
804;4.78831e-15;439;-6;544;10929;1;51;1.98323e+08;-1.57955e+07;0;0;0;0;0;0;198323408;198370592;673964
805;4.78831e-15;440;-6;544;10929;1;51;1.9911e+08;-1.57341e+07;0;0;0;0;0;0;199110133;199158379;687046
806;4.78831e-15;441;-6;544;10929;1;51;1.99894e+08;-1.5673e+07;0;0;0;0;0;0;199893801;199943127;700287
807;4.78831e-15;442;-6;544;10929;1;51;2.00674e+08;-1.56121e+07;0;0;0;0;0;0;200674426;200724848;713688
808;4.78831e-15;442;-6;544;10929;1;51;2.01452e+08;-1.55515e+07;1;0;0;0;1;0;201452019;201503556;727249
809;4.78831e-15;442;-6;544;10929;1;51;2.02227e+08;-1.54911e+07;1;0;0;0;1;0;202226593;202279263;740971
810;4.78831e-15;443;-6;544;10929;1;51;2.02998e+08;-1.5431e+07;0;0;0;0;0;0;202998163;203051983;754854
811;4.78831e-15;443;-6;544;10929;1;51;2.03767e+08;-1.53711e+07;1;0;0;0;1;0;203766739;203821727;768899
812;4.78831e-15;444;-6;544;10929;1;51;2.04532e+08;-1.53115e+07;0;0;0;0;0;0;204532335;204588510;783106
813;4.78831e-15;445;-6;544;10929;1;51;2.05295e+08;-1.52522e+07;0;0;0;0;0;0;205294965;205352345;797476
814;4.78831e-15;445;-6;544;10929;1;51;2.06055e+08;-1.51931e+07;0;0;-1;0;0;-1;206054640;206113243;812008
815;4.78831e-15;445;-6;544;10929;1;51;2.06811e+08;-1.51343e+07;1;0;0;0;1;0;206811374;206871219;826703
816;4.78831e-15;446;-6;544;10929;1;51;2.07565e+08;-1.50757e+07;0;0;0;0;0;0;207565180;207626286;841561
817;4.78831e-15;446;-6;544;10929;1;51;2.08316e+08;-1.50174e+07;1;0;0;0;1;0;208316071;208378456;856583
818;4.78831e-15;446;-6;544;10929;1;51;2.09064e+08;-1.49594e+07;1;0;0;0;1;0;209064059;209127744;871769
819;4.78831e-15;447;-6;544;10929;1;51;2.09809e+08;-1.49016e+07;0;0;0;0;0;0;209809158;209874161;887120
820;4.78831e-15;448;-6;544;10929;1;51;2.10551e+08;-1.48441e+07;0;0;0;0;0;0;210551381;210617721;902634
821;4.78831e-15;448;-6;544;10929;1;51;2.11291e+08;-1.47868e+07;1;0;0;0;1;0;211290741;211358438;918314
822;4.78831e-15;448;-7;544;10929;1;51;2.12027e+08;-1.47298e+07;0;0;0;0;0;0;212027250;212096324;934158
823;4.78831e-15;449;-7;544;10929;1;51;2.12761e+08;-1.4673e+07;0;0;0;0;0;0;212760922;212831393;950168
824;4.78831e-15;450;-7;544;10929;1;51;2.13492e+08;-1.46166e+07;0;0;0;0;0;0;213491770;213563658;966343
825;4.78831e-15;450;-7;544;10929;1;51;2.1422e+08;-1.45603e+07;1;0;0;0;1;0;214219807;214293132;982684
826;4.78831e-15;450;-7;544;10929;1;51;2.14945e+08;-1.45044e+07;1;0;0;0;1;0;214945046;215019828;999191
827;4.78831e-15;450;-7;544;10929;1;51;2.15668e+08;-1.44487e+07;1;0;0;0;1;0;215667500;215743759;1015864
828;4.78831e-15;450;-7;544;10929;1;51;2.16387e+08;-1.43932e+07;1;0;0;0;1;0;216387181;216464939;1032703
829;4.78831e-15;450;-7;544;10929;1;51;2.17104e+08;-1.4338e+07;1;0;0;0;1;0;217104103;217183380;1049708
830;4.78831e-15;451;-7;544;10929;1;51;2.17818e+08;-1.42831e+07;0;0;0;0;0;0;217818279;217899096;1066879
831;4.78831e-15;452;-7;544;10929;1;51;2.1853e+08;-1.42285e+07;0;0;0;0;0;0;218529722;218612100;1084217
832;4.78831e-15;452;-7;544;10929;1;51;2.19238e+08;-1.4174e+07;1;0;0;0;1;0;219238444;219322404;1101722
833;4.78831e-15;453;-7;544;10929;1;51;2.19944e+08;-1.41199e+07;0;0;0;0;0;0;219944459;220030023;1119394
834;4.78831e-15;454;-7;544;10929;1;51;2.20648e+08;-1.4066e+07;0;0;0;0;0;0;220647779;220734968;1137232
835;4.78831e-15;455;-7;544;10929;1;51;2.21348e+08;-1.40124e+07;0;0;0;0;0;0;221348418;221437254;1155238
836;4.78831e-15;456;-7;544;10929;1;51;2.22046e+08;-1.3959e+07;0;0;0;0;0;0;222046388;222136892;1173410
837;4.78831e-15;456;-7;544;10929;1;51;2.22742e+08;-1.39059e+07;1;0;0;0;1;0;222741701;222833896;1191750
838;4.78831e-15;456;-7;544;10929;1;51;2.23434e+08;-1.3853e+07;1;0;0;0;1;0;223434371;223528279;1210256
839;4.78831e-15;457;-7;544;10929;1;51;2.24124e+08;-1.38004e+07;0;0;0;0;0;0;224124411;224220053;1228930
840;4.78831e-15;458;-7;544;10929;1;51;2.24812e+08;-1.3748e+07;0;0;0;0;0;0;224811832;224909232;1247771
841;4.78831e-15;458;-7;544;10929;1;51;2.25497e+08;-1.36959e+07;1;0;0;0;1;0;225496649;225595828;1266779
842;4.78831e-15;458;-7;544;10929;1;51;2.26179e+08;-1.36441e+07;1;0;0;0;1;0;226178873;226279854;1285954
843;4.78831e-15;459;-7;544;10929;1;51;2.26859e+08;-1.35925e+07;0;0;0;0;0;0;226858517;226961324;1305296
844;4.78831e-15;460;-7;544;10929;1;51;2.27536e+08;-1.35411e+07;0;0;0;0;0;0;227535593;227640248;1324805
845;4.78831e-15;461;-7;544;10929;1;51;2.2821e+08;-1.349e+07;0;0;0;0;0;0;228210115;228316641;1344482
846;4.78831e-15;462;-7;544;10929;1;51;2.28882e+08;-1.34392e+07;0;0;0;0;0;0;228882094;228990515;1364325
847;4.78831e-15;462;-7;544;10929;1;51;2.29552e+08;-1.33886e+07;1;0;0;0;1;0;229551544;229661882;1384335
848;4.78831e-15;462;-7;544;10929;1;51;2.30218e+08;-1.33382e+07;1;0;0;0;1;0;230218475;230330755;1404512
849;4.78831e-15;462;-7;544;10929;1;51;2.30883e+08;-1.32881e+07;1;0;0;0;1;0;230882902;230997147;1424856
850;4.78831e-15;462;-7;544;10929;1;51;2.31545e+08;-1.32383e+07;1;0;0;0;1;0;231544836;231661069;1445366
851;4.78831e-15;463;-7;544;10929;1;51;2.32204e+08;-1.31887e+07;0;0;0;0;0;0;232204289;232322535;1466043
852;4.78831e-15;463;-7;544;10929;1;51;2.32861e+08;-1.31393e+07;1;0;0;0;1;0;232861274;232981557;1486886
853;4.78831e-15;463;-7;544;10929;1;51;2.33516e+08;-1.30902e+07;1;0;0;0;1;0;233515803;233638146;1507896
854;4.78831e-15;463;-7;544;10929;1;51;2.34168e+08;-1.30413e+07;1;0;0;0;1;0;234167888;234292317;1529072
855;4.78831e-15;464;-7;544;10929;1;51;2.34818e+08;-1.29927e+07;0;0;0;0;0;0;234817541;234944079;1550414
856;4.78831e-15;465;-7;544;10929;1;51;2.35465e+08;-1.29443e+07;0;0;0;0;0;0;235464775;235593447;1571921
857;4.78831e-15;466;-7;544;10929;1;51;2.3611e+08;-1.28961e+07;0;0;0;0;0;0;236109600;236240431;1593595
858;4.78831e-15;467;-7;544;10929;1;51;2.36752e+08;-1.28482e+07;0;0;0;0;0;0;236752030;236885044;1615433
859;4.78831e-15;467;-7;544;10929;1;51;2.37392e+08;-1.28005e+07;1;0;0;0;1;0;237392075;237527299;1637437
860;4.78831e-15;468;-7;544;10929;1;51;2.3803e+08;-1.27531e+07;0;0;0;0;0;0;238029749;238167206;1659607
861;4.78831e-15;468;-7;544;10929;1;51;2.38665e+08;-1.27059e+07;1;0;0;0;1;0;238665062;238804778;1681941
862;4.78831e-15;469;-7;544;10929;1;51;2.39298e+08;-1.26589e+07;0;0;0;0;0;0;239298027;239440027;1704440
863;4.78831e-15;470;-7;544;10929;1;51;2.39929e+08;-1.26122e+07;0;0;0;0;0;0;239928655;240072965;1727103
864;4.78831e-15;471;-7;544;10929;1;51;2.40557e+08;-1.25657e+07;0;0;0;0;0;0;240556958;240703603;1749930
865;4.78831e-15;471;-7;544;10929;1;51;2.41183e+08;-1.25194e+07;1;0;0;0;1;0;241182947;241331953;1772922
866;4.78831e-15;471;-7;544;10929;1;51;2.41807e+08;-1.24733e+07;1;0;0;0;1;0;241806634;241958027;1796077
867;4.78831e-15;472;-7;544;10929;1;51;2.42428e+08;-1.24275e+07;0;0;0;0;0;0;242428031;242581837;1819396
868;4.78831e-15;472;-7;544;10929;1;51;2.43047e+08;-1.23819e+07;1;0;0;0;1;0;243047148;243203394;1842878
869;4.78831e-15;473;-7;544;10929;1;51;2.43664e+08;-1.23366e+07;0;0;0;0;0;0;243663998;243822709;1866523
870;4.78831e-15;473;-7;544;10929;1;51;2.44279e+08;-1.22915e+07;1;0;0;0;1;0;244278591;244439794;1890330
871;4.78831e-15;474;-7;544;10929;1;51;2.44891e+08;-1.22466e+07;0;0;0;0;0;0;244890940;245054660;1914300
872;4.78831e-15;475;-7;544;10929;1;51;2.45501e+08;-1.22019e+07;0;0;0;0;0;0;245501054;245667319;1938432
873;4.78831e-15;475;-7;544;10929;1;51;2.46109e+08;-1.21574e+07;1;0;0;0;1;0;246108946;246277782;1962725
874;4.78831e-15;476;-7;544;10929;1;51;2.46715e+08;-1.21132e+07;0;0;0;0;0;0;246714626;246886061;1987180
875;4.78831e-15;476;-7;544;10929;1;51;2.47318e+08;-1.20692e+07;0;0;-1;0;0;-1;247318106;247492166;2011796
876;4.78831e-15;476;-7;544;10929;1;51;2.47919e+08;-1.20254e+07;1;0;0;0;1;0;247919396;248096108;2036573
877;4.78831e-15;477;-7;544;10929;1;51;2.48519e+08;-1.19818e+07;0;0;0;0;0;0;248518508;248697899;2061510
878;4.78831e-15;477;-7;544;10929;1;51;2.49115e+08;-1.19385e+07;1;0;0;0;1;0;249115452;249297549;2086608
879;4.78831e-15;478;-7;544;10929;1;51;2.4971e+08;-1.18953e+07;0;0;0;0;0;0;249710239;249895070;2111865
880;4.78831e-15;479;-7;544;10929;1;51;2.50303e+08;-1.18524e+07;0;0;0;0;0;0;250302880;250490473;2137281
881;4.78831e-15;480;-7;544;10929;1;51;2.50893e+08;-1.18097e+07;0;0;0;0;0;0;250893386;251083768;2162856
882;4.78831e-15;481;-7;544;10929;1;51;2.51482e+08;-1.17672e+07;0;0;0;0;0;0;251481767;251674966;2188590
883;4.78831e-15;481;-7;544;10929;1;51;2.52068e+08;-1.17249e+07;1;0;0;0;1;0;252068034;252264077;2214482
884;4.78831e-15;482;-7;544;10929;1;51;2.52652e+08;-1.16829e+07;0;0;0;0;0;0;252652197;252851113;2240532
885;4.78831e-15;482;-7;544;10929;1;51;2.53234e+08;-1.1641e+07;1;0;0;0;1;0;253234268;253436085;2266739
886;4.78831e-15;482;-8;544;10929;1;51;2.53814e+08;-1.15994e+07;0;0;0;0;0;0;253814256;254019002;2293103
887;4.78831e-15;482;-8;544;10929;1;51;2.54392e+08;-1.15579e+07;1;0;0;0;1;0;254392172;254599875;2319624
888;4.78831e-15;482;-8;544;10929;1;51;2.54968e+08;-1.15167e+07;1;0;0;0;1;0;254968026;255178714;2346301
889;4.78831e-15;482;-8;544;10929;1;51;2.55542e+08;-1.14756e+07;1;0;0;0;1;0;255541829;255755531;2373134
890;4.78831e-15;482;-8;544;10929;1;51;2.56114e+08;-1.14348e+07;1;0;0;0;1;0;256113590;256330335;2400122
891;4.78831e-15;482;-8;544;10929;1;51;2.56683e+08;-1.13942e+07;0;0;-1;0;0;-1;256683320;256903136;2427265
892;4.78831e-15;482;-8;544;10929;1;51;2.57251e+08;-1.13538e+07;1;0;0;0;1;0;257251030;257473946;2454562
893;4.78831e-15;482;-8;544;10929;1;51;2.57817e+08;-1.13136e+07;1;0;0;0;1;0;257816728;258042773;2482013
894;4.78831e-15;483;-8;544;10929;1;51;2.5838e+08;-1.12735e+07;0;0;0;0;0;0;258380425;258609628;2509618
895;4.78831e-15;483;-8;544;10929;1;51;2.58942e+08;-1.12337e+07;1;0;0;0;1;0;258942132;259174521;2537376
896;4.78831e-15;483;-8;544;10929;1;51;2.59502e+08;-1.11941e+07;1;0;0;0;1;0;259501857;259737463;2565286
897;4.78831e-15;483;-8;544;10929;1;51;2.6006e+08;-1.11547e+07;1;0;0;0;1;0;260059611;260298462;2593349
898;4.78831e-15;483;-8;544;10929;1;51;2.60615e+08;-1.11154e+07;1;0;0;0;1;0;260615404;260857530;2621563
899;4.78831e-15;483;-8;544;10929;1;51;2.61169e+08;-1.10764e+07;1;0;0;0;1;0;261169244;261414675;2649928
900;4.78831e-15;483;-8;544;10929;1;51;2.61721e+08;-1.10376e+07;1;0;0;0;1;0;261721143;261969907;2678444
901;4.78831e-15;484;-8;544;10929;1;51;2.62271e+08;-1.09989e+07;0;0;0;0;0;0;262271109;262523237;2707110
902;4.78831e-15;484;-8;544;10929;1;51;2.62819e+08;-1.09605e+07;1;0;0;0;1;0;262819153;263074673;2735926
903;4.78831e-15;485;-8;544;10929;1;51;2.63365e+08;-1.09222e+07;0;0;0;0;0;0;263365283;263624226;2764891
904;4.78831e-15;486;-8;544;10929;1;51;2.6391e+08;-1.08841e+07;0;0;0;0;0;0;263909509;264171905;2794005
905;4.78831e-15;486;-8;544;10929;1;51;2.64452e+08;-1.08462e+07;1;0;0;0;1;0;264451840;264717720;2823266
906;4.78831e-15;486;-8;544;10929;1;51;2.64992e+08;-1.08085e+07;1;0;0;0;1;0;264992286;265261679;2852676
907;4.78831e-15;486;-8;544;10929;1;51;2.65531e+08;-1.0771e+07;1;0;0;0;1;0;265530857;265803793;2882232
908;4.78831e-15;487;-8;544;10929;1;51;2.66068e+08;-1.07337e+07;0;0;0;0;0;0;266067560;266344070;2911936
909;4.78831e-15;488;-8;544;10929;1;51;2.66602e+08;-1.06965e+07;0;0;0;0;0;0;266602406;266882520;2941785
910;4.78831e-15;489;-8;544;10929;1;51;2.67135e+08;-1.06596e+07;0;0;0;0;0;0;267135404;267419152;2971779
911;4.78831e-15;490;-8;544;10929;1;51;2.67667e+08;-1.06228e+07;0;0;0;0;0;0;267666563;267953975;3001919
912;4.78831e-15;491;-8;544;10929;1;51;2.68196e+08;-1.05862e+07;0;0;0;0;0;0;268195891;268486999;3032203
913;4.78831e-15;492;-8;544;10929;1;51;2.68723e+08;-1.05497e+07;0;0;0;0;0;0;268723398;269018232;3062631
914;4.78831e-15;492;-8;544;10929;1;51;2.69249e+08;-1.05135e+07;1;0;0;0;1;0;269249092;269547683;3093202
915;4.78831e-15;492;-8;544;10929;1;51;2.69773e+08;-1.04774e+07;1;0;0;0;1;0;269772983;270075362;3123916
916;4.78831e-15;492;-8;544;10929;1;51;2.70295e+08;-1.04415e+07;1;0;0;0;1;0;270295079;270601277;3154773
917;4.78831e-15;493;-8;544;10929;1;51;2.70815e+08;-1.04058e+07;0;0;0;0;0;0;270815390;271125437;3185771
918;4.78831e-15;493;-8;544;10929;1;51;2.71334e+08;-1.03703e+07;1;0;0;0;1;0;271333923;271647851;3216910
919;4.78831e-15;494;-8;544;10929;1;51;2.71851e+08;-1.03349e+07;0;0;0;0;0;0;271850687;272168527;3248189
920;4.78831e-15;495;-8;544;10929;1;51;2.72366e+08;-1.02997e+07;0;0;0;0;0;0;272365692;272687474;3279608
921;4.78831e-15;495;-8;544;10929;1;51;2.72879e+08;-1.02647e+07;1;0;0;0;1;0;272878945;273204702;3311167
922;4.78831e-15;496;-8;544;10929;1;51;2.7339e+08;-1.02298e+07;0;0;0;0;0;0;273390455;273720218;3342865
923;4.78831e-15;496;-8;544;10929;1;51;2.739e+08;-1.01951e+07;1;0;0;0;1;0;273900230;274234031;3374701
924;4.78831e-15;496;-8;544;10929;1;51;2.74408e+08;-1.01606e+07;1;0;0;0;1;0;274408280;274746149;3406674
925;4.78831e-15;497;-8;544;10929;1;51;2.74915e+08;-1.01262e+07;0;0;0;0;0;0;274914612;275256581;3438784
926;4.78831e-15;497;-8;544;10929;1;51;2.75419e+08;-1.0092e+07;1;0;0;0;1;0;275419234;275765336;3471031
927;4.78831e-15;498;-8;544;10929;1;51;2.75922e+08;-1.0058e+07;0;0;0;0;0;0;275922155;276272421;3503414
928;4.78831e-15;499;-8;544;10929;1;51;2.76423e+08;-1.00242e+07;0;0;0;0;0;0;276423384;276777845;3535932
929;4.78831e-15;499;-8;544;10929;1;51;2.76923e+08;-9.99046e+06;1;0;0;0;1;0;276922927;277281615;3568584
930;4.78831e-15;500;-8;544;10929;1;51;2.77421e+08;-9.95693e+06;0;0;0;0;0;0;277420794;277783741;3601371
931;4.78831e-15;501;-8;544;10929;1;51;2.77917e+08;-9.92356e+06;0;0;0;0;0;0;277916992;278284231;3634291
932;4.78831e-15;502;-8;544;10929;1;51;2.78412e+08;-9.89034e+06;0;0;0;0;0;0;278411530;278783091;3667344
933;4.78831e-15;502;-8;544;10929;1;51;2.78904e+08;-9.85729e+06;1;0;0;0;1;0;278904415;279280332;3700529
934;4.78831e-15;502;-8;544;10929;1;51;2.79396e+08;-9.82439e+06;1;0;0;0;1;0;279395655;279775959;3733845
935;4.78831e-15;502;-9;544;10929;1;51;2.79885e+08;-9.79166e+06;0;0;0;0;0;0;279885258;280269982;3767293
936;4.78831e-15;502;-9;544;10929;1;51;2.80373e+08;-9.75907e+06;1;0;0;0;1;0;280373232;280762408;3800871
937;4.78831e-15;502;-9;544;10929;1;51;2.8086e+08;-9.72665e+06;1;0;0;0;1;0;280859584;281253245;3834578
938;4.78831e-15;503;-9;544;10929;1;51;2.81344e+08;-9.69438e+06;0;0;0;0;0;0;281344324;281742501;3868415
939;4.78831e-15;504;-9;544;10929;1;51;2.81827e+08;-9.66226e+06;0;0;0;0;0;0;281827457;282230183;3902380
940;4.78831e-15;504;-9;544;10929;1;51;2.82309e+08;-9.63029e+06;1;0;0;0;1;0;282308992;282716300;3936473
941;4.78831e-15;504;-9;544;10929;1;51;2.82789e+08;-9.59848e+06;1;0;0;0;1;0;282788936;283200858;3970693
942;4.78831e-15;504;-9;544;10929;1;51;2.83267e+08;-9.56681e+06;1;0;0;0;1;0;283267297;283683866;4005040
943;4.78831e-15;504;-9;544;10929;1;51;2.83744e+08;-9.5353e+06;1;0;0;0;1;0;283744082;284165331;4039513
944;4.78831e-15;504;-9;544;10929;1;51;2.84219e+08;-9.50393e+06;1;0;0;0;1;0;284219299;284645260;4074111
945;4.78831e-15;504;-9;544;10929;1;51;2.84693e+08;-9.47272e+06;1;0;0;0;1;0;284692955;285123661;4108834
946;4.78831e-15;504;-9;544;10929;1;51;2.85165e+08;-9.44165e+06;0;0;-1;0;0;-1;285165058;285600541;4143681
947;4.78831e-15;505;-9;544;10929;1;51;2.85636e+08;-9.41072e+06;0;0;0;0;0;0;285635615;286075909;4178652
948;4.78831e-15;506;-9;544;10929;1;51;2.86105e+08;-9.37995e+06;0;0;0;0;0;0;286104632;286549770;4213745
949;4.78831e-15;507;-9;544;10929;1;51;2.86572e+08;-9.34931e+06;0;0;0;0;0;0;286572118;287022132;4248960
950;4.78831e-15;508;-9;544;10929;1;51;2.87038e+08;-9.31882e+06;0;0;0;0;0;0;287038080;287493003;4284297
951;4.78831e-15;508;-9;544;10929;1;51;2.87503e+08;-9.28848e+06;1;0;0;0;1;0;287502524;287962389;4319755
952;4.78831e-15;508;-9;544;10929;1;51;2.87965e+08;-9.25827e+06;1;0;0;0;1;0;287965458;288430298;4355333
953;4.78831e-15;508;-9;544;10929;1;51;2.88427e+08;-9.2282e+06;1;0;0;0;1;0;288426888;288896737;4391030
954;4.78831e-15;509;-9;544;10929;1;51;2.88887e+08;-9.19828e+06;0;0;0;0;0;0;288886823;289361713;4426846
955;4.78831e-15;509;-9;544;10929;1;51;2.89345e+08;-9.16849e+06;1;0;0;0;1;0;289345268;289825233;4462781
956;4.78831e-15;510;-9;544;10929;1;51;2.89802e+08;-9.13885e+06;0;0;0;0;0;0;289802231;290287304;4498833
957;4.78831e-15;511;-9;544;10929;1;51;2.90258e+08;-9.10934e+06;0;0;0;0;0;0;290257718;290747933;4535003
958;4.78831e-15;511;-9;544;10929;1;51;2.90712e+08;-9.07997e+06;1;0;0;0;1;0;290711737;291207126;4571288
959;4.78831e-15;512;-9;544;10929;1;51;2.91164e+08;-9.05073e+06;0;0;0;0;0;0;291164294;291664891;4607689
960;4.78831e-15;512;-9;544;10929;1;51;2.91615e+08;-9.02163e+06;1;0;0;0;1;0;291615395;292121234;4644206
961;4.78831e-15;512;-9;544;10929;1;51;2.92065e+08;-8.99266e+06;1;0;0;0;1;0;292065049;292576162;4680836
962;4.78831e-15;513;-9;544;10929;1;51;2.92513e+08;-8.96383e+06;0;0;0;0;0;0;292513260;293029682;4717581
963;4.78831e-15;514;-9;544;10929;1;51;2.9296e+08;-8.93512e+06;0;0;0;0;0;0;292960037;293481800;4754438
964;4.78831e-15;515;-9;544;10929;1;51;2.93405e+08;-8.90656e+06;0;0;0;0;0;0;293405385;293932523;4791408
965;4.78831e-15;516;-9;544;10929;1;51;2.93849e+08;-8.87812e+06;0;0;0;0;0;0;293849312;294381858;4828489
966;4.78831e-15;516;-9;544;10929;1;51;2.94292e+08;-8.84981e+06;1;0;0;0;1;0;294291823;294829811;4865682
967;4.78831e-15;516;-9;544;10929;1;51;2.94733e+08;-8.82163e+06;1;0;0;0;1;0;294732925;295276388;4902985
968;4.78831e-15;516;-10;544;10929;1;51;2.95173e+08;-8.79358e+06;0;0;0;0;0;0;295172624;295721597;4940398
969;4.78831e-15;516;-10;544;10929;1;51;2.95611e+08;-8.76566e+06;1;0;0;0;1;0;295610927;296165443;4977920
970;4.78831e-15;516;-10;544;10929;1;51;2.96048e+08;-8.73786e+06;1;0;0;0;1;0;296047841;296607934;5015550
971;4.78831e-15;517;-10;544;10929;1;51;2.96483e+08;-8.7102e+06;0;0;0;0;0;0;296483371;297049074;5053288
972;4.78831e-15;517;-10;544;10929;1;51;2.96918e+08;-8.68265e+06;1;0;0;0;1;0;296917524;297488871;5091134
973;4.78831e-15;517;-10;544;10929;1;51;2.9735e+08;-8.65524e+06;1;0;0;0;1;0;297350307;297927331;5129086
974;4.78831e-15;517;-10;544;10929;1;51;2.97782e+08;-8.62794e+06;1;0;0;0;1;0;297781724;298364459;5167143
975;4.78831e-15;517;-10;544;10929;1;51;2.98212e+08;-8.60077e+06;1;0;0;0;1;0;298211783;298800263;5205306
976;4.78831e-15;518;-10;544;10929;1;51;2.9864e+08;-8.57372e+06;0;0;0;0;0;0;298640490;299234749;5243574
977;4.78831e-15;518;-10;544;10929;1;51;2.99068e+08;-8.5468e+06;1;0;0;0;1;0;299067850;299667922;5281945
978;4.78831e-15;518;-10;544;10929;1;51;2.99494e+08;-8.51999e+06;1;0;0;0;1;0;299493870;300099788;5320419
979;4.78831e-15;519;-10;544;10929;1;51;2.99919e+08;-8.49331e+06;0;0;0;0;0;0;299918556;300530354;5358996
980;4.78831e-15;520;-10;544;10929;1;51;3.00342e+08;-8.46674e+06;0;0;0;0;0;0;300341913;300959626;5397675
981;4.78831e-15;521;-10;544;10929;1;51;3.00764e+08;-8.4403e+06;0;0;0;0;0;0;300763949;301387609;5436455
982;4.78831e-15;522;-10;544;10929;1;51;3.01185e+08;-8.41397e+06;0;0;0;0;0;0;301184668;301814310;5475336
983;4.78831e-15;523;-10;544;10929;1;51;3.01604e+08;-8.38776e+06;0;0;0;0;0;0;301604076;302239734;5514317
984;4.78831e-15;523;-10;544;10929;1;51;3.02022e+08;-8.36166e+06;1;0;0;0;1;0;302022180;302663887;5553396
985;4.78831e-15;523;-10;544;10929;1;51;3.02439e+08;-8.33569e+06;1;0;0;0;1;0;302438984;303086775;5592575
986;4.78831e-15;523;-10;544;10929;1;51;3.02854e+08;-8.30982e+06;1;0;0;0;1;0;302854496;303508405;5631851
987;4.78831e-15;524;-10;544;10929;1;51;3.03269e+08;-8.28408e+06;0;0;0;0;0;0;303268721;303928780;5671225
988;4.78831e-15;525;-10;544;10929;1;51;3.03682e+08;-8.25844e+06;0;0;0;0;0;0;303681663;304347908;5710695
989;4.78831e-15;525;-10;544;10929;1;51;3.04093e+08;-8.23293e+06;1;0;0;0;1;0;304093330;304765794;5750262
990;4.78831e-15;526;-10;544;10929;1;51;3.04504e+08;-8.20752e+06;0;0;0;0;0;0;304503727;305182444;5789923
991;4.78831e-15;527;-10;544;10929;1;51;3.04913e+08;-8.18222e+06;0;0;0;0;0;0;304912858;305597862;5829680
992;4.78831e-15;528;-10;544;10929;1;51;3.05321e+08;-8.15704e+06;0;0;0;0;0;0;305320731;306012056;5869530
993;4.78831e-15;528;-10;544;10929;1;51;3.05727e+08;-8.13197e+06;1;0;0;0;1;0;305727349;306425029;5909474
994;4.78831e-15;529;-10;544;10929;1;51;3.06133e+08;-8.107e+06;0;0;0;0;0;0;306132720;306836789;5949510
995;4.78831e-15;530;-10;544;10929;1;51;3.06537e+08;-8.08215e+06;0;0;0;0;0;0;306536848;307247340;5989639
996;4.78831e-15;530;-10;544;10929;1;51;3.0694e+08;-8.0574e+06;1;0;0;0;1;0;306939739;307656687;6029859
997;4.78831e-15;530;-10;544;10929;1;51;3.07341e+08;-8.03277e+06;1;0;0;0;1;0;307341398;308064837;6070169
998;4.78831e-15;530;-10;544;10929;1;51;3.07742e+08;-8.00824e+06;1;0;0;0;1;0;307741830;308471794;6110570
999;4.78831e-15;531;-10;544;10929;1;51;3.08141e+08;-7.98382e+06;0;0;0;0;0;0;308141042;308877564;6151060
1000;4.78831e-15;532;-10;544;10929;1;51;3.08539e+08;-7.9595e+06;0;0;0;0;0;0;308539037;309282152;6191639
1001;4.78831e-15;532;-10;544;10929;1;51;3.08936e+08;-7.93529e+06;1;0;0;0;1;0;308935822;309685563;6232307
1002;4.78831e-15;532;-10;544;10929;1;51;3.09331e+08;-7.91118e+06;1;0;0;0;1;0;309331402;310087803;6273061
1003;4.78831e-15;532;-10;544;10929;1;51;3.09726e+08;-7.88718e+06;1;0;0;0;1;0;309725781;310488877;6313903
1004;4.78831e-15;532;-10;544;10929;1;51;3.10119e+08;-7.86328e+06;1;0;0;0;1;0;310118966;310888790;6354831
1005;4.78831e-15;533;-10;544;10929;1;51;3.10511e+08;-7.83949e+06;0;0;0;0;0;0;310510961;311287548;6395845
1006;4.78831e-15;533;-10;544;10929;1;51;3.10902e+08;-7.8158e+06;1;0;0;0;1;0;310901771;311685154;6436943
1007;4.78831e-15;533;-10;544;10929;1;51;3.11291e+08;-7.7922e+06;0;0;-1;0;0;-1;311291402;312081615;6478126
1008;4.78831e-15;534;-10;544;10929;1;51;3.1168e+08;-7.76872e+06;0;0;0;0;0;0;311679858;312476935;6519392
1009;4.78831e-15;534;-10;544;10929;1;51;3.12067e+08;-7.74533e+06;1;0;0;0;1;0;312067145;312871120;6560742
1010;4.78831e-15;535;-10;544;10929;1;51;3.12453e+08;-7.72204e+06;0;0;0;0;0;0;312453268;313264174;6602174
1011;4.78831e-15;535;-10;544;10929;1;51;3.12838e+08;-7.69885e+06;1;0;0;0;1;0;312838231;313656102;6643688
1012;4.78831e-15;536;-10;544;10929;1;51;3.13222e+08;-7.67576e+06;0;0;0;0;0;0;313222039;314046910;6685282
1013;4.78831e-15;536;-10;544;10929;1;51;3.13605e+08;-7.65277e+06;1;0;0;0;1;0;313604698;314436602;6726958
1014;4.78831e-15;537;-10;544;10929;1;51;3.13986e+08;-7.62987e+06;0;0;0;0;0;0;313986212;314825184;6768713
1015;4.78831e-15;537;-10;544;10929;1;51;3.14367e+08;-7.60708e+06;1;0;0;0;1;0;314366586;315212659;6810547
1016;4.78831e-15;538;-10;544;10929;1;51;3.14746e+08;-7.58438e+06;0;0;0;0;0;0;314745826;315599033;6852460
1017;4.78831e-15;539;-10;544;10929;1;51;3.15124e+08;-7.56177e+06;0;0;0;0;0;0;315123935;315984310;6894451
1018;4.78831e-15;540;-10;544;10929;1;51;3.15501e+08;-7.53926e+06;0;0;0;0;0;0;315500919;316368496;6936520
1019;4.78831e-15;540;-10;544;10929;1;51;3.15877e+08;-7.51685e+06;1;0;0;0;1;0;315876782;316751595;6978665
1020;4.78831e-15;540;-10;544;10929;1;51;3.16252e+08;-7.49453e+06;1;0;0;0;1;0;316251529;317133611;7020886
1021;4.78831e-15;540;-10;544;10929;1;51;3.16625e+08;-7.4723e+06;1;0;0;0;1;0;316625164;317514550;7063183
1022;4.78831e-15;541;-10;544;10929;1;51;3.16998e+08;-7.45017e+06;0;0;0;0;0;0;316997693;317894416;7105554
1023;4.78831e-15;541;-10;544;10929;1;51;3.17369e+08;-7.42813e+06;1;0;0;0;1;0;317369120;318273214;7148000
1024;4.78831e-15;541;-10;544;10929;1;51;3.17739e+08;-7.40618e+06;1;0;0;0;1;0;317739450;318650948;7190519
1025;4.78831e-15;542;-10;544;10929;1;51;3.18109e+08;-7.38433e+06;0;0;0;0;0;0;318108687;319027623;7233112
1026;4.78831e-15;542;-10;544;10929;1;51;3.18477e+08;-7.36256e+06;1;0;0;0;1;0;318476836;319403243;7275777
1027;4.78831e-15;543;-10;544;10929;1;51;3.18844e+08;-7.34089e+06;0;0;0;0;0;0;318843901;319777813;7318513
1028;4.78831e-15;543;-10;544;10929;1;51;3.1921e+08;-7.3193e+06;1;0;0;0;1;0;319209887;320151337;7361321
1029;4.78831e-15;543;-10;544;10929;1;51;3.19575e+08;-7.29781e+06;1;0;0;0;1;0;319574798;320523820;7404199
1030;4.78831e-15;544;-10;544;10929;1;51;3.19939e+08;-7.27641e+06;0;0;0;0;0;0;319938639;320895267;7447147
1031;4.78831e-15;544;-10;544;10929;1;51;3.20301e+08;-7.25509e+06;1;0;0;0;1;0;320301414;321265681;7490164
1032;4.78831e-15;545;-10;544;10929;1;51;3.20663e+08;-7.23386e+06;0;0;0;0;0;0;320663127;321635067;7533251
1033;4.78831e-15;545;-10;544;10929;1;51;3.21024e+08;-7.21272e+06;1;0;0;0;1;0;321023784;322003429;7576405
1034;4.78831e-15;545;-11;544;10929;1;51;3.21383e+08;-7.19167e+06;0;0;0;0;0;0;321383388;322370772;7619627
1035;4.78831e-15;546;-11;544;10929;1;51;3.21742e+08;-7.1707e+06;0;0;0;0;0;0;321741944;322737100;7662915
1036;4.78831e-15;547;-11;544;10929;1;51;3.22099e+08;-7.14982e+06;0;0;0;0;0;0;322099455;323102417;7706270
1037;4.78831e-15;547;-11;544;10929;1;51;3.22456e+08;-7.12902e+06;1;0;0;0;1;0;322455927;323466728;7749691
1038;4.78831e-15;548;-11;544;10929;1;51;3.22811e+08;-7.10831e+06;0;0;0;0;0;0;322811363;323830036;7793176
1039;4.78831e-15;548;-11;544;10929;1;51;3.23166e+08;-7.08769e+06;1;0;0;0;1;0;323165768;324192347;7836727
1040;4.78831e-15;548;-11;544;10929;1;51;3.23519e+08;-7.06714e+06;1;0;0;0;1;0;323519146;324553663;7880341
1041;4.78831e-15;549;-11;544;10929;1;51;3.23872e+08;-7.04669e+06;0;0;0;0;0;0;323871501;324913990;7924018
1042;4.78831e-15;550;-11;544;10929;1;51;3.24223e+08;-7.02631e+06;0;0;0;0;0;0;324222837;325273331;7967758
1043;4.78831e-15;551;-11;544;10929;1;51;3.24573e+08;-7.00602e+06;0;0;0;0;0;0;324573159;325631690;8011560
1044;4.78831e-15;552;-11;544;10929;1;51;3.24922e+08;-6.98581e+06;0;0;0;0;0;0;324922470;325989072;8055424
1045;4.78831e-15;553;-11;544;10929;1;51;3.25271e+08;-6.96568e+06;0;0;0;0;0;0;325270774;326345481;8099349
1046;4.78831e-15;554;-11;544;10929;1;51;3.25618e+08;-6.94563e+06;0;0;0;0;0;0;325618077;326700920;8143334
1047;4.78831e-15;555;-11;544;10929;1;51;3.25964e+08;-6.92567e+06;0;0;0;0;0;0;325964381;327055394;8187379
1048;4.78831e-15;555;-11;544;10929;1;51;3.2631e+08;-6.90578e+06;1;0;0;0;1;0;326309691;327408906;8231483
1049;4.78831e-15;555;-11;544;10929;1;51;3.26654e+08;-6.88598e+06;1;0;0;0;1;0;326654010;327761462;8275646
1050;4.78831e-15;555;-11;544;10929;1;51;3.26997e+08;-6.86625e+06;1;0;0;0;1;0;326997343;328113063;8319866
1051;4.78831e-15;555;-11;544;10929;1;51;3.2734e+08;-6.8466e+06;1;0;0;0;1;0;327339694;328463715;8364145
1052;4.78831e-15;555;-11;544;10929;1;51;3.27681e+08;-6.82704e+06;1;0;0;0;1;0;327681067;328813421;8408480
1053;4.78831e-15;555;-11;544;10929;1;51;3.28021e+08;-6.80755e+06;1;0;0;0;1;0;328021465;329162185;8452871
1054;4.78831e-15;555;-11;544;10929;1;51;3.28361e+08;-6.78813e+06;1;0;0;0;1;0;328360892;329510012;8497318
1055;4.78831e-15;555;-11;544;10929;1;51;3.28699e+08;-6.7688e+06;1;0;0;0;1;0;328699352;329856904;8541821
1056;4.78831e-15;555;-11;544;10929;1;51;3.29037e+08;-6.74954e+06;1;0;0;0;1;0;329036850;330202866;8586378
1057;4.78831e-15;555;-11;544;10929;1;51;3.29373e+08;-6.73036e+06;1;0;0;0;1;0;329373389;330547901;8630989
1058;4.78831e-15;556;-11;544;10929;1;51;3.29709e+08;-6.71125e+06;0;0;0;0;0;0;329708972;330892014;8675653
1059;4.78831e-15;557;-11;544;10929;1;51;3.30044e+08;-6.69222e+06;0;0;0;0;0;0;330043604;331235207;8720370
1060;4.78831e-15;558;-11;544;10929;1;51;3.30377e+08;-6.67327e+06;0;0;0;0;0;0;330377288;331577485;8765140
1061;4.78831e-15;559;-11;544;10929;1;51;3.3071e+08;-6.65439e+06;0;0;0;0;0;0;330710029;331918851;8809962
1062;4.78831e-15;559;-11;544;10929;1;51;3.31042e+08;-6.63558e+06;1;0;0;0;1;0;331041828;332259309;8854835
1063;4.78831e-15;559;-11;544;10929;1;51;3.31373e+08;-6.61685e+06;1;0;0;0;1;0;331372692;332598863;8899758
1064;4.78831e-15;560;-11;544;10929;1;51;3.31703e+08;-6.59819e+06;0;0;0;0;0;0;331702622;332937516;8944732
1065;4.78831e-15;561;-11;544;10929;1;51;3.32032e+08;-6.57961e+06;0;0;0;0;0;0;332031624;333275272;8989755
1066;4.78831e-15;562;-11;544;10929;1;51;3.3236e+08;-6.5611e+06;0;0;0;0;0;0;332359699;333612135;9034827
1067;4.78831e-15;563;-11;544;10929;1;51;3.32687e+08;-6.54266e+06;0;0;0;0;0;0;332686853;333948107;9079948
1068;4.78831e-15;564;-11;544;10929;1;51;3.33013e+08;-6.52429e+06;0;0;0;0;0;0;333013088;334283193;9125117
1069;4.78831e-15;564;-11;544;10929;1;51;3.33338e+08;-6.506e+06;1;0;0;0;1;0;333338409;334617397;9170333
1070;4.78831e-15;564;-11;544;10929;1;51;3.33663e+08;-6.48777e+06;1;0;0;0;1;0;333662818;334950720;9215596
1071;4.78831e-15;564;-11;544;10929;1;51;3.33986e+08;-6.46962e+06;1;0;0;0;1;0;333986320;335283168;9260905
1072;4.78831e-15;565;-11;544;10929;1;51;3.34309e+08;-6.45153e+06;0;0;0;0;0;0;334308917;335614744;9306260
1073;4.78831e-15;566;-11;544;10929;1;51;3.34631e+08;-6.43352e+06;0;0;0;0;0;0;334630614;335945450;9351661
1074;4.78831e-15;566;-11;544;10929;1;51;3.34951e+08;-6.41558e+06;1;0;0;0;1;0;334951413;336275291;9397106
1075;4.78831e-15;566;-11;544;10929;1;51;3.35271e+08;-6.3977e+06;1;0;0;0;1;0;335271319;336604270;9442595
1076;4.78831e-15;567;-11;544;10929;1;51;3.3559e+08;-6.3799e+06;0;0;0;0;0;0;335590335;336932390;9488128
1077;4.78831e-15;567;-11;544;10929;1;51;3.35908e+08;-6.36216e+06;1;0;0;0;1;0;335908463;337259654;9533704
1078;4.78831e-15;567;-11;544;10929;1;51;3.36226e+08;-6.34449e+06;1;0;0;0;1;0;336225709;337586067;9579323
1079;4.78831e-15;568;-11;544;10929;1;51;3.36542e+08;-6.32689e+06;0;0;0;0;0;0;336542074;337911631;9624983
1080;4.78831e-15;568;-11;544;10929;1;51;3.36858e+08;-6.30936e+06;1;0;0;0;1;0;336857563;338236349;9670686
1081;4.78831e-15;568;-11;544;10929;1;51;3.37172e+08;-6.29189e+06;1;0;0;0;1;0;337172178;338560226;9716429
1082;4.78831e-15;568;-11;544;10929;1;51;3.37486e+08;-6.27449e+06;1;0;0;0;1;0;337485923;338883263;9762213
1083;4.78831e-15;569;-11;544;10929;1;51;3.37799e+08;-6.25716e+06;0;0;0;0;0;0;337798802;339205465;9808037
1084;4.78831e-15;569;-11;544;10929;1;51;3.38111e+08;-6.23989e+06;1;0;0;0;1;0;338110817;339526835;9853900
1085;4.78831e-15;570;-11;544;10929;1;51;3.38422e+08;-6.22269e+06;0;0;0;0;0;0;338421972;339847375;9899802
1086;4.78831e-15;571;-11;544;10929;1;51;3.38732e+08;-6.20555e+06;0;0;0;0;0;0;338732271;340167090;9945743
1087;4.78831e-15;571;-11;544;10929;1;51;3.39042e+08;-6.18848e+06;1;0;0;0;1;0;339041716;340485982;9991722
1088;4.78831e-15;571;-11;544;10929;1;51;3.3935e+08;-6.17148e+06;1;0;0;0;1;0;339350310;340804054;10037738
1089;4.78831e-15;572;-11;544;10929;1;51;3.39658e+08;-6.15453e+06;0;0;0;0;0;0;339658057;341121310;10083791
1090;4.78831e-15;573;-11;544;10929;1;51;3.39965e+08;-6.13765e+06;0;0;0;0;0;0;339964961;341437753;10129881
1091;4.78831e-15;574;-11;544;10929;1;51;3.40271e+08;-6.12084e+06;0;0;0;0;0;0;340271024;341753386;10176006
1092;4.78831e-15;575;-11;544;10929;1;51;3.40576e+08;-6.10409e+06;0;0;0;0;0;0;340576249;342068211;10222167
1093;4.78831e-15;576;-11;544;10929;1;51;3.40881e+08;-6.0874e+06;0;0;0;0;0;0;340880640;342382233;10268363
1094;4.78831e-15;576;-11;544;10929;1;51;3.41184e+08;-6.07077e+06;1;0;0;0;1;0;341184199;342695454;10314594
1095;4.78831e-15;577;-11;544;10929;1;51;3.41487e+08;-6.05421e+06;0;0;0;0;0;0;341486930;343007877;10360858
1096;4.78831e-15;578;-11;544;10929;1;51;3.41789e+08;-6.03771e+06;0;0;0;0;0;0;341788837;343319505;10407156
1097;4.78831e-15;578;-11;544;10929;1;51;3.4209e+08;-6.02127e+06;1;0;0;0;1;0;342089921;343630341;10453487
1098;4.78831e-15;579;-11;544;10929;1;51;3.4239e+08;-6.00489e+06;0;0;0;0;0;0;342390186;343940389;10499850
1099;4.78831e-15;580;-11;544;10929;1;51;3.4269e+08;-5.98857e+06;0;0;0;0;0;0;342689636;344249650;10546245
1100;4.78831e-15;580;-11;544;10929;1;51;3.42988e+08;-5.97232e+06;1;0;0;0;1;0;342988272;344558129;10592672
1101;4.78831e-15;581;-11;544;10929;1;51;3.43286e+08;-5.95612e+06;0;0;0;0;0;0;343286099;344865828;10639130
1102;4.78831e-15;581;-11;544;10929;1;51;3.43583e+08;-5.93998e+06;1;0;0;0;1;0;343583119;345172750;10685619
1103;4.78831e-15;582;-11;544;10929;1;51;3.43879e+08;-5.9239e+06;0;0;0;0;0;0;343879335;345478898;10732137
1104;4.78831e-15;583;-11;544;10929;1;51;3.44175e+08;-5.90789e+06;0;0;0;0;0;0;344174750;345784275;10778685
1105;4.78831e-15;584;-11;544;10929;1;51;3.44469e+08;-5.89193e+06;0;0;0;0;0;0;344469367;346088884;10825263
1106;4.78831e-15;584;-11;544;10929;1;51;3.44763e+08;-5.87603e+06;1;0;0;0;1;0;344763189;346392727;10871869
1107;4.78831e-15;585;-11;544;10929;1;51;3.45056e+08;-5.86019e+06;0;0;0;0;0;0;345056220;346695807;10918503
1108;4.78831e-15;585;-11;544;10929;1;51;3.45348e+08;-5.8444e+06;1;0;0;0;1;0;345348461;346998128;10965165
1109;4.78831e-15;586;-11;544;10929;1;51;3.4564e+08;-5.82868e+06;0;0;0;0;0;0;345639916;347299692;11011854
1110;4.78831e-15;587;-11;544;10929;1;51;3.45931e+08;-5.81301e+06;0;0;0;0;0;0;345930587;347600502;11058571
1111;4.78831e-15;587;-11;544;10929;1;51;3.4622e+08;-5.7974e+06;1;0;0;0;1;0;346220478;347900561;11105313
1112;4.78831e-15;588;-11;544;10929;1;51;3.4651e+08;-5.78185e+06;0;0;0;0;0;0;346509591;348199871;11152081
1113;4.78831e-15;589;-11;544;10929;1;51;3.46798e+08;-5.76635e+06;0;0;0;0;0;0;346797930;348498436;11198875
1114;4.78831e-15;589;-11;544;10929;1;51;3.47085e+08;-5.75091e+06;1;0;0;0;1;0;347085496;348796257;11245694
1115;4.78831e-15;589;-11;544;10929;1;51;3.47372e+08;-5.73553e+06;1;0;0;0;1;0;347372294;349093338;11292537
1116;4.78831e-15;589;-11;544;10929;1;51;3.47658e+08;-5.7202e+06;1;0;0;0;1;0;347658325;349389682;11339405
1117;4.78831e-15;590;-11;544;10929;1;51;3.47944e+08;-5.70493e+06;0;0;0;0;0;0;347943592;349685291;11386296
1118;4.78831e-15;590;-11;544;10929;1;51;3.48228e+08;-5.68971e+06;1;0;0;0;1;0;348228099;349980168;11433210
1119;4.78831e-15;591;-11;544;10929;1;51;3.48512e+08;-5.67455e+06;0;0;0;0;0;0;348511847;350274315;11480147
1120;4.78831e-15;592;-11;544;10929;1;51;3.48795e+08;-5.65945e+06;0;0;0;0;0;0;348794840;350567736;11527107
1121;4.78831e-15;593;-11;544;10929;1;51;3.49077e+08;-5.64439e+06;0;0;0;0;0;0;349077081;350860432;11574088
1122;4.78831e-15;594;-11;544;10929;1;51;3.49359e+08;-5.62939e+06;0;0;0;0;0;0;349358571;351152407;11621091
1123;4.78831e-15;594;-11;544;10929;1;51;3.49639e+08;-5.61445e+06;1;0;0;0;1;0;349639315;351443663;11668114
1124;4.78831e-15;594;-11;544;10929;1;51;3.49919e+08;-5.59956e+06;1;0;0;0;1;0;349919313;351734202;11715158
1125;4.78831e-15;595;-11;544;10929;1;51;3.50199e+08;-5.58472e+06;0;0;0;0;0;0;350198570;352024028;11762223
1126;4.78831e-15;595;-11;544;10929;1;51;3.50477e+08;-5.56994e+06;1;0;0;0;1;0;350477088;352313143;11809307
1127;4.78831e-15;595;-11;544;10929;1;51;3.50755e+08;-5.55521e+06;1;0;0;0;1;0;350754869;352601549;11856410
1128;4.78831e-15;596;-11;544;10929;1;51;3.51032e+08;-5.54053e+06;0;0;0;0;0;0;351031916;352889249;11903532
1129;4.78831e-15;596;-11;544;10929;1;51;3.51308e+08;-5.5259e+06;1;0;0;0;1;0;351308232;353176246;11950673
1130;4.78831e-15;596;-11;544;10929;1;51;3.51584e+08;-5.51133e+06;1;0;0;0;1;0;351583819;353462542;11997831
1131;4.78831e-15;597;-11;544;10929;1;51;3.51859e+08;-5.4968e+06;0;0;0;0;0;0;351858680;353748139;12045007
1132;4.78831e-15;598;-11;544;10929;1;51;3.52133e+08;-5.48233e+06;0;0;0;0;0;0;352132818;354033040;12092200
1133;4.78831e-15;599;-11;544;10929;1;51;3.52406e+08;-5.46791e+06;0;0;0;0;0;0;352406234;354317248;12139410
1134;4.78831e-15;599;-11;544;10929;1;51;3.52679e+08;-5.45354e+06;1;0;0;0;1;0;352678932;354600765;12186637
1135;4.78831e-15;600;-11;544;10929;1;51;3.52951e+08;-5.43922e+06;0;0;0;0;0;0;352950915;354883593;12233879
1136;4.78831e-15;600;-11;544;10929;1;51;3.53222e+08;-5.42496e+06;1;0;0;0;1;0;353222183;355165736;12281136
1137;4.78831e-15;600;-11;544;10929;1;51;3.53493e+08;-5.41074e+06;1;0;0;0;1;0;353492741;355447194;12328409
1138;4.78831e-15;601;-11;544;10929;1;51;3.53763e+08;-5.39657e+06;0;0;0;0;0;0;353762591;355727971;12375697
1139;4.78831e-15;602;-11;544;10929;1;51;3.54032e+08;-5.38246e+06;0;0;0;0;0;0;354031735;356008070;12422998
1140;4.78831e-15;602;-11;544;10929;1;51;3.543e+08;-5.36839e+06;1;0;0;0;1;0;354300175;356287492;12470314
1141;4.78831e-15;603;-11;544;10929;1;51;3.54568e+08;-5.35437e+06;0;0;0;0;0;0;354567914;356566240;12517643
1142;4.78831e-15;604;-11;544;10929;1;51;3.54835e+08;-5.3404e+06;0;0;0;0;0;0;354834955;356844316;12564985
1143;4.78831e-15;604;-11;544;10929;1;51;3.55101e+08;-5.32648e+06;1;0;0;0;1;0;355101300;357121723;12612340
1144;4.78831e-15;604;-11;544;10929;1;51;3.55367e+08;-5.31261e+06;1;0;0;0;1;0;355366951;357398463;12659707
1145;4.78831e-15;605;-11;544;10929;1;51;3.55632e+08;-5.29878e+06;0;0;0;0;0;0;355631911;357674539;12707086
1146;4.78831e-15;605;-11;544;10929;1;51;3.55896e+08;-5.28501e+06;1;0;0;0;1;0;355896183;357949952;12754476
1147;4.78831e-15;605;-11;544;10929;1;51;3.5616e+08;-5.27128e+06;1;0;0;0;1;0;356159768;358224705;12801877
1148;4.78831e-15;605;-11;544;10929;1;51;3.56423e+08;-5.2576e+06;1;0;0;0;1;0;356422668;358498800;12849290
1149;4.78831e-15;605;-11;544;10929;1;51;3.56685e+08;-5.24397e+06;1;0;0;0;1;0;356684888;358772240;12896712
1150;4.78831e-15;606;-11;544;10929;1;51;3.56946e+08;-5.23038e+06;0;0;0;0;0;0;356946428;359045027;12944145
1151;4.78831e-15;607;-11;544;10929;1;51;3.57207e+08;-5.21684e+06;0;0;0;0;0;0;357207291;359317163;12991587
1152;4.78831e-15;608;-11;544;10929;1;51;3.57467e+08;-5.20335e+06;0;0;0;0;0;0;357467479;359588650;13039038
1153;4.78831e-15;608;-11;544;10929;1;51;3.57727e+08;-5.18991e+06;1;0;0;0;1;0;357726996;359859490;13086498
1154;4.78831e-15;608;-11;544;10929;1;51;3.57986e+08;-5.17651e+06;1;0;0;0;1;0;357985842;360129687;13133966
1155;4.78831e-15;608;-11;544;10929;1;51;3.58244e+08;-5.16316e+06;0;0;-1;0;0;-1;358244021;360399242;13181442
1156;4.78831e-15;609;-11;544;10929;1;51;3.58502e+08;-5.14985e+06;0;0;0;0;0;0;358501534;360668156;13228927
1157;4.78831e-15;610;-11;544;10929;1;51;3.58758e+08;-5.13659e+06;0;0;0;0;0;0;358758384;360936434;13276418
1158;4.78831e-15;611;-11;544;10929;1;51;3.59015e+08;-5.12337e+06;0;0;0;0;0;0;359014574;361204076;13323916
1159;4.78831e-15;612;-11;544;10929;1;51;3.5927e+08;-5.1102e+06;0;0;0;0;0;0;359270105;361471084;13371421
1160;4.78831e-15;612;-11;544;10929;1;51;3.59525e+08;-5.09707e+06;1;0;0;0;1;0;359524979;361737462;13418932
1161;4.78831e-15;612;-11;544;10929;1;51;3.59779e+08;-5.08399e+06;1;0;0;0;1;0;359779200;362003211;13466449
1162;4.78831e-15;612;-11;544;10929;1;51;3.60033e+08;-5.07096e+06;1;0;0;0;1;0;360032769;362268333;13513972
1163;4.78831e-15;612;-11;544;10929;1;51;3.60286e+08;-5.05796e+06;1;0;0;0;1;0;360285688;362532830;13561499
1164;4.78831e-15;612;-11;544;10929;1;51;3.60538e+08;-5.04502e+06;1;0;0;0;1;0;360537959;362796705;13609031
1165;4.78831e-15;612;-11;544;10929;1;51;3.6079e+08;-5.03211e+06;1;0;0;0;1;0;360789586;363059959;13656568
1166;4.78831e-15;612;-11;544;10929;1;51;3.61041e+08;-5.01925e+06;1;0;0;0;1;0;361040569;363322595;13704109
1167;4.78831e-15;613;-11;544;10929;1;51;3.61291e+08;-5.00643e+06;0;0;0;0;0;0;361290912;363584615;13751653
1168;4.78831e-15;614;-11;544;10929;1;51;3.61541e+08;-4.99366e+06;0;0;0;0;0;0;361540616;363846021;13799201
1169;4.78831e-15;615;-11;544;10929;1;51;3.6179e+08;-4.98093e+06;0;0;0;0;0;0;361789684;364106814;13846751
1170;4.78831e-15;616;-11;544;10929;1;51;3.62038e+08;-4.96824e+06;0;0;0;0;0;0;362038117;364366998;13894305
1171;4.78831e-15;616;-11;544;10929;1;51;3.62286e+08;-4.9556e+06;1;0;0;0;1;0;362285918;364626574;13941860
1172;4.78831e-15;617;-11;544;10929;1;51;3.62533e+08;-4.943e+06;0;0;0;0;0;0;362533088;364885543;13989418
1173;4.78831e-15;617;-11;544;10929;1;51;3.6278e+08;-4.93044e+06;1;0;0;0;1;0;362779631;365143909;14036977
1174;4.78831e-15;618;-11;544;10929;1;51;3.63026e+08;-4.91792e+06;0;0;0;0;0;0;363025548;365401673;14084537
1175;4.78831e-15;619;-11;544;10929;1;51;3.63271e+08;-4.90544e+06;0;0;0;0;0;0;363270841;365658837;14132099
1176;4.78831e-15;619;-11;544;10929;1;51;3.63516e+08;-4.89301e+06;1;0;0;0;1;0;363515512;365915403;14179661
1177;4.78831e-15;619;-11;544;10929;1;51;3.6376e+08;-4.88061e+06;1;0;0;0;1;0;363759564;366171373;14227223
1178;4.78831e-15;620;-11;544;10929;1;51;3.64003e+08;-4.86826e+06;0;0;0;0;0;0;364002998;366426749;14274785
1179;4.78831e-15;621;-11;544;10929;1;51;3.64246e+08;-4.85595e+06;0;0;0;0;0;0;364245816;366681533;14322347
1180;4.78831e-15;621;-11;544;10929;1;51;3.64488e+08;-4.84368e+06;1;0;0;0;1;0;364488022;366935727;14369908
1181;4.78831e-15;622;-11;544;10929;1;51;3.6473e+08;-4.83145e+06;0;0;0;0;0;0;364729615;367189333;14417467
1182;4.78831e-15;622;-11;544;10929;1;51;3.64971e+08;-4.81926e+06;1;0;0;0;1;0;364970599;367442353;14465026
1183;4.78831e-15;623;-11;544;10929;1;51;3.65211e+08;-4.80712e+06;0;0;0;0;0;0;365210976;367694789;14512583
1184;4.78831e-15;623;-11;544;10929;1;51;3.65451e+08;-4.79501e+06;1;0;0;0;1;0;365450748;367946642;14560138
1185;4.78831e-15;623;-11;544;10929;1;51;3.6569e+08;-4.78294e+06;1;0;0;0;1;0;365689916;368197915;14607690
1186;4.78831e-15;624;-11;544;10929;1;51;3.65928e+08;-4.77091e+06;0;0;0;0;0;0;365928482;368448610;14655240
1187;4.78831e-15;624;-11;544;10929;1;51;3.66166e+08;-4.75893e+06;1;0;0;0;1;0;366166450;368698728;14702786
1188;4.78831e-15;624;-11;544;10929;1;51;3.66404e+08;-4.74698e+06;1;0;0;0;1;0;366403820;368948271;14750330
1189;4.78831e-15;625;-11;544;10929;1;51;3.66641e+08;-4.73507e+06;0;0;0;0;0;0;366640594;369197241;14797870
1190;4.78831e-15;626;-11;544;10929;1;51;3.66877e+08;-4.7232e+06;0;0;0;0;0;0;366876775;369445641;14845405
1191;4.78831e-15;627;-11;544;10929;1;51;3.67112e+08;-4.71137e+06;0;0;0;0;0;0;367112364;369693471;14892937
1192;4.78831e-15;628;-11;544;10929;1;51;3.67347e+08;-4.69957e+06;0;0;0;0;0;0;367347364;369940734;14940464
1193;4.78831e-15;629;-11;544;10929;1;51;3.67582e+08;-4.68782e+06;0;0;0;0;0;0;367581776;370187431;14987986
1194;4.78831e-15;630;-11;544;10929;1;51;3.67816e+08;-4.6761e+06;0;0;0;0;0;0;367815602;370433565;15035503
1195;4.78831e-15;631;-11;544;10929;1;51;3.68049e+08;-4.66443e+06;0;0;0;0;0;0;368048844;370679137;15083015
1196;4.78831e-15;632;-11;544;10929;1;51;3.68282e+08;-4.65279e+06;0;0;0;0;0;0;368281505;370924149;15130520
1197;4.78831e-15;632;-11;544;10929;1;51;3.68514e+08;-4.64118e+06;1;0;0;0;1;0;368513585;371168602;15178020
1198;4.78831e-15;633;-11;544;10929;1;51;3.68745e+08;-4.62962e+06;0;0;0;0;0;0;368745087;371412500;15225513
1199;4.78831e-15;633;-11;544;10929;1;51;3.68976e+08;-4.6181e+06;1;0;0;0;1;0;368976013;371655843;15273000
1200;4.78831e-15;634;-11;544;10929;1;51;3.69206e+08;-4.60661e+06;0;0;0;0;0;0;369206364;371898632;15320479
1201;4.78831e-15;635;-11;544;10929;1;51;3.69436e+08;-4.59515e+06;0;0;0;0;0;0;369436143;372140871;15367952
1202;4.78831e-15;635;-11;544;10929;1;51;3.69665e+08;-4.58374e+06;1;0;0;0;1;0;369665351;372382561;15415416
1203;4.78831e-15;636;-11;544;10929;1;51;3.69894e+08;-4.57236e+06;0;0;0;0;0;0;369893990;372623702;15462873
1204;4.78831e-15;637;-11;544;10929;1;51;3.70122e+08;-4.56102e+06;0;0;0;0;0;0;370122062;372864299;15510322
1205;4.78831e-15;638;-11;544;10929;1;51;3.7035e+08;-4.54972e+06;0;0;0;0;0;0;370349569;373104350;15557762
1206;4.78831e-15;639;-11;544;10929;1;51;3.70577e+08;-4.53845e+06;0;0;0;0;0;0;370576513;373343860;15605194
1207;4.78831e-15;639;-12;544;10929;1;51;3.70803e+08;-4.52722e+06;0;0;0;0;0;0;370802895;373582829;15652617
1208;4.78831e-15;640;-12;544;10929;1;51;3.71029e+08;-4.51602e+06;0;0;0;0;0;0;371028717;373821259;15700030
1209;4.78831e-15;640;-12;544;10929;1;51;3.71254e+08;-4.50486e+06;1;0;0;0;1;0;371253981;374059151;15747434
1210;4.78831e-15;641;-12;544;10929;1;51;3.71479e+08;-4.49374e+06;0;0;0;0;0;0;371478689;374296508;15794828
1211;4.78831e-15;642;-12;544;10929;1;51;3.71703e+08;-4.48265e+06;0;0;0;0;0;0;371702842;374533332;15842212
1212;4.78831e-15;643;-12;544;10929;1;51;3.71926e+08;-4.4716e+06;0;0;0;0;0;0;371926443;374769623;15889585
1213;4.78831e-15;644;-12;544;10929;1;51;3.72149e+08;-4.46058e+06;0;0;0;0;0;0;372149493;375005383;15936948
1214;4.78831e-15;645;-12;544;10929;1;51;3.72372e+08;-4.44959e+06;0;0;0;0;0;0;372371994;375240615;15984300
1215;4.78831e-15;646;-12;544;10929;1;51;3.72594e+08;-4.43865e+06;0;0;0;0;0;0;372593947;375475319;16031640
1216;4.78831e-15;647;-12;544;10929;1;51;3.72815e+08;-4.42773e+06;0;0;0;0;0;0;372815355;375709498;16078969
1217;4.78831e-15;648;-12;544;10929;1;51;3.73036e+08;-4.41686e+06;0;0;0;0;0;0;373036219;375943153;16126287
1218;4.78831e-15;648;-12;544;10929;1;51;3.73257e+08;-4.40601e+06;1;0;0;0;1;0;373256540;376176285;16173592
1219;4.78831e-15;648;-12;544;10929;1;51;3.73476e+08;-4.3952e+06;1;0;0;0;1;0;373476321;376408897;16220885
1220;4.78831e-15;649;-12;544;10929;1;51;3.73696e+08;-4.38443e+06;0;0;0;0;0;0;373695564;376640990;16268166
1221;4.78831e-15;650;-12;544;10929;1;51;3.73914e+08;-4.37368e+06;0;0;0;0;0;0;373914269;376872565;16315434
1222;4.78831e-15;650;-12;544;10929;1;51;3.74132e+08;-4.36298e+06;1;0;0;0;1;0;374132439;377103625;16362688
1223;4.78831e-15;651;-12;544;10929;1;51;3.7435e+08;-4.3523e+06;0;0;0;0;0;0;374350075;377334170;16409929
1224;4.78831e-15;652;-12;544;10929;1;51;3.74567e+08;-4.34166e+06;0;0;0;0;0;0;374567180;377564203;16457157
1225;4.78831e-15;652;-12;544;10929;1;51;3.74784e+08;-4.33106e+06;1;0;0;0;1;0;374783754;377793724;16504371
1226;4.78831e-15;652;-12;544;10929;1;51;3.75e+08;-4.32048e+06;1;0;0;0;1;0;374999799;378022736;16551571
1227;4.78831e-15;652;-12;544;10929;1;51;3.75215e+08;-4.30994e+06;1;0;0;0;1;0;375215317;378251240;16598756
1228;4.78831e-15;653;-12;544;10929;1;51;3.7543e+08;-4.29944e+06;0;0;0;0;0;0;375430310;378479237;16645927
1229;4.78831e-15;653;-12;544;10929;1;51;3.75645e+08;-4.28896e+06;1;0;0;0;1;0;375644779;378706730;16693083
1230;4.78831e-15;653;-12;544;10929;1;51;3.75859e+08;-4.27852e+06;1;0;0;0;1;0;375858727;378933719;16740224
1231;4.78831e-15;653;-12;544;10929;1;51;3.76072e+08;-4.26811e+06;1;0;0;0;1;0;376072153;379160207;16787349
1232;4.78831e-15;653;-12;544;10929;1;51;3.76285e+08;-4.25774e+06;1;0;0;0;1;0;376285061;379386194;16834459
1233;4.78831e-15;654;-12;544;10929;1;51;3.76497e+08;-4.24739e+06;0;0;0;0;0;0;376497452;379611683;16881553
1234;4.78831e-15;655;-12;544;10929;1;51;3.76709e+08;-4.23708e+06;0;0;0;0;0;0;376709327;379836674;16928631
1235;4.78831e-15;655;-12;544;10929;1;51;3.76921e+08;-4.2268e+06;1;0;0;0;1;0;376920689;380061170;16975693
1236;4.78831e-15;655;-12;544;10929;1;51;3.77132e+08;-4.21656e+06;1;0;0;0;1;0;377131537;380285171;17022738
1237;4.78831e-15;655;-12;544;10929;1;51;3.77342e+08;-4.20634e+06;1;0;0;0;1;0;377341875;380508680;17069767
1238;4.78831e-15;655;-12;544;10929;1;51;3.77552e+08;-4.19616e+06;1;0;0;0;1;0;377551704;380731697;17116778
1239;4.78831e-15;656;-12;544;10929;1;51;3.77761e+08;-4.186e+06;0;0;0;0;0;0;377761025;380954225;17163772
1240;4.78831e-15;656;-12;544;10929;1;51;3.7797e+08;-4.17588e+06;1;0;0;0;1;0;377969841;381176264;17210748
1241;4.78831e-15;656;-12;544;10929;1;51;3.78178e+08;-4.16579e+06;1;0;0;0;1;0;378178151;381397817;17257707
1242;4.78831e-15;657;-12;544;10929;1;51;3.78386e+08;-4.15573e+06;0;0;0;0;0;0;378385959;381618884;17304648
1243;4.78831e-15;657;-12;544;10929;1;51;3.78593e+08;-4.1457e+06;1;0;0;0;1;0;378593265;381839467;17351570
1244;4.78831e-15;657;-12;544;10929;1;51;3.788e+08;-4.13571e+06;1;0;0;0;1;0;378800072;382059568;17398474
1245;4.78831e-15;658;-12;544;10929;1;51;3.79006e+08;-4.12574e+06;0;0;0;0;0;0;379006380;382279188;17445360
1246;4.78831e-15;659;-12;544;10929;1;51;3.79212e+08;-4.1158e+06;0;0;0;0;0;0;379212191;382498328;17492226
1247;4.78831e-15;660;-12;544;10929;1;51;3.79418e+08;-4.1059e+06;0;0;0;0;0;0;379417507;382716991;17539074
1248;4.78831e-15;661;-12;544;10929;1;51;3.79622e+08;-4.09602e+06;0;0;0;0;0;0;379622330;382935176;17585902
1249;4.78831e-15;662;-12;544;10929;1;51;3.79827e+08;-4.08618e+06;0;0;0;0;0;0;379826660;383152886;17632711
1250;4.78831e-15;662;-12;544;10929;1;51;3.8003e+08;-4.07636e+06;1;0;0;0;1;0;380030499;383370122;17679500
1251;4.78831e-15;662;-12;544;10929;1;51;3.80234e+08;-4.06658e+06;1;0;0;0;1;0;380233849;383586886;17726268
1252;4.78831e-15;663;-12;544;10929;1;51;3.80437e+08;-4.05683e+06;0;0;0;0;0;0;380436712;383803179;17773017
1253;4.78831e-15;663;-12;544;10929;1;51;3.80639e+08;-4.0471e+06;1;0;0;0;1;0;380639088;384019002;17819745
1254;4.78831e-15;664;-12;544;10929;1;51;3.80841e+08;-4.0374e+06;0;0;0;0;0;0;380840979;384234356;17866453
1255;4.78831e-15;665;-12;544;10929;1;51;3.81042e+08;-4.02774e+06;0;0;0;0;0;0;381042388;384449244;17913139
1256;4.78831e-15;666;-12;544;10929;1;51;3.81243e+08;-4.0181e+06;0;0;0;0;0;0;381243314;384663666;17959805
1257;4.78831e-15;667;-12;544;10929;1;51;3.81444e+08;-4.0085e+06;0;0;0;0;0;0;381443760;384877624;18006449
1258;4.78831e-15;668;-12;544;10929;1;51;3.81644e+08;-3.99892e+06;0;0;0;0;0;0;381643727;385091119;18053072
1259;4.78831e-15;668;-12;544;10929;1;51;3.81843e+08;-3.98937e+06;1;0;0;0;1;0;381843216;385304152;18099674
1260;4.78831e-15;668;-12;544;10929;1;51;3.82042e+08;-3.97985e+06;1;0;0;0;1;0;382042230;385516726;18146253
1261;4.78831e-15;669;-12;544;10929;1;51;3.82241e+08;-3.97036e+06;0;0;0;0;0;0;382240769;385728840;18192810
1262;4.78831e-15;670;-12;544;10929;1;51;3.82439e+08;-3.96089e+06;0;0;0;0;0;0;382438834;385940497;18239345
1263;4.78831e-15;670;-12;544;10929;1;51;3.82636e+08;-3.95146e+06;1;0;0;0;1;0;382636428;386151698;18285857
1264;4.78831e-15;670;-12;544;10929;1;51;3.82834e+08;-3.94205e+06;1;0;0;0;1;0;382833552;386362445;18332347
1265;4.78831e-15;670;-12;544;10929;1;51;3.8303e+08;-3.93267e+06;1;0;0;0;1;0;383030207;386572737;18378814
1266;4.78831e-15;671;-12;544;10929;1;51;3.83226e+08;-3.92332e+06;0;0;0;0;0;0;383226394;386782578;18425257
1267;4.78831e-15;671;-12;544;10929;1;51;3.83422e+08;-3.914e+06;1;0;0;0;1;0;383422116;386991967;18471678
1268;4.78831e-15;672;-12;544;10929;1;51;3.83617e+08;-3.90471e+06;0;0;0;0;0;0;383617372;387200908;18518074
1269;4.78831e-15;673;-12;544;10929;1;51;3.83812e+08;-3.89544e+06;0;0;0;0;0;0;383812166;387409399;18564448
1270;4.78831e-15;674;-12;544;10929;1;51;3.84006e+08;-3.8862e+06;0;0;0;0;0;0;384006497;387617444;18610797
1271;4.78831e-15;674;-12;544;10929;1;51;3.842e+08;-3.87699e+06;1;0;0;0;1;0;384200368;387825043;18657122
1272;4.78831e-15;675;-12;544;10929;1;51;3.84394e+08;-3.86781e+06;0;0;0;0;0;0;384393780;388032198;18703423
1273;4.78831e-15;676;-12;544;10929;1;51;3.84587e+08;-3.85865e+06;0;0;0;0;0;0;384586734;388238910;18749699
1274;4.78831e-15;677;-12;544;10929;1;51;3.84779e+08;-3.84953e+06;0;0;0;0;0;0;384779231;388445179;18795951
1275;4.78831e-15;677;-12;544;10929;1;51;3.84971e+08;-3.84042e+06;1;0;0;0;1;0;384971273;388651008;18842178
1276;4.78831e-15;677;-12;544;10929;1;51;3.85163e+08;-3.83135e+06;1;0;0;0;1;0;385162862;388856398;18888380
1277;4.78831e-15;677;-12;544;10929;1;51;3.85354e+08;-3.8223e+06;1;0;0;0;1;0;385353998;389061350;18934557
1278;4.78831e-15;677;-12;544;10929;1;51;3.85545e+08;-3.81328e+06;1;0;0;0;1;0;385544684;389265865;18980708
1279;4.78831e-15;677;-12;544;10929;1;51;3.85735e+08;-3.80429e+06;1;0;0;0;1;0;385734919;389469944;19026834
1280;4.78831e-15;677;-12;544;10929;1;51;3.85925e+08;-3.79532e+06;1;0;0;0;1;0;385924707;389673589;19072933
1281;4.78831e-15;678;-12;544;10929;1;51;3.86114e+08;-3.78638e+06;0;0;0;0;0;0;386114047;389876800;19119007
1282;4.78831e-15;678;-12;544;10929;1;51;3.86303e+08;-3.77747e+06;1;0;0;0;1;0;386302942;390079580;19165055
1283;4.78831e-15;678;-12;544;10929;1;51;3.86491e+08;-3.76858e+06;1;0;0;0;1;0;386491392;390281929;19211077
1284;4.78831e-15;679;-12;544;10929;1;51;3.86679e+08;-3.75972e+06;0;0;0;0;0;0;386679399;390483849;19257072
1285;4.78831e-15;679;-12;544;10929;1;51;3.86867e+08;-3.75088e+06;1;0;0;0;1;0;386866964;390685340;19303041
1286;4.78831e-15;680;-12;544;10929;1;51;3.87054e+08;-3.74207e+06;0;0;0;0;0;0;387054089;390886405;19348982
1287;4.78831e-15;680;-12;544;10929;1;51;3.87241e+08;-3.73329e+06;1;0;0;0;1;0;387240775;391087043;19394897
1288;4.78831e-15;680;-12;544;10929;1;51;3.87427e+08;-3.72453e+06;1;0;0;0;1;0;387427022;391287257;19440784
1289;4.78831e-15;680;-12;544;10929;1;51;3.87613e+08;-3.7158e+06;1;0;0;0;1;0;387612833;391487047;19486644
1290;4.78831e-15;680;-12;544;10929;1;51;3.87798e+08;-3.70709e+06;1;0;0;0;1;0;387798209;391686415;19532477
1291;4.78831e-15;680;-12;544;10929;1;51;3.87983e+08;-3.69841e+06;1;0;0;0;1;0;387983151;391885362;19578282
1292;4.78831e-15;680;-12;544;10929;1;51;3.88168e+08;-3.68975e+06;1;0;0;0;1;0;388167660;392083889;19624059
1293;4.78831e-15;681;-12;544;10929;1;51;3.88352e+08;-3.68112e+06;0;0;0;0;0;0;388351737;392281997;19669808
1294;4.78831e-15;681;-12;544;10929;1;51;3.88535e+08;-3.67252e+06;1;0;0;0;1;0;388535384;392479688;19715529
1295;4.78831e-15;682;-12;544;10929;1;51;3.88719e+08;-3.66394e+06;0;0;0;0;0;0;388718602;392676962;19761222
1296;4.78831e-15;683;-12;544;10929;1;51;3.88901e+08;-3.65538e+06;0;0;0;0;0;0;388901393;392873821;19806886
1297;4.78831e-15;684;-12;544;10929;1;51;3.89084e+08;-3.64685e+06;0;0;0;0;0;0;389083757;393070266;19852521
1298;4.78831e-15;685;-12;544;10929;1;51;3.89266e+08;-3.63835e+06;0;0;0;0;0;0;389265695;393266298;19898128
1299;4.78831e-15;686;-12;544;10929;1;51;3.89447e+08;-3.62986e+06;0;0;0;0;0;0;389447210;393461918;19943706
1300;4.78831e-15;686;-12;544;10929;1;51;3.89628e+08;-3.62141e+06;1;0;0;0;1;0;389628301;393657127;19989254
1301;4.78831e-15;686;-12;544;10929;1;51;3.89809e+08;-3.61298e+06;1;0;0;0;1;0;389808971;393851927;20034774
1302;4.78831e-15;686;-12;544;10929;1;51;3.89989e+08;-3.60457e+06;1;0;0;0;1;0;389989221;394046318;20080263
1303;4.78831e-15;686;-12;544;10929;1;51;3.90169e+08;-3.59619e+06;1;0;0;0;1;0;390169052;394240303;20125724
1304;4.78831e-15;686;-12;544;10929;1;51;3.90348e+08;-3.58783e+06;1;0;0;0;1;0;390348464;394433880;20171154
1305;4.78831e-15;686;-12;544;10929;1;51;3.90527e+08;-3.57949e+06;1;0;0;0;1;0;390527460;394627053;20216554
1306;4.78831e-15;687;-12;544;10929;1;51;3.90706e+08;-3.57118e+06;0;0;0;0;0;0;390706040;394819822;20261925
1307;4.78831e-15;687;-12;544;10929;1;51;3.90884e+08;-3.56289e+06;1;0;0;0;1;0;390884206;395012188;20307265
1308;4.78831e-15;688;-12;544;10929;1;51;3.91062e+08;-3.55463e+06;0;0;0;0;0;0;391061959;395204152;20352575
1309;4.78831e-15;689;-12;544;10929;1;51;3.91239e+08;-3.54639e+06;0;0;0;0;0;0;391239300;395395716;20397855
1310;4.78831e-15;690;-12;544;10929;1;51;3.91416e+08;-3.53818e+06;0;0;0;0;0;0;391416230;395586880;20443103
1311;4.78831e-15;690;-12;544;10929;1;51;3.91593e+08;-3.52998e+06;1;0;0;0;1;0;391592750;395777646;20488321
1312;4.78831e-15;690;-12;544;10929;1;51;3.91769e+08;-3.52182e+06;1;0;0;0;1;0;391768862;395968014;20533508
1313;4.78831e-15;690;-12;544;10929;1;51;3.91945e+08;-3.51367e+06;1;0;0;0;1;0;391944567;396157985;20578664
1314;4.78831e-15;691;-12;544;10929;1;51;3.9212e+08;-3.50555e+06;0;0;0;0;0;0;392119866;396347562;20623789
1315;4.78831e-15;691;-12;544;10929;1;51;3.92295e+08;-3.49745e+06;1;0;0;0;1;0;392294759;396536744;20668882
1316;4.78831e-15;691;-12;544;10929;1;51;3.92469e+08;-3.48937e+06;1;0;0;0;1;0;392469249;396725534;20713944
1317;4.78831e-15;692;-12;544;10929;1;51;3.92643e+08;-3.48132e+06;0;0;0;0;0;0;392643337;396913931;20758974
1318;4.78831e-15;693;-12;544;10929;1;51;3.92817e+08;-3.47329e+06;0;0;0;0;0;0;392817023;397101937;20803972
1319;4.78831e-15;694;-12;544;10929;1;51;3.9299e+08;-3.46528e+06;0;0;0;0;0;0;392990308;397289553;20848939
1320;4.78831e-15;695;-12;544;10929;1;51;3.93163e+08;-3.4573e+06;0;0;0;0;0;0;393163194;397476781;20893873
1321;4.78831e-15;696;-12;544;10929;1;51;3.93336e+08;-3.44934e+06;0;0;0;0;0;0;393335683;397663620;20938775
1322;4.78831e-15;697;-12;544;10929;1;51;3.93508e+08;-3.4414e+06;0;0;0;0;0;0;393507774;397850073;20983645
1323;4.78831e-15;698;-12;544;10929;1;51;3.93679e+08;-3.43348e+06;0;0;0;0;0;0;393679469;398036140;21028482
1324;4.78831e-15;698;-12;544;10929;1;51;3.93851e+08;-3.42559e+06;1;0;0;0;1;0;393850770;398221823;21073287
1325;4.78831e-15;698;-12;544;10929;1;51;3.94022e+08;-3.41772e+06;1;0;0;0;1;0;394021677;398407121;21118059
1326;4.78831e-15;698;-12;544;10929;1;51;3.94192e+08;-3.40987e+06;1;0;0;0;1;0;394192192;398592037;21162798
1327;4.78831e-15;699;-12;544;10929;1;51;3.94362e+08;-3.40204e+06;0;0;0;0;0;0;394362315;398776571;21207504
1328;4.78831e-15;700;-12;544;10929;1;51;3.94532e+08;-3.39424e+06;0;0;0;0;0;0;394532048;398960725;21252178
1329;4.78831e-15;701;-12;544;10929;1;51;3.94701e+08;-3.38645e+06;0;0;0;0;0;0;394701392;399144499;21296817
1330;4.78831e-15;702;-12;544;10929;1;51;3.9487e+08;-3.37869e+06;0;0;0;0;0;0;394870348;399327894;21341424
1331;4.78831e-15;702;-12;544;10929;1;51;3.95039e+08;-3.37095e+06;1;0;0;0;1;0;395038917;399510912;21385997
1332;4.78831e-15;703;-12;544;10929;1;51;3.95207e+08;-3.36324e+06;0;0;0;0;0;0;395207100;399693553;21430536
1333;4.78831e-15;704;-12;544;10929;1;51;3.95375e+08;-3.35554e+06;0;0;0;0;0;0;395374899;399875819;21475041
1334;4.78831e-15;704;-12;544;10929;1;51;3.95542e+08;-3.34787e+06;1;0;0;0;1;0;395542313;400057709;21519513
1335;4.78831e-15;704;-12;544;10929;1;51;3.95709e+08;-3.34021e+06;1;0;0;0;1;0;395709345;400239227;21563951
1336;4.78831e-15;704;-12;544;10929;1;51;3.95876e+08;-3.33258e+06;1;0;0;0;1;0;395875996;400420371;21608354
1337;4.78831e-15;704;-12;544;10929;1;51;3.96042e+08;-3.32497e+06;1;0;0;0;1;0;396042265;400601144;21652724
1338;4.78831e-15;704;-12;544;10929;1;51;3.96208e+08;-3.31738e+06;1;0;0;0;1;0;396208156;400781546;21697059
1339;4.78831e-15;704;-12;544;10929;1;51;3.96374e+08;-3.30982e+06;1;0;0;0;1;0;396373668;400961579;21741359
1340;4.78831e-15;704;-12;544;10929;1;51;3.96539e+08;-3.30227e+06;1;0;0;0;1;0;396538803;401141242;21785625
1341;4.78831e-15;704;-12;544;10929;1;51;3.96704e+08;-3.29474e+06;1;0;0;0;1;0;396703561;401320538;21829856
1342;4.78831e-15;704;-12;544;10929;1;51;3.96868e+08;-3.28724e+06;1;0;0;0;1;0;396867944;401499467;21874053
1343;4.78831e-15;704;-12;544;10929;1;51;3.97032e+08;-3.27976e+06;1;0;0;0;1;0;397031954;401678030;21918214
1344;4.78831e-15;704;-12;544;10929;1;51;3.97196e+08;-3.27229e+06;1;0;0;0;1;0;397195590;401856229;21962340
1345;4.78831e-15;704;-12;544;10929;1;51;3.97359e+08;-3.26485e+06;1;0;0;0;1;0;397358853;402034063;22006432
1346;4.78831e-15;705;-12;544;10929;1;51;3.97522e+08;-3.25743e+06;0;0;0;0;0;0;397521746;402211534;22050488
1347;4.78831e-15;706;-12;544;10929;1;51;3.97684e+08;-3.25003e+06;0;0;0;0;0;0;397684269;402388643;22094508
1348;4.78831e-15;706;-12;544;10929;1;51;3.97846e+08;-3.24265e+06;1;0;0;0;1;0;397846423;402565391;22138493
1349;4.78831e-15;707;-12;544;10929;1;51;3.98008e+08;-3.23529e+06;0;0;0;0;0;0;398008209;402741779;22182443
1350;4.78831e-15;707;-12;544;10929;1;51;3.9817e+08;-3.22795e+06;1;0;0;0;1;0;398169628;402917808;22226356
1351;4.78831e-15;707;-12;544;10929;1;51;3.98331e+08;-3.22063e+06;1;0;0;0;1;0;398330681;403093478;22270234
1352;4.78831e-15;707;-12;544;10929;1;51;3.98491e+08;-3.21333e+06;1;0;0;0;1;0;398491369;403268791;22314076
1353;4.78831e-15;708;-12;544;10929;1;51;3.98652e+08;-3.20606e+06;0;0;0;0;0;0;398651693;403443747;22357882
1354;4.78831e-15;708;-12;544;10929;1;51;3.98812e+08;-3.1988e+06;1;0;0;0;1;0;398811654;403618348;22401652
1355;4.78831e-15;708;-12;544;10929;1;51;3.98971e+08;-3.19156e+06;1;0;0;0;1;0;398971253;403792594;22445386
1356;4.78831e-15;708;-12;544;10929;1;51;3.9913e+08;-3.18434e+06;1;0;0;0;1;0;399130491;403966486;22489083
1357;4.78831e-15;708;-12;544;10929;1;51;3.99289e+08;-3.17714e+06;1;0;0;0;1;0;399289370;404140026;22532744
1358;4.78831e-15;709;-12;544;10929;1;51;3.99448e+08;-3.16996e+06;0;0;0;0;0;0;399447889;404313214;22576368
1359;4.78831e-15;710;-12;544;10929;1;51;3.99606e+08;-3.1628e+06;0;0;0;0;0;0;399606050;404486050;22619956
1360;4.78831e-15;710;-12;544;10929;1;51;3.99764e+08;-3.15566e+06;1;0;0;0;1;0;399763855;404658537;22663507
1361;4.78831e-15;711;-12;544;10929;1;51;3.99921e+08;-3.14854e+06;0;0;0;0;0;0;399921303;404830674;22707021
1362;4.78831e-15;711;-12;544;10929;1;51;4.00078e+08;-3.14144e+06;1;0;0;0;1;0;400078397;405002463;22750498
1363;4.78831e-15;712;-12;544;10929;1;51;4.00235e+08;-3.13436e+06;0;0;0;0;0;0;400235136;405173904;22793938
1364;4.78831e-15;713;-12;544;10929;1;51;4.00392e+08;-3.1273e+06;0;0;0;0;0;0;400391522;405344999;22837341
1365;4.78831e-15;713;-12;544;10929;1;51;4.00548e+08;-3.12025e+06;1;0;0;0;1;0;400547556;405515748;22880707
1366;4.78831e-15;713;-12;544;10929;1;51;4.00703e+08;-3.11323e+06;1;0;0;0;1;0;400703239;405686152;22924036
1367;4.78831e-15;713;-12;544;10929;1;51;4.00859e+08;-3.10623e+06;1;0;0;0;1;0;400858572;405856213;22967327
1368;4.78831e-15;713;-12;544;10929;1;51;4.01014e+08;-3.09924e+06;1;0;0;0;1;0;401013555;406025930;23010580
1369;4.78831e-15;714;-12;544;10929;1;51;4.01168e+08;-3.09227e+06;0;0;0;0;0;0;401168190;406195305;23053796
1370;4.78831e-15;714;-12;544;10929;1;51;4.01322e+08;-3.08533e+06;1;0;0;0;1;0;401322478;406364339;23096974
1371;4.78831e-15;715;-12;544;10929;1;51;4.01476e+08;-3.0784e+06;0;0;0;0;0;0;401476419;406533032;23140115
1372;4.78831e-15;716;-12;544;10929;1;51;4.0163e+08;-3.07149e+06;0;0;0;0;0;0;401630015;406701386;23183217
1373;4.78831e-15;717;-12;544;10929;1;51;4.01783e+08;-3.0646e+06;0;0;0;0;0;0;401783267;406869401;23226282
1374;4.78831e-15;717;-12;544;10929;1;51;4.01936e+08;-3.05773e+06;1;0;0;0;1;0;401936174;407037078;23269309
1375;4.78831e-15;717;-12;544;10929;1;51;4.02089e+08;-3.05087e+06;1;0;0;0;1;0;402088739;407204418;23312297
1376;4.78831e-15;718;-12;544;10929;1;51;4.02241e+08;-3.04404e+06;0;0;0;0;0;0;402240963;407371421;23355247
1377;4.78831e-15;719;-12;544;10929;1;51;4.02393e+08;-3.03722e+06;0;0;0;0;0;0;402392845;407538090;23398159
1378;4.78831e-15;720;-12;544;10929;1;51;4.02544e+08;-3.03042e+06;0;0;0;0;0;0;402544388;407704424;23441033
1379;4.78831e-15;721;-12;544;10929;1;51;4.02696e+08;-3.02364e+06;0;0;0;0;0;0;402695591;407870424;23483868
1380;4.78831e-15;721;-12;544;10929;1;51;4.02846e+08;-3.01688e+06;1;0;0;0;1;0;402846457;408036091;23526664
1381;4.78831e-15;722;-12;544;10929;1;51;4.02997e+08;-3.01014e+06;0;0;0;0;0;0;402996985;408201426;23569422
1382;4.78831e-15;722;-12;544;10929;1;51;4.03147e+08;-3.00341e+06;1;0;0;0;1;0;403147177;408366431;23612141
1383;4.78831e-15;723;-12;544;10929;1;51;4.03297e+08;-2.99671e+06;0;0;0;0;0;0;403297034;408531104;23654822
1384;4.78831e-15;724;-12;544;10929;1;51;4.03447e+08;-2.99002e+06;0;0;0;0;0;0;403446556;408695448;23697463
1385;4.78831e-15;725;-12;544;10929;1;51;4.03596e+08;-2.98334e+06;0;0;0;0;0;0;403595745;408859464;23740065
1386;4.78831e-15;726;-12;544;10929;1;51;4.03745e+08;-2.97669e+06;0;0;0;0;0;0;403744601;409023151;23782629
1387;4.78831e-15;727;-12;544;10929;1;51;4.03893e+08;-2.97006e+06;0;0;0;0;0;0;403893125;409186512;23825153
1388;4.78831e-15;727;-12;544;10929;1;51;4.04041e+08;-2.96344e+06;1;0;0;0;1;0;404041318;409349546;23867638
1389;4.78831e-15;727;-12;544;10929;1;51;4.04189e+08;-2.95684e+06;1;0;0;0;1;0;404189181;409512255;23910084
1390;4.78831e-15;728;-12;544;10929;1;51;4.04337e+08;-2.95026e+06;0;0;0;0;0;0;404336716;409674639;23952491
1391;4.78831e-15;728;-12;544;10929;1;51;4.04484e+08;-2.94369e+06;1;0;0;0;1;0;404483922;409836699;23994858
1392;4.78831e-15;729;-12;544;10929;1;51;4.04631e+08;-2.93715e+06;0;0;0;0;0;0;404630800;409998436;24037185
1393;4.78831e-15;729;-12;544;10929;1;51;4.04777e+08;-2.93062e+06;1;0;0;0;1;0;404777352;410159850;24079473
1394;4.78831e-15;730;-12;544;10929;1;51;4.04924e+08;-2.9241e+06;0;0;0;0;0;0;404923579;410320944;24121722
1395;4.78831e-15;730;-12;544;10929;1;51;4.05069e+08;-2.91761e+06;1;0;0;0;1;0;405069481;410481716;24163930
1396;4.78831e-15;731;-12;544;10929;1;51;4.05215e+08;-2.91113e+06;0;0;0;0;0;0;405215059;410642169;24206099
1397;4.78831e-15;732;-12;544;10929;1;51;4.0536e+08;-2.90467e+06;0;0;0;0;0;0;405360313;410802302;24248228
1398;4.78831e-15;733;-12;544;10929;1;51;4.05505e+08;-2.89823e+06;0;0;0;0;0;0;405505246;410962117;24290317
1399;4.78831e-15;734;-12;544;10929;1;51;4.0565e+08;-2.8918e+06;0;0;0;0;0;0;405649858;411121615;24332366
1400;4.78831e-15;735;-12;544;10929;1;51;4.05794e+08;-2.88539e+06;0;0;0;0;0;0;405794149;411280795;24374376
1401;4.78831e-15;736;-12;544;10929;1;51;4.05938e+08;-2.879e+06;0;0;0;0;0;0;405938120;411439660;24416344
1402;4.78831e-15;736;-12;544;10929;1;51;4.06082e+08;-2.87262e+06;1;0;0;0;1;0;406081772;411598210;24458273
1403;4.78831e-15;736;-12;544;10929;1;51;4.06225e+08;-2.86626e+06;1;0;0;0;1;0;406225107;411756444;24500161
1404;4.78831e-15;737;-12;544;10929;1;51;4.06368e+08;-2.85992e+06;0;0;0;0;0;0;406368125;411914366;24542010
1405;4.78831e-15;737;-12;544;10929;1;51;4.06511e+08;-2.8536e+06;1;0;0;0;1;0;406510826;412071974;24583817
1406;4.78831e-15;738;-12;544;10929;1;51;4.06653e+08;-2.84729e+06;0;0;0;0;0;0;406653212;412229270;24625584
1407;4.78831e-15;738;-12;544;10929;1;51;4.06795e+08;-2.841e+06;1;0;0;0;1;0;406795283;412386255;24667311
1408;4.78831e-15;739;-12;544;10929;1;51;4.06937e+08;-2.83472e+06;0;0;0;0;0;0;406937041;412542929;24708997
1409;4.78831e-15;740;-12;544;10929;1;51;4.07078e+08;-2.82846e+06;0;0;0;0;0;0;407078485;412699293;24750643
1410;4.78831e-15;740;-12;544;10929;1;51;4.0722e+08;-2.82222e+06;1;0;0;0;1;0;407219618;412855348;24792247
1411;4.78831e-15;740;-12;544;10929;1;51;4.0736e+08;-2.816e+06;1;0;0;0;1;0;407360439;413011094;24833811
1412;4.78831e-15;740;-12;544;10929;1;51;4.07501e+08;-2.80979e+06;1;0;0;0;1;0;407500950;413166533;24875334
1413;4.78831e-15;741;-12;544;10929;1;51;4.07641e+08;-2.8036e+06;0;0;0;0;0;0;407641151;413321665;24916816
1414;4.78831e-15;742;-12;544;10929;1;51;4.07781e+08;-2.79742e+06;0;0;0;0;0;0;407781044;413476490;24958258
1415;4.78831e-15;743;-12;544;10929;1;51;4.07921e+08;-2.79126e+06;0;0;0;0;0;0;407920628;413631010;24999658
1416;4.78831e-15;743;-12;544;10929;1;51;4.0806e+08;-2.78511e+06;1;0;0;0;1;0;408059905;413785226;25041017
1417;4.78831e-15;743;-12;544;10929;1;51;4.08199e+08;-2.77899e+06;1;0;0;0;1;0;408198876;413939137;25082335
1418;4.78831e-15;743;-12;544;10929;1;51;4.08338e+08;-2.77287e+06;1;0;0;0;1;0;408337541;414092745;25123612
1419;4.78831e-15;744;-12;544;10929;1;51;4.08476e+08;-2.76678e+06;0;0;0;0;0;0;408475901;414246050;25164847
1420;4.78831e-15;745;-12;544;10929;1;51;4.08614e+08;-2.7607e+06;0;0;0;0;0;0;408613957;414399054;25206042
1421;4.78831e-15;745;-12;544;10929;1;51;4.08752e+08;-2.75463e+06;1;0;0;0;1;0;408751711;414551757;25247195
1422;4.78831e-15;745;-12;544;10929;1;51;4.08889e+08;-2.74858e+06;1;0;0;0;1;0;408889161;414704159;25288306
1423;4.78831e-15;745;-12;544;10929;1;51;4.09026e+08;-2.74255e+06;1;0;0;0;1;0;409026310;414856261;25329376
1424;4.78831e-15;745;-12;544;10929;1;51;4.09163e+08;-2.73653e+06;1;0;0;0;1;0;409163158;415008065;25370405
1425;4.78831e-15;746;-12;544;10929;1;51;4.093e+08;-2.73053e+06;0;0;0;0;0;0;409299706;415159570;25411392
1426;4.78831e-15;747;-12;544;10929;1;51;4.09436e+08;-2.72455e+06;0;0;0;0;0;0;409435955;415310778;25452337
1427;4.78831e-15;747;-12;544;10929;1;51;4.09572e+08;-2.71858e+06;1;0;0;0;1;0;409571905;415461689;25493241
1428;4.78831e-15;747;-12;544;10929;1;51;4.09708e+08;-2.71262e+06;1;0;0;0;1;0;409707558;415612303;25534103
1429;4.78831e-15;747;-12;544;10929;1;51;4.09843e+08;-2.70668e+06;1;0;0;0;1;0;409842913;415762623;25574923
1430;4.78831e-15;747;-12;544;10929;1;51;4.09978e+08;-2.70076e+06;1;0;0;0;1;0;409977973;415912647;25615701
1431;4.78831e-15;747;-12;544;10929;1;51;4.10113e+08;-2.69485e+06;1;0;0;0;1;0;410112737;416062378;25656437
1432;4.78831e-15;748;-12;544;10929;1;51;4.10247e+08;-2.68896e+06;0;0;0;0;0;0;410247206;416211815;25697132
1433;4.78831e-15;748;-12;544;10929;1;51;4.10381e+08;-2.68308e+06;1;0;0;0;1;0;410381381;416360960;25737785
1434;4.78831e-15;748;-12;544;10929;1;51;4.10515e+08;-2.67722e+06;1;0;0;0;1;0;410515263;416509812;25778395
1435;4.78831e-15;749;-12;544;10929;1;51;4.10649e+08;-2.67137e+06;0;0;0;0;0;0;410648853;416658373;25818964
1436;4.78831e-15;750;-12;544;10929;1;51;4.10782e+08;-2.66554e+06;0;0;0;0;0;0;410782151;416806644;25859490
1437;4.78831e-15;751;-12;544;10929;1;51;4.10915e+08;-2.65972e+06;0;0;0;0;0;0;410915159;416954625;25899974
1438;4.78831e-15;751;-12;544;10929;1;51;4.11048e+08;-2.65391e+06;1;0;0;0;1;0;411047876;417102317;25940416
1439;4.78831e-15;751;-12;544;10929;1;51;4.1118e+08;-2.64813e+06;1;0;0;0;1;0;411180304;417249720;25980816
1440;4.78831e-15;751;-12;544;10929;1;51;4.11312e+08;-2.64235e+06;1;0;0;0;1;0;411312443;417396835;26021174
1441;4.78831e-15;751;-12;544;10929;1;51;4.11444e+08;-2.6366e+06;1;0;0;0;1;0;411444294;417543663;26061489
1442;4.78831e-15;752;-12;544;10929;1;51;4.11576e+08;-2.63085e+06;0;0;0;0;0;0;411575858;417690204;26101762
1443;4.78831e-15;753;-12;544;10929;1;51;4.11707e+08;-2.62512e+06;0;0;0;0;0;0;411707136;417836460;26141992
1444;4.78831e-15;754;-12;544;10929;1;51;4.11838e+08;-2.61941e+06;0;0;0;0;0;0;411838128;417982431;26182180
1445;4.78831e-15;754;-12;544;10929;1;51;4.11969e+08;-2.61371e+06;1;0;0;0;1;0;411968835;418128116;26222325
1446;4.78831e-15;754;-12;544;10929;1;51;4.12099e+08;-2.60803e+06;1;0;0;0;1;0;412099258;418273519;26262428
1447;4.78831e-15;754;-12;544;10929;1;51;4.12229e+08;-2.60236e+06;1;0;0;0;1;0;412229397;418418638;26302488
1448;4.78831e-15;754;-12;544;10929;1;51;4.12359e+08;-2.5967e+06;1;0;0;0;1;0;412359254;418563474;26342506
1449;4.78831e-15;754;-12;544;10929;1;51;4.12489e+08;-2.59106e+06;1;0;0;0;1;0;412488828;418708028;26382481
1450;4.78831e-15;755;-12;544;10929;1;51;4.12618e+08;-2.58543e+06;0;0;0;0;0;0;412618121;418852302;26422414
1451;4.78831e-15;755;-12;544;10929;1;51;4.12747e+08;-2.57982e+06;1;0;0;0;1;0;412747134;418996294;26462303
1452;4.78831e-15;756;-12;544;10929;1;51;4.12876e+08;-2.57422e+06;0;0;0;0;0;0;412875867;419140007;26502150
1453;4.78831e-15;757;-12;544;10929;1;51;4.13004e+08;-2.56864e+06;0;0;0;0;0;0;413004320;419283441;26541954
1454;4.78831e-15;758;-12;544;10929;1;51;4.13132e+08;-2.56307e+06;0;0;0;0;0;0;413132495;419426595;26581715
1455;4.78831e-15;759;-12;544;10929;1;51;4.1326e+08;-2.55752e+06;0;0;0;0;0;0;413260392;419569472;26621434
1456;4.78831e-15;759;-12;544;10929;1;51;4.13388e+08;-2.55198e+06;1;0;0;0;1;0;413388013;419712072;26661109
1457;4.78831e-15;760;-12;544;10929;1;51;4.13515e+08;-2.54645e+06;0;0;0;0;0;0;413515357;419854395;26700742
1458;4.78831e-15;760;-12;544;10929;1;51;4.13642e+08;-2.54094e+06;1;0;0;0;1;0;413642425;419996442;26740331
1459;4.78831e-15;760;-12;544;10929;1;51;4.13769e+08;-2.53544e+06;1;0;0;0;1;0;413769218;420138213;26779878
1460;4.78831e-15;761;-12;544;10929;1;51;4.13896e+08;-2.52995e+06;0;0;0;0;0;0;413895737;420279709;26819381
1461;4.78831e-15;762;-12;544;10929;1;51;4.14022e+08;-2.52448e+06;0;0;0;0;0;0;414021983;420420932;26858841
1462;4.78831e-15;763;-12;544;10929;1;51;4.14148e+08;-2.51902e+06;0;0;0;0;0;0;414147955;420561880;26898259
1463;4.78831e-15;763;-12;544;10929;1;51;4.14274e+08;-2.51358e+06;1;0;0;0;1;0;414273656;420702556;26937633
1464;4.78831e-15;763;-12;544;10929;1;51;4.14399e+08;-2.50815e+06;1;0;0;0;1;0;414399085;420842960;26976964
1465;4.78831e-15;764;-12;544;10929;1;51;4.14524e+08;-2.50273e+06;0;0;0;0;0;0;414524243;420983092;27016252
1466;4.78831e-15;764;-13;544;10929;1;51;4.14649e+08;-2.49733e+06;0;0;0;0;0;0;414649131;421122953;27055496
1467;4.78831e-15;765;-13;544;10929;1;51;4.14774e+08;-2.49194e+06;0;0;0;0;0;0;414773750;421262544;27094697
1468;4.78831e-15;766;-13;544;10929;1;51;4.14898e+08;-2.48657e+06;0;0;0;0;0;0;414898099;421401864;27133855
1469;4.78831e-15;766;-13;544;10929;1;51;4.15022e+08;-2.48121e+06;1;0;0;0;1;0;415022181;421540916;27172970
1470;4.78831e-15;766;-13;544;10929;1;51;4.15146e+08;-2.47586e+06;1;0;0;0;1;0;415145996;421679699;27212041
1471;4.78831e-15;766;-13;544;10929;1;51;4.1527e+08;-2.47052e+06;1;0;0;0;1;0;415269543;421818214;27251069
1472;4.78831e-15;766;-13;544;10929;1;51;4.15393e+08;-2.4652e+06;0;0;-1;0;0;-1;415392825;421956461;27290054
1473;4.78831e-15;766;-13;544;10929;1;51;4.15516e+08;-2.4599e+06;1;0;0;0;1;0;415515841;422094442;27328995
1474;4.78831e-15;767;-13;544;10929;1;51;4.15639e+08;-2.4546e+06;0;0;0;0;0;0;415638593;422232157;27367892
1475;4.78831e-15;767;-13;544;10929;1;51;4.15761e+08;-2.44932e+06;1;0;0;0;1;0;415761080;422369606;27406746
1476;4.78831e-15;767;-14;544;10929;1;51;4.15883e+08;-2.44405e+06;0;0;0;0;0;0;415883305;422506790;27445557
1477;4.78831e-15;768;-14;544;10929;1;51;4.16005e+08;-2.4388e+06;0;0;0;0;0;0;416005266;422643710;27484324
1478;4.78831e-15;769;-14;544;10929;1;51;4.16127e+08;-2.43356e+06;0;0;0;0;0;0;416126965;422780366;27523048
1479;4.78831e-15;770;-14;544;10929;1;51;4.16248e+08;-2.42833e+06;0;0;0;0;0;0;416248403;422916759;27561728
1480;4.78831e-15;771;-14;544;10929;1;51;4.1637e+08;-2.42311e+06;0;0;0;0;0;0;416369581;423052890;27600364
1481;4.78831e-15;771;-14;544;10929;1;51;4.1649e+08;-2.41791e+06;1;0;0;0;1;0;416490498;423188758;27638957
1482;4.78831e-15;772;-14;544;10929;1;51;4.16611e+08;-2.41272e+06;0;0;0;0;0;0;416611155;423324366;27677506
1483;4.78831e-15;772;-14;544;10929;1;51;4.16732e+08;-2.40755e+06;1;0;0;0;1;0;416731554;423459712;27716011
1484;4.78831e-15;772;-14;544;10929;1;51;4.16852e+08;-2.40238e+06;1;0;0;0;1;0;416851695;423594798;27754473
1485;4.78831e-15;772;-14;544;10929;1;51;4.16972e+08;-2.39723e+06;1;0;0;0;1;0;416971578;423729625;27792891
1486;4.78831e-15;772;-14;544;10929;1;51;4.17091e+08;-2.3921e+06;1;0;0;0;1;0;417091204;423864192;27831265
1487;4.78831e-15;773;-14;544;10929;1;51;4.17211e+08;-2.38697e+06;0;0;0;0;0;0;417210574;423998501;27869596
1488;4.78831e-15;774;-14;544;10929;1;51;4.1733e+08;-2.38186e+06;0;0;0;0;0;0;417329689;424132552;27907882
1489;4.78831e-15;775;-14;544;10929;1;51;4.17449e+08;-2.37676e+06;0;0;0;0;0;0;417448548;424266346;27946125
1490;4.78831e-15;776;-14;544;10929;1;51;4.17567e+08;-2.37167e+06;0;0;0;0;0;0;417567153;424399884;27984324
1491;4.78831e-15;776;-14;544;10929;1;51;4.17686e+08;-2.3666e+06;1;0;0;0;1;0;417685505;424533165;28022480
1492;4.78831e-15;777;-14;544;10929;1;51;4.17804e+08;-2.36154e+06;0;0;0;0;0;0;417803603;424666190;28060591
1493;4.78831e-15;777;-14;544;10929;1;51;4.17921e+08;-2.35649e+06;1;0;0;0;1;0;417921449;424798961;28098659
1494;4.78831e-15;777;-14;544;10929;1;51;4.18039e+08;-2.35145e+06;1;0;0;0;1;0;418039043;424931477;28136682
1495;4.78831e-15;778;-14;544;10929;1;51;4.18156e+08;-2.34643e+06;0;0;0;0;0;0;418156386;425063739;28174662
1496;4.78831e-15;778;-14;544;10929;1;51;4.18273e+08;-2.34142e+06;1;0;0;0;1;0;418273479;425195748;28212598
1497;4.78831e-15;778;-14;544;10929;1;51;4.1839e+08;-2.33642e+06;1;0;0;0;1;0;418390321;425327505;28250490
1498;4.78831e-15;778;-14;544;10929;1;51;4.18507e+08;-2.33143e+06;1;0;0;0;1;0;418506914;425459009;28288338
1499;4.78831e-15;778;-14;544;10929;1;51;4.18623e+08;-2.32646e+06;1;0;0;0;1;0;418623259;425590261;28326142
1500;4.78831e-15;779;-14;544;10929;1;51;4.18739e+08;-2.3215e+06;0;0;0;0;0;0;418739355;425721262;28363902
1501;4.78831e-15;780;-14;544;10929;1;51;4.18855e+08;-2.31655e+06;0;0;0;0;0;0;418855204;425852013;28401618
1502;4.78831e-15;780;-14;544;10929;1;51;4.18971e+08;-2.31161e+06;1;0;0;0;1;0;418970806;425982514;28439290
1503;4.78831e-15;781;-14;544;10929;1;51;4.19086e+08;-2.30668e+06;0;0;0;0;0;0;419086162;426112766;28476918
1504;4.78831e-15;782;-14;544;10929;1;51;4.19201e+08;-2.30177e+06;0;0;0;0;0;0;419201272;426242769;28514502
1505;4.78831e-15;783;-14;544;10929;1;51;4.19316e+08;-2.29687e+06;0;0;0;0;0;0;419316137;426372523;28552042
1506;4.78831e-15;783;-14;544;10929;1;51;4.19431e+08;-2.29198e+06;1;0;0;0;1;0;419430758;426502030;28589538
1507;4.78831e-15;784;-14;544;10929;1;51;4.19545e+08;-2.2871e+06;0;0;0;0;0;0;419545134;426631290;28626989
1508;4.78831e-15;784;-14;544;10929;1;51;4.19659e+08;-2.28224e+06;1;0;0;0;1;0;419659268;426760303;28664397
1509;4.78831e-15;785;-14;544;10929;1;51;4.19773e+08;-2.27739e+06;0;0;0;0;0;0;419773159;426889069;28701761
1510;4.78831e-15;786;-14;544;10929;1;51;4.19887e+08;-2.27255e+06;0;0;0;0;0;0;419886808;427017591;28739080
1511;4.78831e-15;786;-14;544;10929;1;51;4.2e+08;-2.26772e+06;1;0;0;0;1;0;420000215;427145867;28776355
1512;4.78831e-15;786;-14;544;10929;1;51;4.20113e+08;-2.2629e+06;1;0;0;0;1;0;420113382;427273899;28813587
1513;4.78831e-15;786;-14;544;10929;1;51;4.20226e+08;-2.25809e+06;1;0;0;0;1;0;420226308;427401687;28850774
1514;4.78831e-15;786;-14;544;10929;1;51;4.20339e+08;-2.2533e+06;1;0;0;0;1;0;420338994;427529231;28887917
1515;4.78831e-15;786;-14;544;10929;1;51;4.20451e+08;-2.24852e+06;1;0;0;0;1;0;420451442;427656533;28925015
1516;4.78831e-15;787;-14;544;10929;1;51;4.20564e+08;-2.24375e+06;0;0;0;0;0;0;420563651;427783592;28962070
1517;4.78831e-15;788;-14;544;10929;1;51;4.20676e+08;-2.23899e+06;0;0;0;0;0;0;420675622;427910409;28999081
1518;4.78831e-15;788;-14;544;10929;1;51;4.20787e+08;-2.23424e+06;1;0;0;0;1;0;420787355;428036985;29036047
1519;4.78831e-15;788;-14;544;10929;1;51;4.20899e+08;-2.22951e+06;1;0;0;0;1;0;420898852;428163321;29072969
1520;4.78831e-15;788;-14;544;10929;1;51;4.2101e+08;-2.22478e+06;1;0;0;0;1;0;421010113;428289416;29109847
1521;4.78831e-15;788;-15;544;10929;1;51;4.21121e+08;-2.22007e+06;0;0;0;0;0;0;421121138;428415271;29146680
1522;4.78831e-15;788;-15;544;10929;1;51;4.21232e+08;-2.21537e+06;1;0;0;0;1;0;421231928;428540887;29183470
1523;4.78831e-15;788;-15;544;10929;1;51;4.21342e+08;-2.21068e+06;1;0;0;0;1;0;421342484;428666265;29220215
1524;4.78831e-15;788;-15;544;10929;1;51;4.21453e+08;-2.206e+06;1;0;0;0;1;0;421452805;428791404;29256916
1525;4.78831e-15;789;-15;544;10929;1;51;4.21563e+08;-2.20134e+06;0;0;0;0;0;0;421562894;428916306;29293573
1526;4.78831e-15;790;-15;544;10929;1;51;4.21673e+08;-2.19668e+06;0;0;0;0;0;0;421672750;429040971;29330186
1527;4.78831e-15;790;-15;544;10929;1;51;4.21782e+08;-2.19204e+06;1;0;0;0;1;0;421782373;429165399;29366754
1528;4.78831e-15;791;-15;544;10929;1;51;4.21892e+08;-2.1874e+06;0;0;0;0;0;0;421891765;429289591;29403278
1529;4.78831e-15;791;-15;544;10929;1;51;4.22001e+08;-2.18278e+06;1;0;0;0;1;0;422000926;429413548;29439758
1530;4.78831e-15;791;-15;544;10929;1;51;4.2211e+08;-2.17817e+06;1;0;0;0;1;0;422109856;429537269;29476193
1531;4.78831e-15;792;-15;544;10929;1;51;4.22219e+08;-2.17357e+06;0;0;0;0;0;0;422218556;429660756;29512585
1532;4.78831e-15;792;-15;544;10929;1;51;4.22327e+08;-2.16899e+06;1;0;0;0;1;0;422327027;429784009;29548932
1533;4.78831e-15;792;-15;544;10929;1;51;4.22435e+08;-2.16441e+06;1;0;0;0;1;0;422435269;429907028;29585235
1534;4.78831e-15;792;-15;544;10929;1;51;4.22543e+08;-2.15984e+06;1;0;0;0;1;0;422543283;430029814;29621493
1535;4.78831e-15;792;-15;544;10929;1;51;4.22651e+08;-2.15529e+06;1;0;0;0;1;0;422651069;430152368;29657707
1536;4.78831e-15;792;-15;544;10929;1;51;4.22759e+08;-2.15075e+06;1;0;0;0;1;0;422758628;430274690;29693877
1537;4.78831e-15;793;-15;544;10929;1;51;4.22866e+08;-2.14621e+06;0;0;0;0;0;0;422865960;430396780;29730003
1538;4.78831e-15;794;-15;544;10929;1;51;4.22973e+08;-2.14169e+06;0;0;0;0;0;0;422973066;430518639;29766085
1539;4.78831e-15;794;-15;544;10929;1;51;4.2308e+08;-2.13718e+06;1;0;0;0;1;0;423079947;430640268;29802122
1540;4.78831e-15;794;-15;544;10929;1;51;4.23187e+08;-2.13268e+06;1;0;0;0;1;0;423186602;430761666;29838115
1541;4.78831e-15;795;-15;544;10929;1;51;4.23293e+08;-2.12819e+06;0;0;0;0;0;0;423293034;430882835;29874064
1542;4.78831e-15;795;-15;544;10929;1;51;4.23399e+08;-2.12371e+06;1;0;0;0;1;0;423399241;431003776;29909968
1543;4.78831e-15;796;-15;544;10929;1;51;4.23505e+08;-2.11925e+06;0;0;0;0;0;0;423505225;431124487;29945828
1544;4.78831e-15;796;-15;544;10929;1;51;4.23611e+08;-2.11479e+06;1;0;0;0;1;0;423610986;431244970;29981644
1545;4.78831e-15;796;-15;544;10929;1;51;4.23717e+08;-2.11034e+06;1;0;0;0;1;0;423716525;431365226;30017416
1546;4.78831e-15;797;-15;544;10929;1;51;4.23822e+08;-2.10591e+06;0;0;0;0;0;0;423821842;431485255;30053143
1547;4.78831e-15;798;-15;544;10929;1;51;4.23927e+08;-2.10148e+06;0;0;0;0;0;0;423926938;431605057;30088826
1548;4.78831e-15;799;-15;544;10929;1;51;4.24032e+08;-2.09707e+06;0;0;0;0;0;0;424031813;431724633;30124465
1549;4.78831e-15;800;-15;544;10929;1;51;4.24136e+08;-2.09267e+06;0;0;0;0;0;0;424136468;431843983;30160060
1550;4.78831e-15;800;-15;544;10929;1;51;4.24241e+08;-2.08827e+06;1;0;0;0;1;0;424240903;431963109;30195610
1551;4.78831e-15;800;-15;544;10929;1;51;4.24345e+08;-2.08389e+06;1;0;0;0;1;0;424345119;432082009;30231116
1552;4.78831e-15;800;-15;544;10929;1;51;4.24449e+08;-2.07952e+06;1;0;0;0;1;0;424449117;432200685;30266578
1553;4.78831e-15;800;-15;544;10929;1;51;4.24553e+08;-2.07516e+06;1;0;0;0;1;0;424552897;432319138;30301995
1554;4.78831e-15;801;-15;544;10929;1;51;4.24656e+08;-2.07081e+06;0;0;0;0;0;0;424656459;432437367;30337369
1555;4.78831e-15;802;-15;544;10929;1;51;4.2476e+08;-2.06647e+06;0;0;0;0;0;0;424759804;432555374;30372698
1556;4.78831e-15;802;-15;544;10929;1;51;4.24863e+08;-2.06214e+06;0;0;-1;0;0;-1;424862932;432673158;30407983
1557;4.78831e-15;803;-15;544;10929;1;51;4.24966e+08;-2.05782e+06;0;0;0;0;0;0;424965845;432790721;30443223
1558;4.78831e-15;803;-15;544;10929;1;51;4.25069e+08;-2.05351e+06;1;0;0;0;1;0;425068542;432908062;30478420
1559;4.78831e-15;803;-15;544;10929;1;51;4.25171e+08;-2.04921e+06;1;0;0;0;1;0;425171024;433025182;30513572
1560;4.78831e-15;804;-15;544;10929;1;51;4.25273e+08;-2.04492e+06;0;0;0;0;0;0;425273291;433142082;30548680
1561;4.78831e-15;804;-15;544;10929;1;51;4.25375e+08;-2.04064e+06;1;0;0;0;1;0;425375345;433258762;30583744
1562;4.78831e-15;804;-15;544;10929;1;51;4.25477e+08;-2.03637e+06;1;0;0;0;1;0;425477185;433375222;30618763
1563;4.78831e-15;804;-15;544;10929;1;51;4.25579e+08;-2.03212e+06;1;0;0;0;1;0;425578813;433491464;30653739
1564;4.78831e-15;805;-15;544;10929;1;51;4.2568e+08;-2.02787e+06;0;0;0;0;0;0;425680228;433607487;30688670
1565;4.78831e-15;805;-15;544;10929;1;51;4.25781e+08;-2.02363e+06;0;0;-1;0;0;-1;425781431;433723292;30723557
1566;4.78831e-15;806;-15;544;10929;1;51;4.25882e+08;-2.0194e+06;0;0;0;0;0;0;425882423;433838879;30758400
1567;4.78831e-15;806;-15;544;10929;1;51;4.25983e+08;-2.01518e+06;1;0;0;0;1;0;425983204;433954249;30793199
1568;4.78831e-15;807;-15;544;10929;1;51;4.26084e+08;-2.01098e+06;0;0;0;0;0;0;426083774;434069402;30827953
1569;4.78831e-15;807;-15;544;10929;1;51;4.26184e+08;-2.00678e+06;1;0;0;0;1;0;426184134;434184339;30862664
1570;4.78831e-15;807;-15;544;10929;1;51;4.26284e+08;-2.00259e+06;1;0;0;0;1;0;426284286;434299060;30897330
1571;4.78831e-15;808;-15;544;10929;1;51;4.26384e+08;-1.99841e+06;0;0;0;0;0;0;426384228;434413566;30931952
1572;4.78831e-15;809;-15;544;10929;1;51;4.26484e+08;-1.99424e+06;0;0;0;0;0;0;426483962;434527857;30966530
1573;4.78831e-15;809;-15;544;10929;1;51;4.26583e+08;-1.99009e+06;1;0;0;0;1;0;426583488;434641934;31001064
1574;4.78831e-15;810;-15;544;10929;1;51;4.26683e+08;-1.98594e+06;0;0;0;0;0;0;426682806;434755796;31035554
1575;4.78831e-15;811;-15;544;10929;1;51;4.26782e+08;-1.9818e+06;0;0;0;0;0;0;426781918;434869445;31070000
1576;4.78831e-15;812;-15;544;10929;1;51;4.26881e+08;-1.97767e+06;0;0;0;0;0;0;426880823;434982881;31104401
1577;4.78831e-15;813;-15;544;10929;1;51;4.2698e+08;-1.97355e+06;0;0;0;0;0;0;426979522;435096104;31138759
1578;4.78831e-15;814;-15;544;10929;1;51;4.27078e+08;-1.96944e+06;0;0;0;0;0;0;427078016;435209115;31173072
1579;4.78831e-15;815;-15;544;10929;1;51;4.27176e+08;-1.96534e+06;0;0;0;0;0;0;427176305;435321915;31207342
1580;4.78831e-15;815;-15;544;10929;1;51;4.27274e+08;-1.96125e+06;1;0;0;0;1;0;427274389;435434503;31241567
1581;4.78831e-15;816;-15;544;10929;1;51;4.27372e+08;-1.95717e+06;0;0;0;0;0;0;427372269;435546880;31275748
1582;4.78831e-15;817;-15;544;10929;1;51;4.2747e+08;-1.9531e+06;0;0;0;0;0;0;427469946;435659046;31309886
1583;4.78831e-15;818;-15;544;10929;1;51;4.27567e+08;-1.94904e+06;0;0;0;0;0;0;427567419;435771003;31343979
1584;4.78831e-15;818;-15;544;10929;1;51;4.27665e+08;-1.94499e+06;1;0;0;0;1;0;427664690;435882750;31378029
1585;4.78831e-15;819;-15;544;10929;1;51;4.27762e+08;-1.94095e+06;0;0;0;0;0;0;427761759;435994288;31412034
1586;4.78831e-15;820;-15;544;10929;1;51;4.27859e+08;-1.93691e+06;0;0;0;0;0;0;427858627;436105618;31445995
1587;4.78831e-15;820;-15;544;10929;1;51;4.27955e+08;-1.93289e+06;1;0;0;0;1;0;427955293;436216739;31479913
1588;4.78831e-15;820;-15;544;10929;1;51;4.28052e+08;-1.92888e+06;1;0;0;0;1;0;428051759;436327652;31513786
1589;4.78831e-15;821;-15;544;10929;1;51;4.28148e+08;-1.92487e+06;0;0;0;0;0;0;428148024;436438358;31547616
1590;4.78831e-15;821;-15;544;10929;1;51;4.28244e+08;-1.92088e+06;1;0;0;0;1;0;428244090;436548857;31581402
1591;4.78831e-15;822;-15;544;10929;1;51;4.2834e+08;-1.91689e+06;0;0;0;0;0;0;428339956;436659149;31615143
1592;4.78831e-15;822;-15;544;10929;1;51;4.28436e+08;-1.91292e+06;1;0;0;0;1;0;428435623;436769235;31648841
1593;4.78831e-15;822;-15;544;10929;1;51;4.28531e+08;-1.90895e+06;1;0;0;0;1;0;428531093;436879116;31682495
1594;4.78831e-15;822;-15;544;10929;1;51;4.28626e+08;-1.90499e+06;1;0;0;0;1;0;428626364;436988791;31716105
1595;4.78831e-15;823;-15;544;10929;1;51;4.28721e+08;-1.90105e+06;0;0;0;0;0;0;428721438;437098262;31749672
1596;4.78831e-15;823;-15;544;10929;1;51;4.28816e+08;-1.89711e+06;1;0;0;0;1;0;428816315;437207528;31783194
1597;4.78831e-15;823;-15;544;10929;1;51;4.28911e+08;-1.89318e+06;1;0;0;0;1;0;428910995;437316590;31816673
1598;4.78831e-15;823;-15;544;10929;1;51;4.29005e+08;-1.88926e+06;1;0;0;0;1;0;429005480;437425449;31850108
1599;4.78831e-15;823;-15;544;10929;1;51;4.291e+08;-1.88535e+06;1;0;0;0;1;0;429099769;437534105;31883499
1600;4.78831e-15;824;-15;544;10929;1;51;4.29194e+08;-1.88144e+06;0;0;0;0;0;0;429193863;437642557;31916846
1601;4.78831e-15;825;-15;544;10929;1;51;4.29288e+08;-1.87755e+06;0;0;0;0;0;0;429287762;437750808;31950150
1602;4.78831e-15;825;-15;544;10929;1;51;4.29381e+08;-1.87367e+06;1;0;0;0;1;0;429381467;437858857;31983409
1603;4.78831e-15;826;-15;544;10929;1;51;4.29475e+08;-1.86979e+06;0;0;0;0;0;0;429474978;437966704;32016626
1604;4.78831e-15;826;-15;544;10929;1;51;4.29568e+08;-1.86593e+06;1;0;0;0;1;0;429568296;438074350;32049798
1605;4.78831e-15;826;-15;544;10929;1;51;4.29661e+08;-1.86207e+06;1;0;0;0;1;0;429661421;438181796;32082927
1606;4.78831e-15;826;-15;544;10929;1;51;4.29754e+08;-1.85822e+06;1;0;0;0;1;0;429754354;438289041;32116012
1607;4.78831e-15;826;-15;544;10929;1;51;4.29847e+08;-1.85438e+06;1;0;0;0;1;0;429847095;438396087;32149053
1608;4.78831e-15;827;-15;544;10929;1;51;4.2994e+08;-1.85055e+06;0;0;0;0;0;0;429939644;438502933;32182051
1609;4.78831e-15;827;-15;544;10929;1;51;4.30032e+08;-1.84673e+06;1;0;0;0;1;0;430032002;438609580;32215005
1610;4.78831e-15;827;-15;544;10929;1;51;4.30124e+08;-1.84292e+06;1;0;0;0;1;0;430124170;438716028;32247916
1611;4.78831e-15;828;-15;544;10929;1;51;4.30216e+08;-1.83912e+06;0;0;0;0;0;0;430216148;438822279;32280783
1612;4.78831e-15;828;-15;544;10929;1;51;4.30308e+08;-1.83532e+06;1;0;0;0;1;0;430307935;438928332;32313606
1613;4.78831e-15;828;-15;544;10929;1;51;4.304e+08;-1.83154e+06;1;0;0;0;1;0;430399534;439034187;32346386
1614;4.78831e-15;829;-15;544;10929;1;51;4.30491e+08;-1.82776e+06;0;0;0;0;0;0;430490943;439139845;32379122
1615;4.78831e-15;829;-15;544;10929;1;51;4.30582e+08;-1.82399e+06;1;0;0;0;1;0;430582165;439245307;32411815
1616;4.78831e-15;829;-15;544;10929;1;51;4.30673e+08;-1.82023e+06;1;0;0;0;1;0;430673198;439350573;32444464
1617;4.78831e-15;830;-15;544;10929;1;51;4.30764e+08;-1.81648e+06;0;0;0;0;0;0;430764044;439455643;32477070
1618;4.78831e-15;831;-15;544;10929;1;51;4.30855e+08;-1.81274e+06;0;0;0;0;0;0;430854702;439560517;32509633
1619;4.78831e-15;831;-15;544;10929;1;51;4.30945e+08;-1.80901e+06;1;0;0;0;1;0;430945174;439665197;32542152
1620;4.78831e-15;832;-15;544;10929;1;51;4.31035e+08;-1.80528e+06;0;0;0;0;0;0;431035460;439769682;32574627
1621;4.78831e-15;833;-15;544;10929;1;51;4.31126e+08;-1.80156e+06;0;0;0;0;0;0;431125560;439873973;32607059
1622;4.78831e-15;833;-15;544;10929;1;51;4.31215e+08;-1.79786e+06;1;0;0;0;1;0;431215475;439978071;32639448
1623;4.78831e-15;834;-15;544;10929;1;51;4.31305e+08;-1.79416e+06;0;0;0;0;0;0;431305204;440081974;32671794
1624;4.78831e-15;835;-15;544;10929;1;51;4.31395e+08;-1.79047e+06;0;0;0;0;0;0;431394749;440185685;32704096
1625;4.78831e-15;836;-15;544;10929;1;51;4.31484e+08;-1.78679e+06;0;0;0;0;0;0;431484110;440289204;32736355
1626;4.78831e-15;837;-15;544;10929;1;51;4.31573e+08;-1.78311e+06;0;0;0;0;0;0;431573288;440392530;32768570
1627;4.78831e-15;837;-15;544;10929;1;51;4.31662e+08;-1.77945e+06;1;0;0;0;1;0;431662282;440495664;32800743
1628;4.78831e-15;838;-15;544;10929;1;51;4.31751e+08;-1.77579e+06;0;0;0;0;0;0;431751093;440598607;32832872
1629;4.78831e-15;838;-15;544;10929;1;51;4.3184e+08;-1.77214e+06;1;0;0;0;1;0;431839722;440701359;32864958
1630;4.78831e-15;838;-15;544;10929;1;51;4.31928e+08;-1.7685e+06;1;0;0;0;1;0;431928169;440803921;32897000
1631;4.78831e-15;838;-15;544;10929;1;51;4.32016e+08;-1.76487e+06;1;0;0;0;1;0;432016434;440906292;32929000
1632;4.78831e-15;839;-15;544;10929;1;51;4.32105e+08;-1.76125e+06;0;0;0;0;0;0;432104518;441008473;32960956
1633;4.78831e-15;839;-15;544;10929;1;51;4.32192e+08;-1.75764e+06;1;0;0;0;1;0;432192422;441110465;32992869
1634;4.78831e-15;840;-15;544;10929;1;51;4.3228e+08;-1.75403e+06;0;0;0;0;0;0;432280145;441212268;33024740
1635;4.78831e-15;841;-15;544;10929;1;51;4.32368e+08;-1.75043e+06;0;0;0;0;0;0;432367688;441313882;33056567
1636;4.78831e-15;841;-15;544;10929;1;51;4.32455e+08;-1.74684e+06;1;0;0;0;1;0;432455052;441415307;33088351
1637;4.78831e-15;842;-15;544;10929;1;51;4.32542e+08;-1.74326e+06;0;0;0;0;0;0;432542236;441516545;33120091
1638;4.78831e-15;843;-15;544;10929;1;51;4.32629e+08;-1.73969e+06;0;0;0;0;0;0;432629242;441617595;33151789
1639;4.78831e-15;843;-15;544;10929;1;51;4.32716e+08;-1.73612e+06;1;0;0;0;1;0;432716070;441718458;33183444
1640;4.78831e-15;843;-15;544;10929;1;51;4.32803e+08;-1.73256e+06;1;0;0;0;1;0;432802720;441819135;33215056
1641;4.78831e-15;843;-15;544;10929;1;51;4.32889e+08;-1.72902e+06;1;0;0;0;1;0;432889192;441919625;33246625
1642;4.78831e-15;844;-15;544;10929;1;51;4.32975e+08;-1.72547e+06;0;0;0;0;0;0;432975488;442019928;33278151
1643;4.78831e-15;845;-15;544;10929;1;51;4.33062e+08;-1.72194e+06;0;0;0;0;0;0;433061607;442120047;33309634
1644;4.78831e-15;846;-15;544;10929;1;51;4.33148e+08;-1.71842e+06;0;0;0;0;0;0;433147549;442219979;33341075
1645;4.78831e-15;847;-15;544;10929;1;51;4.33233e+08;-1.7149e+06;0;0;0;0;0;0;433233316;442319727;33372472
1646;4.78831e-15;847;-15;544;10929;1;51;4.33319e+08;-1.71139e+06;1;0;0;0;1;0;433318907;442419291;33403827
1647;4.78831e-15;848;-15;544;10929;1;51;4.33404e+08;-1.70789e+06;0;0;0;0;0;0;433404324;442518670;33435139
1648;4.78831e-15;848;-15;544;10929;1;51;4.3349e+08;-1.7044e+06;1;0;0;0;1;0;433489565;442617865;33466408
1649;4.78831e-15;849;-15;544;10929;1;51;4.33575e+08;-1.70092e+06;0;0;0;0;0;0;433574633;442716877;33497634
1650;4.78831e-15;850;-15;544;10929;1;51;4.3366e+08;-1.69744e+06;0;0;0;0;0;0;433659527;442815706;33528818
1651;4.78831e-15;850;-15;544;10929;1;51;4.33744e+08;-1.69397e+06;1;0;0;0;1;0;433744247;442914352;33559959
1652;4.78831e-15;850;-15;544;10929;1;51;4.33829e+08;-1.69051e+06;1;0;0;0;1;0;433828794;443012816;33591057
1653;4.78831e-15;850;-15;544;10929;1;51;4.33913e+08;-1.68706e+06;1;0;0;0;1;0;433913168;443111098;33622112
1654;4.78831e-15;850;-15;544;10929;1;51;4.33997e+08;-1.68361e+06;1;0;0;0;1;0;433997371;443209198;33653125
1655;4.78831e-15;851;-15;544;10929;1;51;4.34081e+08;-1.68017e+06;0;0;0;0;0;0;434081401;443307117;33684096
1656;4.78831e-15;852;-15;544;10929;1;51;4.34165e+08;-1.67675e+06;0;0;0;0;0;0;434165260;443404855;33715023
1657;4.78831e-15;853;-15;544;10929;1;51;4.34249e+08;-1.67332e+06;0;0;0;0;0;0;434248948;443502413;33745909
1658;4.78831e-15;854;-15;544;10929;1;51;4.34332e+08;-1.66991e+06;0;0;0;0;0;0;434332466;443599791;33776751
1659;4.78831e-15;855;-15;544;10929;1;51;4.34416e+08;-1.6665e+06;0;0;0;0;0;0;434415813;443696988;33807552
1660;4.78831e-15;855;-15;544;10929;1;51;4.34499e+08;-1.66311e+06;1;0;0;0;1;0;434498990;443794007;33838309
1661;4.78831e-15;855;-15;544;10929;1;51;4.34582e+08;-1.65972e+06;1;0;0;0;1;0;434581997;443890846;33869025
1662;4.78831e-15;856;-15;544;10929;1;51;4.34665e+08;-1.65633e+06;0;0;0;0;0;0;434664835;443987506;33899698
1663;4.78831e-15;856;-15;544;10929;1;51;4.34748e+08;-1.65296e+06;1;0;0;0;1;0;434747505;444083988;33930328
1664;4.78831e-15;857;-15;544;10929;1;51;4.3483e+08;-1.64959e+06;0;0;0;0;0;0;434830006;444180292;33960916
1665;4.78831e-15;858;-15;544;10929;1;51;4.34912e+08;-1.64623e+06;0;0;0;0;0;0;434912340;444276419;33991462
1666;4.78831e-15;859;-15;544;10929;1;51;4.34995e+08;-1.64288e+06;0;0;0;0;0;0;434994505;444372368;34021966
1667;4.78831e-15;859;-15;544;10929;1;51;4.35077e+08;-1.63953e+06;1;0;0;0;1;0;435076504;444468140;34052427
1668;4.78831e-15;859;-15;544;10929;1;51;4.35158e+08;-1.6362e+06;1;0;0;0;1;0;435158335;444563736;34082846
1669;4.78831e-15;859;-15;544;10929;1;51;4.3524e+08;-1.63287e+06;1;0;0;0;1;0;435240000;444659155;34113223
1670;4.78831e-15;860;-15;544;10929;1;51;4.35321e+08;-1.62955e+06;0;0;0;0;0;0;435321499;444754399;34143558
1671;4.78831e-15;861;-15;544;10929;1;51;4.35403e+08;-1.62623e+06;0;0;0;0;0;0;435402833;444849467;34173850
1672;4.78831e-15;862;-15;544;10929;1;51;4.35484e+08;-1.62292e+06;0;0;0;0;0;0;435484001;444944359;34204101
1673;4.78831e-15;863;-15;544;10929;1;51;4.35565e+08;-1.61962e+06;0;0;0;0;0;0;435565004;445039077;34234309
1674;4.78831e-15;863;-15;544;10929;1;51;4.35646e+08;-1.61633e+06;1;0;0;0;1;0;435645842;445133621;34264475
1675;4.78831e-15;863;-15;544;10929;1;51;4.35727e+08;-1.61305e+06;1;0;0;0;1;0;435726516;445227990;34294599
1676;4.78831e-15;863;-15;544;10929;1;51;4.35807e+08;-1.60977e+06;1;0;0;0;1;0;435807027;445322185;34324681
1677;4.78831e-15;863;-15;544;10929;1;51;4.35887e+08;-1.6065e+06;1;0;0;0;1;0;435887373;445416207;34354721
1678;4.78831e-15;864;-15;544;10929;1;51;4.35968e+08;-1.60324e+06;0;0;0;0;0;0;435967557;445510056;34384720
1679;4.78831e-15;865;-15;544;10929;1;51;4.36048e+08;-1.59998e+06;0;0;0;0;0;0;436047578;445603732;34414676
1680;4.78831e-15;866;-15;544;10929;1;51;4.36127e+08;-1.59674e+06;0;0;0;0;0;0;436127436;445697236;34444590
1681;4.78831e-15;867;-15;544;10929;1;51;4.36207e+08;-1.5935e+06;0;0;0;0;0;0;436207133;445790568;34474463
1682;4.78831e-15;867;-15;544;10929;1;51;4.36287e+08;-1.59026e+06;1;0;0;0;1;0;436286668;445883728;34504293
1683;4.78831e-15;867;-15;544;10929;1;51;4.36366e+08;-1.58704e+06;1;0;0;0;1;0;436366041;445976716;34534082
1684;4.78831e-15;868;-15;544;10929;1;51;4.36445e+08;-1.58382e+06;0;0;0;0;0;0;436445254;446069533;34563829
1685;4.78831e-15;868;-15;544;10929;1;51;4.36524e+08;-1.58061e+06;1;0;0;0;1;0;436524306;446162180;34593535
1686;4.78831e-15;868;-15;544;10929;1;51;4.36603e+08;-1.5774e+06;1;0;0;0;1;0;436603198;446254656;34623198
1687;4.78831e-15;869;-15;544;10929;1;51;4.36682e+08;-1.5742e+06;0;0;0;0;0;0;436681930;446346962;34652820
1688;4.78831e-15;870;-15;544;10929;1;51;4.36761e+08;-1.57102e+06;0;0;0;0;0;0;436760502;446439099;34682400
1689;4.78831e-15;871;-15;544;10929;1;51;4.36839e+08;-1.56783e+06;0;0;0;0;0;0;436838916;446531066;34711939
1690;4.78831e-15;871;-15;544;10929;1;51;4.36917e+08;-1.56466e+06;1;0;0;0;1;0;436917170;446622864;34741436
1691;4.78831e-15;871;-15;544;10929;1;51;4.36995e+08;-1.56149e+06;1;0;0;0;1;0;436995267;446714493;34770892
1692;4.78831e-15;872;-15;544;10929;1;51;4.37073e+08;-1.55833e+06;0;0;0;0;0;0;437073205;446805954;34800305
1693;4.78831e-15;872;-15;544;10929;1;51;4.37151e+08;-1.55517e+06;1;0;0;0;1;0;437150985;446897247;34829678
1694;4.78831e-15;872;-15;544;10929;1;51;4.37229e+08;-1.55203e+06;1;0;0;0;1;0;437228608;446988372;34859009
1695;4.78831e-15;872;-15;544;10929;1;51;4.37306e+08;-1.54888e+06;1;0;0;0;1;0;437306074;447079330;34888298
1696;4.78831e-15;872;-15;544;10929;1;51;4.37383e+08;-1.54575e+06;1;0;0;0;1;0;437383383;447170120;34917547
1697;4.78831e-15;872;-15;544;10929;1;51;4.37461e+08;-1.54263e+06;1;0;0;0;1;0;437460536;447260744;34946753
1698;4.78831e-15;873;-15;544;10929;1;51;4.37538e+08;-1.53951e+06;0;0;0;0;0;0;437537534;447351202;34975919
1699;4.78831e-15;874;-15;544;10929;1;51;4.37614e+08;-1.53639e+06;0;0;0;0;0;0;437614375;447441493;35005043
1700;4.78831e-15;875;-15;544;10929;1;51;4.37691e+08;-1.53329e+06;0;0;0;0;0;0;437691061;447531619;35034126
1701;4.78831e-15;876;-15;544;10929;1;51;4.37768e+08;-1.53019e+06;0;0;0;0;0;0;437767593;447621579;35063167
1702;4.78831e-15;877;-15;544;10929;1;51;4.37844e+08;-1.5271e+06;0;0;0;0;0;0;437843969;447711374;35092167
1703;4.78831e-15;877;-15;544;10929;1;51;4.3792e+08;-1.52402e+06;1;0;0;0;1;0;437920192;447801005;35121127
1704;4.78831e-15;878;-15;544;10929;1;51;4.37996e+08;-1.52094e+06;0;0;0;0;0;0;437996261;447890470;35150045
1705;4.78831e-15;879;-15;544;10929;1;51;4.38072e+08;-1.51787e+06;0;0;0;0;0;0;438072176;447979772;35178921
1706;4.78831e-15;880;-15;544;10929;1;51;4.38148e+08;-1.5148e+06;0;0;0;0;0;0;438147938;448068910;35207757
1707;4.78831e-15;880;-15;544;10929;1;51;4.38224e+08;-1.51175e+06;1;0;0;0;1;0;438223547;448157884;35236552
1708;4.78831e-15;881;-15;544;10929;1;51;4.38299e+08;-1.5087e+06;0;0;0;0;0;0;438299003;448246696;35265306
1709;4.78831e-15;882;-15;544;10929;1;51;4.38374e+08;-1.50565e+06;0;0;0;0;0;0;438374308;448335344;35294018
1710;4.78831e-15;882;-15;544;10929;1;51;4.38449e+08;-1.50262e+06;1;0;0;0;1;0;438449460;448423830;35322690
1711;4.78831e-15;883;-15;544;10929;1;51;4.38524e+08;-1.49958e+06;0;0;0;0;0;0;438524461;448512153;35351321
1712;4.78831e-15;884;-15;544;10929;1;51;4.38599e+08;-1.49656e+06;0;0;0;0;0;0;438599311;448600315;35379911
1713;4.78831e-15;884;-15;544;10929;1;51;4.38674e+08;-1.49355e+06;1;0;0;0;1;0;438674010;448688315;35408460
1714;4.78831e-15;885;-15;544;10929;1;51;4.38749e+08;-1.49054e+06;0;0;0;0;0;0;438748559;448776154;35436968
1715;4.78831e-15;885;-15;544;10929;1;51;4.38823e+08;-1.48753e+06;1;0;0;0;1;0;438822957;448863832;35465436
1716;4.78831e-15;886;-15;544;10929;1;51;4.38897e+08;-1.48454e+06;0;0;0;0;0;0;438897206;448951349;35493863
1717;4.78831e-15;886;-15;544;10929;1;51;4.38971e+08;-1.48155e+06;1;0;0;0;1;0;438971305;449038706;35522249
1718;4.78831e-15;886;-15;544;10929;1;51;4.39045e+08;-1.47856e+06;1;0;0;0;1;0;439045255;449125903;35550594
1719;4.78831e-15;887;-15;544;10929;1;51;4.39119e+08;-1.47559e+06;0;0;0;0;0;0;439119056;449212940;35578899
1720;4.78831e-15;888;-15;544;10929;1;51;4.39193e+08;-1.47262e+06;0;0;0;0;0;0;439192709;449299818;35607163
1721;4.78831e-15;888;-15;544;10929;1;51;4.39266e+08;-1.46965e+06;1;0;0;0;1;0;439266213;449386536;35635386
1722;4.78831e-15;889;-15;544;10929;1;51;4.3934e+08;-1.4667e+06;0;0;0;0;0;0;439339570;449473096;35663569
1723;4.78831e-15;890;-15;544;10929;1;51;4.39413e+08;-1.46375e+06;0;0;0;0;0;0;439412779;449559498;35691711
1724;4.78831e-15;890;-15;544;10929;1;51;4.39486e+08;-1.4608e+06;1;0;0;0;1;0;439485841;449645741;35719813
1725;4.78831e-15;891;-15;544;10929;1;51;4.39559e+08;-1.45786e+06;0;0;0;0;0;0;439558756;449731826;35747875
1726;4.78831e-15;891;-15;544;10929;1;51;4.39632e+08;-1.45493e+06;1;0;0;0;1;0;439631524;449817754;35775896
1727;4.78831e-15;891;-15;544;10929;1;51;4.39704e+08;-1.45201e+06;1;0;0;0;1;0;439704146;449903525;35803876
1728;4.78831e-15;891;-15;544;10929;1;51;4.39777e+08;-1.44909e+06;1;0;0;0;1;0;439776623;449989138;35831817
1729;4.78831e-15;891;-15;544;10929;1;51;4.39849e+08;-1.44618e+06;1;0;0;0;1;0;439848954;450074595;35859717
1730;4.78831e-15;892;-15;544;10929;1;51;4.39921e+08;-1.44328e+06;0;0;0;0;0;0;439921139;450159896;35887576
1731;4.78831e-15;892;-15;544;10929;1;51;4.39993e+08;-1.44038e+06;1;0;0;0;1;0;439993180;450245041;35915396
1732;4.78831e-15;892;-15;544;10929;1;51;4.40065e+08;-1.43748e+06;1;0;0;0;1;0;440065076;450330030;35943175
1733;4.78831e-15;892;-15;544;10929;1;51;4.40137e+08;-1.4346e+06;1;0;0;0;1;0;440136828;450414863;35970914
1734;4.78831e-15;892;-15;544;10929;1;51;4.40208e+08;-1.43172e+06;1;0;0;0;1;0;440208435;450499542;35998613
1735;4.78831e-15;892;-15;544;10929;1;51;4.4028e+08;-1.42885e+06;1;0;0;0;1;0;440279899;450584065;36026272
1736;4.78831e-15;892;-15;544;10929;1;51;4.40351e+08;-1.42598e+06;1;0;0;0;1;0;440351220;450668434;36053891
1737;4.78831e-15;893;-15;544;10929;1;51;4.40422e+08;-1.42312e+06;0;0;0;0;0;0;440422398;450752649;36081469
1738;4.78831e-15;893;-15;544;10929;1;51;4.40493e+08;-1.42026e+06;1;0;0;0;1;0;440493433;450836710;36109008
1739;4.78831e-15;893;-15;544;10929;1;51;4.40564e+08;-1.41742e+06;1;0;0;0;1;0;440564326;450920617;36136507
1740;4.78831e-15;893;-15;544;10929;1;51;4.40635e+08;-1.41458e+06;1;0;0;0;1;0;440635076;451004371;36163966
1741;4.78831e-15;894;-15;544;10929;1;51;4.40706e+08;-1.41174e+06;0;0;0;0;0;0;440705685;451087972;36191385
1742;4.78831e-15;894;-15;544;10929;1;51;4.40776e+08;-1.40891e+06;1;0;0;0;1;0;440776152;451171421;36218764
1743;4.78831e-15;895;-15;544;10929;1;51;4.40846e+08;-1.40609e+06;0;0;0;0;0;0;440846479;451254716;36246103
1744;4.78831e-15;895;-15;544;10929;1;51;4.40917e+08;-1.40327e+06;1;0;0;0;1;0;440916664;451337860;36273402
1745;4.78831e-15;896;-15;544;10929;1;51;4.40987e+08;-1.40046e+06;0;0;0;0;0;0;440986709;451420852;36300662
1746;4.78831e-15;897;-15;544;10929;1;51;4.41057e+08;-1.39766e+06;0;0;0;0;0;0;441056613;451503692;36327882
1747;4.78831e-15;897;-15;544;10929;1;51;4.41126e+08;-1.39486e+06;1;0;0;0;1;0;441126378;451586381;36355063
1748;4.78831e-15;898;-15;544;10929;1;51;4.41196e+08;-1.39207e+06;0;0;0;0;0;0;441196003;451668919;36382203
1749;4.78831e-15;898;-15;544;10929;1;51;4.41265e+08;-1.38928e+06;1;0;0;0;1;0;441265489;451751306;36409304
1750;4.78831e-15;898;-15;544;10929;1;51;4.41335e+08;-1.3865e+06;1;0;0;0;1;0;441334836;451833543;36436366
1751;4.78831e-15;899;-15;544;10929;1;51;4.41404e+08;-1.38373e+06;0;0;0;0;0;0;441404044;451915629;36463388
1752;4.78831e-15;900;-15;544;10929;1;51;4.41473e+08;-1.38096e+06;0;0;0;0;0;0;441473114;451997566;36490371
1753;4.78831e-15;901;-15;544;10929;1;51;4.41542e+08;-1.3782e+06;0;0;0;0;0;0;441542045;452079354;36517314
1754;4.78831e-15;902;-15;544;10929;1;51;4.41611e+08;-1.37544e+06;0;0;0;0;0;0;441610839;452160992;36544217
1755;4.78831e-15;902;-15;544;10929;1;51;4.41679e+08;-1.37269e+06;1;0;0;0;1;0;441679496;452242481;36571082
1756;4.78831e-15;902;-15;544;10929;1;51;4.41748e+08;-1.36995e+06;1;0;0;0;1;0;441748015;452323821;36597907
1757;4.78831e-15;902;-15;544;10929;1;51;4.41816e+08;-1.36721e+06;1;0;0;0;1;0;441816397;452405014;36624692
1758;4.78831e-15;903;-15;544;10929;1;51;4.41885e+08;-1.36448e+06;0;0;0;0;0;0;441884643;452486058;36651439
1759;4.78831e-15;904;-15;544;10929;1;51;4.41953e+08;-1.36175e+06;0;0;0;0;0;0;441952752;452566954;36678146
1760;4.78831e-15;905;-15;544;10929;1;51;4.42021e+08;-1.35903e+06;0;0;0;0;0;0;442020726;452647702;36704814
1761;4.78831e-15;906;-15;544;10929;1;51;4.42089e+08;-1.35632e+06;0;0;0;0;0;0;442088564;452728304;36731442
1762;4.78831e-15;907;-15;544;10929;1;51;4.42156e+08;-1.35361e+06;0;0;0;0;0;0;442156266;452808758;36758032
1763;4.78831e-15;908;-15;544;10929;1;51;4.42224e+08;-1.35091e+06;0;0;0;0;0;0;442223833;452889066;36784583
1764;4.78831e-15;908;-15;544;10929;1;51;4.42291e+08;-1.34821e+06;1;0;0;0;1;0;442291266;452969227;36811094
1765;4.78831e-15;909;-15;544;10929;1;51;4.42359e+08;-1.34552e+06;0;0;0;0;0;0;442358564;453049243;36837567
1766;4.78831e-15;909;-15;544;10929;1;51;4.42426e+08;-1.34284e+06;1;0;0;0;1;0;442425728;453129112;36864000
1767;4.78831e-15;910;-15;544;10929;1;51;4.42493e+08;-1.34016e+06;0;0;0;0;0;0;442492758;453208836;36890395
1768;4.78831e-15;911;-15;544;10929;1;51;4.4256e+08;-1.33749e+06;0;0;0;0;0;0;442559654;453288414;36916750
1769;4.78831e-15;911;-15;544;10929;1;51;4.42626e+08;-1.33482e+06;1;0;0;0;1;0;442626417;453367848;36943067
1770;4.78831e-15;911;-15;544;10929;1;51;4.42693e+08;-1.33216e+06;1;0;0;0;1;0;442693046;453447137;36969345
1771;4.78831e-15;912;-15;544;10929;1;51;4.4276e+08;-1.3295e+06;0;0;0;0;0;0;442759543;453526281;36995584
1772;4.78831e-15;912;-15;544;10929;1;51;4.42826e+08;-1.32686e+06;1;0;0;0;1;0;442825908;453605281;37021785
1773;4.78831e-15;913;-15;544;10929;1;51;4.42892e+08;-1.32421e+06;0;0;0;0;0;0;442892140;453684138;37047947
1774;4.78831e-15;914;-15;544;10929;1;51;4.42958e+08;-1.32157e+06;0;0;0;0;0;0;442958241;453762850;37074070
1775;4.78831e-15;914;-15;544;10929;1;51;4.43024e+08;-1.31894e+06;1;0;0;0;1;0;443024210;453841420;37100154
1776;4.78831e-15;914;-15;544;10929;1;51;4.4309e+08;-1.31632e+06;1;0;0;0;1;0;443090047;453919846;37126200
1777;4.78831e-15;915;-15;544;10929;1;51;4.43156e+08;-1.31369e+06;0;0;0;0;0;0;443155754;453998129;37152207
1778;4.78831e-15;915;-15;544;10929;1;51;4.43221e+08;-1.31108e+06;1;0;0;0;1;0;443221330;454076270;37178176
1779;4.78831e-15;916;-15;544;10929;1;51;4.43287e+08;-1.30847e+06;0;0;0;0;0;0;443286775;454154269;37204106
1780;4.78831e-15;917;-15;544;10929;1;51;4.43352e+08;-1.30587e+06;0;0;0;0;0;0;443352090;454232125;37229998
1781;4.78831e-15;917;-15;544;10929;1;51;4.43417e+08;-1.30327e+06;1;0;0;0;1;0;443417275;454309840;37255851
1782;4.78831e-15;917;-15;544;10929;1;51;4.43482e+08;-1.30068e+06;1;0;0;0;1;0;443482331;454387414;37281666
1783;4.78831e-15;917;-15;544;10929;1;51;4.43547e+08;-1.29809e+06;1;0;0;0;1;0;443547257;454464846;37307443
1784;4.78831e-15;918;-15;544;10929;1;51;4.43612e+08;-1.29551e+06;0;0;0;0;0;0;443612054;454542137;37333182
1785;4.78831e-15;918;-15;544;10929;1;51;4.43677e+08;-1.29293e+06;1;0;0;0;1;0;443676723;454619288;37358882
1786;4.78831e-15;918;-15;544;10929;1;51;4.43741e+08;-1.29036e+06;1;0;0;0;1;0;443741263;454696298;37384544
1787;4.78831e-15;918;-15;544;10929;1;51;4.43806e+08;-1.2878e+06;1;0;0;0;1;0;443805674;454773168;37410167
1788;4.78831e-15;919;-15;544;10929;1;51;4.4387e+08;-1.28524e+06;0;0;0;0;0;0;443869958;454849899;37435753
1789;4.78831e-15;919;-15;544;10929;1;51;4.43934e+08;-1.28268e+06;1;0;0;0;1;0;443934114;454926490;37461301
1790;4.78831e-15;919;-15;544;10929;1;51;4.43998e+08;-1.28014e+06;1;0;0;0;1;0;443998142;455002941;37486810
1791;4.78831e-15;919;-15;544;10929;1;51;4.44062e+08;-1.27759e+06;1;0;0;0;1;0;444062044;455079253;37512282
1792;4.78831e-15;919;-15;544;10929;1;51;4.44126e+08;-1.27506e+06;1;0;0;0;1;0;444125819;455155427;37537715
1793;4.78831e-15;920;-15;544;10929;1;51;4.44189e+08;-1.27252e+06;0;0;0;0;0;0;444189467;455231462;37563111
1794;4.78831e-15;921;-15;544;10929;1;51;4.44253e+08;-1.27e+06;0;0;0;0;0;0;444252988;455307359;37588468
1795;4.78831e-15;921;-15;544;10929;1;51;4.44316e+08;-1.26748e+06;1;0;0;0;1;0;444316384;455383118;37613788
1796;4.78831e-15;922;-15;544;10929;1;51;4.4438e+08;-1.26496e+06;0;0;0;0;0;0;444379654;455458739;37639070
1797;4.78831e-15;922;-15;544;10929;1;51;4.44443e+08;-1.26245e+06;1;0;0;0;1;0;444442799;455534223;37664314
1798;4.78831e-15;922;-15;544;10929;1;51;4.44506e+08;-1.25995e+06;1;0;0;0;1;0;444505818;455609569;37689520
1799;4.78831e-15;922;-15;544;10929;1;51;4.44569e+08;-1.25745e+06;1;0;0;0;1;0;444568712;455684779;37714689
1800;4.78831e-15;923;-15;544;10929;1;51;4.44631e+08;-1.25496e+06;0;0;0;0;0;0;444631482;455759852;37739820
1801;4.78831e-15;923;-15;544;10929;1;51;4.44694e+08;-1.25247e+06;1;0;0;0;1;0;444694127;455834788;37764913
1802;4.78831e-15;923;-15;544;10929;1;51;4.44757e+08;-1.24998e+06;1;0;0;0;1;0;444756648;455909588;37789969
1803;4.78831e-15;924;-15;544;10929;1;51;4.44819e+08;-1.24751e+06;0;0;0;0;0;0;444819045;455984253;37814987
1804;4.78831e-15;924;-15;544;10929;1;51;4.44881e+08;-1.24504e+06;1;0;0;0;1;0;444881319;456058781;37839968
1805;4.78831e-15;924;-15;544;10929;1;51;4.44943e+08;-1.24257e+06;1;0;0;0;1;0;444943469;456133175;37864911
1806;4.78831e-15;924;-15;544;10929;1;51;4.45005e+08;-1.24011e+06;1;0;0;0;1;0;445005496;456207433;37889817
1807;4.78831e-15;925;-15;544;10929;1;51;4.45067e+08;-1.23765e+06;0;0;0;0;0;0;445067400;456281556;37914685
1808;4.78831e-15;925;-15;544;10929;1;51;4.45129e+08;-1.2352e+06;1;0;0;0;1;0;445129182;456355544;37939516
1809;4.78831e-15;926;-15;544;10929;1;51;4.45191e+08;-1.23275e+06;0;0;0;0;0;0;445190842;456429399;37964310
1810;4.78831e-15;926;-15;544;10929;1;51;4.45252e+08;-1.23031e+06;1;0;0;0;1;0;445252379;456503119;37989067
1811;4.78831e-15;926;-15;544;10929;1;51;4.45314e+08;-1.22788e+06;1;0;0;0;1;0;445313795;456576705;38013786
1812;4.78831e-15;927;-15;544;10929;1;51;4.45375e+08;-1.22545e+06;0;0;0;0;0;0;445375089;456650158;38038468
1813;4.78831e-15;928;-15;544;10929;1;51;4.45436e+08;-1.22302e+06;0;0;0;0;0;0;445436262;456723477;38063113
1814;4.78831e-15;928;-15;544;10929;1;51;4.45497e+08;-1.2206e+06;1;0;0;0;1;0;445497314;456796663;38087720
1815;4.78831e-15;928;-15;544;10929;1;51;4.45558e+08;-1.21819e+06;1;0;0;0;1;0;445558245;456869716;38112291
1816;4.78831e-15;929;-15;544;10929;1;51;4.45619e+08;-1.21578e+06;0;0;0;0;0;0;445619056;456942637;38136825
1817;4.78831e-15;929;-15;544;10929;1;51;4.4568e+08;-1.21338e+06;1;0;0;0;1;0;445679747;457015425;38161321
1818;4.78831e-15;930;-15;544;10929;1;51;4.4574e+08;-1.21098e+06;0;0;0;0;0;0;445740318;457088081;38185781
1819;4.78831e-15;931;-15;544;10929;1;51;4.45801e+08;-1.20858e+06;0;0;0;0;0;0;445800768;457160605;38210203
1820;4.78831e-15;932;-15;544;10929;1;51;4.45861e+08;-1.20619e+06;0;0;0;0;0;0;445861100;457232998;38234589
1821;4.78831e-15;933;-15;544;10929;1;51;4.45921e+08;-1.20381e+06;0;0;0;0;0;0;445921312;457305259;38258938
1822;4.78831e-15;934;-15;544;10929;1;51;4.45981e+08;-1.20143e+06;0;0;0;0;0;0;445981406;457377390;38283250
1823;4.78831e-15;935;-15;544;10929;1;51;4.46041e+08;-1.19906e+06;0;0;0;0;0;0;446041381;457449389;38307526
1824;4.78831e-15;935;-15;544;10929;1;51;4.46101e+08;-1.19669e+06;0;0;-1;0;0;-1;446101237;457521258;38331764
1825;4.78831e-15;935;-15;544;10929;1;51;4.46161e+08;-1.19433e+06;1;0;0;0;1;0;446160975;457592996;38355966
1826;4.78831e-15;935;-15;544;10929;1;51;4.46221e+08;-1.19197e+06;1;0;0;0;1;0;446220595;457664604;38380132
1827;4.78831e-15;936;-15;544;10929;1;51;4.4628e+08;-1.18961e+06;0;0;0;0;0;0;446280098;457736082;38404261
1828;4.78831e-15;936;-15;544;10929;1;51;4.46339e+08;-1.18727e+06;1;0;0;0;1;0;446339483;457807431;38428353
1829;4.78831e-15;937;-15;544;10929;1;51;4.46399e+08;-1.18492e+06;0;0;0;0;0;0;446398751;457878650;38452408
1830;4.78831e-15;938;-15;544;10929;1;51;4.46458e+08;-1.18258e+06;0;0;0;0;0;0;446457902;457949740;38476428
1831;4.78831e-15;939;-15;544;10929;1;51;4.46517e+08;-1.18025e+06;0;0;0;0;0;0;446516937;458020702;38500410
1832;4.78831e-15;940;-15;544;10929;1;51;4.46576e+08;-1.17792e+06;0;0;0;0;0;0;446575855;458091534;38524357
1833;4.78831e-15;940;-15;544;10929;1;51;4.46635e+08;-1.1756e+06;1;0;0;0;1;0;446634657;458162238;38548267
1834;4.78831e-15;941;-15;544;10929;1;51;4.46693e+08;-1.17328e+06;0;0;0;0;0;0;446693343;458232814;38572140
1835;4.78831e-15;942;-15;544;10929;1;51;4.46752e+08;-1.17097e+06;0;0;0;0;0;0;446751913;458303262;38595978
1836;4.78831e-15;942;-15;544;10929;1;51;4.4681e+08;-1.16866e+06;1;0;0;0;1;0;446810368;458373582;38619779
1837;4.78831e-15;943;-15;544;10929;1;51;4.46869e+08;-1.16636e+06;0;0;0;0;0;0;446868708;458443775;38643544
1838;4.78831e-15;943;-15;544;10929;1;51;4.46927e+08;-1.16406e+06;1;0;0;0;1;0;446926932;458513840;38667272
1839;4.78831e-15;944;-15;544;10929;1;51;4.46985e+08;-1.16176e+06;0;0;0;0;0;0;446985042;458583779;38690965
1840;4.78831e-15;945;-15;544;10929;1;51;4.47043e+08;-1.15948e+06;0;0;0;0;0;0;447043038;458653591;38714622
1841;4.78831e-15;945;-15;544;10929;1;51;4.47101e+08;-1.15719e+06;1;0;0;0;1;0;447100919;458723276;38738242
1842;4.78831e-15;946;-15;544;10929;1;51;4.47159e+08;-1.15491e+06;0;0;0;0;0;0;447158687;458792835;38761827
1843;4.78831e-15;947;-15;544;10929;1;51;4.47216e+08;-1.15264e+06;0;0;0;0;0;0;447216341;458862268;38785375
1844;4.78831e-15;947;-15;544;10929;1;51;4.47274e+08;-1.15037e+06;1;0;0;0;1;0;447273881;458931575;38808888
1845;4.78831e-15;948;-15;544;10929;1;51;4.47331e+08;-1.1481e+06;0;0;0;0;0;0;447331308;459000756;38832365
1846;4.78831e-15;949;-15;544;10929;1;51;4.47389e+08;-1.14584e+06;0;0;0;0;0;0;447388622;459069813;38855806
1847;4.78831e-15;949;-15;544;10929;1;51;4.47446e+08;-1.14359e+06;1;0;0;0;1;0;447445823;459138744;38879211
1848;4.78831e-15;949;-15;544;10929;1;51;4.47503e+08;-1.14134e+06;1;0;0;0;1;0;447502912;459207550;38902580
1849;4.78831e-15;949;-15;544;10929;1;51;4.4756e+08;-1.13909e+06;1;0;0;0;1;0;447559889;459276232;38925914
1850;4.78831e-15;950;-15;544;10929;1;51;4.47617e+08;-1.13685e+06;0;0;0;0;0;0;447616753;459344789;38949212
1851;4.78831e-15;951;-15;544;10929;1;51;4.47674e+08;-1.13462e+06;0;0;0;0;0;0;447673506;459413222;38972474
1852;4.78831e-15;952;-15;544;10929;1;51;4.4773e+08;-1.13238e+06;0;0;0;0;0;0;447730147;459481531;38995701
1853;4.78831e-15;952;-15;544;10929;1;51;4.47787e+08;-1.13016e+06;1;0;0;0;1;0;447786677;459549716;39018892
1854;4.78831e-15;953;-15;544;10929;1;51;4.47843e+08;-1.12794e+06;0;0;0;0;0;0;447843096;459617778;39042048
1855;4.78831e-15;954;-15;544;10929;1;51;4.47899e+08;-1.12572e+06;0;0;0;0;0;0;447899404;459685717;39065168
1856;4.78831e-15;955;-15;544;10929;1;51;4.47956e+08;-1.12351e+06;0;0;0;0;0;0;447955601;459753533;39088253
1857;4.78831e-15;956;-15;544;10929;1;51;4.48012e+08;-1.1213e+06;0;0;0;0;0;0;448011688;459821226;39111302
1858;4.78831e-15;957;-15;544;10929;1;51;4.48068e+08;-1.1191e+06;0;0;0;0;0;0;448067664;459888796;39134316
1859;4.78831e-15;958;-15;544;10929;1;51;4.48124e+08;-1.1169e+06;0;0;0;0;0;0;448123531;459956244;39157295
1860;4.78831e-15;959;-15;544;10929;1;51;4.48179e+08;-1.1147e+06;0;0;0;0;0;0;448179288;460023570;39180238
1861;4.78831e-15;960;-15;544;10929;1;51;4.48235e+08;-1.11252e+06;0;0;0;0;0;0;448234936;460090774;39203146
1862;4.78831e-15;960;-15;544;10929;1;51;4.4829e+08;-1.11033e+06;1;0;0;0;1;0;448290474;460157857;39226019
1863;4.78831e-15;960;-15;544;10929;1;51;4.48346e+08;-1.10815e+06;1;0;0;0;1;0;448345904;460224818;39248857
1864;4.78831e-15;961;-15;544;10929;1;51;4.48401e+08;-1.10598e+06;0;0;0;0;0;0;448401224;460291657;39271660
1865;4.78831e-15;962;-15;544;10929;1;51;4.48456e+08;-1.1038e+06;0;0;0;0;0;0;448456437;460358376;39294428
1866;4.78831e-15;963;-15;544;10929;1;51;4.48512e+08;-1.10164e+06;0;0;0;0;0;0;448511540;460424974;39317160
1867;4.78831e-15;963;-15;544;10929;1;51;4.48567e+08;-1.09948e+06;1;0;0;0;1;0;448566536;460491452;39339858
1868;4.78831e-15;964;-15;544;10929;1;51;4.48621e+08;-1.09732e+06;0;0;0;0;0;0;448621424;460557810;39362521
1869;4.78831e-15;965;-15;544;10929;1;51;4.48676e+08;-1.09517e+06;0;0;0;0;0;0;448676204;460624047;39385149
1870;4.78831e-15;965;-15;544;10929;1;51;4.48731e+08;-1.09302e+06;1;0;0;0;1;0;448730877;460690164;39407742
1871;4.78831e-15;966;-15;544;10929;1;51;4.48785e+08;-1.09088e+06;0;0;0;0;0;0;448785443;460756162;39430300
1872;4.78831e-15;966;-15;544;10929;1;51;4.4884e+08;-1.08874e+06;1;0;0;0;1;0;448839902;460822041;39452823
1873;4.78831e-15;966;-15;544;10929;1;51;4.48894e+08;-1.0866e+06;1;0;0;0;1;0;448894254;460887800;39475312
1874;4.78831e-15;966;-15;544;10929;1;51;4.48948e+08;-1.08447e+06;1;0;0;0;1;0;448948499;460953440;39497766
1875;4.78831e-15;967;-15;544;10929;1;51;4.49003e+08;-1.08235e+06;0;0;0;0;0;0;449002638;461018962;39520185
1876;4.78831e-15;967;-15;544;10929;1;51;4.49057e+08;-1.08023e+06;1;0;0;0;1;0;449056672;461084365;39542570
1877;4.78831e-15;968;-15;544;10929;1;51;4.49111e+08;-1.07811e+06;0;0;0;0;0;0;449110599;461149650;39564920
1878;4.78831e-15;969;-15;544;10929;1;51;4.49164e+08;-1.076e+06;0;0;0;0;0;0;449164421;461214817;39587235
1879;4.78831e-15;970;-15;544;10929;1;51;4.49218e+08;-1.07389e+06;0;0;0;0;0;0;449218137;461279866;39609516
1880;4.78831e-15;970;-15;544;10929;1;51;4.49272e+08;-1.07179e+06;1;0;0;0;1;0;449271749;461344797;39631763
1881;4.78831e-15;970;-15;544;10929;1;51;4.49325e+08;-1.06969e+06;1;0;0;0;1;0;449325255;461409611;39653975
1882;4.78831e-15;970;-15;544;10929;1;51;4.49379e+08;-1.0676e+06;1;0;0;0;1;0;449378657;461474307;39676153
1883;4.78831e-15;971;-15;544;10929;1;51;4.49432e+08;-1.0655e+06;0;0;0;0;0;0;449431954;461538887;39698296
1884;4.78831e-15;972;-15;544;10929;1;51;4.49485e+08;-1.06342e+06;0;0;0;0;0;0;449485147;461603350;39720406
1885;4.78831e-15;972;-15;544;10929;1;51;4.49538e+08;-1.06134e+06;1;0;0;0;1;0;449538236;461667697;39742481
1886;4.78831e-15;973;-15;544;10929;1;51;4.49591e+08;-1.05926e+06;0;0;0;0;0;0;449591221;461731927;39764521
1887;4.78831e-15;973;-15;544;10929;1;51;4.49644e+08;-1.05719e+06;1;0;0;0;1;0;449644102;461796041;39786528
1888;4.78831e-15;973;-15;544;10929;1;51;4.49697e+08;-1.05512e+06;1;0;0;0;1;0;449696880;461860039;39808500
1889;4.78831e-15;973;-15;544;10929;1;51;4.4975e+08;-1.05306e+06;1;0;0;0;1;0;449749555;461923921;39830439
1890;4.78831e-15;974;-15;544;10929;1;51;4.49802e+08;-1.051e+06;0;0;0;0;0;0;449802126;461987688;39852343
1891;4.78831e-15;974;-15;544;10929;1;51;4.49855e+08;-1.04894e+06;1;0;0;0;1;0;449854596;462051340;39874213
1892;4.78831e-15;974;-15;544;10929;1;51;4.49907e+08;-1.04689e+06;1;0;0;0;1;0;449906962;462114877;39896050
1893;4.78831e-15;974;-15;544;10929;1;51;4.49959e+08;-1.04485e+06;1;0;0;0;1;0;449959226;462178299;39917852
1894;4.78831e-15;974;-15;544;10929;1;51;4.50011e+08;-1.0428e+06;1;0;0;0;1;0;450011388;462241606;39939621
1895;4.78831e-15;974;-15;544;10929;1;51;4.50063e+08;-1.04077e+06;1;0;0;0;1;0;450063449;462304799;39961355
1896;4.78831e-15;975;-15;544;10929;1;51;4.50115e+08;-1.03873e+06;0;0;0;0;0;0;450115407;462367878;39983056
1897;4.78831e-15;976;-15;544;10929;1;51;4.50167e+08;-1.0367e+06;0;0;0;0;0;0;450167264;462430843;40004723
1898;4.78831e-15;977;-15;544;10929;1;51;4.50219e+08;-1.03468e+06;0;0;0;0;0;0;450219020;462493694;40026357
1899;4.78831e-15;977;-15;544;10929;1;51;4.50271e+08;-1.03266e+06;1;0;0;0;1;0;450270675;462556431;40047957
1900;4.78831e-15;977;-15;544;10929;1;51;4.50322e+08;-1.03064e+06;1;0;0;0;1;0;450322229;462619055;40069523
1901;4.78831e-15;978;-15;544;10929;1;51;4.50374e+08;-1.02863e+06;0;0;0;0;0;0;450373682;462681566;40091055
1902;4.78831e-15;978;-15;544;10929;1;51;4.50425e+08;-1.02662e+06;1;0;0;0;1;0;450425035;462743964;40112554
1903;4.78831e-15;979;-15;544;10929;1;51;4.50476e+08;-1.02462e+06;0;0;0;0;0;0;450476288;462806250;40134020
1904;4.78831e-15;980;-15;544;10929;1;51;4.50527e+08;-1.02262e+06;0;0;0;0;0;0;450527440;462868423;40155452
1905;4.78831e-15;981;-15;544;10929;1;51;4.50578e+08;-1.02062e+06;0;0;0;0;0;0;450578493;462930483;40176850
1906;4.78831e-15;981;-15;544;10929;1;51;4.50629e+08;-1.01863e+06;1;0;0;0;1;0;450629447;462992432;40198215
1907;4.78831e-15;981;-15;544;10929;1;51;4.5068e+08;-1.01664e+06;1;0;0;0;1;0;450680300;463054269;40219547
1908;4.78831e-15;982;-15;544;10929;1;51;4.50731e+08;-1.01466e+06;0;0;0;0;0;0;450731055;463115993;40240846
1909;4.78831e-15;983;-15;544;10929;1;51;4.50782e+08;-1.01268e+06;0;0;0;0;0;0;450781711;463177607;40262111
1910;4.78831e-15;984;-15;544;10929;1;51;4.50832e+08;-1.0107e+06;0;0;0;0;0;0;450832268;463239109;40283343
1911;4.78831e-15;984;-15;544;10929;1;51;4.50883e+08;-1.00873e+06;1;0;0;0;1;0;450882727;463300501;40304542
1912;4.78831e-15;985;-15;544;10929;1;51;4.50933e+08;-1.00677e+06;0;0;0;0;0;0;450933087;463361781;40325707
1913;4.78831e-15;986;-15;544;10929;1;51;4.50983e+08;-1.0048e+06;0;0;0;0;0;0;450983349;463422951;40346840
1914;4.78831e-15;986;-15;544;10929;1;51;4.51034e+08;-1.00284e+06;1;0;0;0;1;0;451033513;463484010;40367940
1915;4.78831e-15;987;-15;544;10929;1;51;4.51084e+08;-1.00089e+06;0;0;0;0;0;0;451083580;463544959;40389006
1916;4.78831e-15;987;-15;544;10929;1;51;4.51134e+08;-998940;1;0;0;0;1;0;451133549;463605798;40410040
1917;4.78831e-15;988;-15;544;10929;1;51;4.51183e+08;-996994;0;0;0;0;0;0;451183420;463666527;40431040
1918;4.78831e-15;989;-15;544;10929;1;51;4.51233e+08;-995051;0;0;0;0;0;0;451233195;463727147;40452008
1919;4.78831e-15;989;-15;544;10929;1;51;4.51283e+08;-993113;1;0;0;0;1;0;451282873;463787657;40472943
1920;4.78831e-15;989;-15;544;10929;1;51;4.51332e+08;-991179;1;0;0;0;1;0;451332453;463848058;40493845
1921;4.78831e-15;990;-15;544;10929;1;51;4.51382e+08;-989249;0;0;0;0;0;0;451381938;463908350;40514714
1922;4.78831e-15;991;-15;544;10929;1;51;4.51431e+08;-987323;0;0;0;0;0;0;451431326;463968533;40535551
1923;4.78831e-15;992;-15;544;10929;1;51;4.51481e+08;-985400;0;0;0;0;0;0;451480618;464028608;40556354
1924;4.78831e-15;993;-15;544;10929;1;51;4.5153e+08;-983482;0;0;0;0;0;0;451529814;464088574;40577126
1925;4.78831e-15;993;-15;544;10929;1;51;4.51579e+08;-981568;1;0;0;0;1;0;451578914;464148432;40597864
1926;4.78831e-15;993;-15;544;10929;1;51;4.51628e+08;-979658;1;0;0;0;1;0;451627919;464208181;40618570
1927;4.78831e-15;993;-15;544;10929;1;51;4.51677e+08;-977752;1;0;0;0;1;0;451676829;464267823;40639244
1928;4.78831e-15;993;-15;544;10929;1;51;4.51726e+08;-975849;1;0;0;0;1;0;451725643;464327358;40659885
1929;4.78831e-15;994;-15;544;10929;1;51;4.51774e+08;-973951;0;0;0;0;0;0;451774362;464386785;40680493
1930;4.78831e-15;995;-15;544;10929;1;51;4.51823e+08;-972057;0;0;0;0;0;0;451822987;464446105;40701069
1931;4.78831e-15;995;-15;544;10929;1;51;4.51872e+08;-970166;1;0;0;0;1;0;451871517;464505317;40721613
1932;4.78831e-15;996;-15;544;10929;1;51;4.5192e+08;-968280;0;0;0;0;0;0;451919953;464564423;40742125
1933;4.78831e-15;996;-15;544;10929;1;51;4.51968e+08;-966397;1;0;0;0;1;0;451968295;464623423;40762604
1934;4.78831e-15;996;-15;544;10929;1;51;4.52017e+08;-964518;1;0;0;0;1;0;452016543;464682316;40783051
1935;4.78831e-15;996;-15;544;10929;1;51;4.52065e+08;-962643;1;0;0;0;1;0;452064697;464741102;40803465
1936;4.78831e-15;996;-15;544;10929;1;51;4.52113e+08;-960772;1;0;0;0;1;0;452112758;464799783;40823848
1937;4.78831e-15;997;-15;544;10929;1;51;4.52161e+08;-958905;0;0;0;0;0;0;452160725;464858358;40844198
1938;4.78831e-15;997;-15;544;10929;1;51;4.52209e+08;-957042;1;0;0;0;1;0;452208599;464916827;40864517
1939;4.78831e-15;998;-15;544;10929;1;51;4.52256e+08;-955183;0;0;0;0;0;0;452256380;464975190;40884803
1940;4.78831e-15;998;-15;544;10929;1;51;4.52304e+08;-953327;1;0;0;0;1;0;452304068;465033449;40905057
1941;4.78831e-15;999;-15;544;10929;1;51;4.52352e+08;-951475;0;0;0;0;0;0;452351664;465091602;40925280
1942;4.78831e-15;999;-15;544;10929;1;51;4.52399e+08;-949628;1;0;0;0;1;0;452399167;465149650;40945470
1943;4.78831e-15;999;-15;544;10929;1;51;4.52447e+08;-947784;1;0;0;0;1;0;452446578;465207594;40965629
1944;4.78831e-15;1000;-15;544;10929;1;51;4.52494e+08;-945943;0;0;0;0;0;0;452493897;465265434;40985755
1945;4.78831e-15;1001;-15;544;10929;1;51;4.52541e+08;-944107;0;0;0;0;0;0;452541125;465323168;41005850
1946;4.78831e-15;1001;-15;544;10929;1;51;4.52588e+08;-942274;1;0;0;0;1;0;452588260;465380799;41025914
1947;4.78831e-15;1001;-15;544;10929;1;51;4.52635e+08;-940445;1;0;0;0;1;0;452635305;465438326;41045945
1948;4.78831e-15;1001;-15;544;10929;1;51;4.52682e+08;-938620;1;0;0;0;1;0;452682258;465495749;41065945
1949;4.78831e-15;1001;-15;544;10929;1;51;4.52729e+08;-936799;1;0;0;0;1;0;452729119;465553069;41085913
1950;4.78831e-15;1001;-15;544;10929;1;51;4.52776e+08;-934982;1;0;0;0;1;0;452775890;465610286;41105850
1951;4.78831e-15;1001;-15;544;10929;1;51;4.52823e+08;-933168;1;0;0;0;1;0;452822571;465667399;41125755
1952;4.78831e-15;1002;-15;544;10929;1;51;4.52869e+08;-931358;0;0;0;0;0;0;452869161;465724409;41145628
1953;4.78831e-15;1002;-15;544;10929;1;51;4.52916e+08;-929551;1;0;0;0;1;0;452915660;465781316;41165470
1954;4.78831e-15;1002;-15;544;10929;1;51;4.52962e+08;-927749;1;0;0;0;1;0;452962069;465838121;41185281
1955;4.78831e-15;1003;-15;544;10929;1;51;4.53008e+08;-925950;0;0;0;0;0;0;453008389;465894824;41205060
1956;4.78831e-15;1004;-15;544;10929;1;51;4.53055e+08;-924155;0;0;0;0;0;0;453054619;465951424;41224808
1957;4.78831e-15;1004;-15;544;10929;1;51;4.53101e+08;-922363;1;0;0;0;1;0;453100759;466007922;41244525
1958;4.78831e-15;1004;-15;544;10929;1;51;4.53147e+08;-920576;1;0;0;0;1;0;453146809;466064319;41264210
1959;4.78831e-15;1004;-15;544;10929;1;51;4.53193e+08;-918792;1;0;0;0;1;0;453192771;466120613;41283864
1960;4.78831e-15;1005;-15;544;10929;1;51;4.53239e+08;-917011;0;0;0;0;0;0;453238644;466176807;41303487
1961;4.78831e-15;1006;-15;544;10929;1;51;4.53284e+08;-915234;0;0;0;0;0;0;453284427;466232899;41323079
1962;4.78831e-15;1006;-15;544;10929;1;51;4.5333e+08;-913461;1;0;0;0;1;0;453330122;466288890;41342639
1963;4.78831e-15;1007;-15;544;10929;1;51;4.53376e+08;-911692;0;0;0;0;0;0;453375729;466344779;41362169
1964;4.78831e-15;1008;-15;544;10929;1;51;4.53421e+08;-909926;0;0;0;0;0;0;453421247;466400569;41381668
1965;4.78831e-15;1009;-15;544;10929;1;51;4.53467e+08;-908164;0;0;0;0;0;0;453466677;466456258;41401135
1966;4.78831e-15;1009;-15;544;10929;1;51;4.53512e+08;-906406;1;0;0;0;1;0;453512020;466511846;41420572
1967;4.78831e-15;1010;-15;544;10929;1;51;4.53557e+08;-904651;0;0;0;0;0;0;453557274;466567334;41439978
1968;4.78831e-15;1011;-15;544;10929;1;51;4.53602e+08;-902899;0;0;0;0;0;0;453602441;466622722;41459353
1969;4.78831e-15;1011;-15;544;10929;1;51;4.53648e+08;-901152;1;0;0;0;1;0;453647521;466678011;41478697
1970;4.78831e-15;1011;-15;544;10929;1;51;4.53693e+08;-899407;1;0;0;0;1;0;453692513;466733200;41498010
1971;4.78831e-15;1012;-15;544;10929;1;51;4.53737e+08;-897667;0;0;0;0;0;0;453737418;466788289;41517292
1972;4.78831e-15;1013;-15;544;10929;1;51;4.53782e+08;-895930;0;0;0;0;0;0;453782237;466843279;41536544
1973;4.78831e-15;1014;-15;544;10929;1;51;4.53827e+08;-894197;0;0;0;0;0;0;453826968;466898170;41555766
1974;4.78831e-15;1015;-15;544;10929;1;51;4.53872e+08;-892467;0;0;0;0;0;0;453871614;466952962;41574956
1975;4.78831e-15;1015;-15;544;10929;1;51;4.53916e+08;-890741;1;0;0;0;1;0;453916173;467007656;41594116
1976;4.78831e-15;1015;-15;544;10929;1;51;4.53961e+08;-889018;1;0;0;0;1;0;453960646;467062251;41613246
1977;4.78831e-15;1016;-15;544;10929;1;51;4.54005e+08;-887299;0;0;0;0;0;0;454005033;467116747;41632345
1978;4.78831e-15;1017;-15;544;10929;1;51;4.54049e+08;-885583;0;0;0;0;0;0;454049334;467171146;41651413
1979;4.78831e-15;1017;-15;544;10929;1;51;4.54094e+08;-883871;1;0;0;0;1;0;454093549;467225446;41670451
1980;4.78831e-15;1018;-15;544;10929;1;51;4.54138e+08;-882162;0;0;0;0;0;0;454137679;467279649;41689459
1981;4.78831e-15;1018;-15;544;10929;1;51;4.54182e+08;-880457;1;0;0;0;1;0;454181724;467333754;41708436
1982;4.78831e-15;1019;-15;544;10929;1;51;4.54226e+08;-878755;0;0;0;0;0;0;454225684;467387761;41727384
1983;4.78831e-15;1019;-15;544;10929;1;51;4.5427e+08;-877057;1;0;0;0;1;0;454269559;467441672;41746300
1984;4.78831e-15;1019;-15;544;10929;1;51;4.54313e+08;-875362;1;0;0;0;1;0;454313349;467495485;41765187
1985;4.78831e-15;1019;-15;544;10929;1;51;4.54357e+08;-873671;1;0;0;0;1;0;454357054;467549201;41784044
1986;4.78831e-15;1020;-15;544;10929;1;51;4.54401e+08;-871984;0;0;0;0;0;0;454400675;467602821;41802870
1987;4.78831e-15;1021;-15;544;10929;1;51;4.54444e+08;-870299;0;0;0;0;0;0;454444212;467656343;41821666
1988;4.78831e-15;1022;-15;544;10929;1;51;4.54488e+08;-868618;0;0;0;0;0;0;454487665;467709770;41840432
1989;4.78831e-15;1023;-15;544;10929;1;51;4.54531e+08;-866941;0;0;0;0;0;0;454531034;467763100;41859169
1990;4.78831e-15;1023;-15;544;10929;1;51;4.54574e+08;-865267;1;0;0;0;1;0;454574320;467816335;41877875
1991;4.78831e-15;1023;-15;544;10929;1;51;4.54618e+08;-863596;1;0;0;0;1;0;454617521;467869473;41896551
1992;4.78831e-15;1024;-15;544;10929;1;51;4.54661e+08;-861929;0;0;0;0;0;0;454660640;467922516;41915197
1993;4.78831e-15;1025;-15;544;10929;1;51;4.54704e+08;-860266;0;0;0;0;0;0;454703675;467975463;41933814
1994;4.78831e-15;1026;-15;544;10929;1;51;4.54747e+08;-858605;0;0;0;0;0;0;454746627;468028315;41952401
1995;4.78831e-15;1027;-15;544;10929;1;51;4.54789e+08;-856948;0;0;0;0;0;0;454789497;468081072;41970957
1996;4.78831e-15;1027;-15;544;10929;1;51;4.54832e+08;-855295;1;0;0;0;1;0;454832283;468133734;41989485
1997;4.78831e-15;1027;-15;544;10929;1;51;4.54875e+08;-853645;1;0;0;0;1;0;454874988;468186301;42007982
1998;4.78831e-15;1027;-15;544;10929;1;51;4.54918e+08;-851998;1;0;0;0;1;0;454917609;468238773;42026450
1999;4.78831e-15;1027;-15;544;10929;1;51;4.5496e+08;-850354;1;0;0;0;1;0;454960149;468291151;42044888
