step;volume;A_0;B_0;C;L;p;Compl;Aext;Bext;A_ingresso;A_uscita;B_ingresso;B_uscita;A_netto;B_netto;Avicino;Amedio;Alontano
513;4.18816e-15;40;602;10327;10005;1;2;344;3539;482;137;467;140;345;327;72;70;5
513;4.18816e-15;40;602;10327;10005;1;1;324;3539;516;130;482;143;386;339;72;70;5
514;4.19195e-15;87;1319;10283;10073;1;47;365;3540;161;31;1769;522;130;1247;72;70;5
514;4.19195e-15;80;1364;10282;10075;1;50;360;3540;153;40;1703;521;113;1182;72;70;5
515;4.23497e-15;106;1619;10248;10128;1;98;359;3540;175;50;1786;711;125;1075;72;71;5
515;4.2356e-15;111;1661;10259;10136;1;84;317;3540;177;46;1771;723;131;1048;72;69;5
516;4.26924e-15;122;1743;10218;10186;1;151;318;3540;156;51;1712;800;105;912;72;70;5
516;4.27496e-15;111;1680;10228;10189;1;134;306;3540;150;51;1739;806;99;933;72;70;5
517;4.30679e-15;95;1746;10224;10247;1;184;355;3541;168;56;1678;854;112;824;73;70;5
517;4.3087e-15;95;1787;10245;10245;1;152;344;3541;155;54;1785;823;101;962;73;70;5
518;4.34573e-15;95;1796;10246;10309;1;201;354;3541;161;59;1729;870;102;859;72;70;5
518;4.34445e-15;94;1756;10266;10316;1;165;338;3541;162;56;1760;886;106;874;72;70;5
519;4.38543e-15;93;1767;10264;10380;1;224;327;3541;182;52;1805;868;130;937;71;70;5
519;4.38992e-15;92;1764;10277;10372;1;188;301;3541;166;51;1775;876;115;899;71;70;5
520;4.43103e-15;92;1726;10270;10433;1;252;325;3541;152;39;1809;911;113;898;72;69;5
520;4.42524e-15;109;1714;10302;10434;1;201;314;3541;151;42;1792;857;109;935;72;69;5
521;4.46518e-15;97;1763;10303;10498;1;267;323;3542;137;59;1724;845;78;879;71;69;5
521;4.46583e-15;74;1726;10335;10501;1;212;318;3542;147;46;1767;847;101;920;71;69;5
522;4.50718e-15;100;1651;10362;10555;1;266;357;3542;156;45;1766;873;111;893;71;68;5
522;4.50912e-15;88;1728;10361;10567;1;226;339;3542;145;51;1819;850;94;969;71;68;5
523;4.54412e-15;90;1732;10418;10613;1;268;352;3542;178;58;1780;842;120;938;70;69;5
523;4.55191e-15;92;1675;10382;10620;1;243;334;3542;188;47;1864;870;141;994;70;69;5
524;4.58181e-15;101;1691;10435;10663;1;293;360;3543;152;50;1813;872;102;941;70;68;5
524;4.58636e-15;98;1822;10397;10681;1;271;344;3543;165;49;1714;832;116;882;70;68;5
525;4.61373e-15;106;1713;10478;10726;1;307;339;3543;179;45;1850;832;134;1018;70;68;5
525;4.62613e-15;118;1764;10470;10736;1;258;328;3543;171;56;1704;855;115;849;70;68;5
526;4.65554e-15;109;1675;10543;10772;1;303;331;3543;164;59;1731;848;105;883;70;68;5
526;4.66208e-15;92;1809;10521;10792;1;256;320;3543;157;64;1805;830;93;975;70;68;5
527;4.68501e-15;120;1739;10602;10828;1;303;312;3544;155;52;1818;772;103;1046;69;68;5
527;4.69878e-15;96;1773;10539;10847;1;275;307;3544;150;42;1737;887;108;850;69;68;5
528;4.72243e-15;79;1740;10653;10881;1;305;355;3544;144;60;1708;877;84;831;70;68;5
528;4.73492e-15;95;1748;10582;10911;1;283;344;3544;160;45;1719;886;115;833;70;68;5
529;4.75731e-15;103;1740;10717;10945;1;303;353;3544;161;51;1834;854;110;980;70;67;5
529;4.77709e-15;112;1676;10616;10963;1;297;327;3544;179;50;1722;889;129;833;70;67;5
530;4.79955e-15;99;1667;10761;11014;1;312;320;3544;179;45;1774;897;134;877;70;68;5
530;4.81145e-15;90;1676;10635;11023;1;326;302;3544;176;55;1788;851;121;937;70;68;5
531;4.84522e-15;91;1601;10815;11071;1;314;373;3545;181;40;1789;858;141;931;70;68;5
531;4.85119e-15;100;1699;10690;11073;1;323;331;3545;151;54;1819;850;97;969;70;68;5
532;4.88306e-15;109;1656;10878;11136;1;305;307;3545;189;48;1733;845;141;888;70;68;5
532;4.88439e-15;122;1663;10771;11111;1;310;302;3545;161;63;1707;863;98;844;70;68;5
533;4.92634e-15;99;1708;10915;11186;1;314;310;3545;158;65;1772;836;93;936;69;68;5
533;4.90968e-15;88;1642;10837;11168;1;312;285;3545;149;61;1741;845;88;896;69;68;5
534;4.95971e-15;94;1677;10967;11226;1;318;285;3546;149;55;1771;856;94;915;69;68;5
534;4.94769e-15;98;1691;10889;11216;1;311;270;3546;153;38;1731;832;115;899;69;68;5
535;4.98646e-15;87;1730;11034;11269;1;309;314;3546;143;32;1807;869;111;938;69;68;5
535;4.97977e-15;95;1689;10929;11268;1;321;282;3546;120;54;1720;790;66;930;69;68;5
536;5.01528e-15;102;1701;11069;11312;1;315;323;3546;155;49;1781;854;106;927;69;68;5
536;5.0146e-15;97;1667;10987;11321;1;319;306;3546;161;48;1672;865;113;807;69;68;5
537;5.04414e-15;92;1697;11089;11365;1;340;319;3546;157;64;1734;865;93;869;68;68;5
537;5.05019e-15;95;1640;11027;11376;1;326;304;3546;141;52;1750;830;89;920;68;68;5
538;5.0798e-15;102;1676;11154;11433;1;336;319;3547;137;57;1772;867;80;905;68;68;5
538;5.08721e-15;109;1640;11069;11429;1;335;305;3547;144;51;1767;910;93;857;68;68;5
539;5.12568e-15;107;1761;11201;11485;1;342;302;3547;162;58;1838;846;104;992;68;67;6
539;5.12297e-15;106;1742;11137;11483;1;323;292;3547;163;62;1679;811;101;868;68;67;6
540;5.16085e-15;117;1698;11247;11541;1;346;306;3547;153;48;1756;902;105;854;68;67;6
540;5.1595e-15;107;1760;11190;11535;1;327;291;3547;145;46;1747;871;99;876;68;67;6
541;5.19882e-15;106;1736;11302;11593;1;348;293;3548;150;57;1716;872;93;844;68;66;6
541;5.19475e-15;94;1731;11242;11576;1;334;289;3548;144;58;1708;859;86;849;68;66;6
542;5.23416e-15;104;1698;11370;11643;1;339;280;3548;138;42;1709;872;96;837;68;67;6
542;5.2226e-15;91;1702;11313;11628;1;322;270;3548;143;52;1786;868;91;918;68;67;6
543;5.26822e-15;84;1689;11410;11690;1;340;281;3548;142;46;1809;793;96;1016;68;66;6
543;5.25799e-15;91;1748;11357;11682;1;326;278;3548;121;47;1825;842;74;983;68;66;6
544;5.3003e-15;85;1794;11474;11746;1;335;276;3548;143;43;1738;795;100;943;67;67;6
544;5.29483e-15;72;1632;11407;11725;1;326;261;3548;159;31;1799;897;128;902;67;67;6
545;5.3386e-15;81;1795;11523;11795;1;336;276;3549;151;43;1806;867;108;939;68;67;6
545;5.32423e-15;79;1716;11473;11781;1;311;248;3549;122;35;1879;826;87;1053;68;66;6
546;5.3722e-15;99;1782;11588;11865;1;322;288;3549;125;46;1777;879;79;898;68;65;6
546;5.36259e-15;87;1736;11517;11834;1;314;280;3549;101;31;1739;861;70;878;68;65;6
547;5.42032e-15;80;1748;11636;11918;1;325;300;3549;137;47;1773;881;90;892;68;66;6
547;5.39899e-15;87;1698;11568;11898;1;310;290;3549;139;44;1712;836;95;876;68;66;6
548;5.45684e-15;103;1699;11683;11961;1;326;290;3550;145;40;1779;857;105;922;67;66;6
548;5.44305e-15;79;1684;11622;11943;1;308;275;3550;146;55;1825;875;91;950;67;66;6
549;5.48654e-15;110;1705;11719;12008;1;340;292;3550;132;48;1843;879;84;964;67;66;6
549;5.4741e-15;82;1722;11684;12017;1;295;282;3550;136;44;1807;830;92;977;67;66;6
550;5.51906e-15;100;1730;11769;12067;1;338;285;3550;147;61;1766;823;86;943;67;66;6
550;5.52529e-15;77;1715;11731;12054;1;294;275;3550;143;37;1815;869;106;946;67;65;6
551;5.55997e-15;104;1742;11848;12129;1;322;297;3550;130;45;1832;867;85;965;67;66;6
551;5.55094e-15;105;1738;11788;12105;1;285;281;3550;140;46;1732;850;94;882;67;66;6
552;5.60307e-15;103;1708;11879;12182;1;336;308;3551;161;58;1733;863;103;870;67;65;6
552;5.58637e-15;90;1744;11814;12155;1;300;300;3551;124;51;1837;885;73;952;67;65;6
553;5.64e-15;105;1671;11930;12237;1;338;319;3551;165;58;1762;849;107;913;66;65;6
553;5.62118e-15;89;1701;11876;12210;1;292;293;3551;143;40;1794;889;103;905;66;65;6
554;5.67842e-15;97;1721;11973;12300;1;345;306;3551;173;61;1770;837;112;933;66;65;6
554;5.65955e-15;87;1698;11913;12254;1;296;284;3551;141;57;1762;905;84;857;66;65;6
555;5.72252e-15;99;1684;11995;12344;1;362;299;3551;140;49;1714;889;91;825;66;65;6
555;5.69031e-15;104;1714;11956;12306;1;298;280;3551;132;37;1789;840;95;949;66;65;6
556;5.75339e-15;91;1717;12044;12392;1;355;275;3552;167;55;1796;863;112;933;66;65;6
556;5.72673e-15;108;1776;11984;12359;1;308;265;3552;160;49;1794;881;111;913;66;65;6
557;5.78714e-15;83;1731;12112;12453;1;344;297;3552;130;49;1759;850;81;909;66;64;6
557;5.76393e-15;90;1798;12042;12423;1;302;279;3552;150;45;1832;894;105;938;66;64;6
558;5.83011e-15;96;1701;12168;12517;1;338;289;3552;151;45;1810;856;106;954;66;63;6
558;5.80896e-15;91;1731;12079;12470;1;309;280;3552;130;49;1676;909;81;767;66;63;6
559;5.87532e-15;115;1685;12203;12565;1;350;290;3553;138;50;1803;901;88;902;66;64;6
559;5.84211e-15;84;1816;12110;12523;1;315;281;3553;136;48;1718;888;88;830;66;64;6
560;5.9093e-15;99;1693;12260;12615;1;342;189;3453;152;59;1736;844;93;892;66;64;6
560;5.87956e-15;100;1836;12174;12575;1;303;279;3553;133;43;1789;882;90;907;65;64;6
561;5.94476e-15;68;1625;12325;12663;1;331;291;3553;96;51;1809;866;45;943;65;64;6
561;5.91639e-15;90;1775;12198;12628;1;314;287;3553;133;44;1831;947;89;884;65;64;6
562;5.97888e-15;91;1710;12405;12721;1;309;339;3553;137;42;1825;804;95;1021;65;64;6
562;5.954e-15;105;1672;12250;12673;1;312;329;3553;133;40;1823;903;93;920;65;64;6
563;6.02018e-15;113;1720;12431;12776;1;322;241;3554;184;42;1778;906;142;872;64;63;6
563;5.98599e-15;113;1691;12280;12715;1;323;235;3554;162;43;1773;879;119;894;64;63;6
564;6.05944e-15;96;1667;12480;12837;1;325;1.07374e+08;-2.14748e+09;126;57;1738;865;69;873;64;63;6
564;6.01591e-15;95;1680;12347;12754;1;311;1.07374e+08;-2.14748e+09;139;50;1804;857;89;947;64;62;6
565;6.10309e-15;96;1667;12480;12837;1;325;1.032e+08;-2.06399e+09;0;0;-1;0;0;-1;64;63;6
565;6.04373e-15;95;1676;12347;12754;1;311;1.032e+08;-2.06399e+09;0;0;-1;0;0;-1;64;63;6
566;6.10309e-15;96;1665;12480;12837;1;325;3.09788e+08;-1.98428e+09;0;0;-1;0;0;-1;64;63;6
566;6.04373e-15;95;1676;12347;12754;1;311;3.09788e+08;-1.98428e+09;0;0;-1;0;0;-1;64;62;6
567;6.10309e-15;96;1665;12480;12837;1;325;2.97823e+08;-1.90817e+09;0;0;-1;0;0;-1;239;238;6
567;6.04373e-15;95;1673;12347;12754;1;311;2.97823e+08;-1.90817e+09;0;0;-1;0;0;-1;239;238;6
568;6.10309e-15;96;1665;12480;12837;1;325;4.96971e+08;-1.83548e+09;0;0;-1;0;0;-1;913;913;6
568;6.04373e-15;95;1673;12347;12754;1;311;4.96971e+08;-1.83548e+09;0;0;-1;0;0;-1;913;913;6
569;6.10309e-15;96;1665;12480;12837;1;325;5.85273e+08;-1.76604e+09;0;0;-1;0;0;-1;2534;2533;6
569;6.04373e-15;95;1673;12347;12754;1;311;5.85273e+08;-1.76604e+09;0;0;-1;0;0;-1;2534;2533;6
570;6.10309e-15;96;1664;12480;12837;1;325;6.70258e+08;-1.69969e+09;1;0;-1;0;1;-1;5648;5647;6
570;6.04373e-15;95;1673;12347;12754;1;311;6.70258e+08;-1.69969e+09;0;0;-1;0;0;-1;5648;5647;6
571;6.10309e-15;97;1663;12480;12837;1;325;7.52072e+08;-1.63627e+09;0;0;-1;0;0;-1;10888;10887;6
571;6.04373e-15;95;1670;12347;12754;1;311;7.52072e+08;-1.63627e+09;3;0;-1;0;3;-1;10888;10887;6
572;6.10309e-15;98;1661;12480;12837;1;325;7.2348e+08;-1.57565e+09;0;0;-1;0;0;-1;18951;18950;6
572;6.04373e-15;95;1669;12347;12754;1;311;8.30855e+08;-1.57565e+09;0;0;-1;0;0;-1;18951;18950;6
573;6.10309e-15;100;1661;12480;12837;1;325;9.06739e+08;-1.51768e+09;0;0;-1;0;0;-1;30582;30581;6
573;6.04373e-15;95;1666;12347;12754;1;311;9.06739e+08;-1.51768e+09;0;0;-1;0;0;-1;30582;30581;6
574;6.10309e-15;100;1661;12480;12837;1;325;9.79851e+08;-1.46224e+09;0;0;-1;0;0;-1;46565;46564;6
574;6.04373e-15;95;1666;12347;12754;1;311;9.79851e+08;-1.46224e+09;0;0;-1;0;0;-1;46565;46564;6
575;6.10309e-15;101;1659;12480;12837;1;325;1.05031e+09;-1.40921e+09;1;0;-1;0;1;-1;67707;67706;6
575;6.04373e-15;95;1666;12347;12754;1;311;1.05031e+09;-1.40921e+09;1;0;-1;0;1;-1;67707;67706;6
576;6.10309e-15;101;1657;12480;12837;1;325;1.11824e+09;-1.35846e+09;1;0;-1;0;1;-1;94830;94828;6
576;6.04373e-15;95;1665;12347;12754;1;311;1.11824e+09;-1.35846e+09;0;0;-1;0;0;-1;94830;94828;6
577;6.10309e-15;101;1654;12480;12837;1;325;1.18373e+09;-1.30989e+09;1;0;-1;0;1;-1;128760;128758;6
577;6.04373e-15;96;1665;12347;12754;1;311;1.18373e+09;-1.30989e+09;1;0;-1;0;1;-1;128760;128758;6
578;6.10309e-15;101;1654;12480;12837;1;325;1.2469e+09;-1.2634e+09;0;0;-1;0;0;-1;170321;170319;6
578;6.04373e-15;100;1664;12347;12754;1;311;1.2469e+09;-1.2634e+09;1;0;-1;0;1;-1;170321;170319;6
579;6.10309e-15;102;1654;12480;12837;1;325;1.30785e+09;-1.21888e+09;0;0;-1;0;0;-1;220327;220326;6
579;6.04373e-15;100;1664;12347;12754;1;311;1.30785e+09;-1.21888e+09;0;0;-1;0;0;-1;220327;220326;6
580;6.10309e-15;104;1653;12480;12837;1;325;1.25928e+09;-1.17625e+09;1;0;-1;0;1;-1;279577;279575;6
580;6.04373e-15;101;1663;12347;12754;1;311;1.25928e+09;-1.17625e+09;0;0;-1;0;0;-1;279577;279575;6
581;6.10309e-15;104;1653;12480;12837;1;325;1.31605e+09;-1.13541e+09;0;0;-1;0;0;-1;348848;348846;6
581;6.04373e-15;103;1660;12347;12754;1;311;1.31605e+09;-1.13541e+09;3;0;-1;0;3;-1;348848;348846;6
582;6.10309e-15;106;1650;12480;12837;1;325;1.37087e+09;-1.09627e+09;1;0;-1;0;1;-1;428893;428891;6
582;6.04373e-15;103;1660;12347;12754;1;311;1.37087e+09;-1.09627e+09;0;0;-1;0;0;-1;428893;428891;6
583;6.10309e-15;106;1649;12480;12837;1;325;1.53118e+09;-1.05877e+09;3;0;-1;0;3;-1;520437;520436;6
583;6.04373e-15;103;1660;12347;12754;1;311;1.53118e+09;-1.05877e+09;0;0;-1;0;0;-1;520437;520436;6
584;6.10309e-15;106;1649;12480;12837;1;325;1.47495e+09;-1.02281e+09;1;0;-1;0;1;-1;624174;624173;6
584;6.04373e-15;103;1660;12347;12754;1;311;1.47495e+09;-1.02281e+09;0;0;-1;0;0;-1;624174;624173;6
585;6.10309e-15;106;1649;12480;12837;1;325;1.52436e+09;-9.88342e+08;0;0;-1;0;0;-1;740763;740762;6
585;6.04373e-15;105;1660;12347;12754;1;311;1.52436e+09;-9.88342e+08;1;0;-1;0;1;-1;740763;740762;6
586;6.10309e-15;106;1649;12480;12837;1;325;1.6795e+09;-9.5528e+08;0;0;-1;0;0;-1;870830;870828;6
586;6.04373e-15;110;1656;12347;12754;1;311;1.6795e+09;-9.5528e+08;5;0;-1;0;5;-1;870830;870828;6
587;6.10309e-15;107;1648;12480;12837;1;325;1.61831e+09;-9.23566e+08;3;0;-1;0;3;-1;1014962;1014960;6
587;6.04373e-15;113;1655;12347;12754;1;311;1.61831e+09;-9.23566e+08;2;0;-1;0;2;-1;1014962;1014960;6
588;6.10309e-15;107;1648;12480;12837;1;325;1.66296e+09;-8.93136e+08;0;0;-1;0;0;-1;1173709;1173707;6
588;6.04373e-15;114;1654;12347;12754;1;311;1.66296e+09;-8.93136e+08;1;0;-1;0;1;-1;1173709;1173707;6
589;6.10309e-15;108;1648;12480;12837;1;325;1.70616e+09;-8.63933e+08;1;0;-1;0;1;-1;1347583;1347581;6
589;6.04373e-15;116;1649;12347;12754;1;311;1.70616e+09;-8.63933e+08;3;0;-1;0;3;-1;1347583;1347581;6
590;6.10309e-15;113;1645;12480;12837;1;325;1.85533e+09;-8.359e+08;1;0;-1;0;1;-1;1537058;1537056;6
590;6.04373e-15;117;1649;12347;12754;1;311;1.85533e+09;-8.359e+08;0;0;-1;0;0;-1;1537058;1537056;6
591;6.10309e-15;118;1644;12480;12837;1;325;1.78841e+09;-8.08984e+08;5;0;-1;0;5;-1;1742568;1742566;6
591;6.04373e-15;118;1648;12347;12754;1;311;1.78841e+09;-8.08984e+08;0;0;-1;0;0;-1;1742568;1742566;6
592;6.10309e-15;118;1644;12480;12837;1;325;1.82756e+09;-7.83135e+08;0;0;-1;0;0;-1;1964509;1964508;6
592;6.04373e-15;118;1648;12347;12754;1;311;1.82756e+09;-7.83135e+08;3;0;-1;0;3;-1;1964509;1964508;6
593;6.10309e-15;124;1644;12480;12837;1;325;1.97285e+09;-7.58305e+08;3;0;-1;0;3;-1;2203240;2203238;6
593;6.04373e-15;118;1648;12347;12754;1;311;1.97285e+09;-7.58305e+08;0;0;-1;0;0;-1;2203240;2203238;6
594;6.10309e-15;127;1644;12480;12837;1;325;1.9022e+09;-7.34449e+08;1;0;-1;0;1;-1;2459079;2459077;6
594;6.04373e-15;119;1647;12347;12754;1;311;1.9022e+09;-7.34449e+08;4;0;-1;0;4;-1;2459079;2459077;6
595;6.10309e-15;130;1642;12480;12837;1;325;1.93778e+09;-7.11523e+08;10;0;-1;0;10;-1;2732311;2732309;6
595;6.04373e-15;119;1647;12347;12754;1;311;1.93778e+09;-7.11523e+08;1;0;-1;0;1;-1;2732311;2732309;6
596;6.10309e-15;134;1640;12480;12837;1;325;2.07963e+09;-6.89486e+08;4;0;-1;0;4;-1;3023183;3023181;7
596;6.04373e-15;119;1647;12347;12754;1;311;2.07963e+09;-6.89486e+08;0;0;-1;0;0;-1;3023183;3023181;7
597;6.10309e-15;136;1637;12480;12837;1;325;2.11304e+09;-6.68298e+08;2;0;-1;0;2;-1;3331907;3331905;7
597;6.04373e-15;119;1647;12347;12754;1;311;2.11304e+09;-6.68298e+08;0;0;-1;0;0;-1;3331907;3331905;7
598;6.10309e-15;136;1637;12480;12837;1;325;2.14544e+09;-6.47923e+08;1;0;-1;0;1;-1;3658661;3658659;7
598;6.04373e-15;119;1647;12347;12754;1;311;2.14544e+09;-6.47923e+08;0;0;-1;0;0;-1;3658661;3658659;7
599;6.10309e-15;137;1637;12480;12837;1;325;-2.14748e+09;-6.28325e+08;2;0;-1;0;2;-1;4003589;4003587;7
599;6.04373e-15;131;1646;12347;12754;1;311;-2.14748e+09;-6.28325e+08;14;0;-1;0;14;-1;4003589;4003587;7
600;6.10309e-15;136;1635;12480;12837;1;325;-2.14748e+09;-6.0947e+08;-1;0;0;0;-1;0;4366806;4366804;7
600;6.04373e-15;131;1646;12347;12754;1;311;-2.14748e+09;-6.0947e+08;-1;0;0;0;-1;0;4366806;4366804;7
601;6.10309e-15;135;1635;12480;12837;1;325;-2.14748e+09;-5.91326e+08;-1;0;0;0;-1;0;4748392;4748390;7
601;6.04373e-15;131;1646;12347;12754;1;311;-2.14748e+09;-5.91326e+08;0;0;-1;0;0;-1;4748392;4748390;7
602;6.10309e-15;135;1635;12480;12837;1;325;-2.14748e+09;-5.73862e+08;-1;0;0;0;-1;0;5148402;5148400;7
602;6.04373e-15;131;1646;12347;12754;1;311;-2.14748e+09;-5.73862e+08;0;0;-1;0;0;-1;5148402;5148400;7
603;6.10309e-15;134;1635;12480;12837;1;325;-2.14748e+09;-5.57049e+08;0;0;-1;0;0;-1;5566860;5566858;8
603;6.04373e-15;131;1646;12347;12754;1;311;-2.14748e+09;-5.57049e+08;0;0;-1;0;0;-1;5566860;5566858;8
604;6.10309e-15;134;1635;12480;12837;1;325;-2.14748e+09;-5.40859e+08;-1;0;0;0;-1;0;6003764;6003762;8
604;6.04373e-15;128;1645;12347;12754;1;311;-2.14748e+09;-5.40859e+08;-1;0;0;0;-1;0;6003764;6003762;8
605;6.10309e-15;134;1635;12480;12837;1;325;-2.14748e+09;-5.25265e+08;-1;0;0;0;-1;0;6459086;6459085;8
605;6.04373e-15;128;1645;12347;12754;1;311;-2.14748e+09;-5.25265e+08;-1;0;0;0;-1;0;6459086;6459085;8
606;6.10309e-15;134;1634;12480;12837;1;325;-2.14748e+09;-5.10244e+08;0;0;-1;0;0;-1;6932775;6932773;9
606;6.04373e-15;127;1645;12347;12754;1;311;-2.14748e+09;-5.10244e+08;-1;0;0;0;-1;0;6932775;6932773;9
607;6.10309e-15;132;1634;12480;12837;1;325;-2.14748e+09;-4.95769e+08;-1;0;0;0;-1;0;7424755;7424753;9
607;6.04373e-15;127;1645;12347;12754;1;311;-2.14748e+09;-4.95769e+08;0;0;-1;0;0;-1;7424755;7424753;9
608;6.10309e-15;132;1634;12480;12837;1;325;-2.14748e+09;-4.81819e+08;0;0;-1;0;0;-1;7934928;7934927;10
608;6.04373e-15;127;1645;12347;12754;1;311;-2.14748e+09;-4.81819e+08;-1;0;0;0;-1;0;7934928;7934927;10
609;6.10309e-15;130;1634;12480;12837;1;325;-2.14748e+09;-4.68371e+08;-1;0;0;0;-1;0;8463179;8463177;11
609;6.04373e-15;125;1645;12347;12754;1;311;-2.14748e+09;-4.68371e+08;-1;0;0;0;-1;0;8463179;8463177;11
610;6.10309e-15;130;1634;12480;12837;1;325;-2.14748e+09;-4.55404e+08;0;0;-1;0;0;-1;9009369;9009367;12
610;6.04373e-15;125;1645;12347;12754;1;311;-2.14748e+09;-4.55404e+08;-1;0;0;0;-1;0;9009369;9009367;12
611;6.10309e-15;128;1634;12480;12837;1;325;-2.14748e+09;-4.429e+08;-1;0;0;0;-1;0;9573344;9573342;13
611;6.04373e-15;125;1645;12347;12754;1;311;-2.14748e+09;-4.429e+08;-1;0;0;0;-1;0;9573344;9573342;13
612;6.10309e-15;128;1634;12480;12837;1;325;-2.14748e+09;-4.30837e+08;-1;0;0;0;-1;0;10154931;10154930;14
612;6.04373e-15;125;1645;12347;12754;1;311;-2.14748e+09;-4.30837e+08;-1;0;0;0;-1;0;10154931;10154930;14
613;6.10309e-15;128;1634;12480;12837;1;325;-2.14748e+09;-4.192e+08;-1;0;0;0;-1;0;10753944;10753942;16
613;6.04373e-15;123;1645;12347;12754;1;311;-2.14748e+09;-4.192e+08;-1;0;0;0;-1;0;10753944;10753942;16
614;6.10309e-15;128;1634;12480;12837;1;325;-2.14748e+09;-4.07969e+08;-1;0;0;0;-1;0;11370178;11370177;18
614;6.04373e-15;123;1645;12347;12754;1;311;-2.14748e+09;-4.07969e+08;0;0;-1;0;0;-1;11370178;11370177;18
615;6.10309e-15;128;1634;12480;12837;1;325;-2.14748e+09;-3.97129e+08;-1;0;0;0;-1;0;12003419;12003417;20
615;6.04373e-15;121;1645;12347;12754;1;311;-2.14748e+09;-3.97129e+08;-1;0;0;0;-1;0;12003419;12003417;20
616;6.10309e-15;128;1634;12480;12837;1;325;-2.14748e+09;-3.86664e+08;-1;0;0;0;-1;0;12653436;12653435;23
616;6.04373e-15;121;1645;12347;12754;1;311;-2.14748e+09;-3.86664e+08;-1;0;0;0;-1;0;12653436;12653435;23
617;6.10309e-15;128;1634;12480;12837;1;325;-2.14748e+09;-3.76558e+08;-1;0;0;0;-1;0;13319990;13319989;26
617;6.04373e-15;119;1644;12347;12754;1;311;-2.14748e+09;-3.76558e+08;0;0;-1;0;0;-1;13319990;13319989;26
618;6.10309e-15;126;1634;12480;12837;1;325;-2.14748e+09;-3.66798e+08;-1;0;0;0;-1;0;14002829;14002828;29
618;6.04373e-15;114;1644;12347;12754;1;311;-2.14748e+09;-3.66798e+08;-1;0;0;0;-1;0;14002829;14002828;29
619;6.10309e-15;125;1634;12480;12837;1;325;-2.14748e+09;-3.57369e+08;-1;0;0;0;-1;0;14701692;14701692;33
619;6.04373e-15;114;1644;12347;12754;1;311;-2.14748e+09;-3.57369e+08;0;0;-1;0;0;-1;14701692;14701692;33
620;6.10309e-15;125;1634;12480;12837;1;325;-2.14748e+09;-3.48258e+08;-1;0;0;0;-1;0;15416310;15416309;38
620;6.04373e-15;114;1644;12347;12754;1;311;-2.14748e+09;-3.48258e+08;-1;0;0;0;-1;0;15416310;15416309;38
621;6.10309e-15;125;1634;12480;12837;1;325;-2.14748e+09;-3.39454e+08;-1;0;0;0;-1;0;16146404;16146404;43
621;6.04373e-15;114;1644;12347;12754;1;311;-2.14748e+09;-3.39454e+08;0;0;-1;0;0;-1;16146404;16146404;43
622;6.10309e-15;123;1634;12480;12837;1;325;-2.14748e+09;-3.30943e+08;-1;0;0;0;-1;0;16891690;16891690;49
622;6.04373e-15;114;1644;12347;12754;1;311;-2.14748e+09;-3.30943e+08;-1;0;0;0;-1;0;16891690;16891690;49
623;6.10309e-15;117;1634;12480;12837;1;325;-2.14748e+09;-3.22714e+08;-1;0;0;0;-1;0;17651876;17651876;56
623;6.04373e-15;114;1644;12347;12754;1;311;-2.14748e+09;-3.22714e+08;-1;0;0;0;-1;0;17651876;17651876;56
624;6.10309e-15;117;1634;12480;12837;1;325;-2.14748e+09;-3.14757e+08;-1;0;0;0;-1;0;18426665;18426666;64
624;6.04373e-15;113;1644;12347;12754;1;311;-2.14748e+09;-3.14757e+08;-1;0;0;0;-1;0;18426665;18426666;64
625;6.10309e-15;116;1634;12480;12837;1;325;-2.14748e+09;-3.07061e+08;-1;0;0;0;-1;0;19215756;19215757;72
625;6.04373e-15;109;1643;12347;12754;1;311;-2.14748e+09;-3.07061e+08;-1;0;0;0;-1;0;19215756;19215757;72
626;6.10309e-15;116;1634;12480;12837;1;325;-2.14748e+09;-2.99615e+08;0;0;-1;0;0;-1;20018843;20018844;82
626;6.04373e-15;109;1643;12347;12754;1;311;-2.14748e+09;-2.99615e+08;-1;0;0;0;-1;0;20018843;20018844;82
627;6.10309e-15;116;1634;12480;12837;1;325;-2.14748e+09;-2.92411e+08;0;0;-1;0;0;-1;20835615;20835617;93
627;6.04373e-15;109;1643;12347;12754;1;311;-2.14748e+09;-2.92411e+08;-1;0;0;0;-1;0;20835615;20835617;93
628;6.10309e-15;114;1633;12480;12837;1;325;-2.14748e+09;-2.85438e+08;0;0;-1;0;0;-1;21665761;21665763;106
628;6.04373e-15;109;1643;12347;12754;1;311;-2.14748e+09;-2.85438e+08;-1;0;0;0;-1;0;21665761;21665763;106
629;6.10309e-15;110;1633;12480;12837;1;325;-2.14748e+09;-2.78689e+08;-1;0;0;0;-1;0;22508964;22508967;120
629;6.04373e-15;109;1642;12347;12754;1;311;-2.14748e+09;-2.78689e+08;-1;0;0;0;-1;0;22508964;22508967;120
630;6.10309e-15;109;1632;12480;12837;1;325;-2.14748e+09;-2.72154e+08;0;0;-1;0;0;-1;23364909;23364913;136
630;6.04373e-15;107;1641;12347;12754;1;311;-2.14748e+09;-2.72154e+08;0;0;-1;0;0;-1;23364909;23364913;136
631;6.10309e-15;106;1632;12480;12837;1;325;-2.14748e+09;-2.65826e+08;-1;0;0;0;-1;0;24233278;24233283;153
631;6.04373e-15;106;1641;12347;12754;1;311;-2.14748e+09;-2.65826e+08;0;0;-1;0;0;-1;24233278;24233283;153
632;6.10309e-15;106;1632;12480;12837;1;325;-2.14748e+09;-2.59697e+08;-1;0;0;0;-1;0;25113751;25113756;172
632;6.04373e-15;106;1641;12347;12754;1;311;-2.14748e+09;-2.59697e+08;0;0;-1;0;0;-1;25113751;25113756;172
633;6.10309e-15;106;1632;12480;12837;1;325;-2.14748e+09;-2.53759e+08;-1;0;0;0;-1;0;26006008;26006015;194
633;6.04373e-15;106;1641;12347;12754;1;311;-2.14748e+09;-2.53759e+08;-1;0;0;0;-1;0;26006008;26006015;194
634;6.10309e-15;104;1632;12480;12837;1;325;-2.14748e+09;-2.48005e+08;-1;0;0;0;-1;0;26909732;26909739;218
634;6.04373e-15;106;1641;12347;12754;1;311;-2.14748e+09;-2.48005e+08;0;0;-1;0;0;-1;26909732;26909739;218
635;6.10309e-15;104;1632;12480;12837;1;325;-2.14748e+09;-2.42429e+08;-1;0;0;0;-1;0;27824602;27824611;244
635;6.04373e-15;106;1641;12347;12754;1;311;-2.14748e+09;-2.42429e+08;-1;0;0;0;-1;0;27824602;27824611;244
636;6.10309e-15;104;1632;12480;12837;1;325;-2.14748e+09;-2.37024e+08;-1;0;0;0;-1;0;28750301;28750312;273
636;6.04373e-15;105;1641;12347;12754;1;311;-2.14748e+09;-2.37024e+08;-1;0;0;0;-1;0;28750301;28750312;273
637;6.10309e-15;104;1632;12480;12837;1;325;-2.14748e+09;-2.31784e+08;-1;0;0;0;-1;0;29686513;29686525;305
637;6.04373e-15;103;1641;12347;12754;1;311;-2.14748e+09;-2.31784e+08;-1;0;0;0;-1;0;29686513;29686525;305
638;6.10309e-15;104;1632;12480;12837;1;325;-2.14748e+09;-2.26703e+08;-1;0;0;0;-1;0;30632922;30632935;340
638;6.04373e-15;103;1641;12347;12754;1;311;-2.14748e+09;-2.26703e+08;-1;0;0;0;-1;0;30632922;30632935;340
639;6.10309e-15;104;1632;12480;12837;1;325;-2.14748e+09;-2.21775e+08;-1;0;0;0;-1;0;31589215;31589230;379
639;6.04373e-15;103;1640;12347;12754;1;311;-2.14748e+09;-2.21775e+08;-1;0;0;0;-1;0;31589215;31589230;379
640;6.10309e-15;104;1632;12480;12837;1;325;-2.14748e+09;-2.16994e+08;-1;0;0;0;-1;0;32555081;32555098;421
640;6.04373e-15;103;1640;12347;12754;1;311;-2.14748e+09;-2.16994e+08;-1;0;0;0;-1;0;32555081;32555098;421
641;6.10309e-15;104;1632;12480;12837;1;325;-2.14748e+09;-2.12356e+08;0;0;-1;0;0;-1;33530210;33530230;467
641;6.04373e-15;103;1640;12347;12754;1;311;-2.14748e+09;-2.12356e+08;-1;0;0;0;-1;0;33530210;33530230;467
642;6.10309e-15;104;1632;12480;12837;1;325;-2.14748e+09;-2.07855e+08;-1;0;0;0;-1;0;34514298;34514320;517
642;6.04373e-15;100;1640;12347;12754;1;311;-2.14748e+09;-2.07855e+08;-1;0;0;0;-1;0;34514298;34514320;517
643;6.10309e-15;104;1632;12480;12837;1;325;-2.14748e+09;-2.03486e+08;-1;0;0;0;-1;0;35507041;35507065;572
643;6.04373e-15;99;1640;12347;12754;1;311;-2.14748e+09;-2.03486e+08;0;0;-1;0;0;-1;35507041;35507065;572
644;6.10309e-15;103;1632;12480;12837;1;325;-2.14748e+09;-1.99245e+08;-1;0;0;0;-1;0;36508138;36508166;632
644;6.04373e-15;99;1639;12347;12754;1;311;-2.14748e+09;-1.99245e+08;-1;0;0;0;-1;0;36508138;36508166;632
645;6.10309e-15;101;1631;12480;12837;1;325;-2.14748e+09;-1.95127e+08;-1;0;0;0;-1;0;37517293;37517324;697
645;6.04373e-15;98;1639;12347;12754;1;311;-2.14748e+09;-1.95127e+08;-1;0;0;0;-1;0;37517293;37517324;697
646;6.10309e-15;100;1631;12480;12837;1;325;-2.14748e+09;-1.91128e+08;0;0;-1;0;0;-1;38534214;38534248;767
646;6.04373e-15;98;1639;12347;12754;1;311;-2.14748e+09;-1.91128e+08;-1;0;0;0;-1;0;38534214;38534248;767
647;6.10309e-15;99;1631;12480;12837;1;325;-2.14748e+09;-1.87243e+08;-1;0;0;0;-1;0;39558609;39558647;843
647;6.04373e-15;96;1639;12347;12754;1;311;-2.14748e+09;-1.87243e+08;-1;0;0;0;-1;0;39558609;39558647;843
648;6.10309e-15;99;1631;12480;12837;1;325;-2.14748e+09;-1.83469e+08;-1;0;0;0;-1;0;40590194;40590236;926
648;6.04373e-15;95;1639;12347;12754;1;311;-2.14748e+09;-1.83469e+08;-1;0;0;0;-1;0;40590194;40590236;926
649;6.10309e-15;99;1631;12480;12837;1;325;-2.14748e+09;-1.79803e+08;-1;0;0;0;-1;0;41628686;41628732;1015
649;6.04373e-15;93;1639;12347;12754;1;311;-2.14748e+09;-1.79803e+08;-1;0;0;0;-1;0;41628686;41628732;1015
650;6.10309e-15;99;1631;12480;12837;1;325;-2.14748e+09;-1.76239e+08;-1;0;0;0;-1;0;42673808;42673858;1111
650;6.04373e-15;93;1639;12347;12754;1;311;-2.14748e+09;-1.76239e+08;-1;0;0;0;-1;0;42673808;42673858;1111
651;6.10309e-15;99;1631;12480;12837;1;325;-2.14748e+09;-1.72776e+08;-1;0;0;0;-1;0;43725285;43725340;1214
651;6.04373e-15;92;1639;12347;12754;1;311;-2.14748e+09;-1.72776e+08;-1;0;0;0;-1;0;43725285;43725340;1214
652;6.10309e-15;99;1631;12480;12837;1;325;-2.14748e+09;-1.69408e+08;0;0;-1;0;0;-1;44782848;44782908;1326
652;6.04373e-15;92;1639;12347;12754;1;311;-2.14748e+09;-1.69408e+08;-1;0;0;0;-1;0;44782848;44782908;1326
653;6.10309e-15;98;1631;12480;12837;1;325;-2.14748e+09;-1.66134e+08;-1;0;0;0;-1;0;45846232;45846298;1445
653;6.04373e-15;92;1639;12347;12754;1;311;-2.14748e+09;-1.66134e+08;-1;0;0;0;-1;0;45846232;45846298;1445
654;6.10309e-15;98;1631;12480;12837;1;325;-2.14748e+09;-1.6295e+08;-1;0;0;0;-1;0;46915175;46915248;1574
654;6.04373e-15;90;1638;12347;12754;1;311;-2.14748e+09;-1.6295e+08;-1;0;0;0;-1;0;46915175;46915248;1574
655;6.10309e-15;97;1631;12480;12837;1;325;-2.14748e+09;-1.59852e+08;-1;0;0;0;-1;0;47989423;47989502;1712
655;6.04373e-15;90;1638;12347;12754;1;311;-2.14748e+09;-1.59852e+08;-1;0;0;0;-1;0;47989423;47989502;1712
656;6.10309e-15;95;1631;12480;12837;1;325;-2.14748e+09;-1.56839e+08;-1;0;0;0;-1;0;49068721;49068807;1860
656;6.04373e-15;90;1638;12347;12754;1;311;-2.14748e+09;-1.56839e+08;-1;0;0;0;-1;0;49068721;49068807;1860
657;6.10309e-15;93;1631;12480;12837;1;325;-2.14748e+09;-1.53907e+08;-1;0;0;0;-1;0;50152824;50152917;2018
657;6.04373e-15;90;1638;12347;12754;1;311;-2.14748e+09;-1.53907e+08;-1;0;0;0;-1;0;50152824;50152917;2018
658;6.10309e-15;87;1631;12480;12837;1;325;-2.14748e+09;-1.51054e+08;-1;0;0;0;-1;0;51241487;51241589;2186
658;6.04373e-15;90;1638;12347;12754;1;311;-2.14748e+09;-1.51054e+08;-1;0;0;0;-1;0;51241487;51241589;2186
659;6.10309e-15;87;1631;12480;12837;1;325;-2.14748e+09;-1.48277e+08;-1;0;0;0;-1;0;52334473;52334584;2367
659;6.04373e-15;89;1638;12347;12754;1;311;-2.14748e+09;-1.48277e+08;-1;0;0;0;-1;0;52334473;52334584;2367
660;6.10309e-15;87;1631;12480;12837;1;325;-2.14748e+09;-1.45573e+08;0;0;-1;0;0;-1;53431548;53431668;2559
660;6.04373e-15;89;1638;12347;12754;1;311;-2.14748e+09;-1.45573e+08;-1;0;0;0;-1;0;53431548;53431668;2559
661;6.10309e-15;87;1631;12480;12837;1;325;-2.14748e+09;-1.42941e+08;-1;0;0;0;-1;0;54532483;54532613;2764
661;6.04373e-15;86;1638;12347;12754;1;311;-2.14748e+09;-1.42941e+08;-1;0;0;0;-1;0;54532483;54532613;2764
662;6.10309e-15;87;1631;12480;12837;1;325;-2.14748e+09;-1.40378e+08;-1;0;0;0;-1;0;55637054;55637194;2982
662;6.04373e-15;84;1638;12347;12754;1;311;-2.14748e+09;-1.40378e+08;-1;0;0;0;-1;0;55637054;55637194;2982
663;6.10309e-15;86;1631;12480;12837;1;325;-2.14748e+09;-1.37881e+08;-1;0;0;0;-1;0;56745040;56745192;3214
663;6.04373e-15;83;1638;12347;12754;1;311;-2.14748e+09;-1.37881e+08;-1;0;0;0;-1;0;56745040;56745192;3214
664;6.10309e-15;86;1631;12480;12837;1;325;-2.14748e+09;-1.35448e+08;-1;0;0;0;-1;0;57856226;57856390;3461
664;6.04373e-15;83;1638;12347;12754;1;311;-2.14748e+09;-1.35448e+08;-1;0;0;0;-1;0;57856226;57856390;3461
665;6.10309e-15;86;1631;12480;12837;1;325;-2.14748e+09;-1.33079e+08;-1;0;0;0;-1;0;58970402;58970579;3722
665;6.04373e-15;83;1638;12347;12754;1;311;-2.14748e+09;-1.33079e+08;-1;0;0;0;-1;0;58970402;58970579;3722
666;6.10309e-15;83;1631;12480;12837;1;325;-2.14748e+09;-1.30769e+08;-1;0;0;0;-1;0;60087362;60087552;4000
666;6.04373e-15;83;1638;12347;12754;1;311;-2.14748e+09;-1.30769e+08;-1;0;0;0;-1;0;60087362;60087552;4000
667;6.10309e-15;83;1631;12480;12837;1;325;-2.14748e+09;-1.28519e+08;-1;0;0;0;-1;0;61206903;61207107;4294
667;6.04373e-15;79;1638;12347;12754;1;311;-2.14748e+09;-1.28519e+08;-1;0;0;0;-1;0;61206903;61207107;4294
668;6.10309e-15;83;1631;12480;12837;1;325;-2.14748e+09;-1.26325e+08;-1;0;0;0;-1;0;62328829;62329048;4605
668;6.04373e-15;79;1638;12347;12754;1;311;-2.14748e+09;-1.26325e+08;-1;0;0;0;-1;0;62328829;62329048;4605
669;6.10309e-15;83;1631;12480;12837;1;325;-2.14748e+09;-1.24186e+08;-1;0;0;0;-1;0;63452947;63453183;4935
669;6.04373e-15;78;1637;12347;12754;1;311;-2.14748e+09;-1.24186e+08;-1;0;0;0;-1;0;63452947;63453183;4935
670;6.10309e-15;82;1631;12480;12837;1;325;-2.14748e+09;-1.221e+08;-1;0;0;0;-1;0;64579069;64579322;5283
670;6.04373e-15;78;1637;12347;12754;1;311;-2.14748e+09;-1.221e+08;-1;0;0;0;-1;0;64579069;64579322;5283
671;6.10309e-15;81;1630;12480;12837;1;325;-2.14748e+09;-1.20066e+08;-1;0;0;0;-1;0;65707012;65707284;5651
671;6.04373e-15;78;1637;12347;12754;1;311;-2.14748e+09;-1.20066e+08;-1;0;0;0;-1;0;65707012;65707284;5651
672;6.10309e-15;81;1630;12480;12837;1;325;-2.14748e+09;-1.18082e+08;-1;0;0;0;-1;0;66836596;66836887;6039
672;6.04373e-15;78;1637;12347;12754;1;311;-2.14748e+09;-1.18082e+08;-1;0;0;0;-1;0;66836596;66836887;6039
673;6.10309e-15;81;1630;12480;12837;1;325;-2.14748e+09;-1.16147e+08;-1;0;0;0;-1;0;67967647;67967958;6448
673;6.04373e-15;78;1637;12347;12754;1;311;-2.14748e+09;-1.16147e+08;-1;0;0;0;-1;0;67967647;67967958;6448
674;6.10309e-15;79;1630;12480;12837;1;325;-2.14748e+09;-1.14258e+08;-1;0;0;0;-1;0;69099992;69100325;6879
674;6.04373e-15;78;1637;12347;12754;1;311;-2.14748e+09;-1.14258e+08;-1;0;0;0;-1;0;69099992;69100325;6879
675;6.10309e-15;77;1630;12480;12837;1;325;-2.14748e+09;-1.12415e+08;-1;0;0;0;-1;0;70233467;70233822;7333
675;6.04373e-15;77;1637;12347;12754;1;311;-2.14748e+09;-1.12415e+08;-1;0;0;0;-1;0;70233467;70233822;7333
676;6.10309e-15;77;1630;12480;12837;1;325;-2.14748e+09;-1.10617e+08;-1;0;0;0;-1;0;71367907;71368288;7811
676;6.04373e-15;76;1637;12347;12754;1;311;-2.14748e+09;-1.10617e+08;-1;0;0;0;-1;0;71367907;71368288;7811
677;6.10309e-15;77;1630;12480;12837;1;325;-2.14748e+09;-1.08861e+08;-1;0;0;0;-1;0;72503157;72503563;8313
677;6.04373e-15;75;1637;12347;12754;1;311;-2.14748e+09;-1.08861e+08;-1;0;0;0;-1;0;72503157;72503563;8313
678;6.10309e-15;77;1630;12480;12837;1;325;-2.14748e+09;-1.07148e+08;-1;0;0;0;-1;0;73639061;73639493;8841
678;6.04373e-15;75;1637;12347;12754;1;311;-2.14748e+09;-1.07148e+08;-1;0;0;0;-1;0;73639061;73639493;8841
679;6.10309e-15;77;1630;12480;12837;1;325;-2.14748e+09;-1.05474e+08;-1;0;0;0;-1;0;74775469;74775930;9395
679;6.04373e-15;75;1637;12347;12754;1;311;-2.14748e+09;-1.05474e+08;-1;0;0;0;-1;0;74775469;74775930;9395
680;6.10309e-15;77;1630;12480;12837;1;325;-2.14748e+09;-1.0384e+08;-1;0;0;0;-1;0;75912236;75912726;9976
680;6.04373e-15;75;1637;12347;12754;1;311;-2.14748e+09;-1.0384e+08;-1;0;0;0;-1;0;75912236;75912726;9976
681;6.10309e-15;77;1630;12480;12837;1;325;-2.14748e+09;-1.02244e+08;-1;0;0;0;-1;0;77049218;77049740;10585
681;6.04373e-15;75;1637;12347;12754;1;311;-2.14748e+09;-1.02244e+08;-1;0;0;0;-1;0;77049218;77049740;10585
682;6.10309e-15;75;1630;12480;12837;1;325;-2.14748e+09;-1.00684e+08;-1;0;0;0;-1;0;78186278;78186832;11224
682;6.04373e-15;75;1637;12347;12754;1;311;-2.14748e+09;-1.00684e+08;-1;0;0;0;-1;0;78186278;78186832;11224
683;6.10309e-15;71;1630;12480;12837;1;325;-2.14748e+09;-9.9161e+07;0;0;-1;0;0;-1;79323281;79323869;11893
683;6.04373e-15;75;1637;12347;12754;1;311;-2.14748e+09;-9.9161e+07;-1;0;0;0;-1;0;79323281;79323869;11893
684;6.10309e-15;71;1629;12480;12837;1;325;-2.14748e+09;-9.76725e+07;-1;0;0;0;-1;0;80460095;80460720;12593
684;6.04373e-15;75;1637;12347;12754;1;311;-2.14748e+09;-9.76725e+07;-1;0;0;0;-1;0;80460095;80460720;12593
685;6.10309e-15;71;1628;12480;12837;1;325;-2.14748e+09;-9.62178e+07;-1;0;0;0;-1;0;81596595;81597258;13325
685;6.04373e-15;75;1637;12347;12754;1;311;-2.14748e+09;-9.62178e+07;-1;0;0;0;-1;0;81596595;81597258;13325
686;6.10309e-15;71;1628;12480;12837;1;325;-2.14748e+09;-9.4796e+07;-1;0;0;0;-1;0;82732656;82733358;14091
686;6.04373e-15;74;1637;12347;12754;1;311;-2.14748e+09;-9.4796e+07;-1;0;0;0;-1;0;82732656;82733358;14091
687;6.10309e-15;70;1628;12480;12837;1;325;-2.14748e+09;-9.34062e+07;-1;0;0;0;-1;0;83868157;83868901;14890
687;6.04373e-15;74;1637;12347;12754;1;311;-2.14748e+09;-9.34062e+07;-1;0;0;0;-1;0;83868157;83868901;14890
688;6.10309e-15;70;1628;12480;12837;1;325;-2.14748e+09;-9.20473e+07;-1;0;0;0;-1;0;85002983;85003771;15725
688;6.04373e-15;72;1637;12347;12754;1;311;-2.14748e+09;-9.20473e+07;-1;0;0;0;-1;0;85002983;85003771;15725
689;6.10309e-15;70;1628;12480;12837;1;325;-2.14748e+09;-9.07186e+07;-1;0;0;0;-1;0;86137020;86137853;16596
689;6.04373e-15;72;1636;12347;12754;1;311;-2.14748e+09;-9.07186e+07;-1;0;0;0;-1;0;86137020;86137853;16596
690;6.10309e-15;69;1628;12480;12837;1;325;-2.14748e+09;-8.94192e+07;-1;0;0;0;-1;0;87270158;87271039;17505
690;6.04373e-15;71;1636;12347;12754;1;311;-2.14748e+09;-8.94192e+07;-1;0;0;0;-1;0;87270158;87271039;17505
691;6.10309e-15;69;1628;12480;12837;1;325;-2.14748e+09;-8.81483e+07;-1;0;0;0;-1;0;88402290;88403221;18452
691;6.04373e-15;71;1636;12347;12754;1;311;-2.14748e+09;-8.81483e+07;-1;0;0;0;-1;0;88402290;88403221;18452
692;6.10309e-15;68;1628;12480;12837;1;325;-2.14748e+09;-8.69051e+07;-1;0;0;0;-1;0;89533314;89534297;19438
692;6.04373e-15;71;1636;12347;12754;1;311;-2.14748e+09;-8.69051e+07;-1;0;0;0;-1;0;89533314;89534297;19438
693;6.10309e-15;67;1628;12480;12837;1;325;-2.14748e+09;-8.56888e+07;-1;0;0;0;-1;0;90663128;90664166;20466
693;6.04373e-15;65;1636;12347;12754;1;311;-2.14748e+09;-8.56888e+07;-1;0;0;0;-1;0;90663128;90664166;20466
694;6.10309e-15;66;1628;12480;12837;1;325;-2.14748e+09;-8.44987e+07;-1;0;0;0;-1;0;91791635;91792731;21535
694;6.04373e-15;60;1636;12347;12754;1;311;-2.14748e+09;-8.44987e+07;-1;0;0;0;-1;0;91791635;91792731;21535
695;6.10309e-15;66;1628;12480;12837;1;325;-2.14748e+09;-8.33341e+07;-1;0;0;0;-1;0;92918742;92919898;22647
695;6.04373e-15;58;1636;12347;12754;1;311;-2.14748e+09;-8.33341e+07;-1;0;0;0;-1;0;92918742;92919898;22647
696;6.10309e-15;62;1628;12480;12837;1;325;-2.14748e+09;-8.21942e+07;-1;0;0;0;-1;0;94044357;94045575;23804
696;6.04373e-15;57;1636;12347;12754;1;311;-2.14748e+09;-8.21942e+07;-1;0;0;0;-1;0;94044357;94045575;23804
697;6.10309e-15;61;1627;12480;12837;1;325;-2.14748e+09;-8.10785e+07;-1;0;0;0;-1;0;95168392;95169675;25005
697;6.04373e-15;56;1636;12347;12754;1;311;-2.14748e+09;-8.10785e+07;-1;0;0;0;-1;0;95168392;95169675;25005
698;6.10309e-15;61;1627;12480;12837;1;325;-2.14748e+09;-7.99862e+07;-1;0;0;0;-1;0;96290761;96292112;26253
698;6.04373e-15;55;1636;12347;12754;1;311;-2.14748e+09;-7.99862e+07;-1;0;0;0;-1;0;96290761;96292112;26253
699;6.10309e-15;61;1627;12480;12837;1;325;-2.14748e+09;-7.89168e+07;-1;0;0;0;-1;0;97411382;97412803;27549
699;6.04373e-15;55;1636;12347;12754;1;311;-2.14748e+09;-7.89168e+07;-1;0;0;0;-1;0;97411382;97412803;27549
700;6.10309e-15;61;1627;12480;12837;1;325;-2.14748e+09;-7.78694e+07;-1;0;0;0;-1;0;98530174;98531668;28894
700;6.04373e-15;54;1636;12347;12754;1;311;-2.14748e+09;-7.78694e+07;-1;0;0;0;-1;0;98530174;98531668;28894
701;6.10309e-15;60;1627;12480;12837;1;325;-2.14748e+09;-7.68437e+07;-1;0;0;0;-1;0;99647061;99648631;30288
701;6.04373e-15;54;1636;12347;12754;1;311;-2.14748e+09;-7.68437e+07;0;0;-1;0;0;-1;99647061;99648631;30288
702;6.10309e-15;60;1627;12480;12837;1;325;-2.14748e+09;-7.58391e+07;-1;0;0;0;-1;0;100761967;100763617;31734
702;6.04373e-15;53;1636;12347;12754;1;311;-2.14748e+09;-7.58391e+07;-1;0;0;0;-1;0;100761967;100763617;31734
703;6.10309e-15;58;1627;12480;12837;1;325;-2.14748e+09;-7.4855e+07;-1;0;0;0;-1;0;101874821;101876553;33233
703;6.04373e-15;51;1636;12347;12754;1;311;-2.14748e+09;-7.4855e+07;-1;0;0;0;-1;0;101874821;101876553;33233
704;6.10309e-15;55;1627;12480;12837;1;325;-2.14748e+09;-7.38908e+07;-1;0;0;0;-1;0;102985552;102987369;34785
704;6.04373e-15;49;1636;12347;12754;1;311;-2.14748e+09;-7.38908e+07;-1;0;0;0;-1;0;102985552;102987369;34785
705;6.10309e-15;55;1627;12480;12837;1;325;-2.14748e+09;-7.2946e+07;-1;0;0;0;-1;0;104094094;104096000;36392
705;6.04373e-15;46;1636;12347;12754;1;311;-2.14748e+09;-7.2946e+07;-1;0;0;0;-1;0;104094094;104096000;36392
706;6.10309e-15;55;1627;12480;12837;1;325;-2.14748e+09;-7.20202e+07;-1;0;0;0;-1;0;105200381;105202380;38055
706;6.04373e-15;46;1636;12347;12754;1;311;-2.14748e+09;-7.20202e+07;-1;0;0;0;-1;0;105200381;105202380;38055
707;6.10309e-15;55;1627;12480;12837;1;325;-2.14748e+09;-7.11128e+07;-1;0;0;0;-1;0;106304350;106306446;39776
707;6.04373e-15;45;1636;12347;12754;1;311;-2.14748e+09;-7.11128e+07;-1;0;0;0;-1;0;106304350;106306446;39776
708;6.10309e-15;55;1627;12480;12837;1;325;-2.14748e+09;-7.02234e+07;-1;0;0;0;-1;0;107405942;107408137;41555
708;6.04373e-15;45;1636;12347;12754;1;311;-2.14748e+09;-7.02234e+07;-1;0;0;0;-1;0;107405942;107408137;41555
709;6.10309e-15;55;1627;12480;12837;1;325;-2.14748e+09;-6.93515e+07;-1;0;0;0;-1;0;108505098;108507397;43394
709;6.04373e-15;45;1636;12347;12754;1;311;-2.14748e+09;-6.93515e+07;-1;0;0;0;-1;0;108505098;108507397;43394
710;6.10309e-15;55;1627;12480;12837;1;325;-2.14748e+09;-6.84966e+07;-1;0;0;0;-1;0;109601763;109604169;45295
710;6.04373e-15;45;1636;12347;12754;1;311;-2.14748e+09;-6.84966e+07;-1;0;0;0;-1;0;109601763;109604169;45295
711;6.10309e-15;53;1627;12480;12837;1;325;-2.14748e+09;-6.76584e+07;-1;0;0;0;-1;0;110695882;110698399;47258
711;6.04373e-15;45;1636;12347;12754;1;311;-2.14748e+09;-6.76584e+07;-1;0;0;0;-1;0;110695882;110698399;47258
712;6.10309e-15;51;1627;12480;12837;1;325;-2.14748e+09;-6.68363e+07;-1;0;0;0;-1;0;111787404;111790035;49285
712;6.04373e-15;45;1636;12347;12754;1;311;-2.14748e+09;-6.68363e+07;-1;0;0;0;-1;0;111787404;111790035;49285
713;6.10309e-15;51;1627;12480;12837;1;325;-2.14748e+09;-6.60301e+07;-1;0;0;0;-1;0;112876279;112879028;51377
713;6.04373e-15;41;1636;12347;12754;1;311;-2.14748e+09;-6.60301e+07;-1;0;0;0;-1;0;112876279;112879028;51377
714;6.10309e-15;50;1627;12480;12837;1;325;-2.14748e+09;-6.52393e+07;-1;0;0;0;-1;0;113962459;113965331;53535
714;6.04373e-15;41;1636;12347;12754;1;311;-2.14748e+09;-6.52393e+07;-1;0;0;0;-1;0;113962459;113965331;53535
715;6.10309e-15;50;1627;12480;12837;1;325;-2.14748e+09;-6.44635e+07;-1;0;0;0;-1;0;115045897;115048897;55762
715;6.04373e-15;39;1636;12347;12754;1;311;-2.14748e+09;-6.44635e+07;-1;0;0;0;-1;0;115045897;115048897;55762
716;6.10309e-15;48;1627;12480;12837;1;325;-2.14748e+09;-6.37024e+07;-1;0;0;0;-1;0;116126550;116129683;58057
716;6.04373e-15;36;1636;12347;12754;1;311;-2.14748e+09;-6.37024e+07;-1;0;0;0;-1;0;116126550;116129683;58057
717;6.10309e-15;43;1627;12480;12837;1;325;-2.14748e+09;-6.29556e+07;-1;0;0;0;-1;0;117204376;117207645;60422
717;6.04373e-15;36;1636;12347;12754;1;311;-2.14748e+09;-6.29556e+07;-1;0;0;0;-1;0;117204376;117207645;60422
718;6.10309e-15;40;1627;12480;12837;1;325;-2.14748e+09;-6.22227e+07;-1;0;0;0;-1;0;118279333;118282744;62859
718;6.04373e-15;36;1636;12347;12754;1;311;-2.14748e+09;-6.22227e+07;-1;0;0;0;-1;0;118279333;118282744;62859
719;6.10309e-15;40;1627;12480;12837;1;325;-2.14748e+09;-6.15032e+07;-1;0;0;0;-1;0;119351383;119354940;65369
719;6.04373e-15;36;1636;12347;12754;1;311;-2.14748e+09;-6.15032e+07;-1;0;0;0;-1;0;119351383;119354940;65369
720;6.10309e-15;39;1627;12480;12837;1;325;-2.14748e+09;-6.07972e+07;-1;0;0;0;-1;0;120420489;120424197;67953
720;6.04373e-15;36;1636;12347;12754;1;311;-2.14748e+09;-6.07972e+07;-1;0;0;0;-1;0;120420489;120424197;67953
721;6.10309e-15;39;1627;12480;12837;1;325;-2.14748e+09;-6.01041e+07;-1;0;0;0;-1;0;121486616;121490479;70612
721;6.04373e-15;34;1636;12347;12754;1;311;-2.14748e+09;-6.01041e+07;-1;0;0;0;-1;0;121486616;121490479;70612
722;6.10309e-15;39;1627;12480;12837;1;325;-2.14748e+09;-5.94236e+07;-1;0;0;0;-1;0;122549729;122553752;73348
722;6.04373e-15;33;1636;12347;12754;1;311;-2.14748e+09;-5.94236e+07;-1;0;0;0;-1;0;122549729;122553752;73348
723;6.10309e-15;39;1627;12480;12837;1;325;-2.14748e+09;-5.87555e+07;-1;0;0;0;-1;0;123609795;123613985;76163
723;6.04373e-15;31;1636;12347;12754;1;311;-2.14748e+09;-5.87555e+07;-1;0;0;0;-1;0;123609795;123613985;76163
724;6.10309e-15;39;1627;12480;12837;1;325;-2.14748e+09;-5.80994e+07;-1;0;0;0;-1;0;124666785;124671145;79057
724;6.04373e-15;30;1636;12347;12754;1;311;-2.14748e+09;-5.80994e+07;-1;0;0;0;-1;0;124666785;124671145;79057
725;6.10309e-15;39;1627;12480;12837;1;325;-2.14748e+09;-5.74551e+07;-1;0;0;0;-1;0;125720668;125725205;82031
725;6.04373e-15;30;1636;12347;12754;1;311;-2.14748e+09;-5.74551e+07;-1;0;0;0;-1;0;125720668;125725205;82031
726;6.10309e-15;39;1627;12480;12837;1;325;-2.14748e+09;-5.68223e+07;0;0;-1;0;0;-1;126771416;126776136;85088
726;6.04373e-15;30;1636;12347;12754;1;311;-2.14748e+09;-5.68223e+07;-1;0;0;0;-1;0;126771416;126776136;85088
727;6.10309e-15;35;1627;12480;12837;1;325;-2.14748e+09;-5.62006e+07;-1;0;0;0;-1;0;127819003;127823911;88228
727;6.04373e-15;30;1636;12347;12754;1;311;-2.14748e+09;-5.62006e+07;-1;0;0;0;-1;0;127819003;127823911;88228
728;6.10309e-15;34;1627;12480;12837;1;325;-2.14748e+09;-5.55901e+07;-1;0;0;0;-1;0;128863404;128868505;91453
728;6.04373e-15;30;1636;12347;12754;1;311;-2.14748e+09;-5.55901e+07;-1;0;0;0;-1;0;128863404;128868505;91453
729;6.10309e-15;34;1627;12480;12837;1;325;-2.14748e+09;-5.499e+07;-1;0;0;0;-1;0;129904594;129909894;94763
729;6.04373e-15;30;1636;12347;12754;1;311;-2.14748e+09;-5.499e+07;-1;0;0;0;-1;0;129904594;129909894;94763
730;6.10309e-15;34;1627;12480;12837;1;325;-2.14748e+09;-5.44004e+07;0;0;-1;0;0;-1;130942550;130948056;98161
730;6.04373e-15;30;1636;12347;12754;1;311;-2.14748e+09;-5.44004e+07;-1;0;0;0;-1;0;130942550;130948056;98161
731;6.10309e-15;32;1626;12480;12837;1;325;-2.14748e+09;-5.38211e+07;-1;0;0;0;-1;0;131977251;131982970;101648
731;6.04373e-15;28;1636;12347;12754;1;311;-2.14748e+09;-5.38211e+07;-1;0;0;0;-1;0;131977251;131982970;101648
732;6.10309e-15;32;1626;12480;12837;1;325;-2.14748e+09;-5.32518e+07;-1;0;0;0;-1;0;133008677;133014614;105224
732;6.04373e-15;25;1636;12347;12754;1;311;-2.14748e+09;-5.32518e+07;-1;0;0;0;-1;0;133008677;133014614;105224
733;6.10309e-15;32;1626;12480;12837;1;325;-2.14748e+09;-5.26921e+07;-1;0;0;0;-1;0;134036809;134042970;108892
733;6.04373e-15;24;1636;12347;12754;1;311;-2.14748e+09;-5.26921e+07;-1;0;0;0;-1;0;134036809;134042970;108892
734;6.10309e-15;31;1626;12480;12837;1;325;-2.14748e+09;-5.2142e+07;-1;0;0;0;-1;0;135061629;135068021;112652
734;6.04373e-15;22;1636;12347;12754;1;311;-2.14748e+09;-5.2142e+07;0;0;-1;0;0;-1;135061629;135068021;112652
735;6.10309e-15;31;1626;12480;12837;1;325;-2.14748e+09;-5.16013e+07;-1;0;0;0;-1;0;136083119;136089749;116505
735;6.04373e-15;19;1636;12347;12754;1;311;-2.14748e+09;-5.16013e+07;-1;0;0;0;-1;0;136083119;136089749;116505
736;6.10309e-15;31;1626;12480;12837;1;325;-2.14748e+09;-5.10696e+07;-1;0;0;0;-1;0;137101264;137108138;120454
736;6.04373e-15;19;1636;12347;12754;1;311;-2.14748e+09;-5.10696e+07;-1;0;0;0;-1;0;137101264;137108138;120454
737;6.10309e-15;31;1626;12480;12837;1;325;-2.14748e+09;-5.05468e+07;-1;0;0;0;-1;0;138116049;138123175;124499
737;6.04373e-15;19;1636;12347;12754;1;311;-2.14748e+09;-5.05468e+07;-1;0;0;0;-1;0;138116049;138123175;124499
738;6.10309e-15;30;1626;12480;12837;1;325;-2.14748e+09;-5.00327e+07;-1;0;0;0;-1;0;139127460;139134844;128642
738;6.04373e-15;19;1636;12347;12754;1;311;-2.14748e+09;-5.00327e+07;-1;0;0;0;-1;0;139127460;139134844;128642
739;6.10309e-15;28;1626;12480;12837;1;325;-2.14748e+09;-4.95272e+07;-1;0;0;0;-1;0;140135485;140143135;132884
739;6.04373e-15;18;1636;12347;12754;1;311;-2.14748e+09;-4.95272e+07;-1;0;0;0;-1;0;140135485;140143135;132884
740;6.10309e-15;27;1626;12480;12837;1;325;-2.14748e+09;-4.90299e+07;-1;0;0;0;-1;0;141140112;141148035;137225
740;6.04373e-15;15;1636;12347;12754;1;311;-2.14748e+09;-4.90299e+07;-1;0;0;0;-1;0;141140112;141148035;137225
741;6.10309e-15;24;1626;12480;12837;1;325;-2.14748e+09;-4.85408e+07;-1;0;0;0;-1;0;142141329;142149532;141668
741;6.04373e-15;15;1636;12347;12754;1;311;-2.14748e+09;-4.85408e+07;-1;0;0;0;-1;0;142141329;142149532;141668
742;6.10309e-15;24;1626;12480;12837;1;325;-2.14748e+09;-4.80597e+07;-1;0;0;0;-1;0;143139127;143147618;146214
742;6.04373e-15;15;1635;12347;12754;1;311;-2.14748e+09;-4.80597e+07;-1;0;0;0;-1;0;143139127;143147618;146214
743;6.10309e-15;24;1626;12480;12837;1;325;-2.14748e+09;-4.75863e+07;-1;0;0;0;-1;0;144133496;144142283;150864
743;6.04373e-15;14;1635;12347;12754;1;311;-2.14748e+09;-4.75863e+07;-1;0;0;0;-1;0;144133496;144142283;150864
744;6.10309e-15;24;1626;12480;12837;1;325;-2.14748e+09;-4.71205e+07;-1;0;0;0;-1;0;145124429;145133519;155618
744;6.04373e-15;13;1635;12347;12754;1;311;-2.14748e+09;-4.71205e+07;-1;0;0;0;-1;0;145124429;145133519;155618
745;6.10309e-15;23;1626;12480;12837;1;325;-2.14748e+09;-4.66622e+07;-1;0;0;0;-1;0;146111917;146121319;160479
745;6.04373e-15;11;1635;12347;12754;1;311;-2.14748e+09;-4.66622e+07;-1;0;0;0;-1;0;146111917;146121319;160479
746;6.10309e-15;22;1626;12480;12837;1;325;-2.14748e+09;-4.62113e+07;-1;0;0;0;-1;0;147095954;147105676;165448
746;6.04373e-15;11;1635;12347;12754;1;311;-2.14748e+09;-4.62113e+07;-1;0;0;0;-1;0;147095954;147105676;165448
747;6.10309e-15;18;1626;12480;12837;1;325;-2.14748e+09;-4.57674e+07;-1;0;0;0;-1;0;148076534;148086584;170525
747;6.04373e-15;11;1635;12347;12754;1;311;-2.14748e+09;-4.57674e+07;-1;0;0;0;-1;0;148076534;148086584;170525
748;6.10309e-15;18;1626;12480;12837;1;325;-2.14748e+09;-4.53305e+07;-1;0;0;0;-1;0;149053653;149064038;175712
748;6.04373e-15;11;1635;12347;12754;1;311;-2.14748e+09;-4.53305e+07;-1;0;0;0;-1;0;149053653;149064038;175712
749;6.10309e-15;17;1626;12480;12837;1;325;-2.14748e+09;-4.49004e+07;-1;0;0;0;-1;0;150027304;150038034;181010
749;6.04373e-15;8;1635;12347;12754;1;311;-2.14748e+09;-4.49004e+07;-1;0;0;0;-1;0;150027304;150038034;181010
750;6.10309e-15;16;1626;12480;12837;1;325;-2.14748e+09;-4.44771e+07;-1;0;0;0;-1;0;150997485;151008568;186421
750;6.04373e-15;7;1634;12347;12754;1;311;-2.14748e+09;-4.44771e+07;-1;0;0;0;-1;0;150997485;151008568;186421
751;6.10309e-15;15;1626;12480;12837;1;325;-2.14748e+09;-4.40603e+07;-1;0;0;0;-1;0;151964192;151975638;191945
751;6.04373e-15;6;1634;12347;12754;1;311;-2.14748e+09;-4.40603e+07;-1;0;0;0;-1;0;151964192;151975638;191945
752;6.10309e-15;14;1626;12480;12837;1;325;-2.14748e+09;-4.36499e+07;-1;0;0;0;-1;0;152927424;152939241;197584
752;6.04373e-15;4;1634;12347;12754;1;311;-2.14748e+09;-4.36499e+07;-1;0;0;0;-1;0;152927424;152939241;197584
753;6.10309e-15;13;1626;12480;12837;1;325;-2.14748e+09;-4.32458e+07;-1;0;0;0;-1;0;153887177;153899375;203339
753;6.04373e-15;4;1634;12347;12754;1;311;-2.14748e+09;-4.32458e+07;-1;0;0;0;-1;0;153887177;153899375;203339
754;6.10309e-15;13;1626;12480;12837;1;325;-2.14748e+09;-4.2848e+07;-1;0;0;0;-1;0;154843452;154856039;209211
754;6.04373e-15;0;1634;12347;12754;1;311;-2.14748e+09;-4.2848e+07;-1;0;0;0;-1;0;154843452;154856039;209211
755;6.10309e-15;10;1626;12480;12837;1;325;-2.14748e+09;-4.2456e+07;-1;0;0;0;-1;0;155796247;155809233;215201
755;6.04373e-15;-1;1634;12347;12754;1;311;-2.14748e+09;-4.2456e+07;0;0;0;0;0;0;155796247;155809233;215201
756;6.10309e-15;7;1626;12480;12837;1;325;-2.14748e+09;-4.207e+07;-1;0;0;0;-1;0;156745562;156758957;221310
756;6.04373e-15;-2;1634;12347;12754;1;311;-2.14748e+09;-4.207e+07;0;0;0;0;0;0;156745562;156758957;221310
757;6.10309e-15;7;1626;12480;12837;1;325;-2.14748e+09;-4.16897e+07;-1;0;0;0;-1;0;157691398;157705212;227539
757;6.04373e-15;-3;1634;12347;12754;1;311;-2.14748e+09;-4.16897e+07;0;0;0;0;0;0;157691398;157705212;227539
758;6.10309e-15;6;1626;12480;12837;1;325;-2.14748e+09;-4.13152e+07;-1;0;0;0;-1;0;158633756;158647998;233890
758;6.04373e-15;-4;1634;12347;12754;1;311;-2.14748e+09;-4.13152e+07;0;0;0;0;0;0;158633756;158647998;233890
759;6.10309e-15;5;1626;12480;12837;1;325;-2.14748e+09;-4.09462e+07;-1;0;0;0;-1;0;159572638;159587318;240364
759;6.04373e-15;-4;1634;12347;12754;1;311;-2.14748e+09;-4.09462e+07;-1;0;0;0;-1;0;159572638;159587318;240364
760;6.10309e-15;5;1626;12480;12837;1;325;-2.14748e+09;-4.05826e+07;-1;0;0;0;-1;0;160508045;160523173;246961
760;6.04373e-15;-4;1634;12347;12754;1;311;-2.14748e+09;-4.05826e+07;-1;0;0;0;-1;0;160508045;160523173;246961
761;6.10309e-15;3;1626;12480;12837;1;325;-2.14748e+09;-4.02244e+07;-1;0;0;0;-1;0;161439981;161455567;253684
761;6.04373e-15;-5;1634;12347;12754;1;311;-2.14748e+09;-4.02244e+07;0;0;0;0;0;0;161439981;161455567;253684
762;6.10309e-15;2;1626;12480;12837;1;325;-2.14748e+09;-3.98714e+07;-1;0;0;0;-1;0;162368447;162384503;260532
762;6.04373e-15;-6;1634;12347;12754;1;311;-2.14748e+09;-3.98714e+07;0;0;0;0;0;0;162368447;162384503;260532
763;6.10309e-15;2;1626;12480;12837;1;325;-2.14748e+09;-3.95235e+07;-1;0;0;0;-1;0;163293449;163309984;267506
763;6.04373e-15;-7;1634;12347;12754;1;311;-2.14748e+09;-3.95235e+07;0;0;0;0;0;0;163293449;163309984;267506
764;6.10309e-15;2;1626;12480;12837;1;325;-2.14748e+09;-3.91808e+07;-1;0;0;0;-1;0;164214989;164232014;274609
764;6.04373e-15;-8;1634;12347;12754;1;311;-2.14748e+09;-3.91808e+07;0;0;0;0;0;0;164214989;164232014;274609
765;6.10309e-15;0;1626;12480;12837;1;325;-2.14748e+09;-3.88428e+07;-1;0;0;0;-1;0;165133072;165150598;281841
765;6.04373e-15;-8;1634;12347;12754;1;311;-2.14748e+09;-3.88428e+07;-1;0;0;0;-1;0;165133072;165150598;281841
766;6.10309e-15;-1;1626;12480;12837;1;325;-2.14748e+09;-3.85097e+07;0;0;0;0;0;0;166047702;166065741;289202
766;6.04373e-15;-9;1634;12347;12754;1;311;-2.14748e+09;-3.85097e+07;0;0;0;0;0;0;166047702;166065741;289202
767;6.10309e-15;-1;1626;12480;12837;1;325;-2.14748e+09;-3.81813e+07;-1;0;0;0;-1;0;166958886;166977448;296695
767;6.04373e-15;-10;1634;12347;12754;1;311;-2.14748e+09;-3.81813e+07;0;0;0;0;0;0;166958886;166977448;296695
768;6.10309e-15;-2;1626;12480;12837;1;325;-2.14748e+09;-3.78576e+07;0;0;0;0;0;0;167866628;167885724;304320
768;6.04373e-15;-11;1634;12347;12754;1;311;-2.14748e+09;-3.78576e+07;0;0;0;0;0;0;167866628;167885724;304320
769;6.10309e-15;-2;1626;12480;12837;1;325;-2.14748e+09;-3.75384e+07;-1;0;0;0;-1;0;168770934;168790577;312077
769;6.04373e-15;-12;1634;12347;12754;1;311;-2.14748e+09;-3.75384e+07;0;0;0;0;0;0;168770934;168790577;312077
770;6.10309e-15;-3;1626;12480;12837;1;325;-2.14748e+09;-3.72237e+07;0;0;0;0;0;0;169671811;169692012;319969
770;6.04373e-15;-12;1634;12347;12754;1;311;-2.14748e+09;-3.72237e+07;-1;0;0;0;-1;0;169671811;169692012;319969
771;6.10309e-15;-4;1626;12480;12837;1;325;-2.14748e+09;-3.69134e+07;0;0;0;0;0;0;170569266;170590035;327995
771;6.04373e-15;-13;1634;12347;12754;1;311;-2.14748e+09;-3.69134e+07;0;0;0;0;0;0;170569266;170590035;327995
772;6.10309e-15;-5;1626;12480;12837;1;325;-2.14748e+09;-3.66073e+07;0;0;0;0;0;0;171463304;171484655;336157
772;6.04373e-15;-13;1634;12347;12754;1;311;-2.14748e+09;-3.66073e+07;-1;0;0;0;-1;0;171463304;171484655;336157
773;6.10309e-15;-6;1626;12480;12837;1;325;-2.14748e+09;-3.63055e+07;0;0;0;0;0;0;172353933;172375878;344456
773;6.04373e-15;-13;1634;12347;12754;1;311;-2.14748e+09;-3.63055e+07;-1;0;0;0;-1;0;172353933;172375878;344456
774;6.10309e-15;-7;1626;12480;12837;1;325;-2.14748e+09;-3.60078e+07;0;0;0;0;0;0;173241162;173263712;352892
774;6.04373e-15;-13;1634;12347;12754;1;311;-2.14748e+09;-3.60078e+07;-1;0;0;0;-1;0;173241162;173263712;352892
775;6.10309e-15;-7;1626;12480;12837;1;325;-2.14748e+09;-3.57142e+07;-1;0;0;0;-1;0;174124997;174148165;361467
775;6.04373e-15;-14;1634;12347;12754;1;311;-2.14748e+09;-3.57142e+07;0;0;0;0;0;0;174124997;174148165;361467
776;6.10309e-15;-7;1626;12480;12837;1;325;-2.14748e+09;-3.54246e+07;-1;0;0;0;-1;0;175005447;175029246;370182
776;6.04373e-15;-14;1634;12347;12754;1;311;-2.14748e+09;-3.54246e+07;-1;0;0;0;-1;0;175005447;175029246;370182
777;6.10309e-15;-7;1626;12480;12837;1;325;-2.14748e+09;-3.51389e+07;-1;0;0;0;-1;0;175882520;175906962;379036
777;6.04373e-15;-14;1634;12347;12754;1;311;-2.14748e+09;-3.51389e+07;-1;0;0;0;-1;0;175882520;175906962;379036
778;6.10309e-15;-7;1626;12480;12837;1;325;-2.14748e+09;-3.4857e+07;-1;0;0;0;-1;0;176756225;176781323;388032
778;6.04373e-15;-15;1634;12347;12754;1;311;-2.14748e+09;-3.4857e+07;0;0;0;0;0;0;176756225;176781323;388032
779;6.10309e-15;-8;1626;12480;12837;1;325;-2.14748e+09;-3.45788e+07;0;0;0;0;0;0;177626570;177652338;397170
779;6.04373e-15;-15;1634;12347;12754;1;311;-2.14748e+09;-3.45788e+07;-1;0;0;0;-1;0;177626570;177652338;397170
780;6.10309e-15;-8;1626;12480;12837;1;325;-2.14748e+09;-3.43044e+07;-1;0;0;0;-1;0;178493566;178520015;406451
780;6.04373e-15;-15;1634;12347;12754;1;311;-2.14748e+09;-3.43044e+07;-1;0;0;0;-1;0;178493566;178520015;406451
781;6.10309e-15;-8;1626;12480;12837;1;325;-2.14748e+09;-3.40336e+07;-1;0;0;0;-1;0;179357220;179384365;415876
781;6.04373e-15;-16;1634;12347;12754;1;311;-2.14748e+09;-3.40336e+07;0;0;0;0;0;0;179357220;179384365;415876
782;6.10309e-15;-9;1626;12480;12837;1;325;-2.14748e+09;-3.37664e+07;0;0;0;0;0;0;180217543;180245398;425445
782;6.04373e-15;-16;1634;12347;12754;1;311;-2.14748e+09;-3.37664e+07;-1;0;0;0;-1;0;180217543;180245398;425445
783;6.10309e-15;-10;1626;12480;12837;1;325;-2.14748e+09;-3.35026e+07;0;0;0;0;0;0;181074545;181103122;435159
783;6.04373e-15;-16;1634;12347;12754;1;311;-2.14748e+09;-3.35026e+07;-1;0;0;0;-1;0;181074545;181103122;435159
784;6.10309e-15;-10;1626;12480;12837;1;325;-2.14748e+09;-3.32423e+07;-1;0;0;0;-1;0;181928235;181957548;445019
784;6.04373e-15;-16;1634;12347;12754;1;311;-2.14748e+09;-3.32423e+07;-1;0;0;0;-1;0;181928235;181957548;445019
785;6.10309e-15;-10;1626;12480;12837;1;325;-2.14748e+09;-3.29854e+07;-1;0;0;0;-1;0;182778623;182808688;455026
785;6.04373e-15;-17;1634;12347;12754;1;311;-2.14748e+09;-3.29854e+07;0;0;0;0;0;0;182778623;182808688;455026
786;6.10309e-15;-11;1626;12480;12837;1;325;-2.14748e+09;-3.27317e+07;0;0;0;0;0;0;183625721;183656550;465181
786;6.04373e-15;-17;1633;12347;12754;1;311;-2.14748e+09;-3.27317e+07;0;0;0;0;0;0;183625721;183656550;465181
787;6.10309e-15;-11;1626;12480;12837;1;325;-2.14748e+09;-3.24814e+07;-1;0;0;0;-1;0;184469538;184501146;475484
787;6.04373e-15;-17;1633;12347;12754;1;311;-2.14748e+09;-3.24814e+07;-1;0;0;0;-1;0;184469538;184501146;475484
788;6.10309e-15;-11;1626;12480;12837;1;325;-2.14748e+09;-3.22343e+07;-1;0;0;0;-1;0;185310085;185342486;485936
788;6.04373e-15;-17;1633;12347;12754;1;311;-2.14748e+09;-3.22343e+07;-1;0;0;0;-1;0;185310085;185342486;485936
789;6.10309e-15;-12;1626;12480;12837;1;325;-2.14748e+09;-3.19902e+07;0;0;0;0;0;0;186147373;186180582;496537
789;6.04373e-15;-18;1633;12347;12754;1;311;-2.14748e+09;-3.19902e+07;0;0;0;0;0;0;186147373;186180582;496537
790;6.10309e-15;-13;1626;12480;12837;1;325;-2.14748e+09;-3.17492e+07;0;0;0;0;0;0;186981414;187015445;507289
790;6.04373e-15;-19;1633;12347;12754;1;311;-2.14748e+09;-3.17492e+07;0;0;0;0;0;0;186981414;187015445;507289
791;6.10309e-15;-13;1626;12480;12837;1;325;-2.14748e+09;-3.15114e+07;-1;0;0;0;-1;0;187812217;187847086;518192
791;6.04373e-15;-20;1633;12347;12754;1;311;-2.14748e+09;-3.15114e+07;0;0;0;0;0;0;187812217;187847086;518192
792;6.10309e-15;-13;1626;12480;12837;1;325;-2.14748e+09;-3.12764e+07;-1;0;0;0;-1;0;188639795;188675517;529247
792;6.04373e-15;-20;1633;12347;12754;1;311;-2.14748e+09;-3.12764e+07;-1;0;0;0;-1;0;188639795;188675517;529247
793;6.10309e-15;-14;1626;12480;12837;1;325;-2.14748e+09;-3.10444e+07;0;0;0;0;0;0;189464159;189500748;540455
793;6.04373e-15;-20;1633;12347;12754;1;311;-2.14748e+09;-3.10444e+07;-1;0;0;0;-1;0;189464159;189500748;540455
794;6.10309e-15;-14;1626;12480;12837;1;325;-2.14748e+09;-3.08154e+07;-1;0;0;0;-1;0;190285320;190322793;551815
794;6.04373e-15;-21;1633;12347;12754;1;311;-2.14748e+09;-3.08154e+07;0;0;0;0;0;0;190285320;190322793;551815
795;6.10309e-15;-15;1626;12480;12837;1;325;-2.14748e+09;-3.0589e+07;0;0;0;0;0;0;191103291;191141662;563329
795;6.04373e-15;-22;1633;12347;12754;1;311;-2.14748e+09;-3.0589e+07;0;0;0;0;0;0;191103291;191141662;563329
796;6.10309e-15;-16;1626;12480;12837;1;325;-2.14748e+09;-3.03654e+07;0;0;0;0;0;0;191918082;191957367;574997
796;6.04373e-15;-22;1633;12347;12754;1;311;-2.14748e+09;-3.03654e+07;-1;0;0;0;-1;0;191918082;191957367;574997
797;6.10309e-15;-16;1626;12480;12837;1;325;-2.14748e+09;-3.01447e+07;-1;0;0;0;-1;0;192729706;192769921;586820
797;6.04373e-15;-23;1633;12347;12754;1;311;-2.14748e+09;-3.01447e+07;0;0;0;0;0;0;192729706;192769921;586820
798;6.10309e-15;-16;1626;12480;12837;1;325;-2.14748e+09;-2.99265e+07;-1;0;0;0;-1;0;193538174;193579336;598799
798;6.04373e-15;-23;1633;12347;12754;1;311;-2.14748e+09;-2.99265e+07;-1;0;0;0;-1;0;193538174;193579336;598799
799;6.10309e-15;-16;1626;12480;12837;1;325;-2.14748e+09;-2.97111e+07;-1;0;0;0;-1;0;194343500;194385624;610933
799;6.04373e-15;-24;1633;12347;12754;1;311;-2.14748e+09;-2.97111e+07;0;0;0;0;0;0;194343500;194385624;610933
800;6.10309e-15;-16;1626;12480;12837;1;325;-2.14748e+09;-2.94982e+07;-1;0;0;0;-1;0;195145695;195188797;623224
800;6.04373e-15;-25;1633;12347;12754;1;311;-2.14748e+09;-2.94982e+07;0;0;0;0;0;0;195145695;195188797;623224
801;6.10309e-15;-17;1626;12480;12837;1;325;-2.14748e+09;-2.92879e+07;0;0;0;0;0;0;195944770;195988868;635672
801;6.04373e-15;-26;1633;12347;12754;1;311;-2.14748e+09;-2.92879e+07;0;0;0;0;0;0;195944770;195988868;635672
802;6.10309e-15;-17;1626;12480;12837;1;325;-2.14748e+09;-2.90801e+07;-1;0;0;0;-1;0;196740740;196785849;648278
802;6.04373e-15;-26;1633;12347;12754;1;311;-2.14748e+09;-2.90801e+07;-1;0;0;0;-1;0;196740740;196785849;648278
803;6.10309e-15;-17;1626;12480;12837;1;325;-2.14748e+09;-2.88747e+07;-1;0;0;0;-1;0;197533615;197579753;661042
803;6.04373e-15;-26;1633;12347;12754;1;311;-2.14748e+09;-2.88747e+07;-1;0;0;0;-1;0;197533615;197579753;661042
804;6.10309e-15;-17;1626;12480;12837;1;325;-2.14748e+09;-2.86718e+07;-1;0;0;0;-1;0;198323408;198370592;673964
804;6.04373e-15;-27;1633;12347;12754;1;311;-2.14748e+09;-2.86718e+07;0;0;0;0;0;0;198323408;198370592;673964
805;6.10309e-15;-18;1626;12480;12837;1;325;-2.14748e+09;-2.84713e+07;0;0;0;0;0;0;199110133;199158379;687046
805;6.04373e-15;-28;1633;12347;12754;1;311;-2.14748e+09;-2.84713e+07;0;0;0;0;0;0;199110133;199158379;687046
806;6.10309e-15;-18;1626;12480;12837;1;325;-2.14748e+09;-2.82731e+07;-1;0;0;0;-1;0;199893801;199943127;700287
806;6.04373e-15;-28;1633;12347;12754;1;311;-2.14748e+09;-2.82731e+07;-1;0;0;0;-1;0;199893801;199943127;700287
807;6.10309e-15;-18;1626;12480;12837;1;325;-2.14748e+09;-2.80773e+07;-1;0;0;0;-1;0;200674426;200724848;713688
807;6.04373e-15;-28;1633;12347;12754;1;311;-2.14748e+09;-2.80773e+07;-1;0;0;0;-1;0;200674426;200724848;713688
808;6.10309e-15;-19;1626;12480;12837;1;325;-2.14748e+09;-2.78837e+07;0;0;0;0;0;0;201452019;201503556;727249
808;6.04373e-15;-28;1633;12347;12754;1;311;-2.14748e+09;-2.78837e+07;-1;0;0;0;-1;0;201452019;201503556;727249
809;6.10309e-15;-19;1626;12480;12837;1;325;-2.14748e+09;-2.76923e+07;-1;0;0;0;-1;0;202226593;202279263;740971
809;6.04373e-15;-29;1633;12347;12754;1;311;-2.14748e+09;-2.76923e+07;0;0;0;0;0;0;202226593;202279263;740971
810;6.10309e-15;-20;1626;12480;12837;1;325;-2.14748e+09;-2.75033e+07;0;0;0;0;0;0;202998163;203051983;754854
810;6.04373e-15;-30;1633;12347;12754;1;311;-2.14748e+09;-2.75033e+07;0;0;0;0;0;0;202998163;203051983;754854
811;6.10309e-15;-20;1626;12480;12837;1;325;-2.14748e+09;-2.73162e+07;-1;0;0;0;-1;0;203766739;203821727;768899
811;6.04373e-15;-30;1633;12347;12754;1;311;-2.14748e+09;-2.73162e+07;-1;0;0;0;-1;0;203766739;203821727;768899
812;6.10309e-15;-21;1626;12480;12837;1;325;-2.14748e+09;-2.71313e+07;0;0;0;0;0;0;204532335;204588510;783106
812;6.04373e-15;-30;1633;12347;12754;1;311;-2.14748e+09;-2.71313e+07;-1;0;0;0;-1;0;204532335;204588510;783106
813;6.10309e-15;-22;1626;12480;12837;1;325;-2.14748e+09;-2.69486e+07;0;0;0;0;0;0;205294965;205352345;797476
813;6.04373e-15;-31;1633;12347;12754;1;311;-2.14748e+09;-2.69486e+07;0;0;0;0;0;0;205294965;205352345;797476
814;6.10309e-15;-23;1626;12480;12837;1;325;-2.14748e+09;-2.67678e+07;0;0;0;0;0;0;206054640;206113243;812008
814;6.04373e-15;-32;1633;12347;12754;1;311;-2.14748e+09;-2.67678e+07;0;0;0;0;0;0;206054640;206113243;812008
815;6.10309e-15;-23;1626;12480;12837;1;325;-2.14748e+09;-2.65892e+07;-1;0;0;0;-1;0;206811374;206871219;826703
815;6.04373e-15;-32;1633;12347;12754;1;311;-2.14748e+09;-2.65892e+07;-1;0;0;0;-1;0;206811374;206871219;826703
816;6.10309e-15;-24;1626;12480;12837;1;325;-2.14748e+09;-2.64126e+07;0;0;0;0;0;0;207565180;207626286;841561
816;6.04373e-15;-33;1633;12347;12754;1;311;-2.14748e+09;-2.64126e+07;0;0;0;0;0;0;207565180;207626286;841561
817;6.10309e-15;-25;1626;12480;12837;1;325;-2.14748e+09;-2.62378e+07;0;0;0;0;0;0;208316071;208378456;856583
817;6.04373e-15;-34;1633;12347;12754;1;311;-2.14748e+09;-2.62378e+07;0;0;0;0;0;0;208316071;208378456;856583
818;6.10309e-15;-25;1626;12480;12837;1;325;-2.14748e+09;-2.6065e+07;-1;0;0;0;-1;0;209064059;209127744;871769
818;6.04373e-15;-34;1633;12347;12754;1;311;-2.14748e+09;-2.6065e+07;-1;0;0;0;-1;0;209064059;209127744;871769
819;6.10309e-15;-25;1626;12480;12837;1;325;-2.14748e+09;-2.58941e+07;-1;0;0;0;-1;0;209809158;209874161;887120
819;6.04373e-15;-34;1633;12347;12754;1;311;-2.14748e+09;-2.58941e+07;-1;0;0;0;-1;0;209809158;209874161;887120
820;6.10309e-15;-25;1626;12480;12837;1;325;-2.14748e+09;-2.57251e+07;-1;0;0;0;-1;0;210551381;210617721;902634
820;6.04373e-15;-35;1633;12347;12754;1;311;-2.14748e+09;-2.57251e+07;0;0;0;0;0;0;210551381;210617721;902634
821;6.10309e-15;-25;1626;12480;12837;1;325;-2.14748e+09;-2.5558e+07;-1;0;0;0;-1;0;211290741;211358438;918314
821;6.04373e-15;-35;1633;12347;12754;1;311;-2.14748e+09;-2.5558e+07;-1;0;0;0;-1;0;211290741;211358438;918314
822;6.10309e-15;-26;1626;12480;12837;1;325;-2.14748e+09;-2.53927e+07;0;0;0;0;0;0;212027250;212096324;934158
822;6.04373e-15;-35;1633;12347;12754;1;311;-2.14748e+09;-2.53927e+07;-1;0;0;0;-1;0;212027250;212096324;934158
823;6.10309e-15;-26;1626;12480;12837;1;325;-2.14748e+09;-2.52292e+07;-1;0;0;0;-1;0;212760922;212831393;950168
823;6.04373e-15;-36;1633;12347;12754;1;311;-2.14748e+09;-2.52292e+07;0;0;0;0;0;0;212760922;212831393;950168
824;6.10309e-15;-27;1626;12480;12837;1;325;-2.14748e+09;-2.50674e+07;0;0;0;0;0;0;213491770;213563658;966343
824;6.04373e-15;-37;1633;12347;12754;1;311;-2.14748e+09;-2.50674e+07;0;0;0;0;0;0;213491770;213563658;966343
825;6.10309e-15;-27;1626;12480;12837;1;325;-2.14748e+09;-2.49074e+07;-1;0;0;0;-1;0;214219807;214293132;982684
825;6.04373e-15;-38;1633;12347;12754;1;311;-2.14748e+09;-2.49074e+07;0;0;0;0;0;0;214219807;214293132;982684
826;6.10309e-15;-27;1626;12480;12837;1;325;-2.14748e+09;-2.47491e+07;-1;0;0;0;-1;0;214945046;215019828;999191
826;6.04373e-15;-39;1633;12347;12754;1;311;-2.14748e+09;-2.47491e+07;0;0;0;0;0;0;214945046;215019828;999191
827;6.10309e-15;-28;1626;12480;12837;1;325;-2.14748e+09;-2.45924e+07;0;0;0;0;0;0;215667500;215743759;1015864
827;6.04373e-15;-40;1633;12347;12754;1;311;-2.14748e+09;-2.45924e+07;0;0;0;0;0;0;215667500;215743759;1015864
828;6.10309e-15;-29;1626;12480;12837;1;325;-2.14748e+09;-2.44375e+07;0;0;0;0;0;0;216387181;216464939;1032703
828;6.04373e-15;-41;1633;12347;12754;1;311;-2.14748e+09;-2.44375e+07;0;0;0;0;0;0;216387181;216464939;1032703
829;6.10309e-15;-29;1626;12480;12837;1;325;-2.14748e+09;-2.42841e+07;-1;0;0;0;-1;0;217104103;217183380;1049708
829;6.04373e-15;-41;1633;12347;12754;1;311;-2.14748e+09;-2.42841e+07;-1;0;0;0;-1;0;217104103;217183380;1049708
830;6.10309e-15;-29;1626;12480;12837;1;325;-2.14748e+09;-2.41324e+07;-1;0;0;0;-1;0;217818279;217899096;1066879
830;6.04373e-15;-42;1633;12347;12754;1;311;-2.14748e+09;-2.41324e+07;0;0;0;0;0;0;217818279;217899096;1066879
831;6.10309e-15;-29;1626;12480;12837;1;325;-2.14748e+09;-2.39823e+07;-1;0;0;0;-1;0;218529722;218612100;1084217
831;6.04373e-15;-43;1633;12347;12754;1;311;-2.14748e+09;-2.39823e+07;0;0;0;0;0;0;218529722;218612100;1084217
832;6.10309e-15;-29;1626;12480;12837;1;325;-2.14748e+09;-2.38337e+07;-1;0;0;0;-1;0;219238444;219322404;1101722
832;6.04373e-15;-44;1633;12347;12754;1;311;-2.14748e+09;-2.38337e+07;0;0;0;0;0;0;219238444;219322404;1101722
833;6.10309e-15;-30;1626;12480;12837;1;325;-2.14748e+09;-2.36867e+07;0;0;0;0;0;0;219944459;220030023;1119394
833;6.04373e-15;-45;1633;12347;12754;1;311;-2.14748e+09;-2.36867e+07;0;0;0;0;0;0;219944459;220030023;1119394
834;6.10309e-15;-31;1626;12480;12837;1;325;-2.14748e+09;-2.35412e+07;0;0;0;0;0;0;220647779;220734968;1137232
834;6.04373e-15;-45;1633;12347;12754;1;311;-2.14748e+09;-2.35412e+07;-1;0;0;0;-1;0;220647779;220734968;1137232
835;6.10309e-15;-32;1626;12480;12837;1;325;-2.14748e+09;-2.33972e+07;0;0;0;0;0;0;221348418;221437254;1155238
835;6.04373e-15;-46;1633;12347;12754;1;311;-2.14748e+09;-2.33972e+07;0;0;0;0;0;0;221348418;221437254;1155238
836;6.10309e-15;-32;1626;12480;12837;1;325;-2.14748e+09;-2.32547e+07;-1;0;0;0;-1;0;222046388;222136892;1173410
836;6.04373e-15;-46;1633;12347;12754;1;311;-2.14748e+09;-2.32547e+07;-1;0;0;0;-1;0;222046388;222136892;1173410
837;6.10309e-15;-33;1626;12480;12837;1;325;-2.14748e+09;-2.31136e+07;0;0;0;0;0;0;222741701;222833896;1191750
837;6.04373e-15;-47;1633;12347;12754;1;311;-2.14748e+09;-2.31136e+07;0;0;0;0;0;0;222741701;222833896;1191750
838;6.10309e-15;-33;1626;12480;12837;1;325;-2.14748e+09;-2.2974e+07;-1;0;0;0;-1;0;223434371;223528279;1210256
838;6.04373e-15;-48;1633;12347;12754;1;311;-2.14748e+09;-2.2974e+07;0;0;0;0;0;0;223434371;223528279;1210256
839;6.10309e-15;-34;1626;12480;12837;1;325;-2.14748e+09;-2.28357e+07;0;0;0;0;0;0;224124411;224220053;1228930
839;6.04373e-15;-48;1633;12347;12754;1;311;-2.14748e+09;-2.28357e+07;-1;0;0;0;-1;0;224124411;224220053;1228930
840;6.10309e-15;-34;1626;12480;12837;1;325;-2.14748e+09;-2.26989e+07;-1;0;0;0;-1;0;224811832;224909232;1247771
840;6.04373e-15;-49;1633;12347;12754;1;311;-2.14748e+09;-2.26989e+07;0;0;0;0;0;0;224811832;224909232;1247771
841;6.10309e-15;-35;1626;12480;12837;1;325;-2.14748e+09;-2.25634e+07;0;0;0;0;0;0;225496649;225595828;1266779
841;6.04373e-15;-50;1633;12347;12754;1;311;-2.14748e+09;-2.25634e+07;0;0;0;0;0;0;225496649;225595828;1266779
842;6.10309e-15;-36;1626;12480;12837;1;325;-2.14748e+09;-2.24293e+07;0;0;0;0;0;0;226178873;226279854;1285954
842;6.04373e-15;-50;1633;12347;12754;1;311;-2.14748e+09;-2.24293e+07;-1;0;0;0;-1;0;226178873;226279854;1285954
843;6.10309e-15;-37;1626;12480;12837;1;325;-2.14748e+09;-2.22966e+07;0;0;0;0;0;0;226858517;226961324;1305296
843;6.04373e-15;-50;1633;12347;12754;1;311;-2.14748e+09;-2.22966e+07;-1;0;0;0;-1;0;226858517;226961324;1305296
844;6.10309e-15;-38;1626;12480;12837;1;325;-2.14748e+09;-2.21652e+07;0;0;0;0;0;0;227535593;227640248;1324805
844;6.04373e-15;-50;1633;12347;12754;1;311;-2.14748e+09;-2.21651e+07;-1;0;0;0;-1;0;227535593;227640248;1324805
845;6.10309e-15;-38;1626;12480;12837;1;325;-2.14748e+09;-2.20349e+07;-1;0;0;0;-1;0;228210115;228316641;1344482
845;6.04373e-15;-51;1633;12347;12754;1;311;-2.14748e+09;-2.20349e+07;0;0;0;0;0;0;228210115;228316641;1344482
846;6.10309e-15;-38;1626;12480;12837;1;325;-2.14748e+09;-2.19061e+07;-1;0;0;0;-1;0;228882094;228990515;1364325
846;6.04373e-15;-51;1633;12347;12754;1;311;-2.14748e+09;-2.19061e+07;-1;0;0;0;-1;0;228882094;228990515;1364325
847;6.10309e-15;-38;1626;12480;12837;1;325;-2.14748e+09;-2.17785e+07;-1;0;0;0;-1;0;229551544;229661882;1384335
847;6.04373e-15;-52;1633;12347;12754;1;311;-2.14748e+09;-2.17785e+07;0;0;0;0;0;0;229551544;229661882;1384335
848;6.10309e-15;-38;1626;12480;12837;1;325;-2.14748e+09;-2.16522e+07;-1;0;0;0;-1;0;230218475;230330755;1404512
848;6.04373e-15;-53;1633;12347;12754;1;311;-2.14748e+09;-2.16522e+07;0;0;0;0;0;0;230218475;230330755;1404512
849;6.10309e-15;-38;1626;12480;12837;1;325;-2.14748e+09;-2.15269e+07;-1;0;0;0;-1;0;230882902;230997147;1424856
849;6.04373e-15;-54;1633;12347;12754;1;311;-2.14748e+09;-2.15269e+07;0;0;0;0;0;0;230882902;230997147;1424856
850;6.10309e-15;-39;1626;12480;12837;1;325;-2.14748e+09;-2.1403e+07;0;0;0;0;0;0;231544836;231661069;1445366
850;6.04373e-15;-55;1633;12347;12754;1;311;-2.14748e+09;-2.1403e+07;0;0;0;0;0;0;231544836;231661069;1445366
851;6.10309e-15;-40;1626;12480;12837;1;325;-2.14748e+09;-2.12802e+07;0;0;0;0;0;0;232204289;232322535;1466043
851;6.04373e-15;-55;1633;12347;12754;1;311;-2.14748e+09;-2.12802e+07;-1;0;0;0;-1;0;232204289;232322535;1466043
852;6.10309e-15;-40;1626;12480;12837;1;325;-2.14748e+09;-2.11588e+07;-1;0;0;0;-1;0;232861274;232981557;1486886
852;6.04373e-15;-56;1633;12347;12754;1;311;-2.14748e+09;-2.11588e+07;0;0;0;0;0;0;232861274;232981557;1486886
853;6.10309e-15;-40;1626;12480;12837;1;325;-2.14748e+09;-2.10383e+07;-1;0;0;0;-1;0;233515803;233638146;1507896
853;6.04373e-15;-57;1633;12347;12754;1;311;-2.14748e+09;-2.10383e+07;0;0;0;0;0;0;233515803;233638146;1507896
854;6.10309e-15;-40;1626;12480;12837;1;325;-2.14748e+09;-2.09191e+07;-1;0;0;0;-1;0;234167888;234292317;1529072
854;6.04373e-15;-58;1633;12347;12754;1;311;-2.14748e+09;-2.09191e+07;0;0;0;0;0;0;234167888;234292317;1529072
855;6.10309e-15;-41;1626;12480;12837;1;325;-2.14748e+09;-2.08009e+07;0;0;0;0;0;0;234817541;234944079;1550414
855;6.04373e-15;-59;1633;12347;12754;1;311;-2.14748e+09;-2.08009e+07;0;0;0;0;0;0;234817541;234944079;1550414
856;6.10309e-15;-41;1626;12480;12837;1;325;-2.14748e+09;-2.06839e+07;-1;0;0;0;-1;0;235464775;235593447;1571921
856;6.04373e-15;-59;1633;12347;12754;1;311;-2.14748e+09;-2.06839e+07;-1;0;0;0;-1;0;235464775;235593447;1571921
857;6.10309e-15;-41;1626;12480;12837;1;325;-2.14748e+09;-2.05679e+07;-1;0;0;0;-1;0;236109600;236240431;1593595
857;6.04373e-15;-60;1633;12347;12754;1;311;-2.14748e+09;-2.05679e+07;0;0;0;0;0;0;236109600;236240431;1593595
858;6.10309e-15;-41;1626;12480;12837;1;325;-2.14748e+09;-2.04531e+07;-1;0;0;0;-1;0;236752030;236885044;1615433
858;6.04373e-15;-60;1633;12347;12754;1;311;-2.14748e+09;-2.04531e+07;-1;0;0;0;-1;0;236752030;236885044;1615433
859;6.10309e-15;-42;1626;12480;12837;1;325;-2.14748e+09;-2.03394e+07;0;0;0;0;0;0;237392075;237527299;1637437
859;6.04373e-15;-60;1633;12347;12754;1;311;-2.14748e+09;-2.03394e+07;-1;0;0;0;-1;0;237392075;237527299;1637437
860;6.10309e-15;-43;1626;12480;12837;1;325;-2.14748e+09;-2.02268e+07;0;0;0;0;0;0;238029749;238167206;1659607
860;6.04373e-15;-61;1633;12347;12754;1;311;-2.14748e+09;-2.02268e+07;0;0;0;0;0;0;238029749;238167206;1659607
861;6.10309e-15;-43;1626;12480;12837;1;325;-2.14748e+09;-2.0115e+07;-1;0;0;0;-1;0;238665062;238804778;1681941
861;6.04373e-15;-61;1633;12347;12754;1;311;-2.14748e+09;-2.0115e+07;-1;0;0;0;-1;0;238665062;238804778;1681941
862;6.10309e-15;-43;1626;12480;12837;1;325;-2.14748e+09;-2.00044e+07;-1;0;0;0;-1;0;239298027;239440027;1704440
862;6.04373e-15;-62;1633;12347;12754;1;311;-2.14748e+09;-2.00044e+07;0;0;0;0;0;0;239298027;239440027;1704440
863;6.10309e-15;-44;1626;12480;12837;1;325;-2.14748e+09;-1.98949e+07;0;0;0;0;0;0;239928655;240072965;1727103
863;6.04373e-15;-62;1633;12347;12754;1;311;-2.14748e+09;-1.98949e+07;-1;0;0;0;-1;0;239928655;240072965;1727103
864;6.10309e-15;-45;1626;12480;12837;1;325;-2.14748e+09;-1.97863e+07;0;0;0;0;0;0;240556958;240703603;1749930
864;6.04373e-15;-62;1633;12347;12754;1;311;-2.14748e+09;-1.97862e+07;-1;0;0;0;-1;0;240556958;240703603;1749930
865;6.10309e-15;-46;1626;12480;12837;1;325;-2.14748e+09;-1.96787e+07;0;0;0;0;0;0;241182947;241331953;1772922
865;6.04373e-15;-63;1633;12347;12754;1;311;-2.14748e+09;-1.96787e+07;0;0;0;0;0;0;241182947;241331953;1772922
866;6.10309e-15;-46;1626;12480;12837;1;325;-2.14748e+09;-1.95719e+07;-1;0;0;0;-1;0;241806634;241958027;1796077
866;6.04373e-15;-63;1633;12347;12754;1;311;-2.14748e+09;-1.95719e+07;-1;0;0;0;-1;0;241806634;241958027;1796077
867;6.10309e-15;-47;1626;12480;12837;1;325;-2.14748e+09;-1.94663e+07;0;0;0;0;0;0;242428031;242581837;1819396
867;6.04373e-15;-64;1633;12347;12754;1;311;-2.14748e+09;-1.94663e+07;0;0;0;0;0;0;242428031;242581837;1819396
868;6.10309e-15;-48;1626;12480;12837;1;325;-2.14748e+09;-1.93615e+07;0;0;0;0;0;0;243047148;243203394;1842878
868;6.04373e-15;-65;1633;12347;12754;1;311;-2.14748e+09;-1.93615e+07;0;0;0;0;0;0;243047148;243203394;1842878
869;6.10309e-15;-49;1626;12480;12837;1;325;-2.14748e+09;-1.92578e+07;0;0;0;0;0;0;243663998;243822709;1866523
869;6.04373e-15;-66;1633;12347;12754;1;311;-2.14748e+09;-1.92578e+07;0;0;0;0;0;0;243663998;243822709;1866523
870;6.10309e-15;-50;1626;12480;12837;1;325;-2.14748e+09;-1.91549e+07;0;0;0;0;0;0;244278591;244439794;1890330
870;6.04373e-15;-66;1633;12347;12754;1;311;-2.14748e+09;-1.91549e+07;-1;0;0;0;-1;0;244278591;244439794;1890330
871;6.10309e-15;-50;1626;12480;12837;1;325;-2.14748e+09;-1.9053e+07;-1;0;0;0;-1;0;244890940;245054660;1914300
871;6.04373e-15;-66;1633;12347;12754;1;311;-2.14748e+09;-1.9053e+07;-1;0;0;0;-1;0;244890940;245054660;1914300
872;6.10309e-15;-51;1626;12480;12837;1;325;-2.14748e+09;-1.89519e+07;0;0;0;0;0;0;245501054;245667319;1938432
872;6.04373e-15;-66;1633;12347;12754;1;311;-2.14748e+09;-1.89519e+07;-1;0;0;0;-1;0;245501054;245667319;1938432
873;6.10309e-15;-52;1626;12480;12837;1;325;-2.14748e+09;-1.88518e+07;0;0;0;0;0;0;246108946;246277782;1962725
873;6.04373e-15;-66;1633;12347;12754;1;311;-2.14748e+09;-1.88518e+07;-1;0;0;0;-1;0;246108946;246277782;1962725
874;6.10309e-15;-52;1626;12480;12837;1;325;-2.14748e+09;-1.87526e+07;-1;0;0;0;-1;0;246714626;246886061;1987180
874;6.04373e-15;-67;1633;12347;12754;1;311;-2.14748e+09;-1.87526e+07;0;0;0;0;0;0;246714626;246886061;1987180
875;6.10309e-15;-52;1626;12480;12837;1;325;-2.14748e+09;-1.86542e+07;-1;0;0;0;-1;0;247318106;247492166;2011796
875;6.04373e-15;-67;1633;12347;12754;1;311;-2.14748e+09;-1.86542e+07;-1;0;0;0;-1;0;247318106;247492166;2011796
876;6.10309e-15;-52;1626;12480;12837;1;325;-2.14748e+09;-1.85566e+07;-1;0;0;0;-1;0;247919396;248096108;2036573
876;6.04373e-15;-68;1633;12347;12754;1;311;-2.14748e+09;-1.85566e+07;0;0;0;0;0;0;247919396;248096108;2036573
877;6.10309e-15;-53;1626;12480;12837;1;325;-2.14748e+09;-1.846e+07;0;0;0;0;0;0;248518508;248697899;2061510
877;6.04373e-15;-68;1633;12347;12754;1;311;-2.14748e+09;-1.846e+07;-1;0;0;0;-1;0;248518508;248697899;2061510
878;6.10309e-15;-54;1626;12480;12837;1;325;-2.14748e+09;-1.83641e+07;0;0;0;0;0;0;249115452;249297549;2086608
878;6.04373e-15;-68;1633;12347;12754;1;311;-2.14748e+09;-1.83641e+07;-1;0;0;0;-1;0;249115452;249297549;2086608
879;6.10309e-15;-54;1626;12480;12837;1;325;-2.14748e+09;-1.82692e+07;-1;0;0;0;-1;0;249710239;249895070;2111865
879;6.04373e-15;-69;1633;12347;12754;1;311;-2.14748e+09;-1.82692e+07;0;0;0;0;0;0;249710239;249895070;2111865
880;6.10309e-15;-55;1626;12480;12837;1;325;-2.14748e+09;-1.8175e+07;0;0;0;0;0;0;250302880;250490473;2137281
880;6.04373e-15;-70;1633;12347;12754;1;311;-2.14748e+09;-1.8175e+07;0;0;0;0;0;0;250302880;250490473;2137281
881;6.10309e-15;-55;1626;12480;12837;1;325;-2.14748e+09;-1.80816e+07;-1;0;0;0;-1;0;250893386;251083768;2162856
881;6.04373e-15;-71;1633;12347;12754;1;311;-2.14748e+09;-1.80816e+07;0;0;0;0;0;0;250893386;251083768;2162856
882;6.10309e-15;-55;1626;12480;12837;1;325;-2.14748e+09;-1.7989e+07;-1;0;0;0;-1;0;251481767;251674966;2188590
882;6.04373e-15;-72;1633;12347;12754;1;311;-2.14748e+09;-1.7989e+07;0;0;0;0;0;0;251481767;251674966;2188590
883;6.10309e-15;-55;1626;12480;12837;1;325;-2.14748e+09;-1.78972e+07;-1;0;0;0;-1;0;252068034;252264077;2214482
883;6.04373e-15;-72;1633;12347;12754;1;311;-2.14748e+09;-1.78972e+07;-1;0;0;0;-1;0;252068034;252264077;2214482
884;6.10309e-15;-55;1626;12480;12837;1;325;-2.14748e+09;-1.78062e+07;-1;0;0;0;-1;0;252652197;252851113;2240532
884;6.04373e-15;-72;1633;12347;12754;1;311;-2.14748e+09;-1.78062e+07;-1;0;0;0;-1;0;252652197;252851113;2240532
885;6.10309e-15;-55;1626;12480;12837;1;325;-2.14748e+09;-1.7716e+07;-1;0;0;0;-1;0;253234268;253436085;2266739
885;6.04373e-15;-73;1633;12347;12754;1;311;-2.14748e+09;-1.7716e+07;0;0;0;0;0;0;253234268;253436085;2266739
886;6.10309e-15;-55;1626;12480;12837;1;325;-2.14748e+09;-1.76265e+07;-1;0;0;0;-1;0;253814256;254019002;2293103
886;6.04373e-15;-73;1633;12347;12754;1;311;-2.14748e+09;-1.76265e+07;-1;0;0;0;-1;0;253814256;254019002;2293103
887;6.10309e-15;-55;1626;12480;12837;1;325;-2.14748e+09;-1.75378e+07;-1;0;0;0;-1;0;254392172;254599875;2319624
887;6.04373e-15;-74;1633;12347;12754;1;311;-2.14748e+09;-1.75378e+07;0;0;0;0;0;0;254392172;254599875;2319624
888;6.10309e-15;-55;1626;12480;12837;1;325;-2.14748e+09;-1.74498e+07;-1;0;0;0;-1;0;254968026;255178714;2346301
888;6.04373e-15;-75;1633;12347;12754;1;311;-2.14748e+09;-1.74498e+07;0;0;0;0;0;0;254968026;255178714;2346301
889;6.10309e-15;-56;1626;12480;12837;1;325;-2.14748e+09;-1.73625e+07;0;0;0;0;0;0;255541829;255755531;2373134
889;6.04373e-15;-75;1633;12347;12754;1;311;-2.14748e+09;-1.73625e+07;-1;0;0;0;-1;0;255541829;255755531;2373134
890;6.10309e-15;-56;1626;12480;12837;1;325;-2.14748e+09;-1.7276e+07;-1;0;0;0;-1;0;256113590;256330335;2400122
890;6.04373e-15;-75;1633;12347;12754;1;311;-2.14748e+09;-1.7276e+07;-1;0;0;0;-1;0;256113590;256330335;2400122
891;6.10309e-15;-56;1626;12480;12837;1;325;-2.14748e+09;-1.71903e+07;-1;0;0;0;-1;0;256683320;256903136;2427265
891;6.04373e-15;-75;1633;12347;12754;1;311;-2.14748e+09;-1.71903e+07;-1;0;0;0;-1;0;256683320;256903136;2427265
892;6.10309e-15;-57;1626;12480;12837;1;325;-2.14748e+09;-1.71052e+07;0;0;0;0;0;0;257251030;257473946;2454562
892;6.04373e-15;-76;1633;12347;12754;1;311;-2.14748e+09;-1.71052e+07;0;0;0;0;0;0;257251030;257473946;2454562
893;6.10309e-15;-58;1626;12480;12837;1;325;-2.14748e+09;-1.70207e+07;0;0;0;0;0;0;257816728;258042773;2482013
893;6.04373e-15;-76;1633;12347;12754;1;311;-2.14748e+09;-1.70207e+07;-1;0;0;0;-1;0;257816728;258042773;2482013
894;6.10309e-15;-58;1626;12480;12837;1;325;-2.14748e+09;-1.69371e+07;-1;0;0;0;-1;0;258380425;258609628;2509618
894;6.04373e-15;-77;1633;12347;12754;1;311;-2.14748e+09;-1.69371e+07;0;0;0;0;0;0;258380425;258609628;2509618
895;6.10309e-15;-58;1626;12480;12837;1;325;-2.14748e+09;-1.68541e+07;-1;0;0;0;-1;0;258942132;259174521;2537376
895;6.04373e-15;-78;1633;12347;12754;1;311;-2.14748e+09;-1.68541e+07;0;0;0;0;0;0;258942132;259174521;2537376
896;6.10309e-15;-59;1626;12480;12837;1;325;-2.14748e+09;-1.67716e+07;0;0;0;0;0;0;259501857;259737463;2565286
896;6.04373e-15;-79;1633;12347;12754;1;311;-2.14748e+09;-1.67716e+07;0;0;0;0;0;0;259501857;259737463;2565286
897;6.10309e-15;-60;1626;12480;12837;1;325;-2.14748e+09;-1.66899e+07;0;0;0;0;0;0;260059611;260298462;2593349
897;6.04373e-15;-80;1633;12347;12754;1;311;-2.14748e+09;-1.66899e+07;0;0;0;0;0;0;260059611;260298462;2593349
898;6.10309e-15;-60;1626;12480;12837;1;325;-2.14748e+09;-1.66089e+07;-1;0;0;0;-1;0;260615404;260857530;2621563
898;6.04373e-15;-80;1633;12347;12754;1;311;-2.14748e+09;-1.66089e+07;-1;0;0;0;-1;0;260615404;260857530;2621563
899;6.10309e-15;-61;1626;12480;12837;1;325;-2.14748e+09;-1.65285e+07;0;0;0;0;0;0;261169244;261414675;2649928
899;6.04373e-15;-80;1633;12347;12754;1;311;-2.14748e+09;-1.65285e+07;-1;0;0;0;-1;0;261169244;261414675;2649928
900;6.10309e-15;-62;1626;12480;12837;1;325;-2.14748e+09;-1.64488e+07;0;0;0;0;0;0;261721143;261969907;2678444
900;6.04373e-15;-80;1633;12347;12754;1;311;-2.14748e+09;-1.64488e+07;-1;0;0;0;-1;0;261721143;261969907;2678444
901;6.10309e-15;-62;1626;12480;12837;1;325;-2.14748e+09;-1.63697e+07;-1;0;0;0;-1;0;262271109;262523237;2707110
901;6.04373e-15;-81;1633;12347;12754;1;311;-2.14748e+09;-1.63697e+07;0;0;0;0;0;0;262271109;262523237;2707110
902;6.10309e-15;-63;1626;12480;12837;1;325;-2.14748e+09;-1.62913e+07;0;0;0;0;0;0;262819153;263074673;2735926
902;6.04373e-15;-81;1633;12347;12754;1;311;-2.14748e+09;-1.62913e+07;-1;0;0;0;-1;0;262819153;263074673;2735926
903;6.10309e-15;-63;1626;12480;12837;1;325;-2.14748e+09;-1.62134e+07;-1;0;0;0;-1;0;263365283;263624226;2764891
903;6.04373e-15;-81;1633;12347;12754;1;311;-2.14748e+09;-1.62134e+07;-1;0;0;0;-1;0;263365283;263624226;2764891
904;6.10309e-15;-63;1626;12480;12837;1;325;-2.14748e+09;-1.61362e+07;-1;0;0;0;-1;0;263909509;264171905;2794005
904;6.04373e-15;-82;1633;12347;12754;1;311;-2.14748e+09;-1.61362e+07;0;0;0;0;0;0;263909509;264171905;2794005
905;6.10309e-15;-63;1626;12480;12837;1;325;-2.14748e+09;-1.60596e+07;-1;0;0;0;-1;0;264451840;264717720;2823266
905;6.04373e-15;-83;1633;12347;12754;1;311;-2.14748e+09;-1.60596e+07;0;0;0;0;0;0;264451840;264717720;2823266
906;6.10309e-15;-64;1626;12480;12837;1;325;-2.14748e+09;-1.59836e+07;0;0;0;0;0;0;264992286;265261679;2852676
906;6.04373e-15;-84;1633;12347;12754;1;311;-2.14748e+09;-1.59836e+07;0;0;0;0;0;0;264992286;265261679;2852676
907;6.10309e-15;-65;1626;12480;12837;1;325;-2.14748e+09;-1.59082e+07;0;0;0;0;0;0;265530857;265803793;2882232
907;6.04373e-15;-84;1633;12347;12754;1;311;-2.14748e+09;-1.59082e+07;-1;0;0;0;-1;0;265530857;265803793;2882232
908;6.10309e-15;-65;1626;12480;12837;1;325;-2.14748e+09;-1.58334e+07;-1;0;0;0;-1;0;266067560;266344070;2911936
908;6.04373e-15;-85;1633;12347;12754;1;311;-2.14748e+09;-1.58334e+07;0;0;0;0;0;0;266067560;266344070;2911936
909;6.10309e-15;-66;1626;12480;12837;1;325;-2.14748e+09;-1.57593e+07;0;0;0;0;0;0;266602406;266882520;2941785
909;6.04373e-15;-86;1633;12347;12754;1;311;-2.14748e+09;-1.57593e+07;0;0;0;0;0;0;266602406;266882520;2941785
910;6.10309e-15;-67;1626;12480;12837;1;325;-2.14748e+09;-1.56855e+07;0;0;0;0;0;0;267135404;267419152;2971779
910;6.04373e-15;-86;1633;12347;12754;1;311;-2.14748e+09;-1.56855e+07;-1;0;0;0;-1;0;267135404;267419152;2971779
911;6.10309e-15;-68;1626;12480;12837;1;325;-2.14748e+09;-1.56124e+07;0;0;0;0;0;0;267666563;267953975;3001919
911;6.04373e-15;-86;1633;12347;12754;1;311;-2.14748e+09;-1.56124e+07;-1;0;0;0;-1;0;267666563;267953975;3001919
912;6.10309e-15;-68;1626;12480;12837;1;325;-2.14748e+09;-1.554e+07;-1;0;0;0;-1;0;268195891;268486999;3032203
912;6.04373e-15;-86;1633;12347;12754;1;311;-2.14748e+09;-1.554e+07;-1;0;0;0;-1;0;268195891;268486999;3032203
913;6.10309e-15;-69;1626;12480;12837;1;325;-2.14748e+09;-1.54679e+07;0;0;0;0;0;0;268723398;269018232;3062631
913;6.04373e-15;-86;1633;12347;12754;1;311;-2.14748e+09;-1.54679e+07;-1;0;0;0;-1;0;268723398;269018232;3062631
914;6.10309e-15;-70;1626;12480;12837;1;325;-2.14748e+09;-1.53965e+07;0;0;0;0;0;0;269249092;269547683;3093202
914;6.04373e-15;-86;1633;12347;12754;1;311;-2.14748e+09;-1.53965e+07;-1;0;0;0;-1;0;269249092;269547683;3093202
915;6.10309e-15;-70;1626;12480;12837;1;325;-2.14748e+09;-1.53256e+07;-1;0;0;0;-1;0;269772983;270075362;3123916
915;6.04373e-15;-87;1633;12347;12754;1;311;-2.14748e+09;-1.53256e+07;0;0;0;0;0;0;269772983;270075362;3123916
916;6.10309e-15;-71;1626;12480;12837;1;325;-2.14748e+09;-1.52553e+07;0;0;0;0;0;0;270295079;270601277;3154773
916;6.04373e-15;-87;1633;12347;12754;1;311;-2.14748e+09;-1.52553e+07;-1;0;0;0;-1;0;270295079;270601277;3154773
917;6.10309e-15;-72;1626;12480;12837;1;325;-2.14748e+09;-1.51855e+07;0;0;0;0;0;0;270815390;271125437;3185771
917;6.04373e-15;-87;1633;12347;12754;1;311;-2.14748e+09;-1.51855e+07;-1;0;0;0;-1;0;270815390;271125437;3185771
918;6.10309e-15;-73;1626;12480;12837;1;325;-2.14748e+09;-1.51163e+07;0;0;0;0;0;0;271333923;271647851;3216910
918;6.04373e-15;-88;1633;12347;12754;1;311;-2.14748e+09;-1.51163e+07;0;0;0;0;0;0;271333923;271647851;3216910
919;6.10309e-15;-74;1626;12480;12837;1;325;-2.14748e+09;-1.50475e+07;0;0;0;0;0;0;271850687;272168527;3248189
919;6.04373e-15;-88;1633;12347;12754;1;311;-2.14748e+09;-1.50475e+07;-1;0;0;0;-1;0;271850687;272168527;3248189
920;6.10309e-15;-74;1626;12480;12837;1;325;-2.14748e+09;-1.49792e+07;-1;0;0;0;-1;0;272365692;272687474;3279608
920;6.04373e-15;-89;1633;12347;12754;1;311;-2.14748e+09;-1.49792e+07;0;0;0;0;0;0;272365692;272687474;3279608
921;6.10309e-15;-74;1626;12480;12837;1;325;-2.14748e+09;-1.49115e+07;-1;0;0;0;-1;0;272878945;273204702;3311167
921;6.04373e-15;-89;1633;12347;12754;1;311;-2.14748e+09;-1.49115e+07;-1;0;0;0;-1;0;272878945;273204702;3311167
922;6.10309e-15;-74;1626;12480;12837;1;325;-2.14748e+09;-1.48443e+07;-1;0;0;0;-1;0;273390455;273720218;3342865
922;6.04373e-15;-90;1633;12347;12754;1;311;-2.14748e+09;-1.48443e+07;0;0;0;0;0;0;273390455;273720218;3342865
923;6.10309e-15;-74;1626;12480;12837;1;325;-2.14748e+09;-1.47776e+07;-1;0;0;0;-1;0;273900230;274234031;3374701
923;6.04373e-15;-91;1633;12347;12754;1;311;-2.14748e+09;-1.47776e+07;0;0;0;0;0;0;273900230;274234031;3374701
924;6.10309e-15;-74;1626;12480;12837;1;325;-2.14748e+09;-1.47113e+07;-1;0;0;0;-1;0;274408280;274746149;3406674
924;6.04373e-15;-92;1633;12347;12754;1;311;-2.14748e+09;-1.47113e+07;0;0;0;0;0;0;274408280;274746149;3406674
925;6.10309e-15;-75;1626;12480;12837;1;325;-2.14748e+09;-1.46457e+07;0;0;0;0;0;0;274914612;275256581;3438784
925;6.04373e-15;-93;1633;12347;12754;1;311;-2.14748e+09;-1.46457e+07;0;0;0;0;0;0;274914612;275256581;3438784
926;6.10309e-15;-75;1626;12480;12837;1;325;-2.14748e+09;-1.45803e+07;-1;0;0;0;-1;0;275419234;275765336;3471031
926;6.04373e-15;-93;1633;12347;12754;1;311;-2.14748e+09;-1.45803e+07;-1;0;0;0;-1;0;275419234;275765336;3471031
927;6.10309e-15;-76;1626;12480;12837;1;325;-2.14748e+09;-1.45156e+07;0;0;0;0;0;0;275922155;276272421;3503414
927;6.04373e-15;-94;1633;12347;12754;1;311;-2.14748e+09;-1.45156e+07;0;0;0;0;0;0;275922155;276272421;3503414
928;6.10309e-15;-76;1626;12480;12837;1;325;-2.14748e+09;-1.44514e+07;-1;0;0;0;-1;0;276423384;276777845;3535932
928;6.04373e-15;-94;1633;12347;12754;1;311;-2.14748e+09;-1.44514e+07;-1;0;0;0;-1;0;276423384;276777845;3535932
929;6.10309e-15;-77;1626;12480;12837;1;325;-2.14748e+09;-1.43874e+07;0;0;0;0;0;0;276922927;277281615;3568584
929;6.04373e-15;-95;1633;12347;12754;1;311;-2.14748e+09;-1.43874e+07;0;0;0;0;0;0;276922927;277281615;3568584
930;6.10309e-15;-78;1626;12480;12837;1;325;-2.14748e+09;-1.43241e+07;0;0;0;0;0;0;277420794;277783741;3601371
930;6.04373e-15;-95;1633;12347;12754;1;311;-2.14748e+09;-1.43241e+07;-1;0;0;0;-1;0;277420794;277783741;3601371
931;6.10309e-15;-78;1626;12480;12837;1;325;-2.14748e+09;-1.42612e+07;-1;0;0;0;-1;0;277916992;278284231;3634291
931;6.04373e-15;-95;1633;12347;12754;1;311;-2.14748e+09;-1.42612e+07;-1;0;0;0;-1;0;277916992;278284231;3634291
932;6.10309e-15;-78;1626;12480;12837;1;325;-2.14748e+09;-1.41987e+07;-1;0;0;0;-1;0;278411530;278783091;3667344
932;6.04373e-15;-95;1633;12347;12754;1;311;-2.14748e+09;-1.41987e+07;-1;0;0;0;-1;0;278411530;278783091;3667344
933;6.10309e-15;-79;1626;12480;12837;1;325;-2.14748e+09;-1.41367e+07;0;0;0;0;0;0;278904415;279280332;3700529
933;6.04373e-15;-95;1633;12347;12754;1;311;-2.14748e+09;-1.41367e+07;-1;0;0;0;-1;0;278904415;279280332;3700529
934;6.10309e-15;-79;1626;12480;12837;1;325;-2.14748e+09;-1.40752e+07;-1;0;0;0;-1;0;279395655;279775959;3733845
934;6.04373e-15;-96;1633;12347;12754;1;311;-2.14748e+09;-1.40752e+07;0;0;0;0;0;0;279395655;279775959;3733845
935;6.10309e-15;-79;1626;12480;12837;1;325;-2.14748e+09;-1.4014e+07;-1;0;0;0;-1;0;279885258;280269982;3767293
935;6.04373e-15;-97;1633;12347;12754;1;311;-2.14748e+09;-1.4014e+07;0;0;0;0;0;0;279885258;280269982;3767293
936;6.10309e-15;-80;1626;12480;12837;1;325;-2.14748e+09;-1.39534e+07;0;0;0;0;0;0;280373232;280762408;3800871
936;6.04373e-15;-98;1633;12347;12754;1;311;-2.14748e+09;-1.39534e+07;0;0;0;0;0;0;280373232;280762408;3800871
937;6.10309e-15;-80;1626;12480;12837;1;325;-2.14748e+09;-1.38932e+07;-1;0;0;0;-1;0;280859584;281253245;3834578
937;6.04373e-15;-98;1633;12347;12754;1;311;-2.14748e+09;-1.38932e+07;-1;0;0;0;-1;0;280859584;281253245;3834578
938;6.10309e-15;-81;1626;12480;12837;1;325;-2.14748e+09;-1.38333e+07;0;0;0;0;0;0;281344324;281742501;3868415
938;6.04373e-15;-99;1633;12347;12754;1;311;-2.14748e+09;-1.38333e+07;0;0;0;0;0;0;281344324;281742501;3868415
939;6.10309e-15;-82;1626;12480;12837;1;325;-2.14748e+09;-1.37739e+07;0;0;0;0;0;0;281827457;282230183;3902380
939;6.04373e-15;-99;1633;12347;12754;1;311;-2.14748e+09;-1.37739e+07;-1;0;0;0;-1;0;281827457;282230183;3902380
940;6.10309e-15;-83;1626;12480;12837;1;325;-2.14748e+09;-1.3715e+07;0;0;0;0;0;0;282308992;282716300;3936473
940;6.04373e-15;-99;1633;12347;12754;1;311;-2.14748e+09;-1.3715e+07;-1;0;0;0;-1;0;282308992;282716300;3936473
941;6.10309e-15;-83;1626;12480;12837;1;325;-2.14748e+09;-1.36564e+07;-1;0;0;0;-1;0;282788936;283200858;3970693
941;6.04373e-15;-100;1633;12347;12754;1;311;-2.14748e+09;-1.36564e+07;0;0;0;0;0;0;282788936;283200858;3970693
942;6.10309e-15;-83;1626;12480;12837;1;325;-2.14748e+09;-1.35982e+07;-1;0;0;0;-1;0;283267297;283683866;4005040
942;6.04373e-15;-100;1633;12347;12754;1;311;-2.14748e+09;-1.35982e+07;-1;0;0;0;-1;0;283267297;283683866;4005040
943;6.10309e-15;-83;1626;12480;12837;1;325;-2.14748e+09;-1.35405e+07;-1;0;0;0;-1;0;283744082;284165331;4039513
943;6.04373e-15;-101;1633;12347;12754;1;311;-2.14748e+09;-1.35405e+07;0;0;0;0;0;0;283744082;284165331;4039513
944;6.10309e-15;-83;1626;12480;12837;1;325;-2.14748e+09;-1.34831e+07;-1;0;0;0;-1;0;284219299;284645260;4074111
944;6.04373e-15;-101;1633;12347;12754;1;311;-2.14748e+09;-1.34831e+07;-1;0;0;0;-1;0;284219299;284645260;4074111
945;6.10309e-15;-83;1626;12480;12837;1;325;-2.14748e+09;-1.34263e+07;-1;0;0;0;-1;0;284692955;285123661;4108834
945;6.04373e-15;-102;1633;12347;12754;1;311;-2.14748e+09;-1.34263e+07;0;0;0;0;0;0;284692955;285123661;4108834
946;6.10309e-15;-83;1626;12480;12837;1;325;-2.14748e+09;-1.33696e+07;-1;0;0;0;-1;0;285165058;285600541;4143681
946;6.04373e-15;-102;1633;12347;12754;1;311;-2.14748e+09;-1.33696e+07;-1;0;0;0;-1;0;285165058;285600541;4143681
947;6.10309e-15;-83;1626;12480;12837;1;325;-2.14748e+09;-1.33134e+07;-1;0;0;0;-1;0;285635615;286075908;4178652
947;6.04373e-15;-103;1633;12347;12754;1;311;-2.14748e+09;-1.33134e+07;0;0;0;0;0;0;285635615;286075908;4178652
948;6.10309e-15;-84;1626;12480;12837;1;325;-2.14748e+09;-1.32577e+07;0;0;0;0;0;0;286104632;286549770;4213745
948;6.04373e-15;-103;1633;12347;12754;1;311;-2.14748e+09;-1.32577e+07;-1;0;0;0;-1;0;286104632;286549770;4213745
949;6.10309e-15;-85;1626;12480;12837;1;325;-2.14748e+09;-1.32023e+07;0;0;0;0;0;0;286572118;287022132;4248960
949;6.04373e-15;-103;1633;12347;12754;1;311;-2.14748e+09;-1.32023e+07;-1;0;0;0;-1;0;286572118;287022132;4248960
950;6.10309e-15;-85;1626;12480;12837;1;325;-2.14748e+09;-1.31473e+07;-1;0;0;0;-1;0;287038080;287493003;4284297
950;6.04373e-15;-104;1633;12347;12754;1;311;-2.14748e+09;-1.31473e+07;0;0;0;0;0;0;287038080;287493003;4284297
951;6.10309e-15;-86;1626;12480;12837;1;325;-2.14748e+09;-1.30927e+07;0;0;0;0;0;0;287502524;287962389;4319755
951;6.04373e-15;-104;1633;12347;12754;1;311;-2.14748e+09;-1.30926e+07;-1;0;0;0;-1;0;287502524;287962389;4319755
952;6.10309e-15;-87;1626;12480;12837;1;325;-2.14748e+09;-1.30384e+07;0;0;0;0;0;0;287965458;288430298;4355333
952;6.04373e-15;-105;1633;12347;12754;1;311;-2.14748e+09;-1.30384e+07;0;0;0;0;0;0;287965458;288430298;4355333
953;6.10309e-15;-87;1626;12480;12837;1;325;-2.14748e+09;-1.29846e+07;-1;0;0;0;-1;0;288426888;288896737;4391030
953;6.04373e-15;-105;1633;12347;12754;1;311;-2.14748e+09;-1.29846e+07;-1;0;0;0;-1;0;288426888;288896737;4391030
954;6.10309e-15;-87;1626;12480;12837;1;325;-2.14748e+09;-1.29309e+07;-1;0;0;0;-1;0;288886823;289361713;4426846
954;6.04373e-15;-106;1633;12347;12754;1;311;-2.14748e+09;-1.29309e+07;0;0;0;0;0;0;288886823;289361713;4426846
955;6.10309e-15;-87;1626;12480;12837;1;325;-2.14748e+09;-1.28777e+07;-1;0;0;0;-1;0;289345268;289825233;4462781
955;6.04373e-15;-107;1633;12347;12754;1;311;-2.14748e+09;-1.28777e+07;0;0;0;0;0;0;289345268;289825233;4462781
956;6.10309e-15;-88;1626;12480;12837;1;325;-2.14748e+09;-1.28249e+07;0;0;0;0;0;0;289802231;290287304;4498833
956;6.04373e-15;-107;1633;12347;12754;1;311;-2.14748e+09;-1.28249e+07;-1;0;0;0;-1;0;289802231;290287304;4498833
957;6.10309e-15;-89;1626;12480;12837;1;325;-2.14748e+09;-1.27725e+07;0;0;0;0;0;0;290257718;290747933;4535003
957;6.04373e-15;-107;1633;12347;12754;1;311;-2.14748e+09;-1.27725e+07;-1;0;0;0;-1;0;290257718;290747933;4535003
958;6.10309e-15;-89;1626;12480;12837;1;325;-2.14748e+09;-1.27203e+07;-1;0;0;0;-1;0;290711737;291207126;4571288
958;6.04373e-15;-108;1633;12347;12754;1;311;-2.14748e+09;-1.27203e+07;0;0;0;0;0;0;290711737;291207126;4571288
959;6.10309e-15;-90;1626;12480;12837;1;325;-2.14748e+09;-1.26687e+07;0;0;0;0;0;0;291164294;291664891;4607689
959;6.04373e-15;-109;1633;12347;12754;1;311;-2.14748e+09;-1.26687e+07;0;0;0;0;0;0;291164294;291664891;4607689
960;6.10309e-15;-90;1626;12480;12837;1;325;-2.14748e+09;-1.26172e+07;-1;0;0;0;-1;0;291615395;292121234;4644206
960;6.04373e-15;-109;1633;12347;12754;1;311;-2.14748e+09;-1.26172e+07;-1;0;0;0;-1;0;291615395;292121234;4644206
961;6.10309e-15;-91;1626;12480;12837;1;325;-2.14748e+09;-1.25661e+07;0;0;0;0;0;0;292065049;292576162;4680836
961;6.04373e-15;-109;1633;12347;12754;1;311;-2.14748e+09;-1.25661e+07;-1;0;0;0;-1;0;292065049;292576162;4680836
962;6.10309e-15;-92;1626;12480;12837;1;325;-2.14748e+09;-1.25153e+07;0;0;0;0;0;0;292513260;293029682;4717581
962;6.04373e-15;-109;1633;12347;12754;1;311;-2.14748e+09;-1.25153e+07;-1;0;0;0;-1;0;292513260;293029682;4717581
963;6.10309e-15;-93;1626;12480;12837;1;325;-2.14748e+09;-1.24649e+07;0;0;0;0;0;0;292960037;293481800;4754438
963;6.04373e-15;-109;1633;12347;12754;1;311;-2.14748e+09;-1.24649e+07;0;0;-1;0;0;-1;292960037;293481800;4754438
964;6.10309e-15;-93;1626;12480;12837;1;325;-2.14748e+09;-1.24148e+07;-1;0;0;0;-1;0;293405385;293932523;4791408
964;6.04373e-15;-109;1633;12347;12754;1;311;-2.14748e+09;-1.24148e+07;-1;0;0;0;-1;0;293405385;293932523;4791408
965;6.10309e-15;-94;1626;12480;12837;1;325;-2.14748e+09;-1.23652e+07;0;0;0;0;0;0;293849312;294381858;4828489
965;6.04373e-15;-109;1633;12347;12754;1;311;-2.14748e+09;-1.23652e+07;-1;0;0;0;-1;0;293849312;294381858;4828489
966;6.10309e-15;-95;1626;12480;12837;1;325;-2.14748e+09;-1.23157e+07;0;0;0;0;0;0;294291823;294829811;4865682
966;6.04373e-15;-109;1633;12347;12754;1;311;-2.14748e+09;-1.23157e+07;-1;0;0;0;-1;0;294291823;294829811;4865682
967;6.10309e-15;-96;1626;12480;12837;1;325;-2.14748e+09;-1.22665e+07;0;0;0;0;0;0;294732925;295276388;4902985
967;6.04373e-15;-109;1633;12347;12754;1;311;-2.14748e+09;-1.22665e+07;-1;0;0;0;-1;0;294732925;295276388;4902985
968;6.10309e-15;-96;1626;12480;12837;1;325;-2.14748e+09;-1.22179e+07;-1;0;0;0;-1;0;295172624;295721597;4940398
968;6.04373e-15;-109;1633;12347;12754;1;311;-2.14748e+09;-1.22179e+07;-1;0;0;0;-1;0;295172624;295721597;4940398
969;6.10309e-15;-96;1626;12480;12837;1;325;-2.14748e+09;-1.21694e+07;-1;0;0;0;-1;0;295610927;296165443;4977920
969;6.04373e-15;-109;1633;12347;12754;1;311;-2.14748e+09;-1.21694e+07;-1;0;0;0;-1;0;295610927;296165443;4977920
970;6.10309e-15;-97;1626;12480;12837;1;325;-2.14748e+09;-1.21211e+07;0;0;0;0;0;0;296047841;296607933;5015550
970;6.04373e-15;-109;1633;12347;12754;1;311;-2.14748e+09;-1.21211e+07;-1;0;0;0;-1;0;296047841;296607933;5015550
971;6.10309e-15;-98;1626;12480;12837;1;325;-2.14748e+09;-1.20733e+07;0;0;0;0;0;0;296483371;297049074;5053288
971;6.04373e-15;-109;1633;12347;12754;1;311;-2.14748e+09;-1.20733e+07;-1;0;0;0;-1;0;296483371;297049074;5053288
972;6.10309e-15;-98;1626;12480;12837;1;325;-2.14748e+09;-1.20257e+07;-1;0;0;0;-1;0;296917524;297488871;5091134
972;6.04373e-15;-109;1633;12347;12754;1;311;-2.14748e+09;-1.20257e+07;-1;0;0;0;-1;0;296917524;297488871;5091134
973;6.10309e-15;-99;1626;12480;12837;1;325;-2.14748e+09;-1.19785e+07;0;0;0;0;0;0;297350307;297927331;5129086
973;6.04373e-15;-109;1633;12347;12754;1;311;-2.14748e+09;-1.19785e+07;-1;0;0;0;-1;0;297350307;297927331;5129086
974;6.10309e-15;-100;1626;12480;12837;1;325;-2.14748e+09;-1.19316e+07;0;0;0;0;0;0;297781724;298364459;5167143
974;6.04373e-15;-109;1633;12347;12754;1;311;-2.14748e+09;-1.19316e+07;-1;0;0;0;-1;0;297781724;298364459;5167143
975;6.10309e-15;-101;1626;12480;12837;1;325;-2.14748e+09;-1.18849e+07;0;0;0;0;0;0;298211783;298800263;5205306
975;6.04373e-15;-109;1633;12347;12754;1;311;-2.14748e+09;-1.18849e+07;-1;0;0;0;-1;0;298211783;298800263;5205306
976;6.10309e-15;-101;1626;12480;12837;1;325;-2.14748e+09;-1.18386e+07;-1;0;0;0;-1;0;298640490;299234749;5243574
976;6.04373e-15;-110;1633;12347;12754;1;311;-2.14748e+09;-1.18386e+07;0;0;0;0;0;0;298640490;299234749;5243574
977;6.10309e-15;-102;1626;12480;12837;1;325;-2.14748e+09;-1.17926e+07;0;0;0;0;0;0;299067850;299667922;5281945
977;6.04373e-15;-110;1633;12347;12754;1;311;-2.14748e+09;-1.17926e+07;-1;0;0;0;-1;0;299067850;299667922;5281945
978;6.10309e-15;-103;1626;12480;12837;1;325;-2.14748e+09;-1.17468e+07;0;0;0;0;0;0;299493870;300099788;5320419
978;6.04373e-15;-110;1633;12347;12754;1;311;-2.14748e+09;-1.17468e+07;-1;0;0;0;-1;0;299493870;300099788;5320419
979;6.10309e-15;-103;1626;12480;12837;1;325;-2.14748e+09;-1.17013e+07;-1;0;0;0;-1;0;299918556;300530354;5358996
979;6.04373e-15;-110;1633;12347;12754;1;311;-2.14748e+09;-1.17013e+07;-1;0;0;0;-1;0;299918556;300530354;5358996
980;6.10309e-15;-103;1626;12480;12837;1;325;-2.14748e+09;-1.16562e+07;-1;0;0;0;-1;0;300341913;300959626;5397675
980;6.04373e-15;-111;1633;12347;12754;1;311;-2.14748e+09;-1.16562e+07;0;0;0;0;0;0;300341913;300959626;5397675
981;6.10309e-15;-104;1626;12480;12837;1;325;-2.14748e+09;-1.16113e+07;0;0;0;0;0;0;300763949;301387609;5436455
981;6.04373e-15;-111;1633;12347;12754;1;311;-2.14748e+09;-1.16113e+07;-1;0;0;0;-1;0;300763949;301387609;5436455
982;6.10309e-15;-104;1626;12480;12837;1;325;-2.14748e+09;-1.15667e+07;-1;0;0;0;-1;0;301184668;301814310;5475336
982;6.04373e-15;-111;1633;12347;12754;1;311;-2.14748e+09;-1.15667e+07;-1;0;0;0;-1;0;301184668;301814310;5475336
983;6.10309e-15;-104;1626;12480;12837;1;325;-2.14748e+09;-1.15223e+07;-1;0;0;0;-1;0;301604076;302239734;5514317
983;6.04373e-15;-112;1633;12347;12754;1;311;-2.14748e+09;-1.15223e+07;0;0;0;0;0;0;301604076;302239734;5514317
984;6.10309e-15;-105;1626;12480;12837;1;325;-2.14748e+09;-1.14782e+07;0;0;0;0;0;0;302022180;302663887;5553396
984;6.04373e-15;-113;1633;12347;12754;1;311;-2.14748e+09;-1.14782e+07;0;0;0;0;0;0;302022180;302663887;5553396
985;6.10309e-15;-105;1626;12480;12837;1;325;-2.14748e+09;-1.14344e+07;-1;0;0;0;-1;0;302438984;303086775;5592575
985;6.04373e-15;-113;1633;12347;12754;1;311;-2.14748e+09;-1.14344e+07;-1;0;0;0;-1;0;302438984;303086775;5592575
986;6.10309e-15;-106;1626;12480;12837;1;325;-2.14748e+09;-1.13909e+07;0;0;0;0;0;0;302854496;303508405;5631851
986;6.04373e-15;-113;1633;12347;12754;1;311;-2.14748e+09;-1.13909e+07;-1;0;0;0;-1;0;302854496;303508405;5631851
987;6.10309e-15;-107;1626;12480;12837;1;325;-2.14748e+09;-1.13476e+07;0;0;0;0;0;0;303268721;303928780;5671225
987;6.04373e-15;-114;1633;12347;12754;1;311;-2.14748e+09;-1.13476e+07;0;0;0;0;0;0;303268721;303928780;5671225
988;6.10309e-15;-107;1626;12480;12837;1;325;-2.14748e+09;-1.13046e+07;-1;0;0;0;-1;0;303681663;304347908;5710695
988;6.04373e-15;-115;1633;12347;12754;1;311;-2.14748e+09;-1.13046e+07;0;0;0;0;0;0;303681663;304347908;5710695
989;6.10309e-15;-107;1626;12480;12837;1;325;-2.14748e+09;-1.12619e+07;-1;0;0;0;-1;0;304093330;304765794;5750262
989;6.04373e-15;-116;1633;12347;12754;1;311;-2.14748e+09;-1.12619e+07;0;0;0;0;0;0;304093330;304765794;5750262
990;6.10309e-15;-107;1626;12480;12837;1;325;-2.14748e+09;-1.12195e+07;-1;0;0;0;-1;0;304503727;305182444;5789923
990;6.04373e-15;-116;1633;12347;12754;1;311;-2.14748e+09;-1.12195e+07;-1;0;0;0;-1;0;304503727;305182444;5789923
991;6.10309e-15;-108;1626;12480;12837;1;325;-2.14748e+09;-1.11772e+07;0;0;0;0;0;0;304912858;305597862;5829680
991;6.04373e-15;-117;1633;12347;12754;1;311;-2.14748e+09;-1.11772e+07;0;0;0;0;0;0;304912858;305597862;5829680
992;6.10309e-15;-108;1626;12480;12837;1;325;-2.14748e+09;-1.11352e+07;-1;0;0;0;-1;0;305320731;306012056;5869530
992;6.04373e-15;-118;1633;12347;12754;1;311;-2.14748e+09;-1.11352e+07;0;0;0;0;0;0;305320731;306012056;5869530
993;6.10309e-15;-109;1626;12480;12837;1;325;-2.14748e+09;-1.10935e+07;0;0;0;0;0;0;305727349;306425029;5909474
993;6.04373e-15;-118;1633;12347;12754;1;311;-2.14748e+09;-1.10935e+07;-1;0;0;0;-1;0;305727349;306425029;5909474
994;6.10309e-15;-109;1625;12480;12837;1;325;-2.14748e+09;-1.10521e+07;0;0;0;0;0;0;306132720;306836789;5949510
994;6.04373e-15;-118;1633;12347;12754;1;311;-2.14748e+09;-1.10521e+07;-1;0;0;0;-1;0;306132720;306836789;5949510
995;6.10309e-15;-109;1625;12480;12837;1;325;-2.14748e+09;-1.10109e+07;-1;0;0;0;-1;0;306536848;307247340;5989639
995;6.04373e-15;-118;1633;12347;12754;1;311;-2.14748e+09;-1.10109e+07;-1;0;0;0;-1;0;306536848;307247340;5989639
996;6.10309e-15;-110;1625;12480;12837;1;325;-2.14748e+09;-1.097e+07;0;0;0;0;0;0;306939739;307656687;6029859
996;6.04373e-15;-119;1633;12347;12754;1;311;-2.14748e+09;-1.097e+07;0;0;0;0;0;0;306939739;307656687;6029859
997;6.10309e-15;-111;1625;12480;12837;1;325;-2.14748e+09;-1.09292e+07;0;0;0;0;0;0;307341398;308064837;6070169
997;6.04373e-15;-120;1633;12347;12754;1;311;-2.14748e+09;-1.09292e+07;0;0;0;0;0;0;307341398;308064837;6070169
998;6.10309e-15;-111;1625;12480;12837;1;325;-2.14748e+09;-1.08888e+07;-1;0;0;0;-1;0;307741830;308471794;6110570
998;6.04373e-15;-120;1633;12347;12754;1;311;-2.14748e+09;-1.08888e+07;-1;0;0;0;-1;0;307741830;308471794;6110570
999;6.10309e-15;-111;1625;12480;12837;1;325;-2.14748e+09;-1.08486e+07;-1;0;0;0;-1;0;308141042;308877564;6151060
999;6.04373e-15;-120;1633;12347;12754;1;311;-2.14748e+09;-1.08486e+07;-1;0;0;0;-1;0;308141042;308877564;6151060
1000;6.10309e-15;-111;1625;12480;12837;1;325;-2.14748e+09;-1.08086e+07;-1;0;0;0;-1;0;308539037;309282152;6191639
1000;6.04373e-15;-120;1633;12347;12754;1;311;-2.14748e+09;-1.08086e+07;-1;0;0;0;-1;0;308539037;309282152;6191639
1001;6.10309e-15;-112;1625;12480;12837;1;325;-2.14748e+09;-1.07688e+07;0;0;0;0;0;0;308935822;309685563;6232307
1001;6.04373e-15;-120;1633;12347;12754;1;311;-2.14748e+09;-1.07688e+07;-1;0;0;0;-1;0;308935822;309685563;6232307
1002;6.10309e-15;-112;1625;12480;12837;1;325;-2.14748e+09;-1.07293e+07;-1;0;0;0;-1;0;309331402;310087803;6273061
1002;6.04373e-15;-120;1633;12347;12754;1;311;-2.14748e+09;-1.07293e+07;-1;0;0;0;-1;0;309331402;310087803;6273061
1003;6.10309e-15;-112;1625;12480;12837;1;325;-2.14748e+09;-1.06901e+07;-1;0;0;0;-1;0;309725781;310488877;6313903
1003;6.04373e-15;-121;1633;12347;12754;1;311;-2.14748e+09;-1.06901e+07;0;0;0;0;0;0;309725781;310488877;6313903
1004;6.10309e-15;-112;1625;12480;12837;1;325;-2.14748e+09;-1.0651e+07;-1;0;0;0;-1;0;310118966;310888790;6354831
1004;6.04373e-15;-122;1633;12347;12754;1;311;-2.14748e+09;-1.0651e+07;0;0;0;0;0;0;310118966;310888790;6354831
1005;6.10309e-15;-112;1625;12480;12837;1;325;-2.14748e+09;-1.06122e+07;-1;0;0;0;-1;0;310510961;311287548;6395845
1005;6.04373e-15;-122;1633;12347;12754;1;311;-2.14748e+09;-1.06122e+07;-1;0;0;0;-1;0;310510961;311287548;6395845
1006;6.10309e-15;-113;1625;12480;12837;1;325;-2.14748e+09;-1.05736e+07;0;0;0;0;0;0;310901771;311685154;6436943
1006;6.04373e-15;-123;1633;12347;12754;1;311;-2.14748e+09;-1.05736e+07;0;0;0;0;0;0;310901771;311685154;6436943
1007;6.10309e-15;-113;1625;12480;12837;1;325;-2.14748e+09;-1.05352e+07;-1;0;0;0;-1;0;311291402;312081615;6478126
1007;6.04373e-15;-124;1633;12347;12754;1;311;-2.14748e+09;-1.05352e+07;0;0;0;0;0;0;311291402;312081615;6478126
1008;6.10309e-15;-113;1625;12480;12837;1;325;-2.14748e+09;-1.04972e+07;-1;0;0;0;-1;0;311679858;312476935;6519392
1008;6.04373e-15;-125;1633;12347;12754;1;311;-2.14748e+09;-1.04972e+07;0;0;0;0;0;0;311679858;312476935;6519392
1009;6.10309e-15;-113;1625;12480;12837;1;325;-2.14748e+09;-1.04593e+07;-1;0;0;0;-1;0;312067145;312871120;6560742
1009;6.04373e-15;-125;1633;12347;12754;1;311;-2.14748e+09;-1.04593e+07;-1;0;0;0;-1;0;312067145;312871120;6560742
1010;6.10309e-15;-113;1625;12480;12837;1;325;-2.14748e+09;-1.04215e+07;-1;0;0;0;-1;0;312453268;313264174;6602174
1010;6.04373e-15;-125;1633;12347;12754;1;311;-2.14748e+09;-1.04215e+07;-1;0;0;0;-1;0;312453268;313264174;6602174
1011;6.10309e-15;-114;1625;12480;12837;1;325;-2.14748e+09;-1.0384e+07;0;0;0;0;0;0;312838231;313656102;6643688
1011;6.04373e-15;-126;1633;12347;12754;1;311;-2.14748e+09;-1.0384e+07;0;0;0;0;0;0;312838231;313656102;6643688
1012;6.10309e-15;-114;1625;12480;12837;1;325;-2.14748e+09;-1.03467e+07;-1;0;0;0;-1;0;313222039;314046910;6685282
1012;6.04373e-15;-126;1633;12347;12754;1;311;-2.14748e+09;-1.03467e+07;-1;0;0;0;-1;0;313222039;314046910;6685282
1013;6.10309e-15;-115;1625;12480;12837;1;325;-2.14748e+09;-1.03096e+07;0;0;0;0;0;0;313604698;314436602;6726958
1013;6.04373e-15;-126;1633;12347;12754;1;311;-2.14748e+09;-1.03096e+07;-1;0;0;0;-1;0;313604698;314436602;6726958
1014;6.10309e-15;-115;1625;12480;12837;1;325;-2.14748e+09;-1.02728e+07;-1;0;0;0;-1;0;313986212;314825184;6768713
1014;6.04373e-15;-126;1633;12347;12754;1;311;-2.14748e+09;-1.02728e+07;-1;0;0;0;-1;0;313986212;314825184;6768713
1015;6.10309e-15;-115;1625;12480;12837;1;325;-2.14748e+09;-1.02362e+07;-1;0;0;0;-1;0;314366586;315212659;6810547
1015;6.04373e-15;-127;1633;12347;12754;1;311;-2.14748e+09;-1.02362e+07;0;0;0;0;0;0;314366586;315212659;6810547
1016;6.10309e-15;-116;1625;12480;12837;1;325;-2.14748e+09;-1.01998e+07;0;0;0;0;0;0;314745826;315599033;6852460
1016;6.04373e-15;-128;1633;12347;12754;1;311;-2.14748e+09;-1.01998e+07;0;0;0;0;0;0;314745826;315599033;6852460
1017;6.10309e-15;-117;1625;12480;12837;1;325;-2.14748e+09;-1.01635e+07;0;0;0;0;0;0;315123935;315984310;6894451
1017;6.04373e-15;-129;1633;12347;12754;1;311;-2.14748e+09;-1.01635e+07;0;0;0;0;0;0;315123935;315984310;6894451
1018;6.10309e-15;-118;1625;12480;12837;1;325;-2.14748e+09;-1.01275e+07;0;0;0;0;0;0;315500919;316368496;6936520
1018;6.04373e-15;-129;1633;12347;12754;1;311;-2.14748e+09;-1.01275e+07;-1;0;0;0;-1;0;315500919;316368496;6936520
1019;6.10309e-15;-119;1625;12480;12837;1;325;-2.14748e+09;-1.00917e+07;0;0;0;0;0;0;315876782;316751595;6978665
1019;6.04373e-15;-129;1633;12347;12754;1;311;-2.14748e+09;-1.00917e+07;-1;0;0;0;-1;0;315876782;316751595;6978665
1020;6.10309e-15;-120;1625;12480;12837;1;325;-2.14748e+09;-1.00561e+07;0;0;0;0;0;0;316251529;317133611;7020886
1020;6.04373e-15;-130;1633;12347;12754;1;311;-2.14748e+09;-1.00561e+07;0;0;0;0;0;0;316251529;317133611;7020886
1021;6.10309e-15;-121;1625;12480;12837;1;325;-2.14748e+09;-1.00207e+07;0;0;0;0;0;0;316625164;317514550;7063183
1021;6.04373e-15;-131;1633;12347;12754;1;311;-2.14748e+09;-1.00207e+07;0;0;0;0;0;0;316625164;317514550;7063183
1022;6.10309e-15;-121;1625;12480;12837;1;325;-2.14748e+09;-9.98552e+06;-1;0;0;0;-1;0;316997693;317894416;7105554
1022;6.04373e-15;-131;1633;12347;12754;1;311;-2.14748e+09;-9.98552e+06;-1;0;0;0;-1;0;316997693;317894416;7105554
1023;6.10309e-15;-121;1625;12480;12837;1;325;-2.14748e+09;-9.95051e+06;-1;0;0;0;-1;0;317369120;318273214;7148000
1023;6.04373e-15;-131;1633;12347;12754;1;311;-2.14748e+09;-9.95051e+06;-1;0;0;0;-1;0;317369120;318273214;7148000
1024;6.10309e-15;-122;1625;12480;12837;1;325;-2.14748e+09;-9.9157e+06;0;0;0;0;0;0;317739450;318650948;7190519
1024;6.04373e-15;-132;1633;12347;12754;1;311;-2.14748e+09;-9.9157e+06;0;0;0;0;0;0;317739450;318650948;7190519
1025;6.10309e-15;-122;1625;12480;12837;1;325;-2.14748e+09;-9.88108e+06;-1;0;0;0;-1;0;318108687;319027623;7233112
1025;6.04373e-15;-133;1633;12347;12754;1;311;-2.14748e+09;-9.88108e+06;0;0;0;0;0;0;318108687;319027623;7233112
1026;6.10309e-15;-123;1625;12480;12837;1;325;-2.14748e+09;-9.84666e+06;0;0;0;0;0;0;318476836;319403243;7275777
1026;6.04373e-15;-133;1633;12347;12754;1;311;-2.14748e+09;-9.84666e+06;-1;0;0;0;-1;0;318476836;319403243;7275777
1027;6.10309e-15;-124;1625;12480;12837;1;325;-2.14748e+09;-9.81242e+06;0;0;0;0;0;0;318843901;319777813;7318513
1027;6.04373e-15;-134;1633;12347;12754;1;311;-2.14748e+09;-9.81242e+06;0;0;0;0;0;0;318843901;319777813;7318513
1028;6.10309e-15;-125;1625;12480;12837;1;325;-2.14748e+09;-9.77838e+06;0;0;0;0;0;0;319209887;320151337;7361321
1028;6.04373e-15;-134;1633;12347;12754;1;311;-2.14748e+09;-9.77838e+06;-1;0;0;0;-1;0;319209887;320151337;7361321
1029;6.10309e-15;-126;1625;12480;12837;1;325;-2.14748e+09;-9.74452e+06;0;0;0;0;0;0;319574798;320523820;7404199
1029;6.04373e-15;-134;1633;12347;12754;1;311;-2.14748e+09;-9.74452e+06;-1;0;0;0;-1;0;319574798;320523820;7404199
1030;6.10309e-15;-126;1625;12480;12837;1;325;-2.14748e+09;-9.71095e+06;-1;0;0;0;-1;0;319938639;320895267;7447147
1030;6.04373e-15;-135;1633;12347;12754;1;311;-2.14748e+09;-9.71095e+06;0;0;0;0;0;0;319938639;320895267;7447147
1031;6.10309e-15;-126;1625;12480;12837;1;325;-2.14748e+09;-9.67736e+06;-1;0;0;0;-1;0;320301414;321265681;7490164
1031;6.04373e-15;-135;1633;12347;12754;1;311;-2.14748e+09;-9.67736e+06;-1;0;0;0;-1;0;320301414;321265681;7490164
1032;6.10309e-15;-126;1625;12480;12837;1;325;-2.14748e+09;-9.64416e+06;-1;0;0;0;-1;0;320663127;321635067;7533251
1032;6.04373e-15;-135;1633;12347;12754;1;311;-2.14748e+09;-9.64416e+06;-1;0;0;0;-1;0;320663127;321635067;7533251
1033;6.10309e-15;-126;1625;12480;12837;1;325;-2.14748e+09;-9.61104e+06;-1;0;0;0;-1;0;321023784;322003429;7576405
1033;6.04373e-15;-135;1633;12347;12754;1;311;-2.14748e+09;-9.61104e+06;-1;0;0;0;-1;0;321023784;322003429;7576405
1034;6.10309e-15;-127;1625;12480;12837;1;325;-2.14748e+09;-9.578e+06;0;0;0;0;0;0;321383388;322370772;7619627
1034;6.04373e-15;-135;1633;12347;12754;1;311;-2.14748e+09;-9.578e+06;-1;0;0;0;-1;0;321383388;322370772;7619627
1035;6.10309e-15;-128;1625;12480;12837;1;325;-2.14748e+09;-9.54524e+06;0;0;0;0;0;0;321741944;322737100;7662915
1035;6.04373e-15;-136;1633;12347;12754;1;311;-2.14748e+09;-9.54524e+06;0;0;0;0;0;0;321741944;322737100;7662915
1036;6.10309e-15;-128;1625;12480;12837;1;325;-2.14748e+09;-9.51266e+06;-1;0;0;0;-1;0;322099455;323102417;7706270
1036;6.04373e-15;-137;1633;12347;12754;1;311;-2.14748e+09;-9.51266e+06;0;0;0;0;0;0;322099455;323102417;7706270
1037;6.10309e-15;-128;1625;12480;12837;1;325;-2.14748e+09;-9.48025e+06;-1;0;0;0;-1;0;322455927;323466728;7749691
1037;6.04373e-15;-138;1633;12347;12754;1;311;-2.14748e+09;-9.48025e+06;0;0;0;0;0;0;322455927;323466728;7749691
1038;6.10309e-15;-128;1625;12480;12837;1;325;-2.14748e+09;-9.44802e+06;-1;0;0;0;-1;0;322811363;323830036;7793176
1038;6.04373e-15;-138;1633;12347;12754;1;311;-2.14748e+09;-9.44802e+06;-1;0;0;0;-1;0;322811363;323830036;7793176
1039;6.10309e-15;-128;1625;12480;12837;1;325;-2.14748e+09;-9.41606e+06;-1;0;0;0;-1;0;323165768;324192347;7836727
1039;6.04373e-15;-139;1633;12347;12754;1;311;-2.14748e+09;-9.41606e+06;0;0;0;0;0;0;323165768;324192347;7836727
1040;6.10309e-15;-129;1625;12480;12837;1;325;-2.14748e+09;-9.38407e+06;0;0;0;0;0;0;323519146;324553663;7880341
1040;6.04373e-15;-140;1633;12347;12754;1;311;-2.14748e+09;-9.38407e+06;0;0;0;0;0;0;323519146;324553663;7880341
1041;6.10309e-15;-129;1625;12480;12837;1;325;-2.14748e+09;-9.35236e+06;-1;0;0;0;-1;0;323871501;324913990;7924018
1041;6.04373e-15;-140;1633;12347;12754;1;311;-2.14748e+09;-9.35236e+06;-1;0;0;0;-1;0;323871501;324913990;7924018
1042;6.10309e-15;-130;1625;12480;12837;1;325;-2.14748e+09;-9.32081e+06;0;0;0;0;0;0;324222837;325273331;7967758
1042;6.04373e-15;-141;1633;12347;12754;1;311;-2.14748e+09;-9.32081e+06;0;0;0;0;0;0;324222837;325273331;7967758
1043;6.10309e-15;-130;1625;12480;12837;1;325;-2.14748e+09;-9.28943e+06;-1;0;0;0;-1;0;324573159;325631690;8011560
1043;6.04373e-15;-141;1633;12347;12754;1;311;-2.14748e+09;-9.28943e+06;-1;0;0;0;-1;0;324573159;325631690;8011560
1044;6.10309e-15;-131;1625;12480;12837;1;325;-2.14748e+09;-9.25822e+06;0;0;0;0;0;0;324922470;325989072;8055424
1044;6.04373e-15;-141;1633;12347;12754;1;311;-2.14748e+09;-9.25822e+06;-1;0;0;0;-1;0;324922470;325989072;8055424
1045;6.10309e-15;-131;1625;12480;12837;1;325;-2.14748e+09;-9.22718e+06;-1;0;0;0;-1;0;325270774;326345481;8099349
1045;6.04373e-15;-141;1633;12347;12754;1;311;-2.14748e+09;-9.22718e+06;-1;0;0;0;-1;0;325270774;326345481;8099349
1046;6.10309e-15;-132;1625;12480;12837;1;325;-2.14748e+09;-9.1963e+06;0;0;0;0;0;0;325618077;326700920;8143334
1046;6.04373e-15;-141;1633;12347;12754;1;311;-2.14748e+09;-9.1963e+06;-1;0;0;0;-1;0;325618077;326700920;8143334
1047;6.10309e-15;-132;1625;12480;12837;1;325;-2.14748e+09;-9.16558e+06;-1;0;0;0;-1;0;325964381;327055394;8187379
1047;6.04373e-15;-141;1633;12347;12754;1;311;-2.14748e+09;-9.16558e+06;-1;0;0;0;-1;0;325964381;327055394;8187379
1048;6.10309e-15;-132;1625;12480;12837;1;325;-2.14748e+09;-9.13502e+06;-1;0;0;0;-1;0;326309691;327408906;8231483
1048;6.04373e-15;-141;1633;12347;12754;1;311;-2.14748e+09;-9.13502e+06;-1;0;0;0;-1;0;326309691;327408906;8231483
1049;6.10309e-15;-133;1625;12480;12837;1;325;-2.14748e+09;-9.10463e+06;0;0;0;0;0;0;326654010;327761461;8275646
1049;6.04373e-15;-142;1633;12347;12754;1;311;-2.14748e+09;-9.10463e+06;0;0;0;0;0;0;326654010;327761461;8275646
1050;6.10309e-15;-133;1625;12480;12837;1;325;-2.14748e+09;-9.07439e+06;-1;0;0;0;-1;0;326997343;328113063;8319866
1050;6.04373e-15;-142;1633;12347;12754;1;311;-2.14748e+09;-9.07439e+06;-1;0;0;0;-1;0;326997343;328113063;8319866
1051;6.10309e-15;-133;1625;12480;12837;1;325;-2.14748e+09;-9.04441e+06;-1;0;0;0;-1;0;327339694;328463715;8364145
1051;6.04373e-15;-142;1633;12347;12754;1;311;-2.14748e+09;-9.04441e+06;-1;0;0;0;-1;0;327339694;328463715;8364145
1052;6.10309e-15;-134;1625;12480;12837;1;325;-2.14748e+09;-9.01439e+06;0;0;0;0;0;0;327681067;328813421;8408480
1052;6.04373e-15;-143;1633;12347;12754;1;311;-2.14748e+09;-9.01439e+06;0;0;0;0;0;0;327681067;328813421;8408480
1053;6.10309e-15;-135;1625;12480;12837;1;325;-2.14748e+09;-8.98462e+06;0;0;0;0;0;0;328021465;329162185;8452871
1053;6.04373e-15;-143;1633;12347;12754;1;311;-2.14748e+09;-8.98462e+06;-1;0;0;0;-1;0;328021465;329162185;8452871
1054;6.10309e-15;-136;1625;12480;12837;1;325;-2.14748e+09;-8.95501e+06;0;0;0;0;0;0;328360892;329510012;8497318
1054;6.04373e-15;-144;1633;12347;12754;1;311;-2.14748e+09;-8.95501e+06;0;0;0;0;0;0;328360892;329510012;8497318
1055;6.10309e-15;-137;1625;12480;12837;1;325;-2.14748e+09;-8.92556e+06;0;0;0;0;0;0;328699352;329856904;8541821
1055;6.04373e-15;-144;1633;12347;12754;1;311;-2.14748e+09;-8.92556e+06;-1;0;0;0;-1;0;328699352;329856904;8541821
1056;6.10309e-15;-137;1625;12480;12837;1;325;-2.14748e+09;-8.89625e+06;-1;0;0;0;-1;0;329036850;330202866;8586378
1056;6.04373e-15;-144;1633;12347;12754;1;311;-2.14748e+09;-8.89625e+06;-1;0;0;0;-1;0;329036850;330202866;8586378
1057;6.10309e-15;-137;1625;12480;12837;1;325;-2.14748e+09;-8.8671e+06;-1;0;0;0;-1;0;329373389;330547901;8630989
1057;6.04373e-15;-144;1633;12347;12754;1;311;-2.14748e+09;-8.8671e+06;-1;0;0;0;-1;0;329373389;330547901;8630989
1058;6.10309e-15;-138;1625;12480;12837;1;325;-2.14748e+09;-8.83809e+06;0;0;0;0;0;0;329708972;330892014;8675653
1058;6.04373e-15;-144;1633;12347;12754;1;311;-2.14748e+09;-8.83809e+06;-1;0;0;0;-1;0;329708972;330892014;8675653
1059;6.10309e-15;-138;1625;12480;12837;1;325;-2.14748e+09;-8.80934e+06;-1;0;0;0;-1;0;330043604;331235207;8720370
1059;6.04373e-15;-144;1633;12347;12754;1;311;-2.14748e+09;-8.80934e+06;-1;0;0;0;-1;0;330043604;331235207;8720370
1060;6.10309e-15;-138;1625;12480;12837;1;325;-2.14748e+09;-8.78053e+06;-1;0;0;0;-1;0;330377288;331577485;8765140
1060;6.04373e-15;-145;1633;12347;12754;1;311;-2.14748e+09;-8.78053e+06;0;0;0;0;0;0;330377288;331577485;8765140
1061;6.10309e-15;-138;1625;12480;12837;1;325;-2.14748e+09;-8.75197e+06;-1;0;0;0;-1;0;330710029;331918851;8809962
1061;6.04373e-15;-146;1633;12347;12754;1;311;-2.14748e+09;-8.75197e+06;0;0;0;0;0;0;330710029;331918851;8809962
1062;6.10309e-15;-138;1625;12480;12837;1;325;-2.14748e+09;-8.72355e+06;-1;0;0;0;-1;0;331041828;332259309;8854835
1062;6.04373e-15;-147;1633;12347;12754;1;311;-2.14748e+09;-8.72355e+06;0;0;0;0;0;0;331041828;332259309;8854835
1063;6.10309e-15;-139;1625;12480;12837;1;325;-2.14748e+09;-8.69538e+06;0;0;0;0;0;0;331372692;332598863;8899758
1063;6.04373e-15;-147;1633;12347;12754;1;311;-2.14748e+09;-8.69538e+06;-1;0;0;0;-1;0;331372692;332598863;8899758
1064;6.10309e-15;-139;1625;12480;12837;1;325;-2.14748e+09;-8.66715e+06;-1;0;0;0;-1;0;331702622;332937516;8944732
1064;6.04373e-15;-148;1633;12347;12754;1;311;-2.14748e+09;-8.66715e+06;0;0;0;0;0;0;331702622;332937516;8944732
1065;6.10309e-15;-140;1625;12480;12837;1;325;-2.14748e+09;-8.63917e+06;0;0;0;0;0;0;332031624;333275272;8989755
1065;6.04373e-15;-149;1633;12347;12754;1;311;-2.14748e+09;-8.63917e+06;0;0;0;0;0;0;332031624;333275272;8989755
1066;6.10309e-15;-140;1625;12480;12837;1;325;-2.14748e+09;-8.61142e+06;-1;0;0;0;-1;0;332359699;333612135;9034827
1066;6.04373e-15;-149;1633;12347;12754;1;311;-2.14748e+09;-8.61142e+06;-1;0;0;0;-1;0;332359699;333612135;9034827
1067;6.10309e-15;-141;1625;12480;12837;1;325;-2.14748e+09;-8.58362e+06;0;0;0;0;0;0;332686853;333948107;9079948
1067;6.04373e-15;-150;1633;12347;12754;1;311;-2.14748e+09;-8.58362e+06;0;0;0;0;0;0;332686853;333948107;9079948
1068;6.10309e-15;-142;1625;12480;12837;1;325;-2.14748e+09;-8.55606e+06;0;0;0;0;0;0;333013088;334283193;9125117
1068;6.04373e-15;-151;1633;12347;12754;1;311;-2.14748e+09;-8.55606e+06;0;0;0;0;0;0;333013088;334283193;9125117
1069;6.10309e-15;-142;1625;12480;12837;1;325;-2.14748e+09;-8.52863e+06;-1;0;0;0;-1;0;333338409;334617397;9170333
1069;6.04373e-15;-151;1633;12347;12754;1;311;-2.14748e+09;-8.52863e+06;-1;0;0;0;-1;0;333338409;334617397;9170333
1070;6.10309e-15;-142;1625;12480;12837;1;325;-2.14748e+09;-8.50144e+06;-1;0;0;0;-1;0;333662818;334950720;9215596
1070;6.04373e-15;-151;1633;12347;12754;1;311;-2.14748e+09;-8.50144e+06;-1;0;0;0;-1;0;333662818;334950720;9215596
1071;6.10309e-15;-142;1625;12480;12837;1;325;-2.14748e+09;-8.47419e+06;-1;0;0;0;-1;0;333986320;335283168;9260905
1071;6.04373e-15;-152;1633;12347;12754;1;311;-2.14748e+09;-8.47419e+06;0;0;0;0;0;0;333986320;335283168;9260905
1072;6.10309e-15;-143;1625;12480;12837;1;325;-2.14748e+09;-8.44717e+06;0;0;0;0;0;0;334308917;335614744;9306260
1072;6.04373e-15;-152;1633;12347;12754;1;311;-2.14748e+09;-8.44717e+06;-1;0;0;0;-1;0;334308917;335614744;9306260
1073;6.10309e-15;-144;1625;12480;12837;1;325;-2.14748e+09;-8.42028e+06;0;0;0;0;0;0;334630614;335945450;9351661
1073;6.04373e-15;-153;1633;12347;12754;1;311;-2.14748e+09;-8.42028e+06;0;0;0;0;0;0;334630614;335945450;9351661
1074;6.10309e-15;-144;1625;12480;12837;1;325;-2.14748e+09;-8.39354e+06;-1;0;0;0;-1;0;334951413;336275291;9397106
1074;6.04373e-15;-153;1633;12347;12754;1;311;-2.14748e+09;-8.39354e+06;-1;0;0;0;-1;0;334951413;336275291;9397106
1075;6.10309e-15;-145;1625;12480;12837;1;325;-2.14748e+09;-8.36702e+06;0;0;0;0;0;0;335271319;336604270;9442595
1075;6.04373e-15;-153;1633;12347;12754;1;311;-2.14748e+09;-8.36702e+06;-1;0;0;0;-1;0;335271319;336604270;9442595
1076;6.10309e-15;-146;1625;12480;12837;1;325;-2.14748e+09;-8.34043e+06;0;0;0;0;0;0;335590335;336932390;9488128
1076;6.04373e-15;-153;1633;12347;12754;1;311;-2.14748e+09;-8.34043e+06;-1;0;0;0;-1;0;335590335;336932390;9488128
1077;6.10309e-15;-146;1625;12480;12837;1;325;-2.14748e+09;-8.31407e+06;-1;0;0;0;-1;0;335908463;337259654;9533704
1077;6.04373e-15;-153;1633;12347;12754;1;311;-2.14748e+09;-8.31407e+06;-1;0;0;0;-1;0;335908463;337259654;9533704
1078;6.10309e-15;-146;1625;12480;12837;1;325;-2.14748e+09;-8.28785e+06;-1;0;0;0;-1;0;336225709;337586067;9579323
1078;6.04373e-15;-154;1633;12347;12754;1;311;-2.14748e+09;-8.28785e+06;0;0;0;0;0;0;336225709;337586067;9579323
1079;6.10309e-15;-146;1625;12480;12837;1;325;-2.14748e+09;-8.26175e+06;-1;0;0;0;-1;0;336542074;337911631;9624983
1079;6.04373e-15;-154;1633;12347;12754;1;311;-2.14748e+09;-8.26175e+06;-1;0;0;0;-1;0;336542074;337911631;9624983
1080;6.10309e-15;-146;1625;12480;12837;1;325;-2.14748e+09;-8.23578e+06;-1;0;0;0;-1;0;336857563;338236349;9670686
1080;6.04373e-15;-154;1633;12347;12754;1;311;-2.14748e+09;-8.23578e+06;-1;0;0;0;-1;0;336857563;338236349;9670686
1081;6.10309e-15;-147;1625;12480;12837;1;325;-2.14748e+09;-8.20994e+06;0;0;0;0;0;0;337172178;338560226;9716429
1081;6.04373e-15;-155;1633;12347;12754;1;311;-2.14748e+09;-8.20994e+06;0;0;0;0;0;0;337172178;338560226;9716429
1082;6.10309e-15;-147;1625;12480;12837;1;325;-2.14748e+09;-8.18422e+06;-1;0;0;0;-1;0;337485923;338883263;9762213
1082;6.04373e-15;-156;1633;12347;12754;1;311;-2.14748e+09;-8.18422e+06;0;0;0;0;0;0;337485923;338883263;9762213
1083;6.10309e-15;-148;1625;12480;12837;1;325;-2.14748e+09;-8.15862e+06;0;0;0;0;0;0;337798802;339205465;9808037
1083;6.04373e-15;-156;1633;12347;12754;1;311;-2.14748e+09;-8.15862e+06;-1;0;0;0;-1;0;337798802;339205465;9808037
1084;6.10309e-15;-149;1625;12480;12837;1;325;-2.14748e+09;-8.13316e+06;0;0;0;0;0;0;338110817;339526835;9853900
1084;6.04373e-15;-156;1633;12347;12754;1;311;-2.14748e+09;-8.13316e+06;-1;0;0;0;-1;0;338110817;339526835;9853900
1085;6.10309e-15;-150;1625;12480;12837;1;325;-2.14748e+09;-8.10781e+06;0;0;0;0;0;0;338421972;339847375;9899802
1085;6.04373e-15;-157;1633;12347;12754;1;311;-2.14748e+09;-8.10781e+06;0;0;0;0;0;0;338421972;339847375;9899802
1086;6.10309e-15;-151;1625;12480;12837;1;325;-2.14748e+09;-8.08258e+06;0;0;0;0;0;0;338732271;340167090;9945743
1086;6.04373e-15;-158;1633;12347;12754;1;311;-2.14748e+09;-8.08258e+06;0;0;0;0;0;0;338732271;340167090;9945743
1087;6.10309e-15;-152;1625;12480;12837;1;325;-2.14748e+09;-8.05758e+06;0;0;0;0;0;0;339041716;340485982;9991722
1087;6.04373e-15;-159;1633;12347;12754;1;311;-2.14748e+09;-8.05758e+06;0;0;0;0;0;0;339041716;340485982;9991722
1088;6.10309e-15;-152;1625;12480;12837;1;325;-2.14748e+09;-8.0325e+06;-1;0;0;0;-1;0;339350310;340804054;10037738
1088;6.04373e-15;-159;1633;12347;12754;1;311;-2.14748e+09;-8.0325e+06;-1;0;0;0;-1;0;339350310;340804054;10037738
1089;6.10309e-15;-152;1625;12480;12837;1;325;-2.14748e+09;-8.00764e+06;-1;0;0;0;-1;0;339658057;341121310;10083791
1089;6.04373e-15;-160;1633;12347;12754;1;311;-2.14748e+09;-8.00764e+06;0;0;0;0;0;0;339658057;341121310;10083791
1090;6.10309e-15;-153;1625;12480;12837;1;325;-2.14748e+09;-7.9829e+06;0;0;0;0;0;0;339964961;341437753;10129881
1090;6.04373e-15;-160;1633;12347;12754;1;311;-2.14748e+09;-7.9829e+06;-1;0;0;0;-1;0;339964961;341437753;10129881
1091;6.10309e-15;-153;1625;12480;12837;1;325;-2.14748e+09;-7.95827e+06;-1;0;0;0;-1;0;340271024;341753386;10176006
1091;6.04373e-15;-161;1633;12347;12754;1;311;-2.14748e+09;-7.95827e+06;0;0;0;0;0;0;340271024;341753386;10176006
1092;6.10309e-15;-154;1625;12480;12837;1;325;-2.14748e+09;-7.93376e+06;0;0;0;0;0;0;340576249;342068211;10222167
1092;6.04373e-15;-161;1633;12347;12754;1;311;-2.14748e+09;-7.93376e+06;-1;0;0;0;-1;0;340576249;342068211;10222167
1093;6.10309e-15;-155;1625;12480;12837;1;325;-2.14748e+09;-7.90937e+06;0;0;0;0;0;0;340880640;342382233;10268363
1093;6.04373e-15;-161;1633;12347;12754;1;311;-2.14748e+09;-7.90937e+06;-1;0;0;0;-1;0;340880640;342382233;10268363
1094;6.10309e-15;-155;1625;12480;12837;1;325;-2.14748e+09;-7.8851e+06;-1;0;0;0;-1;0;341184199;342695454;10314594
1094;6.04373e-15;-162;1633;12347;12754;1;311;-2.14748e+09;-7.8851e+06;0;0;0;0;0;0;341184199;342695454;10314594
1095;6.10309e-15;-156;1625;12480;12837;1;325;-2.14748e+09;-7.86094e+06;0;0;0;0;0;0;341486930;343007877;10360858
1095;6.04373e-15;-162;1633;12347;12754;1;311;-2.14748e+09;-7.86094e+06;-1;0;0;0;-1;0;341486930;343007877;10360858
1096;6.10309e-15;-157;1625;12480;12837;1;325;-2.14748e+09;-7.83689e+06;0;0;0;0;0;0;341788837;343319505;10407156
1096;6.04373e-15;-162;1633;12347;12754;1;311;-2.14748e+09;-7.83689e+06;-1;0;0;0;-1;0;341788837;343319505;10407156
1097;6.10309e-15;-158;1625;12480;12837;1;325;-2.14748e+09;-7.81296e+06;0;0;0;0;0;0;342089921;343630341;10453487
1097;6.04373e-15;-163;1633;12347;12754;1;311;-2.14748e+09;-7.81296e+06;0;0;0;0;0;0;342089921;343630341;10453487
1098;6.10309e-15;-158;1625;12480;12837;1;325;-2.14748e+09;-7.78914e+06;-1;0;0;0;-1;0;342390186;343940389;10499850
1098;6.04373e-15;-163;1633;12347;12754;1;311;-2.14748e+09;-7.78914e+06;-1;0;0;0;-1;0;342390186;343940389;10499850
1099;6.10309e-15;-159;1625;12480;12837;1;325;-2.14748e+09;-7.76543e+06;0;0;0;0;0;0;342689636;344249650;10546245
1099;6.04373e-15;-164;1633;12347;12754;1;311;-2.14748e+09;-7.76543e+06;0;0;0;0;0;0;342689636;344249650;10546245
1100;6.10309e-15;-160;1625;12480;12837;1;325;-2.14748e+09;-7.74183e+06;0;0;0;0;0;0;342988272;344558129;10592672
1100;6.04373e-15;-165;1633;12347;12754;1;311;-2.14748e+09;-7.74183e+06;0;0;0;0;0;0;342988272;344558129;10592672
1101;6.10309e-15;-160;1625;12480;12837;1;325;-2.14748e+09;-7.71834e+06;-1;0;0;0;-1;0;343286099;344865828;10639130
1101;6.04373e-15;-165;1633;12347;12754;1;311;-2.14748e+09;-7.71834e+06;-1;0;0;0;-1;0;343286099;344865828;10639130
1102;6.10309e-15;-160;1625;12480;12837;1;325;-2.14748e+09;-7.69496e+06;-1;0;0;0;-1;0;343583119;345172750;10685619
1102;6.04373e-15;-165;1633;12347;12754;1;311;-2.14748e+09;-7.69496e+06;-1;0;0;0;-1;0;343583119;345172750;10685619
1103;6.10309e-15;-160;1625;12480;12837;1;325;-2.14748e+09;-7.67169e+06;-1;0;0;0;-1;0;343879335;345478898;10732137
1103;6.04373e-15;-166;1633;12347;12754;1;311;-2.14748e+09;-7.67169e+06;0;0;0;0;0;0;343879335;345478898;10732137
1104;6.10309e-15;-160;1625;12480;12837;1;325;-2.14748e+09;-7.64853e+06;-1;0;0;0;-1;0;344174750;345784275;10778685
1104;6.04373e-15;-166;1633;12347;12754;1;311;-2.14748e+09;-7.64853e+06;-1;0;0;0;-1;0;344174750;345784275;10778685
1105;6.10309e-15;-160;1625;12480;12837;1;325;-2.14748e+09;-7.62547e+06;-1;0;0;0;-1;0;344469367;346088884;10825263
1105;6.04373e-15;-167;1633;12347;12754;1;311;-2.14748e+09;-7.62547e+06;0;0;0;0;0;0;344469367;346088884;10825263
1106;6.10309e-15;-160;1625;12480;12837;1;325;-2.14748e+09;-7.60252e+06;-1;0;0;0;-1;0;344763189;346392727;10871869
1106;6.04373e-15;-168;1633;12347;12754;1;311;-2.14748e+09;-7.60253e+06;0;0;0;0;0;0;344763189;346392727;10871869
1107;6.10309e-15;-161;1625;12480;12837;1;325;-2.14748e+09;-7.57968e+06;0;0;0;0;0;0;345056220;346695807;10918503
1107;6.04373e-15;-169;1633;12347;12754;1;311;-2.14748e+09;-7.57968e+06;0;0;0;0;0;0;345056220;346695807;10918503
1108;6.10309e-15;-161;1625;12480;12837;1;325;-2.14748e+09;-7.55694e+06;-1;0;0;0;-1;0;345348461;346998128;10965165
1108;6.04373e-15;-170;1633;12347;12754;1;311;-2.14748e+09;-7.55695e+06;0;0;0;0;0;0;345348461;346998128;10965165
1109;6.10309e-15;-161;1625;12480;12837;1;325;-2.14748e+09;-7.53441e+06;-1;0;0;0;-1;0;345639916;347299692;11011854
1109;6.04373e-15;-171;1633;12347;12754;1;311;-2.14748e+09;-7.53441e+06;0;0;0;0;0;0;345639916;347299692;11011854
1110;6.10309e-15;-162;1625;12480;12837;1;325;-2.14748e+09;-7.51178e+06;0;0;0;0;0;0;345930587;347600502;11058571
1110;6.04373e-15;-171;1633;12347;12754;1;311;-2.14748e+09;-7.51178e+06;-1;0;0;0;-1;0;345930587;347600502;11058571
1111;6.10309e-15;-162;1625;12480;12837;1;325;-2.14748e+09;-7.48935e+06;-1;0;0;0;-1;0;346220478;347900561;11105313
1111;6.04373e-15;-172;1633;12347;12754;1;311;-2.14748e+09;-7.48936e+06;0;0;0;0;0;0;346220478;347900561;11105313
1112;6.10309e-15;-162;1625;12480;12837;1;325;-2.14748e+09;-7.46713e+06;-1;0;0;0;-1;0;346509591;348199871;11152081
1112;6.04373e-15;-172;1633;12347;12754;1;311;-2.14748e+09;-7.46713e+06;-1;0;0;0;-1;0;346509591;348199871;11152081
1113;6.10309e-15;-163;1625;12480;12837;1;325;-2.14748e+09;-7.44491e+06;0;0;0;0;0;0;346797930;348498436;11198875
1113;6.04373e-15;-173;1633;12347;12754;1;311;-2.14748e+09;-7.44491e+06;0;0;0;0;0;0;346797930;348498436;11198875
1114;6.10309e-15;-163;1625;12480;12837;1;325;-2.14748e+09;-7.42278e+06;-1;0;0;0;-1;0;347085497;348796257;11245694
1114;6.04373e-15;-173;1633;12347;12754;1;311;-2.14748e+09;-7.42278e+06;-1;0;0;0;-1;0;347085497;348796257;11245694
1115;6.10309e-15;-164;1625;12480;12837;1;325;-2.14748e+09;-7.40076e+06;0;0;0;0;0;0;347372294;349093338;11292537
1115;6.04373e-15;-173;1633;12347;12754;1;311;-2.14748e+09;-7.40076e+06;-1;0;0;0;-1;0;347372294;349093338;11292537
1116;6.10309e-15;-164;1625;12480;12837;1;325;-2.14748e+09;-7.37874e+06;0;0;-1;0;0;-1;347658325;349389682;11339405
1116;6.04373e-15;-173;1633;12347;12754;1;311;-2.14748e+09;-7.37874e+06;-1;0;0;0;-1;0;347658325;349389682;11339405
1117;6.10309e-15;-164;1625;12480;12837;1;325;-2.14748e+09;-7.35692e+06;-1;0;0;0;-1;0;347943592;349685291;11386296
1117;6.04373e-15;-173;1633;12347;12754;1;311;-2.14748e+09;-7.35692e+06;-1;0;0;0;-1;0;347943592;349685291;11386296
1118;6.10309e-15;-164;1625;12480;12837;1;325;-2.14748e+09;-7.33529e+06;-1;0;0;0;-1;0;348228099;349980168;11433210
1118;6.04373e-15;-173;1633;12347;12754;1;311;-2.14748e+09;-7.33529e+06;-1;0;0;0;-1;0;348228099;349980168;11433210
1119;6.10309e-15;-165;1625;12480;12837;1;325;-2.14748e+09;-7.31357e+06;0;0;0;0;0;0;348511847;350274315;11480147
1119;6.04373e-15;-173;1633;12347;12754;1;311;-2.14748e+09;-7.31357e+06;-1;0;0;0;-1;0;348511847;350274315;11480147
1120;6.10309e-15;-165;1625;12480;12837;1;325;-2.14748e+09;-7.29204e+06;-1;0;0;0;-1;0;348794840;350567736;11527107
1120;6.04373e-15;-174;1633;12347;12754;1;311;-2.14748e+09;-7.29204e+06;0;0;0;0;0;0;348794840;350567736;11527107
1121;6.10309e-15;-166;1625;12480;12837;1;325;-2.14748e+09;-7.2707e+06;0;0;0;0;0;0;349077081;350860432;11574088
1121;6.04373e-15;-175;1633;12347;12754;1;311;-2.14748e+09;-7.2707e+06;0;0;0;0;0;0;349077081;350860432;11574088
1122;6.10309e-15;-166;1625;12480;12837;1;325;-2.14748e+09;-7.24926e+06;-1;0;0;0;-1;0;349358571;351152407;11621091
1122;6.04373e-15;-176;1633;12347;12754;1;311;-2.14748e+09;-7.24926e+06;0;0;0;0;0;0;349358571;351152407;11621091
1123;6.10309e-15;-167;1625;12480;12837;1;325;-2.14748e+09;-7.22802e+06;0;0;0;0;0;0;349639315;351443663;11668114
1123;6.04373e-15;-177;1633;12347;12754;1;311;-2.14748e+09;-7.22802e+06;0;0;0;0;0;0;349639315;351443663;11668114
1124;6.10309e-15;-168;1625;12480;12837;1;325;-2.14748e+09;-7.20687e+06;0;0;0;0;0;0;349919313;351734202;11715158
1124;6.04373e-15;-177;1633;12347;12754;1;311;-2.14748e+09;-7.20687e+06;-1;0;0;0;-1;0;349919313;351734202;11715158
1125;6.10309e-15;-168;1625;12480;12837;1;325;-2.14748e+09;-7.18582e+06;-1;0;0;0;-1;0;350198570;352024028;11762223
1125;6.04373e-15;-177;1633;12347;12754;1;311;-2.14748e+09;-7.18582e+06;-1;0;0;0;-1;0;350198570;352024028;11762223
1126;6.10309e-15;-168;1625;12480;12837;1;325;-2.14748e+09;-7.16485e+06;-1;0;0;0;-1;0;350477088;352313143;11809307
1126;6.04373e-15;-178;1633;12347;12754;1;311;-2.14748e+09;-7.16485e+06;0;0;0;0;0;0;350477088;352313143;11809307
1127;6.10309e-15;-168;1625;12480;12837;1;325;-2.14748e+09;-7.14398e+06;-1;0;0;0;-1;0;350754869;352601549;11856410
1127;6.04373e-15;-178;1633;12347;12754;1;311;-2.14748e+09;-7.14398e+06;-1;0;0;0;-1;0;350754869;352601549;11856410
1128;6.10309e-15;-168;1625;12480;12837;1;325;-2.14748e+09;-7.12321e+06;-1;0;0;0;-1;0;351031916;352889249;11903532
1128;6.04373e-15;-178;1633;12347;12754;1;311;-2.14748e+09;-7.12321e+06;-1;0;0;0;-1;0;351031916;352889249;11903532
1129;6.10309e-15;-169;1625;12480;12837;1;325;-2.14748e+09;-7.10252e+06;0;0;0;0;0;0;351308232;353176246;11950673
1129;6.04373e-15;-179;1633;12347;12754;1;311;-2.14748e+09;-7.10252e+06;0;0;0;0;0;0;351308232;353176246;11950673
1130;6.10309e-15;-170;1625;12480;12837;1;325;-2.14748e+09;-7.08193e+06;0;0;0;0;0;0;351583819;353462542;11997831
1130;6.04373e-15;-179;1633;12347;12754;1;311;-2.14748e+09;-7.08193e+06;-1;0;0;0;-1;0;351583819;353462542;11997831
1131;6.10309e-15;-170;1625;12480;12837;1;325;-2.14748e+09;-7.06142e+06;-1;0;0;0;-1;0;351858680;353748139;12045007
1131;6.04373e-15;-180;1633;12347;12754;1;311;-2.14748e+09;-7.06142e+06;0;0;0;0;0;0;351858680;353748139;12045007
1132;6.10309e-15;-171;1625;12480;12837;1;325;-2.14748e+09;-7.04101e+06;0;0;0;0;0;0;352132818;354033040;12092200
1132;6.04373e-15;-181;1633;12347;12754;1;311;-2.14748e+09;-7.04101e+06;0;0;0;0;0;0;352132818;354033040;12092200
1133;6.10309e-15;-171;1625;12480;12837;1;325;-2.14748e+09;-7.02068e+06;-1;0;0;0;-1;0;352406234;354317248;12139410
1133;6.04373e-15;-182;1633;12347;12754;1;311;-2.14748e+09;-7.02068e+06;0;0;0;0;0;0;352406234;354317248;12139410
1134;6.10309e-15;-171;1625;12480;12837;1;325;-2.14748e+09;-7.00044e+06;-1;0;0;0;-1;0;352678932;354600765;12186637
1134;6.04373e-15;-183;1633;12347;12754;1;311;-2.14748e+09;-7.00044e+06;0;0;0;0;0;0;352678932;354600765;12186637
1135;6.10309e-15;-171;1625;12480;12837;1;325;-2.14748e+09;-6.98029e+06;-1;0;0;0;-1;0;352950915;354883593;12233879
1135;6.04373e-15;-183;1633;12347;12754;1;311;-2.14748e+09;-6.98029e+06;-1;0;0;0;-1;0;352950915;354883593;12233879
1136;6.10309e-15;-172;1625;12480;12837;1;325;-2.14748e+09;-6.96023e+06;0;0;0;0;0;0;353222183;355165736;12281136
1136;6.04373e-15;-183;1633;12347;12754;1;311;-2.14748e+09;-6.96023e+06;-1;0;0;0;-1;0;353222183;355165736;12281136
1137;6.10309e-15;-173;1625;12480;12837;1;325;-2.14748e+09;-6.94026e+06;0;0;0;0;0;0;353492741;355447194;12328409
1137;6.04373e-15;-184;1633;12347;12754;1;311;-2.14748e+09;-6.94026e+06;0;0;0;0;0;0;353492741;355447194;12328409
1138;6.10309e-15;-173;1625;12480;12837;1;325;-2.14748e+09;-6.92037e+06;-1;0;0;0;-1;0;353762591;355727971;12375697
1138;6.04373e-15;-185;1633;12347;12754;1;311;-2.14748e+09;-6.92037e+06;0;0;0;0;0;0;353762591;355727971;12375697
1139;6.10309e-15;-174;1625;12480;12837;1;325;-2.14748e+09;-6.90056e+06;0;0;0;0;0;0;354031735;356008070;12422998
1139;6.04373e-15;-186;1633;12347;12754;1;311;-2.14748e+09;-6.90056e+06;0;0;0;0;0;0;354031735;356008070;12422998
1140;6.10309e-15;-174;1625;12480;12837;1;325;-2.14748e+09;-6.88085e+06;-1;0;0;0;-1;0;354300175;356287492;12470314
1140;6.04373e-15;-187;1633;12347;12754;1;311;-2.14748e+09;-6.88085e+06;0;0;0;0;0;0;354300175;356287492;12470314
1141;6.10309e-15;-174;1625;12480;12837;1;325;-2.14748e+09;-6.86121e+06;-1;0;0;0;-1;0;354567914;356566240;12517643
1141;6.04373e-15;-188;1633;12347;12754;1;311;-2.14748e+09;-6.86121e+06;0;0;0;0;0;0;354567914;356566240;12517643
1142;6.10309e-15;-175;1625;12480;12837;1;325;-2.14748e+09;-6.84166e+06;0;0;0;0;0;0;354834955;356844316;12564985
1142;6.04373e-15;-189;1633;12347;12754;1;311;-2.14748e+09;-6.84166e+06;0;0;0;0;0;0;354834955;356844316;12564985
1143;6.10309e-15;-175;1625;12480;12837;1;325;-2.14748e+09;-6.8222e+06;-1;0;0;0;-1;0;355101300;357121723;12612340
1143;6.04373e-15;-190;1633;12347;12754;1;311;-2.14748e+09;-6.8222e+06;0;0;0;0;0;0;355101300;357121723;12612340
1144;6.10309e-15;-175;1625;12480;12837;1;325;-2.14748e+09;-6.80282e+06;-1;0;0;0;-1;0;355366951;357398463;12659707
1144;6.04373e-15;-191;1633;12347;12754;1;311;-2.14748e+09;-6.80282e+06;0;0;0;0;0;0;355366951;357398463;12659707
1145;6.10309e-15;-175;1625;12480;12837;1;325;-2.14748e+09;-6.78352e+06;-1;0;0;0;-1;0;355631911;357674539;12707086
1145;6.04373e-15;-191;1633;12347;12754;1;311;-2.14748e+09;-6.78352e+06;-1;0;0;0;-1;0;355631911;357674539;12707086
1146;6.10309e-15;-175;1625;12480;12837;1;325;-2.14748e+09;-6.7643e+06;-1;0;0;0;-1;0;355896183;357949952;12754476
1146;6.04373e-15;-192;1633;12347;12754;1;311;-2.14748e+09;-6.7643e+06;0;0;0;0;0;0;355896183;357949952;12754476
1147;6.10309e-15;-176;1625;12480;12837;1;325;-2.14748e+09;-6.74516e+06;0;0;0;0;0;0;356159768;358224705;12801877
1147;6.04373e-15;-192;1633;12347;12754;1;311;-2.14748e+09;-6.74516e+06;-1;0;0;0;-1;0;356159768;358224705;12801877
1148;6.10309e-15;-176;1625;12480;12837;1;325;-2.14748e+09;-6.72611e+06;-1;0;0;0;-1;0;356422668;358498800;12849290
1148;6.04373e-15;-193;1633;12347;12754;1;311;-2.14748e+09;-6.72611e+06;0;0;0;0;0;0;356422668;358498800;12849290
1149;6.10309e-15;-177;1625;12480;12837;1;325;-2.14748e+09;-6.70723e+06;0;0;0;0;0;0;356684888;358772240;12896712
1149;6.04373e-15;-193;1633;12347;12754;1;311;-2.14748e+09;-6.70723e+06;-1;0;0;0;-1;0;356684888;358772240;12896712
1150;6.10309e-15;-178;1625;12480;12837;1;325;-2.14748e+09;-6.68834e+06;0;0;0;0;0;0;356946428;359045027;12944145
1150;6.04373e-15;-194;1633;12347;12754;1;311;-2.14748e+09;-6.68834e+06;0;0;0;0;0;0;356946428;359045027;12944145
1151;6.10309e-15;-179;1625;12480;12837;1;325;-2.14748e+09;-6.66942e+06;0;0;0;0;0;0;357207291;359317163;12991587
1151;6.04373e-15;-195;1633;12347;12754;1;311;-2.14748e+09;-6.66942e+06;0;0;0;0;0;0;357207291;359317163;12991587
1152;6.10309e-15;-180;1625;12480;12837;1;325;-2.14748e+09;-6.65069e+06;0;0;0;0;0;0;357467479;359588650;13039038
1152;6.04373e-15;-196;1633;12347;12754;1;311;-2.14748e+09;-6.65069e+06;0;0;0;0;0;0;357467479;359588650;13039038
1153;6.10309e-15;-180;1625;12480;12837;1;325;-2.14748e+09;-6.63203e+06;-1;0;0;0;-1;0;357726996;359859490;13086498
1153;6.04373e-15;-196;1633;12347;12754;1;311;-2.14748e+09;-6.63203e+06;-1;0;0;0;-1;0;357726996;359859490;13086498
1154;6.10309e-15;-180;1625;12480;12837;1;325;-2.14748e+09;-6.61345e+06;-1;0;0;0;-1;0;357985842;360129687;13133966
1154;6.04373e-15;-197;1633;12347;12754;1;311;-2.14748e+09;-6.61345e+06;0;0;0;0;0;0;357985842;360129687;13133966
1155;6.10309e-15;-181;1625;12480;12837;1;325;-2.14748e+09;-6.59495e+06;0;0;0;0;0;0;358244021;360399242;13181442
1155;6.04373e-15;-197;1633;12347;12754;1;311;-2.14748e+09;-6.59495e+06;-1;0;0;0;-1;0;358244021;360399242;13181442
1156;6.10309e-15;-181;1625;12480;12837;1;325;-2.14748e+09;-6.57652e+06;-1;0;0;0;-1;0;358501534;360668156;13228927
1156;6.04373e-15;-197;1633;12347;12754;1;311;-2.14748e+09;-6.57652e+06;-1;0;0;0;-1;0;358501534;360668156;13228927
1157;6.10309e-15;-181;1625;12480;12837;1;325;-2.14748e+09;-6.55818e+06;-1;0;0;0;-1;0;358758384;360936434;13276418
1157;6.04373e-15;-197;1633;12347;12754;1;311;-2.14748e+09;-6.55818e+06;-1;0;0;0;-1;0;358758384;360936434;13276418
1158;6.10309e-15;-181;1625;12480;12837;1;325;-2.14748e+09;-6.5399e+06;-1;0;0;0;-1;0;359014574;361204076;13323916
1158;6.04373e-15;-197;1633;12347;12754;1;311;-2.14748e+09;-6.5399e+06;-1;0;0;0;-1;0;359014574;361204076;13323916
1159;6.10309e-15;-181;1625;12480;12837;1;325;-2.14748e+09;-6.52171e+06;-1;0;0;0;-1;0;359270105;361471084;13371421
1159;6.04373e-15;-198;1633;12347;12754;1;311;-2.14748e+09;-6.52171e+06;0;0;0;0;0;0;359270105;361471084;13371421
1160;6.10309e-15;-181;1625;12480;12837;1;325;-2.14748e+09;-6.50359e+06;-1;0;0;0;-1;0;359524979;361737462;13418932
1160;6.04373e-15;-199;1633;12347;12754;1;311;-2.14748e+09;-6.50359e+06;0;0;0;0;0;0;359524979;361737462;13418932
1161;6.10309e-15;-181;1625;12480;12837;1;325;-2.14748e+09;-6.48564e+06;-1;0;0;0;-1;0;359779200;362003211;13466449
1161;6.04373e-15;-200;1633;12347;12754;1;311;-2.14748e+09;-6.48564e+06;0;0;0;0;0;0;359779200;362003211;13466449
1162;6.10309e-15;-181;1625;12480;12837;1;325;-2.14748e+09;-6.46757e+06;-1;0;0;0;-1;0;360032769;362268333;13513972
1162;6.04373e-15;-200;1633;12347;12754;1;311;-2.14748e+09;-6.46757e+06;-1;0;0;0;-1;0;360032769;362268333;13513972
1163;6.10309e-15;-182;1625;12480;12837;1;325;-2.14748e+09;-6.44967e+06;0;0;0;0;0;0;360285688;362532830;13561499
1163;6.04373e-15;-200;1633;12347;12754;1;311;-2.14748e+09;-6.44967e+06;-1;0;0;0;-1;0;360285688;362532830;13561499
1164;6.10309e-15;-183;1625;12480;12837;1;325;-2.14748e+09;-6.43194e+06;0;0;0;0;0;0;360537960;362796705;13609031
1164;6.04373e-15;-201;1633;12347;12754;1;311;-2.14748e+09;-6.43194e+06;0;0;0;0;0;0;360537960;362796705;13609031
1165;6.10309e-15;-184;1625;12480;12837;1;325;-2.14748e+09;-6.41419e+06;0;0;0;0;0;0;360789586;363059959;13656568
1165;6.04373e-15;-202;1633;12347;12754;1;311;-2.14748e+09;-6.41419e+06;0;0;0;0;0;0;360789586;363059959;13656568
1166;6.10309e-15;-185;1625;12480;12837;1;325;-2.14748e+09;-6.39642e+06;0;0;0;0;0;0;361040569;363322595;13704109
1166;6.04373e-15;-203;1633;12347;12754;1;311;-2.14748e+09;-6.39642e+06;0;0;0;0;0;0;361040569;363322595;13704109
1167;6.10309e-15;-185;1625;12480;12837;1;325;-2.14748e+09;-6.37881e+06;-1;0;0;0;-1;0;361290912;363584615;13751653
1167;6.04373e-15;-204;1633;12347;12754;1;311;-2.14748e+09;-6.37881e+06;0;0;0;0;0;0;361290912;363584615;13751653
1168;6.10309e-15;-186;1625;12480;12837;1;325;-2.14748e+09;-6.36127e+06;0;0;0;0;0;0;361540616;363846021;13799201
1168;6.04373e-15;-204;1633;12347;12754;1;311;-2.14748e+09;-6.36127e+06;-1;0;0;0;-1;0;361540616;363846021;13799201
1169;6.10309e-15;-187;1625;12480;12837;1;325;-2.14748e+09;-6.34381e+06;0;0;0;0;0;0;361789684;364106814;13846751
1169;6.04373e-15;-205;1633;12347;12754;1;311;-2.14748e+09;-6.34381e+06;0;0;0;0;0;0;361789684;364106814;13846751
1170;6.10309e-15;-187;1625;12480;12837;1;325;-2.14748e+09;-6.32642e+06;-1;0;0;0;-1;0;362038117;364366998;13894305
1170;6.04373e-15;-206;1633;12347;12754;1;311;-2.14748e+09;-6.32642e+06;0;0;0;0;0;0;362038117;364366998;13894305
1171;6.10309e-15;-188;1625;12480;12837;1;325;-2.14748e+09;-6.30909e+06;0;0;0;0;0;0;362285918;364626574;13941860
1171;6.04373e-15;-207;1633;12347;12754;1;311;-2.14748e+09;-6.30909e+06;0;0;0;0;0;0;362285918;364626574;13941860
1172;6.10309e-15;-189;1625;12480;12837;1;325;-2.14748e+09;-6.29184e+06;0;0;0;0;0;0;362533088;364885543;13989418
1172;6.04373e-15;-208;1633;12347;12754;1;311;-2.14748e+09;-6.29184e+06;0;0;0;0;0;0;362533088;364885543;13989418
1173;6.10309e-15;-190;1625;12480;12837;1;325;-2.14748e+09;-6.27466e+06;0;0;0;0;0;0;362779631;365143909;14036977
1173;6.04373e-15;-208;1633;12347;12754;1;311;-2.14748e+09;-6.27466e+06;-1;0;0;0;-1;0;362779631;365143909;14036977
1174;6.10309e-15;-191;1625;12480;12837;1;325;-2.14748e+09;-6.25754e+06;0;0;0;0;0;0;363025548;365401673;14084537
1174;6.04373e-15;-208;1633;12347;12754;1;311;-2.14748e+09;-6.25754e+06;-1;0;0;0;-1;0;363025548;365401673;14084537
1175;6.10309e-15;-191;1625;12480;12837;1;325;-2.14748e+09;-6.2405e+06;-1;0;0;0;-1;0;363270841;365658837;14132099
1175;6.04373e-15;-208;1633;12347;12754;1;311;-2.14748e+09;-6.2405e+06;-1;0;0;0;-1;0;363270841;365658837;14132099
1176;6.10309e-15;-191;1625;12480;12837;1;325;-2.14748e+09;-6.22352e+06;-1;0;0;0;-1;0;363515512;365915403;14179661
1176;6.04373e-15;-208;1633;12347;12754;1;311;-2.14748e+09;-6.22352e+06;-1;0;0;0;-1;0;363515512;365915403;14179661
1177;6.10309e-15;-191;1625;12480;12837;1;325;-2.14748e+09;-6.20661e+06;-1;0;0;0;-1;0;363759564;366171373;14227223
1177;6.04373e-15;-209;1633;12347;12754;1;311;-2.14748e+09;-6.20661e+06;0;0;0;0;0;0;363759564;366171373;14227223
1178;6.10309e-15;-191;1625;12480;12837;1;325;-2.14748e+09;-6.18977e+06;-1;0;0;0;-1;0;364002998;366426749;14274785
1178;6.04373e-15;-210;1633;12347;12754;1;311;-2.14748e+09;-6.18977e+06;0;0;0;0;0;0;364002998;366426749;14274785
1179;6.10309e-15;-192;1625;12480;12837;1;325;-2.14748e+09;-6.173e+06;0;0;0;0;0;0;364245816;366681533;14322347
1179;6.04373e-15;-210;1633;12347;12754;1;311;-2.14748e+09;-6.173e+06;-1;0;0;0;-1;0;364245816;366681533;14322347
1180;6.10309e-15;-193;1625;12480;12837;1;325;-2.14748e+09;-6.15639e+06;0;0;0;0;0;0;364488022;366935727;14369908
1180;6.04373e-15;-210;1633;12347;12754;1;311;-2.14748e+09;-6.15639e+06;-1;0;0;0;-1;0;364488022;366935727;14369908
1181;6.10309e-15;-193;1625;12480;12837;1;325;-2.14748e+09;-6.13975e+06;-1;0;0;0;-1;0;364729615;367189333;14417467
1181;6.04373e-15;-211;1633;12347;12754;1;311;-2.14748e+09;-6.13975e+06;0;0;0;0;0;0;364729615;367189333;14417467
1182;6.10309e-15;-193;1625;12480;12837;1;325;-2.14748e+09;-6.12307e+06;-1;0;0;0;-1;0;364970599;367442353;14465026
1182;6.04373e-15;-211;1633;12347;12754;1;311;-2.14748e+09;-6.12307e+06;-1;0;0;0;-1;0;364970599;367442353;14465026
1183;6.10309e-15;-193;1625;12480;12837;1;325;-2.14748e+09;-6.10656e+06;-1;0;0;0;-1;0;365210976;367694789;14512583
1183;6.04373e-15;-212;1633;12347;12754;1;311;-2.14748e+09;-6.10656e+06;0;0;0;0;0;0;365210976;367694789;14512583
1184;6.10309e-15;-194;1625;12480;12837;1;325;-2.14748e+09;-6.09012e+06;0;0;0;0;0;0;365450748;367946642;14560138
1184;6.04373e-15;-212;1633;12347;12754;1;311;-2.14748e+09;-6.09012e+06;-1;0;0;0;-1;0;365450748;367946642;14560138
1185;6.10309e-15;-195;1625;12480;12837;1;325;-2.14748e+09;-6.07384e+06;0;0;0;0;0;0;365689916;368197915;14607690
1185;6.04373e-15;-213;1633;12347;12754;1;311;-2.14748e+09;-6.07384e+06;0;0;0;0;0;0;365689916;368197915;14607690
1186;6.10309e-15;-196;1625;12480;12837;1;325;-2.14748e+09;-6.05753e+06;0;0;0;0;0;0;365928482;368448610;14655240
1186;6.04373e-15;-214;1633;12347;12754;1;311;-2.14748e+09;-6.05743e+06;0;0;0;0;0;0;365928482;368448610;14655240
1187;6.10309e-15;-196;1625;12480;12837;1;325;-2.14748e+09;-6.04118e+06;-1;0;0;0;-1;0;366166450;368698728;14702786
1187;6.04373e-15;-214;1633;12347;12754;1;311;-2.14748e+09;-6.04118e+06;-1;0;0;0;-1;0;366166450;368698728;14702786
1188;6.10309e-15;-196;1625;12480;12837;1;325;-2.14748e+09;-6.02499e+06;-1;0;0;0;-1;0;366403820;368948271;14750330
1188;6.04373e-15;-214;1633;12347;12754;1;311;-2.14748e+09;-6.02499e+06;-1;0;0;0;-1;0;366403820;368948271;14750330
1189;6.10309e-15;-197;1625;12480;12837;1;325;-2.14748e+09;-6.00886e+06;0;0;0;0;0;0;366640594;369197241;14797870
1189;6.04373e-15;-214;1633;12347;12754;1;311;-2.14748e+09;-6.00886e+06;-1;0;0;0;-1;0;366640594;369197241;14797870
1190;6.10309e-15;-198;1625;12480;12837;1;325;-2.14748e+09;-5.9928e+06;0;0;0;0;0;0;366876775;369445640;14845405
1190;6.04373e-15;-214;1633;12347;12754;1;311;-2.14748e+09;-5.9928e+06;-1;0;0;0;-1;0;366876775;369445640;14845405
1191;6.10309e-15;-198;1625;12480;12837;1;325;-2.14748e+09;-5.97681e+06;-1;0;0;0;-1;0;367112364;369693471;14892937
1191;6.04373e-15;-215;1633;12347;12754;1;311;-2.14748e+09;-5.97681e+06;0;0;0;0;0;0;367112364;369693471;14892937
1192;6.10309e-15;-198;1625;12480;12837;1;325;-2.14748e+09;-5.96097e+06;-1;0;0;0;-1;0;367347364;369940734;14940464
1192;6.04373e-15;-216;1633;12347;12754;1;311;-2.14748e+09;-5.96097e+06;0;0;0;0;0;0;367347364;369940734;14940464
1193;6.10309e-15;-198;1625;12480;12837;1;325;-2.14748e+09;-5.945e+06;-1;0;0;0;-1;0;367581776;370187431;14987986
1193;6.04373e-15;-217;1633;12347;12754;1;311;-2.14748e+09;-5.945e+06;0;0;0;0;0;0;367581776;370187431;14987986
1194;6.10309e-15;-199;1625;12480;12837;1;325;-2.14748e+09;-5.92918e+06;0;0;0;0;0;0;367815602;370433565;15035503
1194;6.04373e-15;-217;1633;12347;12754;1;311;-2.14748e+09;-5.92918e+06;-1;0;0;0;-1;0;367815602;370433565;15035503
1195;6.10309e-15;-200;1625;12480;12837;1;325;-2.14748e+09;-5.91343e+06;0;0;0;0;0;0;368048844;370679137;15083015
1195;6.04373e-15;-218;1633;12347;12754;1;311;-2.14748e+09;-5.91343e+06;0;0;0;0;0;0;368048844;370679137;15083015
1196;6.10309e-15;-200;1625;12480;12837;1;325;-2.14748e+09;-5.89774e+06;-1;0;0;0;-1;0;368281505;370924149;15130520
1196;6.04373e-15;-218;1633;12347;12754;1;311;-2.14748e+09;-5.89774e+06;-1;0;0;0;-1;0;368281505;370924149;15130520
1197;6.10309e-15;-201;1625;12480;12837;1;325;-2.14748e+09;-5.88211e+06;0;0;0;0;0;0;368513585;371168602;15178020
1197;6.04373e-15;-219;1633;12347;12754;1;311;-2.14748e+09;-5.88211e+06;0;0;0;0;0;0;368513585;371168602;15178020
1198;6.10309e-15;-202;1625;12480;12837;1;325;-2.14748e+09;-5.86654e+06;0;0;0;0;0;0;368745087;371412500;15225513
1198;6.04373e-15;-220;1633;12347;12754;1;311;-2.14748e+09;-5.86654e+06;0;0;0;0;0;0;368745087;371412500;15225513
1199;6.10309e-15;-202;1625;12480;12837;1;325;-2.14748e+09;-5.85103e+06;-1;0;0;0;-1;0;368976013;371655843;15273000
1199;6.04373e-15;-221;1633;12347;12754;1;311;-2.14748e+09;-5.85103e+06;0;0;0;0;0;0;368976013;371655843;15273000
1200;6.10309e-15;-202;1625;12480;12837;1;325;-2.14748e+09;-5.83558e+06;-1;0;0;0;-1;0;369206364;371898632;15320479
1200;6.04373e-15;-222;1633;12347;12754;1;311;-2.14748e+09;-5.83558e+06;0;0;0;0;0;0;369206364;371898632;15320479
1201;6.10309e-15;-203;1625;12480;12837;1;325;-2.14748e+09;-5.82019e+06;0;0;0;0;0;0;369436143;372140871;15367952
1201;6.04373e-15;-223;1633;12347;12754;1;311;-2.14748e+09;-5.82019e+06;0;0;0;0;0;0;369436143;372140871;15367952
1202;6.10309e-15;-203;1625;12480;12837;1;325;-2.14748e+09;-5.80496e+06;-1;0;0;0;-1;0;369665351;372382561;15415416
1202;6.04373e-15;-223;1633;12347;12754;1;311;-2.14748e+09;-5.80496e+06;-1;0;0;0;-1;0;369665351;372382561;15415416
1203;6.10309e-15;-204;1625;12480;12837;1;325;-2.14748e+09;-5.78958e+06;0;0;0;0;0;0;369893990;372623702;15462873
1203;6.04373e-15;-224;1633;12347;12754;1;311;-2.14748e+09;-5.78958e+06;0;0;0;0;0;0;369893990;372623702;15462873
1204;6.10309e-15;-204;1625;12480;12837;1;325;-2.14748e+09;-5.77447e+06;-1;0;0;0;-1;0;370122062;372864299;15510322
1204;6.04373e-15;-224;1633;12347;12754;1;311;-2.14748e+09;-5.77447e+06;-1;0;0;0;-1;0;370122062;372864299;15510322
1205;6.10309e-15;-204;1625;12480;12837;1;325;-2.14748e+09;-5.75921e+06;-1;0;0;0;-1;0;370349569;373104350;15557762
1205;6.04373e-15;-225;1633;12347;12754;1;311;-2.14748e+09;-5.75921e+06;0;0;0;0;0;0;370349569;373104350;15557762
1206;6.10309e-15;-204;1625;12480;12837;1;325;-2.14748e+09;-5.74411e+06;-1;0;0;0;-1;0;370576513;373343860;15605194
1206;6.04373e-15;-226;1633;12347;12754;1;311;-2.14748e+09;-5.74411e+06;0;0;0;0;0;0;370576513;373343860;15605194
1207;6.10309e-15;-205;1625;12480;12837;1;325;-2.14748e+09;-5.72907e+06;0;0;0;0;0;0;370802895;373582829;15652617
1207;6.04373e-15;-226;1633;12347;12754;1;311;-2.14748e+09;-5.72907e+06;-1;0;0;0;-1;0;370802895;373582829;15652617
1208;6.10309e-15;-205;1625;12480;12837;1;325;-2.14748e+09;-5.71408e+06;-1;0;0;0;-1;0;371028717;373821259;15700030
1208;6.04373e-15;-227;1633;12347;12754;1;311;-2.14748e+09;-5.71408e+06;0;0;0;0;0;0;371028717;373821259;15700030
1209;6.10309e-15;-205;1625;12480;12837;1;325;-2.14748e+09;-5.69925e+06;-1;0;0;0;-1;0;371253981;374059151;15747434
1209;6.04373e-15;-228;1633;12347;12754;1;311;-2.14748e+09;-5.69925e+06;0;0;0;0;0;0;371253981;374059151;15747434
1210;6.10309e-15;-205;1625;12480;12837;1;325;-2.14748e+09;-5.68438e+06;-1;0;0;0;-1;0;371478689;374296508;15794828
1210;6.04373e-15;-228;1633;12347;12754;1;311;-2.14748e+09;-5.68438e+06;-1;0;0;0;-1;0;371478689;374296508;15794828
1211;6.10309e-15;-206;1625;12480;12837;1;325;-2.14748e+09;-5.66956e+06;0;0;0;0;0;0;371702842;374533332;15842212
1211;6.04373e-15;-229;1633;12347;12754;1;311;-2.14748e+09;-5.66956e+06;0;0;0;0;0;0;371702842;374533332;15842212
1212;6.10309e-15;-206;1625;12480;12837;1;325;-2.14748e+09;-5.6547e+06;-1;0;0;0;-1;0;371926443;374769623;15889585
1212;6.04373e-15;-229;1633;12347;12754;1;311;-2.14748e+09;-5.6547e+06;-1;0;0;0;-1;0;371926443;374769623;15889585
1213;6.10309e-15;-206;1625;12480;12837;1;325;-2.14748e+09;-5.63999e+06;-1;0;0;0;-1;0;372149493;375005383;15936948
1213;6.04373e-15;-229;1633;12347;12754;1;311;-2.14748e+09;-5.63999e+06;-1;0;0;0;-1;0;372149493;375005383;15936948
1214;6.10309e-15;-206;1625;12480;12837;1;325;-2.14748e+09;-5.62534e+06;-1;0;0;0;-1;0;372371994;375240615;15984300
1214;6.04373e-15;-230;1633;12347;12754;1;311;-2.14748e+09;-5.62534e+06;0;0;0;0;0;0;372371994;375240615;15984300
1215;6.10309e-15;-207;1625;12480;12837;1;325;-2.14748e+09;-5.61074e+06;0;0;0;0;0;0;372593947;375475319;16031640
1215;6.04373e-15;-230;1633;12347;12754;1;311;-2.14748e+09;-5.61074e+06;-1;0;0;0;-1;0;372593947;375475319;16031640
1216;6.10309e-15;-208;1625;12480;12837;1;325;-2.14748e+09;-5.5962e+06;0;0;0;0;0;0;372815355;375709498;16078969
1216;6.04373e-15;-230;1633;12347;12754;1;311;-2.14748e+09;-5.5962e+06;-1;0;0;0;-1;0;372815355;375709498;16078969
1217;6.10309e-15;-208;1625;12480;12837;1;325;-2.14748e+09;-5.58181e+06;-1;0;0;0;-1;0;373036219;375943153;16126287
1217;6.04373e-15;-231;1633;12347;12754;1;311;-2.14748e+09;-5.58181e+06;0;0;0;0;0;0;373036219;375943153;16126287
1218;6.10309e-15;-209;1625;12480;12837;1;325;-2.14748e+09;-5.56728e+06;0;0;0;0;0;0;373256540;376176285;16173592
1218;6.04373e-15;-232;1633;12347;12754;1;311;-2.14748e+09;-5.56728e+06;0;0;0;0;0;0;373256540;376176285;16173592
1219;6.10309e-15;-209;1625;12480;12837;1;325;-2.14748e+09;-5.5529e+06;-1;0;0;0;-1;0;373476321;376408897;16220885
1219;6.04373e-15;-233;1633;12347;12754;1;311;-2.14748e+09;-5.5529e+06;0;0;0;0;0;0;373476321;376408897;16220885
1220;6.10309e-15;-209;1625;12480;12837;1;325;-2.14748e+09;-5.53857e+06;-1;0;0;0;-1;0;373695564;376640990;16268166
1220;6.04373e-15;-234;1633;12347;12754;1;311;-2.14748e+09;-5.53857e+06;0;0;0;0;0;0;373695564;376640990;16268166
1221;6.10309e-15;-210;1625;12480;12837;1;325;-2.14748e+09;-5.5243e+06;0;0;0;0;0;0;373914269;376872565;16315434
1221;6.04373e-15;-234;1633;12347;12754;1;311;-2.14748e+09;-5.5243e+06;-1;0;0;0;-1;0;373914269;376872565;16315434
1222;6.10309e-15;-211;1625;12480;12837;1;325;-2.14748e+09;-5.51017e+06;0;0;0;0;0;0;374132439;377103625;16362688
1222;6.04373e-15;-235;1633;12347;12754;1;311;-2.14748e+09;-5.51017e+06;0;0;0;0;0;0;374132439;377103625;16362688
1223;6.10309e-15;-212;1625;12480;12837;1;325;-2.14748e+09;-5.4959e+06;0;0;0;0;0;0;374350075;377334170;16409929
1223;6.04373e-15;-235;1633;12347;12754;1;311;-2.14748e+09;-5.4959e+06;-1;0;0;0;-1;0;374350075;377334170;16409929
1224;6.10309e-15;-213;1625;12480;12837;1;325;-2.14748e+09;-5.48189e+06;0;0;0;0;0;0;374567180;377564203;16457157
1224;6.04373e-15;-235;1633;12347;12754;1;311;-2.14748e+09;-5.48189e+06;-1;0;0;0;-1;0;374567180;377564203;16457157
1225;6.10309e-15;-214;1625;12480;12837;1;325;-2.14748e+09;-5.46772e+06;0;0;0;0;0;0;374783754;377793724;16504371
1225;6.04373e-15;-235;1633;12347;12754;1;311;-2.14748e+09;-5.46772e+06;-1;0;0;0;-1;0;374783754;377793724;16504371
1226;6.10309e-15;-215;1625;12480;12837;1;325;-2.14748e+09;-5.45371e+06;0;0;0;0;0;0;374999799;378022736;16551571
1226;6.04373e-15;-236;1633;12347;12754;1;311;-2.14748e+09;-5.45371e+06;0;0;0;0;0;0;374999799;378022736;16551571
1227;6.10309e-15;-216;1625;12480;12837;1;325;-2.14748e+09;-5.43974e+06;0;0;0;0;0;0;375215317;378251240;16598756
1227;6.04373e-15;-237;1633;12347;12754;1;311;-2.14748e+09;-5.43974e+06;0;0;0;0;0;0;375215317;378251240;16598756
1228;6.10309e-15;-216;1625;12480;12837;1;325;-2.14748e+09;-5.42593e+06;-1;0;0;0;-1;0;375430310;378479237;16645927
1228;6.04373e-15;-237;1633;12347;12754;1;311;-2.14748e+09;-5.42593e+06;-1;0;0;0;-1;0;375430310;378479237;16645927
1229;6.10309e-15;-216;1625;12480;12837;1;325;-2.14748e+09;-5.41197e+06;-1;0;0;0;-1;0;375644779;378706730;16693083
1229;6.04373e-15;-238;1633;12347;12754;1;311;-2.14748e+09;-5.41197e+06;0;0;0;0;0;0;375644779;378706730;16693083
1230;6.10309e-15;-216;1625;12480;12837;1;325;-2.14748e+09;-5.39816e+06;-1;0;0;0;-1;0;375858727;378933719;16740224
1230;6.04373e-15;-239;1633;12347;12754;1;311;-2.14748e+09;-5.39816e+06;0;0;0;0;0;0;375858727;378933719;16740224
1231;6.10309e-15;-217;1625;12480;12837;1;325;-2.14748e+09;-5.3844e+06;0;0;0;0;0;0;376072153;379160207;16787349
1231;6.04373e-15;-240;1633;12347;12754;1;311;-2.14748e+09;-5.3844e+06;0;0;0;0;0;0;376072153;379160207;16787349
1232;6.10309e-15;-217;1625;12480;12837;1;325;-2.14748e+09;-5.37079e+06;-1;0;0;0;-1;0;376285061;379386194;16834459
1232;6.04373e-15;-240;1633;12347;12754;1;311;-2.14748e+09;-5.37079e+06;-1;0;0;0;-1;0;376285061;379386194;16834459
1233;6.10309e-15;-217;1625;12480;12837;1;325;-2.14748e+09;-5.35702e+06;0;0;-1;0;0;-1;376497452;379611683;16881553
1233;6.04373e-15;-240;1633;12347;12754;1;311;-2.14748e+09;-5.35702e+06;-1;0;0;0;-1;0;376497452;379611683;16881553
1234;6.10309e-15;-218;1625;12480;12837;1;325;-2.14748e+09;-5.34341e+06;0;0;0;0;0;0;376709327;379836674;16928631
1234;6.04373e-15;-241;1633;12347;12754;1;311;-2.14748e+09;-5.34341e+06;0;0;0;0;0;0;376709327;379836674;16928631
1235;6.10309e-15;-219;1625;12480;12837;1;325;-2.14748e+09;-5.32985e+06;0;0;0;0;0;0;376920689;380061170;16975693
1235;6.04373e-15;-241;1633;12347;12754;1;311;-2.14748e+09;-5.32985e+06;-1;0;0;0;-1;0;376920689;380061170;16975693
1236;6.10309e-15;-219;1625;12480;12837;1;325;-2.14748e+09;-5.31634e+06;-1;0;0;0;-1;0;377131537;380285171;17022738
1236;6.04373e-15;-242;1633;12347;12754;1;311;-2.14748e+09;-5.31634e+06;0;0;0;0;0;0;377131537;380285171;17022738
1237;6.10309e-15;-220;1625;12480;12837;1;325;-2.14748e+09;-5.30287e+06;0;0;0;0;0;0;377341875;380508680;17069767
1237;6.04373e-15;-242;1633;12347;12754;1;311;-2.14748e+09;-5.30287e+06;-1;0;0;0;-1;0;377341875;380508680;17069767
1238;6.10309e-15;-221;1625;12480;12837;1;325;-2.14748e+09;-5.28945e+06;0;0;0;0;0;0;377551704;380731697;17116778
1238;6.04373e-15;-242;1633;12347;12754;1;311;-2.14748e+09;-5.28945e+06;-1;0;0;0;-1;0;377551704;380731697;17116778
1239;6.10309e-15;-221;1625;12480;12837;1;325;-2.14748e+09;-5.27608e+06;-1;0;0;0;-1;0;377761025;380954225;17163772
1239;6.04373e-15;-243;1633;12347;12754;1;311;-2.14748e+09;-5.27608e+06;0;0;0;0;0;0;377761025;380954225;17163772
1240;6.10309e-15;-222;1625;12480;12837;1;325;-2.14748e+09;-5.26276e+06;0;0;0;0;0;0;377969841;381176264;17210748
1240;6.04373e-15;-243;1633;12347;12754;1;311;-2.14748e+09;-5.26276e+06;-1;0;0;0;-1;0;377969841;381176264;17210748
1241;6.10309e-15;-222;1625;12480;12837;1;325;-2.14748e+09;-5.24949e+06;-1;0;0;0;-1;0;378178151;381397817;17257707
1241;6.04373e-15;-243;1633;12347;12754;1;311;-2.14748e+09;-5.24949e+06;-1;0;0;0;-1;0;378178151;381397817;17257707
1242;6.10309e-15;-222;1625;12480;12837;1;325;-2.14748e+09;-5.23626e+06;-1;0;0;0;-1;0;378385959;381618884;17304648
1242;6.04373e-15;-244;1633;12347;12754;1;311;-2.14748e+09;-5.23626e+06;0;0;0;0;0;0;378385959;381618884;17304648
1243;6.10309e-15;-223;1625;12480;12837;1;325;-2.14748e+09;-5.22308e+06;0;0;0;0;0;0;378593265;381839467;17351570
1243;6.04373e-15;-244;1633;12347;12754;1;311;-2.14748e+09;-5.22308e+06;-1;0;0;0;-1;0;378593265;381839467;17351570
1244;6.10309e-15;-223;1625;12480;12837;1;325;-2.14748e+09;-5.21005e+06;-1;0;0;0;-1;0;378800072;382059568;17398474
1244;6.04373e-15;-244;1633;12347;12754;1;311;-2.14748e+09;-5.21005e+06;-1;0;0;0;-1;0;378800072;382059568;17398474
1245;6.10309e-15;-223;1625;12480;12837;1;325;-2.14748e+09;-5.19696e+06;-1;0;0;0;-1;0;379006380;382279188;17445360
1245;6.04373e-15;-245;1633;12347;12754;1;311;-2.14748e+09;-5.19696e+06;0;0;0;0;0;0;379006380;382279188;17445360
1246;6.10309e-15;-224;1625;12480;12837;1;325;-2.14748e+09;-5.18382e+06;0;0;0;0;0;0;379212191;382498328;17492226
1246;6.04373e-15;-245;1633;12347;12754;1;311;-2.14748e+09;-5.18382e+06;-1;0;0;0;-1;0;379212191;382498328;17492226
1247;6.10309e-15;-225;1625;12480;12837;1;325;-2.14748e+09;-5.17083e+06;0;0;0;0;0;0;379417507;382716991;17539074
1247;6.04373e-15;-245;1633;12347;12754;1;311;-2.14748e+09;-5.17083e+06;-1;0;0;0;-1;0;379417507;382716991;17539074
1248;6.10309e-15;-226;1625;12480;12837;1;325;-2.14748e+09;-5.15788e+06;0;0;0;0;0;0;379622330;382935176;17585902
1248;6.04373e-15;-245;1633;12347;12754;1;311;-2.14748e+09;-5.15788e+06;-1;0;0;0;-1;0;379622330;382935176;17585902
1249;6.10309e-15;-226;1625;12480;12837;1;325;-2.14748e+09;-5.14498e+06;-1;0;0;0;-1;0;379826660;383152886;17632711
1249;6.04373e-15;-245;1633;12347;12754;1;311;-2.14748e+09;-5.14498e+06;-1;0;0;0;-1;0;379826660;383152886;17632711
1250;6.10309e-15;-226;1625;12480;12837;1;325;-2.14748e+09;-5.13212e+06;-1;0;0;0;-1;0;380030499;383370122;17679500
1250;6.04373e-15;-245;1633;12347;12754;1;311;-2.14748e+09;-5.13212e+06;-1;0;0;0;-1;0;380030499;383370122;17679500
1251;6.10309e-15;-227;1625;12480;12837;1;325;-2.14748e+09;-5.11931e+06;0;0;0;0;0;0;380233849;383586886;17726268
1251;6.04373e-15;-245;1633;12347;12754;1;311;-2.14748e+09;-5.11931e+06;-1;0;0;0;-1;0;380233849;383586886;17726268
1252;6.10309e-15;-228;1625;12480;12837;1;325;-2.14748e+09;-5.10655e+06;0;0;0;0;0;0;380436712;383803179;17773017
1252;6.04373e-15;-246;1633;12347;12754;1;311;-2.14748e+09;-5.10655e+06;0;0;0;0;0;0;380436712;383803179;17773017
1253;6.10309e-15;-228;1625;12480;12837;1;325;-2.14748e+09;-5.09382e+06;-1;0;0;0;-1;0;380639088;384019002;17819745
1253;6.04373e-15;-246;1633;12347;12754;1;311;-2.14748e+09;-5.09382e+06;-1;0;0;0;-1;0;380639088;384019002;17819745
1254;6.10309e-15;-228;1625;12480;12837;1;325;-2.14748e+09;-5.08115e+06;-1;0;0;0;-1;0;380840979;384234356;17866453
1254;6.04373e-15;-246;1633;12347;12754;1;311;-2.14748e+09;-5.08115e+06;-1;0;0;0;-1;0;380840979;384234356;17866453
1255;6.10309e-15;-228;1625;12480;12837;1;325;-2.14748e+09;-5.06861e+06;-1;0;0;0;-1;0;381042388;384449244;17913139
1255;6.04373e-15;-247;1633;12347;12754;1;311;-2.14748e+09;-5.06861e+06;0;0;0;0;0;0;381042388;384449244;17913139
1256;6.10309e-15;-228;1625;12480;12837;1;325;-2.14748e+09;-5.05592e+06;-1;0;0;0;-1;0;381243314;384663666;17959805
1256;6.04373e-15;-248;1633;12347;12754;1;311;-2.14748e+09;-5.05592e+06;0;0;0;0;0;0;381243314;384663666;17959805
1257;6.10309e-15;-229;1625;12480;12837;1;325;-2.14748e+09;-5.04338e+06;0;0;0;0;0;0;381443760;384877624;18006449
1257;6.04373e-15;-248;1633;12347;12754;1;311;-2.14748e+09;-5.04338e+06;-1;0;0;0;-1;0;381443760;384877624;18006449
1258;6.10309e-15;-229;1625;12480;12837;1;325;-2.14748e+09;-5.03098e+06;-1;0;0;0;-1;0;381643727;385091119;18053072
1258;6.04373e-15;-249;1633;12347;12754;1;311;-2.14748e+09;-5.03098e+06;0;0;0;0;0;0;381643727;385091119;18053072
1259;6.10309e-15;-229;1625;12480;12837;1;325;-2.14748e+09;-5.01842e+06;-1;0;0;0;-1;0;381843216;385304152;18099674
1259;6.04373e-15;-250;1633;12347;12754;1;311;-2.14748e+09;-5.01842e+06;0;0;0;0;0;0;381843216;385304152;18099674
1260;6.10309e-15;-229;1625;12480;12837;1;325;-2.14748e+09;-5.0061e+06;-1;0;0;0;-1;0;382042230;385516726;18146253
1260;6.04373e-15;-250;1633;12347;12754;1;311;-2.14748e+09;-5.0061e+06;-1;0;0;0;-1;0;382042230;385516726;18146253
1261;6.10309e-15;-229;1625;12480;12837;1;325;-2.14748e+09;-4.99363e+06;-1;0;0;0;-1;0;382240769;385728840;18192810
1261;6.04373e-15;-251;1633;12347;12754;1;311;-2.14748e+09;-4.99363e+06;0;0;0;0;0;0;382240769;385728840;18192810
1262;6.10309e-15;-229;1625;12480;12837;1;325;-2.14748e+09;-4.9813e+06;-1;0;0;0;-1;0;382438834;385940497;18239345
1262;6.04373e-15;-252;1633;12347;12754;1;311;-2.14748e+09;-4.9813e+06;0;0;0;0;0;0;382438834;385940497;18239345
1263;6.10309e-15;-229;1625;12480;12837;1;325;-2.14748e+09;-4.96901e+06;-1;0;0;0;-1;0;382636428;386151698;18285857
1263;6.04373e-15;-252;1633;12347;12754;1;311;-2.14748e+09;-4.96901e+06;-1;0;0;0;-1;0;382636428;386151698;18285857
1264;6.10309e-15;-229;1625;12480;12837;1;325;-2.14748e+09;-4.95677e+06;-1;0;0;0;-1;0;382833552;386362445;18332347
1264;6.04373e-15;-253;1633;12347;12754;1;311;-2.14748e+09;-4.95677e+06;0;0;0;0;0;0;382833552;386362445;18332347
1265;6.10309e-15;-230;1625;12480;12837;1;325;-2.14748e+09;-4.94456e+06;0;0;0;0;0;0;383030207;386572737;18378814
1265;6.04373e-15;-254;1633;12347;12754;1;311;-2.14748e+09;-4.94456e+06;0;0;0;0;0;0;383030207;386572737;18378814
1266;6.10309e-15;-231;1625;12480;12837;1;325;-2.14748e+09;-4.9324e+06;0;0;0;0;0;0;383226394;386782578;18425257
1266;6.04373e-15;-255;1633;12347;12754;1;311;-2.14748e+09;-4.9324e+06;0;0;0;0;0;0;383226394;386782578;18425257
1267;6.10309e-15;-231;1625;12480;12837;1;325;-2.14748e+09;-4.92028e+06;-1;0;0;0;-1;0;383422116;386991967;18471678
1267;6.04373e-15;-256;1633;12347;12754;1;311;-2.14748e+09;-4.92028e+06;0;0;0;0;0;0;383422116;386991967;18471678
1268;6.10309e-15;-232;1625;12480;12837;1;325;-2.14748e+09;-4.9082e+06;0;0;0;0;0;0;383617372;387200908;18518074
1268;6.04373e-15;-257;1633;12347;12754;1;311;-2.14748e+09;-4.9082e+06;0;0;0;0;0;0;383617372;387200908;18518074
1269;6.10309e-15;-233;1625;12480;12837;1;325;-2.14748e+09;-4.89617e+06;0;0;0;0;0;0;383812166;387409399;18564448
1269;6.04373e-15;-257;1633;12347;12754;1;311;-2.14748e+09;-4.89617e+06;-1;0;0;0;-1;0;383812166;387409399;18564448
1270;6.10309e-15;-234;1625;12480;12837;1;325;-2.14748e+09;-4.88417e+06;0;0;0;0;0;0;384006497;387617444;18610797
1270;6.04373e-15;-257;1633;12347;12754;1;311;-2.14748e+09;-4.88417e+06;-1;0;0;0;-1;0;384006497;387617444;18610797
1271;6.10309e-15;-234;1625;12480;12837;1;325;-2.14748e+09;-4.87222e+06;-1;0;0;0;-1;0;384200368;387825043;18657122
1271;6.04373e-15;-258;1633;12347;12754;1;311;-2.14748e+09;-4.87222e+06;0;0;0;0;0;0;384200368;387825043;18657122
1272;6.10309e-15;-235;1625;12480;12837;1;325;-2.14748e+09;-4.8603e+06;0;0;0;0;0;0;384393780;388032198;18703423
1272;6.04373e-15;-259;1633;12347;12754;1;311;-2.14748e+09;-4.8603e+06;0;0;0;0;0;0;384393780;388032198;18703423
1273;6.10309e-15;-235;1625;12480;12837;1;325;-2.14748e+09;-4.84843e+06;-1;0;0;0;-1;0;384586734;388238910;18749699
1273;6.04373e-15;-260;1633;12347;12754;1;311;-2.14748e+09;-4.84843e+06;0;0;0;0;0;0;384586734;388238910;18749699
1274;6.10309e-15;-235;1625;12480;12837;1;325;-2.14748e+09;-4.83659e+06;-1;0;0;0;-1;0;384779231;388445179;18795951
1274;6.04373e-15;-261;1633;12347;12754;1;311;-2.14748e+09;-4.83659e+06;0;0;0;0;0;0;384779231;388445179;18795951
1275;6.10309e-15;-235;1625;12480;12837;1;325;-2.14748e+09;-4.8248e+06;-1;0;0;0;-1;0;384971273;388651008;18842178
1275;6.04373e-15;-261;1633;12347;12754;1;311;-2.14748e+09;-4.8248e+06;-1;0;0;0;-1;0;384971273;388651008;18842178
1276;6.10309e-15;-235;1625;12480;12837;1;325;-2.14748e+09;-4.81304e+06;-1;0;0;0;-1;0;385162862;388856398;18888380
1276;6.04373e-15;-261;1633;12347;12754;1;311;-2.14748e+09;-4.81304e+06;-1;0;0;0;-1;0;385162862;388856398;18888380
1277;6.10309e-15;-236;1625;12480;12837;1;325;-2.14748e+09;-4.80133e+06;0;0;0;0;0;0;385353998;389061350;18934557
1277;6.04373e-15;-262;1633;12347;12754;1;311;-2.14748e+09;-4.80133e+06;0;0;0;0;0;0;385353998;389061350;18934557
1278;6.10309e-15;-236;1625;12480;12837;1;325;-2.14748e+09;-4.78965e+06;-1;0;0;0;-1;0;385544684;389265865;18980708
1278;6.04373e-15;-263;1633;12347;12754;1;311;-2.14748e+09;-4.78965e+06;0;0;0;0;0;0;385544684;389265865;18980708
1279;6.10309e-15;-237;1625;12480;12837;1;325;-2.14748e+09;-4.77802e+06;0;0;0;0;0;0;385734919;389469944;19026834
1279;6.04373e-15;-263;1633;12347;12754;1;311;-2.14748e+09;-4.77802e+06;-1;0;0;0;-1;0;385734919;389469944;19026834
1280;6.10309e-15;-238;1625;12480;12837;1;325;-2.14748e+09;-4.76642e+06;0;0;0;0;0;0;385924707;389673589;19072933
1280;6.04373e-15;-264;1633;12347;12754;1;311;-2.14748e+09;-4.76642e+06;0;0;0;0;0;0;385924707;389673589;19072933
1281;6.10309e-15;-238;1625;12480;12837;1;325;-2.14748e+09;-4.75486e+06;-1;0;0;0;-1;0;386114047;389876800;19119007
1281;6.04373e-15;-264;1633;12347;12754;1;311;-2.14748e+09;-4.75486e+06;-1;0;0;0;-1;0;386114047;389876800;19119007
1282;6.10309e-15;-239;1625;12480;12837;1;325;-2.14748e+09;-4.74334e+06;0;0;0;0;0;0;386302942;390079580;19165055
1282;6.04373e-15;-265;1633;12347;12754;1;311;-2.14748e+09;-4.74334e+06;0;0;0;0;0;0;386302942;390079580;19165055
1283;6.10309e-15;-239;1625;12480;12837;1;325;-2.14748e+09;-4.73186e+06;-1;0;0;0;-1;0;386491392;390281929;19211077
1283;6.04373e-15;-266;1633;12347;12754;1;311;-2.14748e+09;-4.73186e+06;0;0;0;0;0;0;386491392;390281929;19211077
1284;6.10309e-15;-239;1625;12480;12837;1;325;-2.14748e+09;-4.72042e+06;-1;0;0;0;-1;0;386679399;390483849;19257072
1284;6.04373e-15;-266;1633;12347;12754;1;311;-2.14748e+09;-4.72042e+06;-1;0;0;0;-1;0;386679399;390483849;19257072
1285;6.10309e-15;-240;1625;12480;12837;1;325;-2.14748e+09;-4.70901e+06;0;0;0;0;0;0;386866964;390685340;19303041
1285;6.04373e-15;-267;1633;12347;12754;1;311;-2.14748e+09;-4.70901e+06;0;0;0;0;0;0;386866964;390685340;19303041
1286;6.10309e-15;-240;1625;12480;12837;1;325;-2.14748e+09;-4.69764e+06;-1;0;0;0;-1;0;387054089;390886404;19348982
1286;6.04373e-15;-267;1633;12347;12754;1;311;-2.14748e+09;-4.69764e+06;-1;0;0;0;-1;0;387054089;390886404;19348982
1287;6.10309e-15;-240;1625;12480;12837;1;325;-2.14748e+09;-4.68631e+06;-1;0;0;0;-1;0;387240775;391087043;19394897
1287;6.04373e-15;-267;1633;12347;12754;1;311;-2.14748e+09;-4.68631e+06;-1;0;0;0;-1;0;387240775;391087043;19394897
1288;6.10309e-15;-241;1625;12480;12837;1;325;-2.14748e+09;-4.67502e+06;0;0;0;0;0;0;387427022;391287257;19440784
1288;6.04373e-15;-267;1633;12347;12754;1;311;-2.14748e+09;-4.67502e+06;-1;0;0;0;-1;0;387427022;391287257;19440784
1289;6.10309e-15;-241;1625;12480;12837;1;325;-2.14748e+09;-4.66377e+06;-1;0;0;0;-1;0;387612833;391487047;19486644
1289;6.04373e-15;-268;1633;12347;12754;1;311;-2.14748e+09;-4.66377e+06;0;0;0;0;0;0;387612833;391487047;19486644
1290;6.10309e-15;-242;1625;12480;12837;1;325;-2.14748e+09;-4.65255e+06;0;0;0;0;0;0;387798209;391686415;19532477
1290;6.04373e-15;-268;1633;12347;12754;1;311;-2.14748e+09;-4.65255e+06;-1;0;0;0;-1;0;387798209;391686415;19532477
1291;6.10309e-15;-243;1625;12480;12837;1;325;-2.14748e+09;-4.64137e+06;0;0;0;0;0;0;387983151;391885362;19578282
1291;6.04373e-15;-269;1633;12347;12754;1;311;-2.14748e+09;-4.64137e+06;0;0;0;0;0;0;387983151;391885362;19578282
1292;6.10309e-15;-243;1625;12480;12837;1;325;-2.14748e+09;-4.63022e+06;-1;0;0;0;-1;0;388167660;392083889;19624059
1292;6.04373e-15;-270;1633;12347;12754;1;311;-2.14748e+09;-4.63022e+06;0;0;0;0;0;0;388167660;392083889;19624059
1293;6.10309e-15;-244;1625;12480;12837;1;325;-2.14748e+09;-4.61922e+06;0;0;0;0;0;0;388351737;392281997;19669808
1293;6.04373e-15;-271;1633;12347;12754;1;311;-2.14748e+09;-4.61922e+06;0;0;0;0;0;0;388351737;392281997;19669808
1294;6.10309e-15;-245;1625;12480;12837;1;325;-2.14748e+09;-4.60805e+06;0;0;0;0;0;0;388535384;392479688;19715529
1294;6.04373e-15;-271;1633;12347;12754;1;311;-2.14748e+09;-4.60805e+06;-1;0;0;0;-1;0;388535384;392479688;19715529
1295;6.10309e-15;-246;1625;12480;12837;1;325;-2.14748e+09;-4.59701e+06;0;0;0;0;0;0;388718602;392676962;19761222
1295;6.04373e-15;-271;1633;12347;12754;1;311;-2.14748e+09;-4.59701e+06;-1;0;0;0;-1;0;388718602;392676962;19761222
1296;6.10309e-15;-247;1625;12480;12837;1;325;-2.14748e+09;-4.58601e+06;0;0;0;0;0;0;388901393;392873821;19806886
1296;6.04373e-15;-272;1633;12347;12754;1;311;-2.14748e+09;-4.58601e+06;0;0;0;0;0;0;388901393;392873821;19806886
1297;6.10309e-15;-247;1625;12480;12837;1;325;-2.14748e+09;-4.57505e+06;-1;0;0;0;-1;0;389083757;393070266;19852521
1297;6.04373e-15;-273;1633;12347;12754;1;311;-2.14748e+09;-4.57505e+06;0;0;0;0;0;0;389083757;393070266;19852521
1298;6.10309e-15;-248;1625;12480;12837;1;325;-2.14748e+09;-4.56412e+06;0;0;0;0;0;0;389265695;393266298;19898128
1298;6.04373e-15;-274;1633;12347;12754;1;311;-2.14748e+09;-4.56412e+06;0;0;0;0;0;0;389265695;393266298;19898128
1299;6.10309e-15;-248;1625;12480;12837;1;325;-2.14748e+09;-4.55323e+06;-1;0;0;0;-1;0;389447210;393461918;19943706
1299;6.04373e-15;-275;1633;12347;12754;1;311;-2.14748e+09;-4.55323e+06;0;0;0;0;0;0;389447210;393461918;19943706
1300;6.10309e-15;-249;1625;12480;12837;1;325;-2.14748e+09;-4.54238e+06;0;0;0;0;0;0;389628301;393657127;19989254
1300;6.04373e-15;-276;1633;12347;12754;1;311;-2.14748e+09;-4.54238e+06;0;0;0;0;0;0;389628301;393657127;19989254
1301;6.10309e-15;-249;1625;12480;12837;1;325;-2.14748e+09;-4.53156e+06;-1;0;0;0;-1;0;389808971;393851927;20034774
1301;6.04373e-15;-276;1633;12347;12754;1;311;-2.14748e+09;-4.53156e+06;-1;0;0;0;-1;0;389808971;393851927;20034774
1302;6.10309e-15;-249;1625;12480;12837;1;325;-2.14748e+09;-4.52077e+06;-1;0;0;0;-1;0;389989221;394046318;20080263
1302;6.04373e-15;-277;1633;12347;12754;1;311;-2.14748e+09;-4.52077e+06;0;0;0;0;0;0;389989221;394046318;20080263
1303;6.10309e-15;-250;1625;12480;12837;1;325;-2.14748e+09;-4.51002e+06;0;0;0;0;0;0;390169052;394240303;20125724
1303;6.04373e-15;-278;1633;12347;12754;1;311;-2.14748e+09;-4.51002e+06;0;0;0;0;0;0;390169052;394240303;20125724
1304;6.10309e-15;-250;1625;12480;12837;1;325;-2.14748e+09;-4.4993e+06;-1;0;0;0;-1;0;390348464;394433880;20171154
1304;6.04373e-15;-278;1633;12347;12754;1;311;-2.14748e+09;-4.4993e+06;-1;0;0;0;-1;0;390348464;394433880;20171154
1305;6.10309e-15;-251;1625;12480;12837;1;325;-2.14748e+09;-4.48862e+06;0;0;0;0;0;0;390527460;394627053;20216554
1305;6.04373e-15;-279;1633;12347;12754;1;311;-2.14748e+09;-4.48862e+06;0;0;0;0;0;0;390527460;394627053;20216554
1306;6.10309e-15;-252;1625;12480;12837;1;325;-2.14748e+09;-4.47798e+06;0;0;0;0;0;0;390706040;394819822;20261925
1306;6.04373e-15;-280;1633;12347;12754;1;311;-2.14748e+09;-4.47798e+06;0;0;0;0;0;0;390706040;394819822;20261925
1307;6.10309e-15;-252;1625;12480;12837;1;325;-2.14748e+09;-4.46736e+06;-1;0;0;0;-1;0;390884206;395012188;20307265
1307;6.04373e-15;-280;1633;12347;12754;1;311;-2.14748e+09;-4.46736e+06;-1;0;0;0;-1;0;390884206;395012188;20307265
1308;6.10309e-15;-253;1625;12480;12837;1;325;-2.14748e+09;-4.45678e+06;0;0;0;0;0;0;391061959;395204152;20352575
1308;6.04373e-15;-280;1633;12347;12754;1;311;-2.14748e+09;-4.45678e+06;-1;0;0;0;-1;0;391061959;395204152;20352575
1309;6.10309e-15;-254;1625;12480;12837;1;325;-2.14748e+09;-4.44624e+06;0;0;0;0;0;0;391239300;395395716;20397855
1309;6.04373e-15;-280;1633;12347;12754;1;311;-2.14748e+09;-4.44624e+06;-1;0;0;0;-1;0;391239300;395395716;20397855
1310;6.10309e-15;-254;1625;12480;12837;1;325;-2.14748e+09;-4.43573e+06;-1;0;0;0;-1;0;391416230;395586880;20443103
1310;6.04373e-15;-280;1633;12347;12754;1;311;-2.14748e+09;-4.43573e+06;-1;0;0;0;-1;0;391416230;395586880;20443103
1311;6.10309e-15;-255;1625;12480;12837;1;325;-2.14748e+09;-4.42525e+06;0;0;0;0;0;0;391592750;395777646;20488321
1311;6.04373e-15;-280;1633;12347;12754;1;311;-2.14748e+09;-4.42525e+06;-1;0;0;0;-1;0;391592750;395777645;20488321
1312;6.10309e-15;-256;1625;12480;12837;1;325;-2.14748e+09;-4.41481e+06;0;0;0;0;0;0;391768862;395968014;20533508
1312;6.04373e-15;-281;1633;12347;12754;1;311;-2.14748e+09;-4.41481e+06;0;0;0;0;0;0;391768862;395968014;20533508
1313;6.10309e-15;-256;1625;12480;12837;1;325;-2.14748e+09;-4.4044e+06;-1;0;0;0;-1;0;391944567;396157985;20578664
1313;6.04373e-15;-282;1633;12347;12754;1;311;-2.14748e+09;-4.4044e+06;0;0;0;0;0;0;391944567;396157985;20578664
1314;6.10309e-15;-256;1625;12480;12837;1;325;-2.14748e+09;-4.39412e+06;-1;0;0;0;-1;0;392119866;396347562;20623789
1314;6.04373e-15;-283;1633;12347;12754;1;311;-2.14748e+09;-4.39412e+06;0;0;0;0;0;0;392119866;396347562;20623789
1315;6.10309e-15;-256;1624;12480;12837;1;325;-2.14748e+09;-4.38378e+06;0;0;0;0;0;0;392294760;396536744;20668882
1315;6.04373e-15;-284;1633;12347;12754;1;311;-2.14748e+09;-4.38378e+06;0;0;0;0;0;0;392294760;396536744;20668882
1316;6.10309e-15;-257;1624;12480;12837;1;325;-2.14748e+09;-4.37336e+06;0;0;0;0;0;0;392469249;396725534;20713944
1316;6.04373e-15;-285;1633;12347;12754;1;311;-2.14748e+09;-4.37336e+06;0;0;0;0;0;0;392469249;396725534;20713944
1317;6.10309e-15;-257;1624;12480;12837;1;325;-2.14748e+09;-4.36308e+06;-1;0;0;0;-1;0;392643337;396913931;20758974
1317;6.04373e-15;-286;1633;12347;12754;1;311;-2.14748e+09;-4.36308e+06;0;0;0;0;0;0;392643337;396913931;20758974
1318;6.10309e-15;-258;1624;12480;12837;1;325;-2.14748e+09;-4.35284e+06;0;0;0;0;0;0;392817023;397101937;20803972
1318;6.04373e-15;-287;1633;12347;12754;1;311;-2.14748e+09;-4.35284e+06;0;0;0;0;0;0;392817023;397101937;20803972
1319;6.10309e-15;-258;1624;12480;12837;1;325;-2.14748e+09;-4.34272e+06;-1;0;0;0;-1;0;392990308;397289553;20848939
1319;6.04373e-15;-288;1633;12347;12754;1;311;-2.14748e+09;-4.34272e+06;0;0;0;0;0;0;392990308;397289553;20848939
1320;6.10309e-15;-259;1624;12480;12837;1;325;-2.14748e+09;-4.33244e+06;0;0;0;0;0;0;393163194;397476781;20893873
1320;6.04373e-15;-289;1633;12347;12754;1;311;-2.14748e+09;-4.33244e+06;0;0;0;0;0;0;393163194;397476781;20893873
1321;6.10309e-15;-260;1624;12480;12837;1;325;-2.14748e+09;-4.32229e+06;0;0;0;0;0;0;393335683;397663620;20938775
1321;6.04373e-15;-289;1633;12347;12754;1;311;-2.14748e+09;-4.32229e+06;-1;0;0;0;-1;0;393335683;397663620;20938775
1322;6.10309e-15;-260;1624;12480;12837;1;325;-2.14748e+09;-4.31218e+06;-1;0;0;0;-1;0;393507774;397850073;20983645
1322;6.04373e-15;-289;1633;12347;12754;1;311;-2.14748e+09;-4.31218e+06;-1;0;0;0;-1;0;393507774;397850073;20983645
1323;6.10309e-15;-261;1624;12480;12837;1;325;-2.14748e+09;-4.30209e+06;0;0;0;0;0;0;393679469;398036140;21028482
1323;6.04373e-15;-289;1633;12347;12754;1;311;-2.14748e+09;-4.30209e+06;-1;0;0;0;-1;0;393679469;398036140;21028482
1324;6.10309e-15;-262;1624;12480;12837;1;325;-2.14748e+09;-4.29204e+06;0;0;0;0;0;0;393850770;398221823;21073287
1324;6.04373e-15;-290;1633;12347;12754;1;311;-2.14748e+09;-4.29204e+06;0;0;0;0;0;0;393850770;398221823;21073287
1325;6.10309e-15;-263;1624;12480;12837;1;325;-2.14748e+09;-4.28201e+06;0;0;0;0;0;0;394021677;398407121;21118059
1325;6.04373e-15;-290;1633;12347;12754;1;311;-2.14748e+09;-4.28201e+06;-1;0;0;0;-1;0;394021677;398407121;21118059
1326;6.10309e-15;-264;1624;12480;12837;1;325;-2.14748e+09;-4.27202e+06;0;0;0;0;0;0;394192192;398592037;21162798
1326;6.04373e-15;-291;1633;12347;12754;1;311;-2.14748e+09;-4.27202e+06;0;0;0;0;0;0;394192192;398592037;21162798
1327;6.10309e-15;-265;1624;12480;12837;1;325;-2.14748e+09;-4.26206e+06;0;0;0;0;0;0;394362315;398776571;21207504
1327;6.04373e-15;-291;1633;12347;12754;1;311;-2.14748e+09;-4.26206e+06;-1;0;0;0;-1;0;394362315;398776571;21207504
1328;6.10309e-15;-265;1624;12480;12837;1;325;-2.14748e+09;-4.25213e+06;-1;0;0;0;-1;0;394532048;398960725;21252178
1328;6.04373e-15;-291;1633;12347;12754;1;311;-2.14748e+09;-4.25213e+06;-1;0;0;0;-1;0;394532048;398960725;21252178
1329;6.10309e-15;-266;1624;12480;12837;1;325;-2.14748e+09;-4.24224e+06;0;0;0;0;0;0;394701392;399144499;21296817
1329;6.04373e-15;-291;1633;12347;12754;1;311;-2.14748e+09;-4.24224e+06;-1;0;0;0;-1;0;394701392;399144499;21296817
1330;6.10309e-15;-267;1624;12480;12837;1;325;-2.14748e+09;-4.23237e+06;0;0;0;0;0;0;394870348;399327894;21341424
1330;6.04373e-15;-291;1633;12347;12754;1;311;-2.14748e+09;-4.23237e+06;-1;0;0;0;-1;0;394870348;399327894;21341424
1331;6.10309e-15;-267;1624;12480;12837;1;325;-2.14748e+09;-4.22263e+06;-1;0;0;0;-1;0;395038917;399510912;21385997
1331;6.04373e-15;-291;1633;12347;12754;1;311;-2.14748e+09;-4.22263e+06;-1;0;0;0;-1;0;395038917;399510912;21385997
1332;6.10309e-15;-267;1624;12480;12837;1;325;-2.14748e+09;-4.21272e+06;-1;0;0;0;-1;0;395207100;399693553;21430536
1332;6.04373e-15;-292;1633;12347;12754;1;311;-2.14748e+09;-4.21272e+06;0;0;0;0;0;0;395207100;399693553;21430536
1333;6.10309e-15;-268;1624;12480;12837;1;325;-2.14748e+09;-4.20295e+06;0;0;0;0;0;0;395374899;399875819;21475041
1333;6.04373e-15;-292;1633;12347;12754;1;311;-2.14748e+09;-4.20295e+06;-1;0;0;0;-1;0;395374899;399875819;21475041
1334;6.10309e-15;-269;1624;12480;12837;1;325;-2.14748e+09;-4.1932e+06;0;0;0;0;0;0;395542313;400057709;21519513
1334;6.04373e-15;-293;1633;12347;12754;1;311;-2.14748e+09;-4.1932e+06;0;0;0;0;0;0;395542313;400057709;21519513
1335;6.10309e-15;-269;1624;12480;12837;1;325;-2.14748e+09;-4.18359e+06;-1;0;0;0;-1;0;395709345;400239227;21563951
1335;6.04373e-15;-294;1633;12347;12754;1;311;-2.14748e+09;-4.18359e+06;0;0;0;0;0;0;395709345;400239227;21563951
1336;6.10309e-15;-269;1624;12480;12837;1;325;-2.14748e+09;-4.1738e+06;-1;0;0;0;-1;0;395875996;400420371;21608354
1336;6.04373e-15;-294;1633;12347;12754;1;311;-2.14748e+09;-4.1738e+06;-1;0;0;0;-1;0;395875996;400420371;21608354
1337;6.10309e-15;-270;1624;12480;12837;1;325;-2.14748e+09;-4.16415e+06;0;0;0;0;0;0;396042265;400601144;21652724
1337;6.04373e-15;-294;1633;12347;12754;1;311;-2.14748e+09;-4.16415e+06;-1;0;0;0;-1;0;396042265;400601144;21652724
1338;6.10309e-15;-271;1624;12480;12837;1;325;-2.14748e+09;-4.15452e+06;0;0;0;0;0;0;396208156;400781546;21697059
1338;6.04373e-15;-295;1633;12347;12754;1;311;-2.14748e+09;-4.15452e+06;0;0;0;0;0;0;396208156;400781546;21697059
1339;6.10309e-15;-272;1624;12480;12837;1;325;-2.14748e+09;-4.14502e+06;0;0;0;0;0;0;396373668;400961579;21741359
1339;6.04373e-15;-296;1633;12347;12754;1;311;-2.14748e+09;-4.14502e+06;0;0;0;0;0;0;396373668;400961579;21741359
1340;6.10309e-15;-272;1624;12480;12837;1;325;-2.14748e+09;-4.13536e+06;-1;0;0;0;-1;0;396538803;401141242;21785625
1340;6.04373e-15;-296;1633;12347;12754;1;311;-2.14748e+09;-4.13536e+06;-1;0;0;0;-1;0;396538803;401141242;21785625
1341;6.10309e-15;-272;1624;12480;12837;1;325;-2.14748e+09;-4.12582e+06;-1;0;0;0;-1;0;396703561;401320538;21829856
1341;6.04373e-15;-296;1633;12347;12754;1;311;-2.14748e+09;-4.12582e+06;-1;0;0;0;-1;0;396703561;401320538;21829856
1342;6.10309e-15;-272;1624;12480;12837;1;325;-2.14748e+09;-4.11631e+06;-1;0;0;0;-1;0;396867944;401499467;21874053
1342;6.04373e-15;-296;1633;12347;12754;1;311;-2.14748e+09;-4.11631e+06;-1;0;0;0;-1;0;396867944;401499467;21874053
1343;6.10309e-15;-273;1624;12480;12837;1;325;-2.14748e+09;-4.10683e+06;0;0;0;0;0;0;397031954;401678030;21918214
1343;6.04373e-15;-297;1633;12347;12754;1;311;-2.14748e+09;-4.10683e+06;0;0;0;0;0;0;397031954;401678030;21918214
1344;6.10309e-15;-274;1624;12480;12837;1;325;-2.14748e+09;-4.09738e+06;0;0;0;0;0;0;397195590;401856229;21962340
1344;6.04373e-15;-297;1633;12347;12754;1;311;-2.14748e+09;-4.09738e+06;-1;0;0;0;-1;0;397195590;401856229;21962340
1345;6.10309e-15;-274;1624;12480;12837;1;325;-2.14748e+09;-4.08796e+06;-1;0;0;0;-1;0;397358853;402034063;22006432
1345;6.04373e-15;-298;1633;12347;12754;1;311;-2.14748e+09;-4.08796e+06;0;0;0;0;0;0;397358853;402034063;22006432
1346;6.10309e-15;-274;1624;12480;12837;1;325;-2.14748e+09;-4.07857e+06;-1;0;0;0;-1;0;397521746;402211534;22050488
1346;6.04373e-15;-298;1633;12347;12754;1;311;-2.14748e+09;-4.07857e+06;-1;0;0;0;-1;0;397521746;402211534;22050488
1347;6.10309e-15;-274;1624;12480;12837;1;325;-2.14748e+09;-4.06921e+06;-1;0;0;0;-1;0;397684269;402388643;22094508
1347;6.04373e-15;-299;1633;12347;12754;1;311;-2.14748e+09;-4.0692e+06;0;0;0;0;0;0;397684269;402388643;22094508
1348;6.10309e-15;-275;1624;12480;12837;1;325;-2.14748e+09;-4.05987e+06;0;0;0;0;0;0;397846423;402565391;22138493
1348;6.04373e-15;-300;1633;12347;12754;1;311;-2.14748e+09;-4.05987e+06;0;0;0;0;0;0;397846423;402565391;22138493
1349;6.10309e-15;-276;1624;12480;12837;1;325;-2.14748e+09;-4.05056e+06;0;0;0;0;0;0;398008209;402741779;22182443
1349;6.04373e-15;-300;1633;12347;12754;1;311;-2.14748e+09;-4.05056e+06;-1;0;0;0;-1;0;398008209;402741779;22182443
1350;6.10309e-15;-277;1624;12480;12837;1;325;-2.14748e+09;-4.04128e+06;0;0;0;0;0;0;398169628;402917808;22226356
1350;6.04373e-15;-300;1633;12347;12754;1;311;-2.14748e+09;-4.04128e+06;-1;0;0;0;-1;0;398169628;402917808;22226356
1351;6.10309e-15;-278;1624;12480;12837;1;325;-2.14748e+09;-4.03203e+06;0;0;0;0;0;0;398330681;403093478;22270234
1351;6.04373e-15;-301;1633;12347;12754;1;311;-2.14748e+09;-4.03203e+06;0;0;0;0;0;0;398330681;403093478;22270234
1352;6.10309e-15;-278;1623;12480;12837;1;325;-2.14748e+09;-4.02281e+06;0;0;0;0;0;0;398491369;403268791;22314076
1352;6.04373e-15;-301;1633;12347;12754;1;311;-2.14748e+09;-4.02281e+06;-1;0;0;0;-1;0;398491369;403268791;22314076
1353;6.10309e-15;-278;1623;12480;12837;1;325;-2.14748e+09;-4.01361e+06;-1;0;0;0;-1;0;398651693;403443747;22357882
1353;6.04373e-15;-301;1633;12347;12754;1;311;-2.14748e+09;-4.01361e+06;-1;0;0;0;-1;0;398651693;403443747;22357882
1354;6.10309e-15;-279;1623;12480;12837;1;325;-2.14748e+09;-4.00444e+06;0;0;0;0;0;0;398811654;403618348;22401652
1354;6.04373e-15;-302;1633;12347;12754;1;311;-2.14748e+09;-4.00444e+06;0;0;0;0;0;0;398811654;403618348;22401652
1355;6.10309e-15;-279;1623;12480;12837;1;325;-2.14748e+09;-3.9953e+06;-1;0;0;0;-1;0;398971253;403792594;22445386
1355;6.04373e-15;-303;1633;12347;12754;1;311;-2.14748e+09;-3.9953e+06;0;0;0;0;0;0;398971253;403792594;22445386
1356;6.10309e-15;-279;1623;12480;12837;1;325;-2.14748e+09;-3.98619e+06;-1;0;0;0;-1;0;399130491;403966486;22489083
1356;6.04373e-15;-303;1633;12347;12754;1;311;-2.14748e+09;-3.98619e+06;-1;0;0;0;-1;0;399130491;403966486;22489083
1357;6.10309e-15;-280;1623;12480;12837;1;325;-2.14748e+09;-3.9772e+06;0;0;0;0;0;0;399289370;404140026;22532744
1357;6.04373e-15;-303;1633;12347;12754;1;311;-2.14748e+09;-3.9772e+06;-1;0;0;0;-1;0;399289370;404140026;22532744
1358;6.10309e-15;-281;1623;12480;12837;1;325;-2.14748e+09;-3.96815e+06;0;0;0;0;0;0;399447889;404313214;22576368
1358;6.04373e-15;-304;1633;12347;12754;1;311;-2.14748e+09;-3.96815e+06;0;0;0;0;0;0;399447889;404313214;22576368
1359;6.10309e-15;-281;1623;12480;12837;1;325;-2.14748e+09;-3.95912e+06;-1;0;0;0;-1;0;399606050;404486050;22619956
1359;6.04373e-15;-304;1633;12347;12754;1;311;-2.14748e+09;-3.95912e+06;-1;0;0;0;-1;0;399606050;404486050;22619956
1360;6.10309e-15;-281;1623;12480;12837;1;325;-2.14748e+09;-3.95001e+06;-1;0;0;0;-1;0;399763855;404658537;22663507
1360;6.04373e-15;-304;1633;12347;12754;1;311;-2.14748e+09;-3.95001e+06;-1;0;0;0;-1;0;399763855;404658537;22663507
1361;6.10309e-15;-282;1623;12480;12837;1;325;-2.14748e+09;-3.94103e+06;0;0;0;0;0;0;399921303;404830674;22707021
1361;6.04373e-15;-304;1633;12347;12754;1;311;-2.14748e+09;-3.94103e+06;-1;0;0;0;-1;0;399921303;404830674;22707021
1362;6.10309e-15;-282;1623;12480;12837;1;325;-2.14748e+09;-3.93218e+06;-1;0;0;0;-1;0;400078397;405002463;22750498
1362;6.04373e-15;-304;1633;12347;12754;1;311;-2.14748e+09;-3.93218e+06;-1;0;0;0;-1;0;400078397;405002463;22750498
1363;6.10309e-15;-282;1623;12480;12837;1;325;-2.14748e+09;-3.92316e+06;-1;0;0;0;-1;0;400235136;405173904;22793938
1363;6.04373e-15;-305;1633;12347;12754;1;311;-2.14748e+09;-3.92316e+06;0;0;0;0;0;0;400235136;405173904;22793938
1364;6.10309e-15;-283;1623;12480;12837;1;325;-2.14748e+09;-3.91426e+06;0;0;0;0;0;0;400391522;405344999;22837341
1364;6.04373e-15;-306;1633;12347;12754;1;311;-2.14748e+09;-3.91426e+06;0;0;0;0;0;0;400391522;405344999;22837341
1365;6.10309e-15;-284;1623;12480;12837;1;325;-2.14748e+09;-3.90539e+06;0;0;0;0;0;0;400547556;405515748;22880707
1365;6.04373e-15;-306;1633;12347;12754;1;311;-2.14748e+09;-3.90539e+06;-1;0;0;0;-1;0;400547556;405515748;22880707
1366;6.10309e-15;-284;1623;12480;12837;1;325;-2.14748e+09;-3.89665e+06;-1;0;0;0;-1;0;400703239;405686152;22924036
1366;6.04373e-15;-306;1633;12347;12754;1;311;-2.14748e+09;-3.89665e+06;-1;0;0;0;-1;0;400703239;405686152;22924036
1367;6.10309e-15;-284;1623;12480;12837;1;325;-2.14748e+09;-3.88783e+06;-1;0;0;0;-1;0;400858572;405856213;22967327
1367;6.04373e-15;-307;1633;12347;12754;1;311;-2.14748e+09;-3.88783e+06;0;0;0;0;0;0;400858572;405856213;22967327
1368;6.10309e-15;-284;1623;12480;12837;1;325;-2.14748e+09;-3.87903e+06;-1;0;0;0;-1;0;401013555;406025930;23010580
1368;6.04373e-15;-308;1633;12347;12754;1;311;-2.14748e+09;-3.87903e+06;0;0;0;0;0;0;401013555;406025930;23010580
1369;6.10309e-15;-284;1623;12480;12837;1;325;-2.14748e+09;-3.87017e+06;-1;0;0;0;-1;0;401168190;406195305;23053796
1369;6.04373e-15;-309;1633;12347;12754;1;311;-2.14748e+09;-3.87017e+06;0;0;0;0;0;0;401168190;406195305;23053796
1370;6.10309e-15;-285;1623;12480;12837;1;325;-2.14748e+09;-3.86153e+06;0;0;0;0;0;0;401322478;406364339;23096974
1370;6.04373e-15;-310;1633;12347;12754;1;311;-2.14748e+09;-3.86153e+06;0;0;0;0;0;0;401322478;406364339;23096974
1371;6.10309e-15;-286;1623;12480;12837;1;325;-2.14748e+09;-3.85271e+06;0;0;0;0;0;0;401476419;406533032;23140115
1371;6.04373e-15;-310;1633;12347;12754;1;311;-2.14748e+09;-3.85271e+06;-1;0;0;0;-1;0;401476419;406533032;23140115
1372;6.10309e-15;-287;1623;12480;12837;1;325;-2.14748e+09;-3.84402e+06;0;0;0;0;0;0;401630015;406701386;23183217
1372;6.04373e-15;-310;1633;12347;12754;1;311;-2.14748e+09;-3.84402e+06;-1;0;0;0;-1;0;401630015;406701386;23183217
1373;6.10309e-15;-288;1623;12480;12837;1;325;-2.14748e+09;-3.83536e+06;0;0;0;0;0;0;401783267;406869401;23226282
1373;6.04373e-15;-311;1633;12347;12754;1;311;-2.14748e+09;-3.83536e+06;0;0;0;0;0;0;401783267;406869401;23226282
1374;6.10309e-15;-288;1623;12480;12837;1;325;-2.14748e+09;-3.82672e+06;-1;0;0;0;-1;0;401936174;407037078;23269309
1374;6.04373e-15;-311;1633;12347;12754;1;311;-2.14748e+09;-3.82672e+06;-1;0;0;0;-1;0;401936174;407037078;23269309
1375;6.10309e-15;-289;1623;12480;12837;1;325;-2.14748e+09;-3.81811e+06;0;0;0;0;0;0;402088739;407204418;23312297
1375;6.04373e-15;-312;1633;12347;12754;1;311;-2.14748e+09;-3.81811e+06;0;0;0;0;0;0;402088739;407204418;23312297
1376;6.10309e-15;-289;1623;12480;12837;1;325;-2.14748e+09;-3.80952e+06;-1;0;0;0;-1;0;402240963;407371421;23355247
1376;6.04373e-15;-313;1633;12347;12754;1;311;-2.14748e+09;-3.80952e+06;0;0;0;0;0;0;402240963;407371421;23355247
1377;6.10309e-15;-290;1623;12480;12837;1;325;-2.14748e+09;-3.80096e+06;0;0;0;0;0;0;402392845;407538090;23398159
1377;6.04373e-15;-313;1633;12347;12754;1;311;-2.14748e+09;-3.80096e+06;-1;0;0;0;-1;0;402392845;407538090;23398159
1378;6.10309e-15;-290;1623;12480;12837;1;325;-2.14748e+09;-3.79242e+06;-1;0;0;0;-1;0;402544388;407704424;23441033
1378;6.04373e-15;-313;1633;12347;12754;1;311;-2.14748e+09;-3.79242e+06;-1;0;0;0;-1;0;402544388;407704424;23441033
1379;6.10309e-15;-290;1623;12480;12837;1;325;-2.14748e+09;-3.7839e+06;-1;0;0;0;-1;0;402695591;407870424;23483868
1379;6.04373e-15;-313;1633;12347;12754;1;311;-2.14748e+09;-3.78391e+06;-1;0;0;0;-1;0;402695591;407870424;23483868
1380;6.10309e-15;-291;1623;12480;12837;1;325;-2.14748e+09;-3.77542e+06;0;0;0;0;0;0;402846457;408036091;23526664
1380;6.04373e-15;-314;1633;12347;12754;1;311;-2.14748e+09;-3.77542e+06;0;0;0;0;0;0;402846457;408036091;23526664
1381;6.10309e-15;-291;1623;12480;12837;1;325;-2.14748e+09;-3.76695e+06;-1;0;0;0;-1;0;402996985;408201426;23569422
1381;6.04373e-15;-314;1633;12347;12754;1;311;-2.14748e+09;-3.76695e+06;-1;0;0;0;-1;0;402996985;408201426;23569422
1382;6.10309e-15;-292;1623;12480;12837;1;325;-2.14748e+09;-3.75851e+06;0;0;0;0;0;0;403147177;408366431;23612141
1382;6.04373e-15;-314;1633;12347;12754;1;311;-2.14748e+09;-3.75851e+06;-1;0;0;0;-1;0;403147177;408366431;23612141
1383;6.10309e-15;-293;1623;12480;12837;1;325;-2.14748e+09;-3.7501e+06;0;0;0;0;0;0;403297034;408531104;23654822
1383;6.04373e-15;-314;1633;12347;12754;1;311;-2.14748e+09;-3.7501e+06;-1;0;0;0;-1;0;403297034;408531104;23654822
1384;6.10309e-15;-294;1623;12480;12837;1;325;-2.14748e+09;-3.74171e+06;0;0;0;0;0;0;403446556;408695448;23697463
1384;6.04373e-15;-315;1633;12347;12754;1;311;-2.14748e+09;-3.74171e+06;0;0;0;0;0;0;403446556;408695448;23697463
1385;6.10309e-15;-295;1623;12480;12837;1;325;-2.14748e+09;-3.73334e+06;0;0;0;0;0;0;403595745;408859464;23740065
1385;6.04373e-15;-315;1633;12347;12754;1;311;-2.14748e+09;-3.73334e+06;-1;0;0;0;-1;0;403595745;408859464;23740065
1386;6.10309e-15;-295;1623;12480;12837;1;325;-2.14748e+09;-3.725e+06;-1;0;0;0;-1;0;403744601;409023151;23782629
1386;6.04373e-15;-315;1633;12347;12754;1;311;-2.14748e+09;-3.725e+06;-1;0;0;0;-1;0;403744601;409023151;23782629
1387;6.10309e-15;-296;1623;12480;12837;1;325;-2.14748e+09;-3.71668e+06;0;0;0;0;0;0;403893125;409186512;23825153
1387;6.04373e-15;-315;1633;12347;12754;1;311;-2.14748e+09;-3.71668e+06;-1;0;0;0;-1;0;403893125;409186512;23825153
1388;6.10309e-15;-297;1623;12480;12837;1;325;-2.14748e+09;-3.70839e+06;0;0;0;0;0;0;404041318;409349546;23867638
1388;6.04373e-15;-316;1633;12347;12754;1;311;-2.14748e+09;-3.70839e+06;0;0;0;0;0;0;404041318;409349546;23867638
1389;6.10309e-15;-298;1623;12480;12837;1;325;-2.14748e+09;-3.70012e+06;0;0;0;0;0;0;404189181;409512255;23910084
1389;6.04373e-15;-317;1633;12347;12754;1;311;-2.14748e+09;-3.70012e+06;0;0;0;0;0;0;404189181;409512255;23910084
1390;6.10309e-15;-298;1623;12480;12837;1;325;-2.14748e+09;-3.69197e+06;-1;0;0;0;-1;0;404336716;409674639;23952491
1390;6.04373e-15;-318;1633;12347;12754;1;311;-2.14748e+09;-3.69197e+06;0;0;0;0;0;0;404336716;409674639;23952491
1391;6.10309e-15;-298;1623;12480;12837;1;325;-2.14748e+09;-3.68365e+06;-1;0;0;0;-1;0;404483922;409836699;23994858
1391;6.04373e-15;-318;1633;12347;12754;1;311;-2.14748e+09;-3.68365e+06;-1;0;0;0;-1;0;404483922;409836699;23994858
1392;6.10309e-15;-299;1623;12480;12837;1;325;-2.14748e+09;-3.67545e+06;0;0;0;0;0;0;404630800;409998436;24037185
1392;6.04373e-15;-318;1633;12347;12754;1;311;-2.14748e+09;-3.67545e+06;-1;0;0;0;-1;0;404630800;409998436;24037185
1393;6.10309e-15;-300;1623;12480;12837;1;325;-2.14748e+09;-3.66738e+06;0;0;0;0;0;0;404777352;410159850;24079473
1393;6.04373e-15;-319;1633;12347;12754;1;311;-2.14748e+09;-3.66738e+06;0;0;0;0;0;0;404777352;410159850;24079473
1394;6.10309e-15;-300;1623;12480;12837;1;325;-2.14748e+09;-3.65922e+06;-1;0;0;0;-1;0;404923579;410320944;24121722
1394;6.04373e-15;-319;1633;12347;12754;1;311;-2.14748e+09;-3.65923e+06;-1;0;0;0;-1;0;404923579;410320944;24121722
1395;6.10309e-15;-300;1623;12480;12837;1;325;-2.14748e+09;-3.651e+06;-1;0;0;0;-1;0;405069481;410481716;24163930
1395;6.04373e-15;-320;1633;12347;12754;1;311;-2.14748e+09;-3.651e+06;0;0;0;0;0;0;405069481;410481716;24163930
1396;6.10309e-15;-300;1623;12480;12837;1;325;-2.14748e+09;-3.64289e+06;-1;0;0;0;-1;0;405215059;410642169;24206099
1396;6.04373e-15;-320;1633;12347;12754;1;311;-2.14748e+09;-3.64289e+06;-1;0;0;0;-1;0;405215059;410642169;24206099
1397;6.10309e-15;-301;1623;12480;12837;1;325;-2.14748e+09;-3.63481e+06;0;0;0;0;0;0;405360313;410802302;24248228
1397;6.04373e-15;-321;1633;12347;12754;1;311;-2.14748e+09;-3.63481e+06;0;0;0;0;0;0;405360313;410802302;24248228
1398;6.10309e-15;-301;1623;12480;12837;1;325;-2.14748e+09;-3.62675e+06;-1;0;0;0;-1;0;405505246;410962117;24290317
1398;6.04373e-15;-321;1633;12347;12754;1;311;-2.14748e+09;-3.62675e+06;-1;0;0;0;-1;0;405505246;410962117;24290317
1399;6.10309e-15;-302;1623;12480;12837;1;325;-2.14748e+09;-3.61871e+06;0;0;0;0;0;0;405649858;411121615;24332366
1399;6.04373e-15;-321;1633;12347;12754;1;311;-2.14748e+09;-3.61871e+06;-1;0;0;0;-1;0;405649858;411121615;24332366
1400;6.10309e-15;-302;1623;12480;12837;1;325;-2.14748e+09;-3.6107e+06;-1;0;0;0;-1;0;405794149;411280795;24374376
1400;6.04373e-15;-321;1633;12347;12754;1;311;-2.14748e+09;-3.6107e+06;-1;0;0;0;-1;0;405794149;411280795;24374376
1401;6.10309e-15;-303;1623;12480;12837;1;325;-2.14748e+09;-3.60271e+06;0;0;0;0;0;0;405938120;411439660;24416344
1401;6.04373e-15;-322;1633;12347;12754;1;311;-2.14748e+09;-3.60271e+06;0;0;0;0;0;0;405938120;411439660;24416344
1402;6.10309e-15;-304;1623;12480;12837;1;325;-2.14748e+09;-3.59474e+06;0;0;0;0;0;0;406081772;411598210;24458273
1402;6.04373e-15;-322;1633;12347;12754;1;311;-2.14748e+09;-3.59474e+06;-1;0;0;0;-1;0;406081772;411598210;24458273
1403;6.10309e-15;-305;1623;12480;12837;1;325;-2.14748e+09;-3.58689e+06;0;0;0;0;0;0;406225107;411756444;24500161
1403;6.04373e-15;-322;1633;12347;12754;1;311;-2.14748e+09;-3.58689e+06;-1;0;0;0;-1;0;406225107;411756444;24500161
1404;6.10309e-15;-305;1623;12480;12837;1;325;-2.14748e+09;-3.57887e+06;-1;0;0;0;-1;0;406368125;411914366;24542010
1404;6.04373e-15;-322;1633;12347;12754;1;311;-2.14748e+09;-3.57887e+06;-1;0;0;0;-1;0;406368125;411914366;24542010
1405;6.10309e-15;-306;1623;12480;12837;1;325;-2.14748e+09;-3.57097e+06;0;0;0;0;0;0;406510826;412071974;24583817
1405;6.04373e-15;-323;1633;12347;12754;1;311;-2.14748e+09;-3.57097e+06;0;0;0;0;0;0;406510826;412071974;24583817
1406;6.10309e-15;-306;1623;12480;12837;1;325;-2.14748e+09;-3.56309e+06;-1;0;0;0;-1;0;406653212;412229270;24625584
1406;6.04373e-15;-324;1633;12347;12754;1;311;-2.14748e+09;-3.56309e+06;0;0;0;0;0;0;406653212;412229270;24625584
1407;6.10309e-15;-307;1623;12480;12837;1;325;-2.14748e+09;-3.55533e+06;0;0;0;0;0;0;406795283;412386255;24667311
1407;6.04373e-15;-324;1633;12347;12754;1;311;-2.14748e+09;-3.55533e+06;-1;0;0;0;-1;0;406795283;412386255;24667311
1408;6.10309e-15;-307;1623;12480;12837;1;325;-2.14748e+09;-3.5474e+06;-1;0;0;0;-1;0;406937041;412542929;24708997
1408;6.04373e-15;-325;1633;12347;12754;1;311;-2.14748e+09;-3.5474e+06;0;0;0;0;0;0;406937041;412542929;24708997
1409;6.10309e-15;-308;1623;12480;12837;1;325;-2.14748e+09;-3.53959e+06;0;0;0;0;0;0;407078485;412699293;24750643
1409;6.04373e-15;-325;1633;12347;12754;1;311;-2.14748e+09;-3.53959e+06;-1;0;0;0;-1;0;407078485;412699293;24750643
1410;6.10309e-15;-308;1623;12480;12837;1;325;-2.14748e+09;-3.5318e+06;-1;0;0;0;-1;0;407219618;412855348;24792247
1410;6.04373e-15;-325;1633;12347;12754;1;311;-2.14748e+09;-3.5318e+06;-1;0;0;0;-1;0;407219618;412855348;24792247
1411;6.10309e-15;-308;1623;12480;12837;1;325;-2.14748e+09;-3.52403e+06;-1;0;0;0;-1;0;407360439;413011094;24833811
1411;6.04373e-15;-326;1633;12347;12754;1;311;-2.14748e+09;-3.52403e+06;0;0;0;0;0;0;407360439;413011094;24833811
1412;6.10309e-15;-309;1623;12480;12837;1;325;-2.14748e+09;-3.51628e+06;0;0;0;0;0;0;407500950;413166533;24875334
1412;6.04373e-15;-327;1633;12347;12754;1;311;-2.14748e+09;-3.51628e+06;0;0;0;0;0;0;407500950;413166533;24875334
1413;6.10309e-15;-309;1623;12480;12837;1;325;-2.14748e+09;-3.50856e+06;-1;0;0;0;-1;0;407641151;413321665;24916816
1413;6.04373e-15;-328;1633;12347;12754;1;311;-2.14748e+09;-3.50856e+06;0;0;0;0;0;0;407641151;413321665;24916816
1414;6.10309e-15;-310;1623;12480;12837;1;325;-2.14748e+09;-3.50085e+06;0;0;0;0;0;0;407781044;413476490;24958258
1414;6.04373e-15;-329;1633;12347;12754;1;311;-2.14748e+09;-3.50085e+06;0;0;0;0;0;0;407781044;413476490;24958258
1415;6.10309e-15;-310;1623;12480;12837;1;325;-2.14748e+09;-3.49317e+06;-1;0;0;0;-1;0;407920628;413631010;24999658
1415;6.04373e-15;-329;1633;12347;12754;1;311;-2.14748e+09;-3.49317e+06;-1;0;0;0;-1;0;407920628;413631010;24999658
1416;6.10309e-15;-311;1623;12480;12837;1;325;-2.14748e+09;-3.48551e+06;0;0;0;0;0;0;408059905;413785226;25041017
1416;6.04373e-15;-329;1633;12347;12754;1;311;-2.14748e+09;-3.48551e+06;-1;0;0;0;-1;0;408059905;413785226;25041017
1417;6.10309e-15;-312;1623;12480;12837;1;325;-2.14748e+09;-3.47797e+06;0;0;0;0;0;0;408198876;413939137;25082335
1417;6.04373e-15;-330;1633;12347;12754;1;311;-2.14748e+09;-3.47797e+06;0;0;0;0;0;0;408198876;413939137;25082335
1418;6.10309e-15;-313;1623;12480;12837;1;325;-2.14748e+09;-3.47025e+06;0;0;0;0;0;0;408337541;414092745;25123612
1418;6.04373e-15;-331;1633;12347;12754;1;311;-2.14748e+09;-3.47025e+06;0;0;0;0;0;0;408337541;414092745;25123612
1419;6.10309e-15;-313;1623;12480;12837;1;325;-2.14748e+09;-3.46265e+06;-1;0;0;0;-1;0;408475901;414246050;25164847
1419;6.04373e-15;-332;1633;12347;12754;1;311;-2.14748e+09;-3.46265e+06;0;0;0;0;0;0;408475901;414246050;25164847
1420;6.10309e-15;-314;1623;12480;12837;1;325;-2.14748e+09;-3.45508e+06;0;0;0;0;0;0;408613957;414399054;25206042
1420;6.04373e-15;-333;1633;12347;12754;1;311;-2.14748e+09;-3.45508e+06;0;0;0;0;0;0;408613957;414399054;25206042
1421;6.10309e-15;-314;1623;12480;12837;1;325;-2.14748e+09;-3.44752e+06;-1;0;0;0;-1;0;408751711;414551757;25247195
1421;6.04373e-15;-333;1633;12347;12754;1;311;-2.14748e+09;-3.44752e+06;-1;0;0;0;-1;0;408751711;414551757;25247195
1422;6.10309e-15;-314;1623;12480;12837;1;325;-2.14748e+09;-3.44009e+06;-1;0;0;0;-1;0;408889161;414704159;25288306
1422;6.04373e-15;-333;1633;12347;12754;1;311;-2.14748e+09;-3.44009e+06;-1;0;0;0;-1;0;408889161;414704159;25288306
1423;6.10309e-15;-315;1623;12480;12837;1;325;-2.14748e+09;-3.43258e+06;0;0;0;0;0;0;409026310;414856261;25329376
1423;6.04373e-15;-333;1633;12347;12754;1;311;-2.14748e+09;-3.43258e+06;-1;0;0;0;-1;0;409026310;414856261;25329376
1424;6.10309e-15;-316;1623;12480;12837;1;325;-2.14748e+09;-3.42498e+06;0;0;0;0;0;0;409163158;415008065;25370405
1424;6.04373e-15;-334;1633;12347;12754;1;311;-2.14748e+09;-3.42498e+06;0;0;0;0;0;0;409163158;415008065;25370405
1425;6.10309e-15;-317;1623;12480;12837;1;325;-2.14748e+09;-3.41751e+06;0;0;0;0;0;0;409299706;415159570;25411392
1425;6.04373e-15;-334;1633;12347;12754;1;311;-2.14748e+09;-3.41751e+06;-1;0;0;0;-1;0;409299706;415159570;25411392
1426;6.10309e-15;-318;1623;12480;12837;1;325;-2.14748e+09;-3.41016e+06;0;0;0;0;0;0;409435955;415310778;25452337
1426;6.04373e-15;-335;1633;12347;12754;1;311;-2.14748e+09;-3.41016e+06;0;0;0;0;0;0;409435955;415310778;25452337
1427;6.10309e-15;-318;1623;12480;12837;1;325;-2.14748e+09;-3.40273e+06;-1;0;0;0;-1;0;409571905;415461689;25493241
1427;6.04373e-15;-335;1633;12347;12754;1;311;-2.14748e+09;-3.40273e+06;-1;0;0;0;-1;0;409571905;415461689;25493241
1428;6.10309e-15;-319;1623;12480;12837;1;325;-2.14748e+09;-3.39522e+06;0;0;0;0;0;0;409707558;415612303;25534103
1428;6.04373e-15;-335;1633;12347;12754;1;311;-2.14748e+09;-3.39522e+06;-1;0;0;0;-1;0;409707558;415612303;25534103
1429;6.10309e-15;-319;1623;12480;12837;1;325;-2.14748e+09;-3.38783e+06;-1;0;0;0;-1;0;409842913;415762623;25574923
1429;6.04373e-15;-335;1633;12347;12754;1;311;-2.14748e+09;-3.38783e+06;-1;0;0;0;-1;0;409842913;415762623;25574923
1430;6.10309e-15;-319;1623;12480;12837;1;325;-2.14748e+09;-3.38046e+06;-1;0;0;0;-1;0;409977973;415912647;25615701
1430;6.04373e-15;-336;1633;12347;12754;1;311;-2.14748e+09;-3.38046e+06;0;0;0;0;0;0;409977973;415912647;25615701
1431;6.10309e-15;-320;1623;12480;12837;1;325;-2.14748e+09;-3.37321e+06;0;0;0;0;0;0;410112737;416062378;25656437
1431;6.04373e-15;-336;1633;12347;12754;1;311;-2.14748e+09;-3.37321e+06;-1;0;0;0;-1;0;410112737;416062378;25656437
1432;6.10309e-15;-320;1623;12480;12837;1;325;-2.14748e+09;-3.36578e+06;-1;0;0;0;-1;0;410247206;416211815;25697132
1432;6.04373e-15;-336;1633;12347;12754;1;311;-2.14748e+09;-3.36578e+06;-1;0;0;0;-1;0;410247206;416211815;25697132
1433;6.10309e-15;-320;1623;12480;12837;1;325;-2.14748e+09;-3.35847e+06;-1;0;0;0;-1;0;410381381;416360960;25737785
1433;6.04373e-15;-336;1633;12347;12754;1;311;-2.14748e+09;-3.35847e+06;-1;0;0;0;-1;0;410381381;416360960;25737785
1434;6.10309e-15;-321;1623;12480;12837;1;325;-2.14748e+09;-3.35118e+06;0;0;0;0;0;0;410515263;416509812;25778395
1434;6.04373e-15;-336;1633;12347;12754;1;311;-2.14748e+09;-3.35118e+06;-1;0;0;0;-1;0;410515263;416509812;25778395
1435;6.10309e-15;-321;1623;12480;12837;1;325;-2.14748e+09;-3.34391e+06;-1;0;0;0;-1;0;410648853;416658373;25818964
1435;6.04373e-15;-337;1633;12347;12754;1;311;-2.14748e+09;-3.34391e+06;0;0;0;0;0;0;410648853;416658373;25818964
1436;6.10309e-15;-322;1623;12480;12837;1;325;-2.14748e+09;-3.33666e+06;0;0;0;0;0;0;410782151;416806644;25859490
1436;6.04373e-15;-337;1633;12347;12754;1;311;-2.14748e+09;-3.33666e+06;-1;0;0;0;-1;0;410782151;416806644;25859490
1437;6.10309e-15;-323;1623;12480;12837;1;325;-2.14748e+09;-3.32943e+06;0;0;0;0;0;0;410915159;416954625;25899974
1437;6.04373e-15;-338;1633;12347;12754;1;311;-2.14748e+09;-3.32943e+06;0;0;0;0;0;0;410915159;416954625;25899974
1438;6.10309e-15;-324;1623;12480;12837;1;325;-2.14748e+09;-3.32222e+06;0;0;0;0;0;0;411047876;417102317;25940416
1438;6.04373e-15;-339;1633;12347;12754;1;311;-2.14748e+09;-3.32222e+06;0;0;0;0;0;0;411047876;417102317;25940416
1439;6.10309e-15;-324;1623;12480;12837;1;325;-2.14748e+09;-3.31503e+06;-1;0;0;0;-1;0;411180304;417249720;25980816
1439;6.04373e-15;-339;1633;12347;12754;1;311;-2.14748e+09;-3.31503e+06;-1;0;0;0;-1;0;411180304;417249720;25980816
1440;6.10309e-15;-324;1623;12480;12837;1;325;-2.14748e+09;-3.30786e+06;-1;0;0;0;-1;0;411312443;417396835;26021174
1440;6.04373e-15;-340;1633;12347;12754;1;311;-2.14748e+09;-3.30786e+06;0;0;0;0;0;0;411312443;417396835;26021174
1441;6.10309e-15;-324;1623;12480;12837;1;325;-2.14748e+09;-3.3007e+06;-1;0;0;0;-1;0;411444294;417543663;26061489
1441;6.04373e-15;-341;1633;12347;12754;1;311;-2.14748e+09;-3.3007e+06;0;0;0;0;0;0;411444294;417543663;26061489
1442;6.10309e-15;-324;1623;12480;12837;1;325;-2.14748e+09;-3.29357e+06;-1;0;0;0;-1;0;411575858;417690204;26101762
1442;6.04373e-15;-341;1633;12347;12754;1;311;-2.14748e+09;-3.29357e+06;-1;0;0;0;-1;0;411575858;417690204;26101762
1443;6.10309e-15;-325;1623;12480;12837;1;325;-2.14748e+09;-3.28656e+06;0;0;0;0;0;0;411707136;417836460;26141992
1443;6.04373e-15;-342;1633;12347;12754;1;311;-2.14748e+09;-3.28656e+06;0;0;0;0;0;0;411707136;417836460;26141992
1444;6.10309e-15;-325;1623;12480;12837;1;325;-2.14748e+09;-3.27936e+06;-1;0;0;0;-1;0;411838128;417982431;26182180
1444;6.04373e-15;-342;1633;12347;12754;1;311;-2.14748e+09;-3.27936e+06;-1;0;0;0;-1;0;411838128;417982431;26182180
1445;6.10309e-15;-325;1623;12480;12837;1;325;-2.14748e+09;-3.27229e+06;-1;0;0;0;-1;0;411968835;418128116;26222325
1445;6.04373e-15;-343;1633;12347;12754;1;311;-2.14748e+09;-3.27229e+06;0;0;0;0;0;0;411968835;418128116;26222325
1446;6.10309e-15;-326;1623;12480;12837;1;325;-2.14748e+09;-3.26523e+06;0;0;0;0;0;0;412099258;418273519;26262428
1446;6.04373e-15;-343;1633;12347;12754;1;311;-2.14748e+09;-3.26523e+06;-1;0;0;0;-1;0;412099258;418273519;26262428
1447;6.10309e-15;-327;1623;12480;12837;1;325;-2.14748e+09;-3.2582e+06;0;0;0;0;0;0;412229397;418418638;26302488
1447;6.04373e-15;-343;1633;12347;12754;1;311;-2.14748e+09;-3.2582e+06;-1;0;0;0;-1;0;412229397;418418638;26302488
1448;6.10309e-15;-327;1623;12480;12837;1;325;-2.14748e+09;-3.25118e+06;-1;0;0;0;-1;0;412359254;418563474;26342506
1448;6.04373e-15;-343;1633;12347;12754;1;311;-2.14748e+09;-3.25118e+06;-1;0;0;0;-1;0;412359254;418563474;26342506
1449;6.10309e-15;-328;1623;12480;12837;1;325;-2.14748e+09;-3.24418e+06;0;0;0;0;0;0;412488828;418708028;26382481
1449;6.04373e-15;-343;1633;12347;12754;1;311;-2.14748e+09;-3.24418e+06;-1;0;0;0;-1;0;412488828;418708028;26382481
1450;6.10309e-15;-328;1623;12480;12837;1;325;-2.14748e+09;-3.2373e+06;-1;0;0;0;-1;0;412618121;418852302;26422414
1450;6.04373e-15;-343;1633;12347;12754;1;311;-2.14748e+09;-3.2373e+06;-1;0;0;0;-1;0;412618121;418852302;26422414
1451;6.10309e-15;-329;1623;12480;12837;1;325;-2.14748e+09;-3.23024e+06;0;0;0;0;0;0;412747134;418996294;26462303
1451;6.04373e-15;-344;1633;12347;12754;1;311;-2.14748e+09;-3.23024e+06;0;0;0;0;0;0;412747134;418996294;26462303
1452;6.10309e-15;-330;1623;12480;12837;1;325;-2.14748e+09;-3.22329e+06;0;0;0;0;0;0;412875867;419140007;26502150
1452;6.04373e-15;-345;1633;12347;12754;1;311;-2.14748e+09;-3.22329e+06;0;0;0;0;0;0;412875867;419140007;26502150
1453;6.10309e-15;-331;1623;12480;12837;1;325;-2.14748e+09;-3.21647e+06;0;0;0;0;0;0;413004320;419283441;26541954
1453;6.04373e-15;-345;1633;12347;12754;1;311;-2.14748e+09;-3.21647e+06;-1;0;0;0;-1;0;413004320;419283441;26541954
1454;6.10309e-15;-332;1623;12480;12837;1;325;-2.14748e+09;-3.20946e+06;0;0;0;0;0;0;413132495;419426595;26581715
1454;6.04373e-15;-345;1633;12347;12754;1;311;-2.14748e+09;-3.20946e+06;0;0;-1;0;0;-1;413132495;419426595;26581715
1455;6.10309e-15;-332;1623;12480;12837;1;325;-2.14748e+09;-3.20257e+06;-1;0;0;0;-1;0;413260392;419569472;26621434
1455;6.04373e-15;-345;1633;12347;12754;1;311;-2.14748e+09;-3.20257e+06;-1;0;0;0;-1;0;413260392;419569472;26621434
1456;6.10309e-15;-332;1623;12480;12837;1;325;-2.14748e+09;-3.1957e+06;-1;0;0;0;-1;0;413388013;419712072;26661109
1456;6.04373e-15;-345;1633;12347;12754;1;311;-2.14748e+09;-3.1957e+06;-1;0;0;0;-1;0;413388013;419712072;26661109
1457;6.10309e-15;-332;1623;12480;12837;1;325;-2.14748e+09;-3.18885e+06;-1;0;0;0;-1;0;413515357;419854395;26700742
1457;6.04373e-15;-345;1633;12347;12754;1;311;-2.14748e+09;-3.18885e+06;-1;0;0;0;-1;0;413515357;419854395;26700742
1458;6.10309e-15;-333;1623;12480;12837;1;325;-2.14748e+09;-3.18202e+06;0;0;0;0;0;0;413642425;419996442;26740331
1458;6.04373e-15;-345;1633;12347;12754;1;311;-2.14748e+09;-3.18202e+06;-1;0;0;0;-1;0;413642425;419996442;26740331
1459;6.10309e-15;-333;1623;12480;12837;1;325;-2.14748e+09;-3.1752e+06;-1;0;0;0;-1;0;413769218;420138213;26779878
1459;6.04373e-15;-345;1633;12347;12754;1;311;-2.14748e+09;-3.1752e+06;-1;0;0;0;-1;0;413769218;420138213;26779878
1460;6.10309e-15;-334;1623;12480;12837;1;325;-2.14748e+09;-3.16841e+06;0;0;0;0;0;0;413895737;420279709;26819381
1460;6.04373e-15;-345;1633;12347;12754;1;311;-2.14748e+09;-3.16841e+06;-1;0;0;0;-1;0;413895737;420279709;26819381
1461;6.10309e-15;-335;1623;12480;12837;1;325;-2.14748e+09;-3.16163e+06;0;0;0;0;0;0;414021983;420420932;26858841
1461;6.04373e-15;-345;1633;12347;12754;1;311;-2.14748e+09;-3.16163e+06;-1;0;0;0;-1;0;414021983;420420932;26858841
1462;6.10309e-15;-336;1623;12480;12837;1;325;-2.14748e+09;-3.15487e+06;0;0;0;0;0;0;414147955;420561880;26898259
1462;6.04373e-15;-346;1633;12347;12754;1;311;-2.14748e+09;-3.15487e+06;0;0;0;0;0;0;414147955;420561880;26898259
1463;6.10309e-15;-337;1623;12480;12837;1;325;-2.14748e+09;-3.14812e+06;0;0;0;0;0;0;414273656;420702556;26937633
1463;6.04373e-15;-347;1633;12347;12754;1;311;-2.14748e+09;-3.14812e+06;0;0;0;0;0;0;414273656;420702556;26937633
1464;6.10309e-15;-337;1623;12480;12837;1;325;-2.14748e+09;-3.1414e+06;-1;0;0;0;-1;0;414399085;420842960;26976964
1464;6.04373e-15;-348;1633;12347;12754;1;311;-2.14748e+09;-3.1414e+06;0;0;0;0;0;0;414399085;420842960;26976964
1465;6.10309e-15;-338;1623;12480;12837;1;325;-2.14748e+09;-3.13479e+06;0;0;0;0;0;0;414524243;420983092;27016252
1465;6.04373e-15;-348;1633;12347;12754;1;311;-2.14748e+09;-3.13479e+06;-1;0;0;0;-1;0;414524243;420983092;27016252
1466;6.10309e-15;-338;1623;12480;12837;1;325;-2.14748e+09;-3.128e+06;-1;0;0;0;-1;0;414649131;421122953;27055496
1466;6.04373e-15;-349;1633;12347;12754;1;311;-2.14748e+09;-3.128e+06;0;0;0;0;0;0;414649131;421122953;27055496
1467;6.10309e-15;-339;1623;12480;12837;1;325;-2.14748e+09;-3.12133e+06;0;0;0;0;0;0;414773750;421262544;27094697
1467;6.04373e-15;-349;1633;12347;12754;1;311;-2.14748e+09;-3.12133e+06;-1;0;0;0;-1;0;414773750;421262543;27094697
1468;6.10309e-15;-339;1623;12480;12837;1;325;-2.14748e+09;-3.11478e+06;-1;0;0;0;-1;0;414898099;421401864;27133855
1468;6.04373e-15;-349;1633;12347;12754;1;311;-2.14748e+09;-3.11478e+06;-1;0;0;0;-1;0;414898099;421401864;27133855
1469;6.10309e-15;-340;1623;12480;12837;1;325;-2.14748e+09;-3.10804e+06;0;0;0;0;0;0;415022181;421540916;27172970
1469;6.04373e-15;-349;1633;12347;12754;1;311;-2.14748e+09;-3.10804e+06;-1;0;0;0;-1;0;415022181;421540916;27172970
1470;6.10309e-15;-340;1623;12480;12837;1;325;-2.14748e+09;-3.10152e+06;-1;0;0;0;-1;0;415145996;421679699;27212041
1470;6.04373e-15;-350;1633;12347;12754;1;311;-2.14748e+09;-3.10152e+06;0;0;0;0;0;0;415145996;421679699;27212041
1471;6.10309e-15;-340;1623;12480;12837;1;325;-2.14748e+09;-3.09482e+06;-1;0;0;0;-1;0;415269543;421818214;27251069
1471;6.04373e-15;-351;1633;12347;12754;1;311;-2.14748e+09;-3.09482e+06;0;0;0;0;0;0;415269543;421818214;27251069
1472;6.10309e-15;-340;1623;12480;12837;1;325;-2.14748e+09;-3.08823e+06;-1;0;0;0;-1;0;415392825;421956461;27290054
1472;6.04373e-15;-352;1633;12347;12754;1;311;-2.14748e+09;-3.08823e+06;0;0;0;0;0;0;415392825;421956461;27290054
1473;6.10309e-15;-340;1623;12480;12837;1;325;-2.14748e+09;-3.08176e+06;-1;0;0;0;-1;0;415515841;422094442;27328995
1473;6.04373e-15;-353;1633;12347;12754;1;311;-2.14748e+09;-3.08176e+06;0;0;0;0;0;0;415515841;422094442;27328995
1474;6.10309e-15;-340;1623;12480;12837;1;325;-2.14748e+09;-3.07511e+06;-1;0;0;0;-1;0;415638593;422232157;27367892
1474;6.04373e-15;-354;1633;12347;12754;1;311;-2.14748e+09;-3.07511e+06;0;0;0;0;0;0;415638593;422232157;27367892
1475;6.10309e-15;-341;1623;12480;12837;1;325;-2.14748e+09;-3.06858e+06;0;0;0;0;0;0;415761080;422369606;27406746
1475;6.04373e-15;-354;1633;12347;12754;1;311;-2.14748e+09;-3.06858e+06;-1;0;0;0;-1;0;415761080;422369606;27406746
1476;6.10309e-15;-341;1623;12480;12837;1;325;-2.14748e+09;-3.06206e+06;-1;0;0;0;-1;0;415883305;422506790;27445557
1476;6.04373e-15;-355;1633;12347;12754;1;311;-2.14748e+09;-3.06206e+06;0;0;0;0;0;0;415883305;422506790;27445557
1477;6.10309e-15;-341;1623;12480;12837;1;325;-2.14748e+09;-3.05566e+06;-1;0;0;0;-1;0;416005266;422643710;27484324
1477;6.04373e-15;-355;1633;12347;12754;1;311;-2.14748e+09;-3.05566e+06;-1;0;0;0;-1;0;416005266;422643710;27484324
1478;6.10309e-15;-341;1623;12480;12837;1;325;-2.14748e+09;-3.04918e+06;-1;0;0;0;-1;0;416126965;422780366;27523048
1478;6.04373e-15;-356;1633;12347;12754;1;311;-2.14748e+09;-3.04918e+06;0;0;0;0;0;0;416126965;422780366;27523048
1479;6.10309e-15;-341;1623;12480;12837;1;325;-2.14748e+09;-3.04262e+06;-1;0;0;0;-1;0;416248403;422916759;27561728
1479;6.04373e-15;-356;1633;12347;12754;1;311;-2.14748e+09;-3.04262e+06;-1;0;0;0;-1;0;416248403;422916759;27561728
1480;6.10309e-15;-342;1623;12480;12837;1;325;-2.14748e+09;-3.03627e+06;0;0;0;0;0;0;416369581;423052890;27600364
1480;6.04373e-15;-357;1633;12347;12754;1;311;-2.14748e+09;-3.03627e+06;0;0;0;0;0;0;416369581;423052890;27600364
1481;6.10309e-15;-343;1623;12480;12837;1;325;-2.14748e+09;-3.02974e+06;0;0;0;0;0;0;416490498;423188758;27638957
1481;6.04373e-15;-357;1633;12347;12754;1;311;-2.14748e+09;-3.02974e+06;-1;0;0;0;-1;0;416490498;423188758;27638957
1482;6.10309e-15;-344;1623;12480;12837;1;325;-2.14748e+09;-3.02332e+06;0;0;0;0;0;0;416611155;423324366;27677506
1482;6.04373e-15;-358;1633;12347;12754;1;311;-2.14748e+09;-3.02332e+06;0;0;0;0;0;0;416611155;423324366;27677506
1483;6.10309e-15;-345;1623;12480;12837;1;325;-2.14748e+09;-3.01702e+06;0;0;0;0;0;0;416731554;423459712;27716011
1483;6.04373e-15;-358;1633;12347;12754;1;311;-2.14748e+09;-3.01702e+06;-1;0;0;0;-1;0;416731554;423459712;27716011
1484;6.10309e-15;-346;1623;12480;12837;1;325;-2.14748e+09;-3.01054e+06;0;0;0;0;0;0;416851695;423594798;27754473
1484;6.04373e-15;-359;1633;12347;12754;1;311;-2.14748e+09;-3.01054e+06;0;0;0;0;0;0;416851695;423594798;27754473
1485;6.10309e-15;-347;1623;12480;12837;1;325;-2.14748e+09;-3.00427e+06;0;0;0;0;0;0;416971578;423729625;27792891
1485;6.04373e-15;-360;1633;12347;12754;1;311;-2.14748e+09;-3.00427e+06;0;0;0;0;0;0;416971578;423729625;27792891
1486;6.10309e-15;-348;1623;12480;12837;1;325;-2.14748e+09;-2.99792e+06;0;0;0;0;0;0;417091204;423864192;27831265
1486;6.04373e-15;-361;1633;12347;12754;1;311;-2.14748e+09;-2.99792e+06;0;0;0;0;0;0;417091204;423864192;27831265
1487;6.10309e-15;-348;1623;12480;12837;1;325;-2.14748e+09;-2.99159e+06;-1;0;0;0;-1;0;417210574;423998501;27869596
1487;6.04373e-15;-361;1633;12347;12754;1;311;-2.14748e+09;-2.99159e+06;-1;0;0;0;-1;0;417210574;423998501;27869596
1488;6.10309e-15;-349;1623;12480;12837;1;325;-2.14748e+09;-2.98518e+06;0;0;0;0;0;0;417329689;424132552;27907882
1488;6.04373e-15;-362;1633;12347;12754;1;311;-2.14748e+09;-2.98518e+06;0;0;0;0;0;0;417329689;424132552;27907882
1489;6.10309e-15;-350;1623;12480;12837;1;325;-2.14748e+09;-2.97888e+06;0;0;0;0;0;0;417448548;424266346;27946125
1489;6.04373e-15;-363;1633;12347;12754;1;311;-2.14748e+09;-2.97888e+06;0;0;0;0;0;0;417448548;424266346;27946125
1490;6.10309e-15;-350;1623;12480;12837;1;325;-2.14748e+09;-2.97259e+06;-1;0;0;0;-1;0;417567153;424399884;27984324
1490;6.04373e-15;-364;1633;12347;12754;1;311;-2.14748e+09;-2.97259e+06;0;0;0;0;0;0;417567153;424399884;27984324
1491;6.10309e-15;-351;1623;12480;12837;1;325;-2.14748e+09;-2.96632e+06;0;0;0;0;0;0;417685505;424533165;28022480
1491;6.04373e-15;-365;1633;12347;12754;1;311;-2.14748e+09;-2.96632e+06;0;0;0;0;0;0;417685505;424533165;28022480
1492;6.10309e-15;-351;1623;12480;12837;1;325;-2.14748e+09;-2.96007e+06;-1;0;0;0;-1;0;417803603;424666190;28060591
1492;6.04373e-15;-366;1633;12347;12754;1;311;-2.14748e+09;-2.96007e+06;0;0;0;0;0;0;417803603;424666190;28060591
1493;6.10309e-15;-352;1623;12480;12837;1;325;-2.14748e+09;-2.95384e+06;0;0;0;0;0;0;417921449;424798961;28098659
1493;6.04373e-15;-367;1633;12347;12754;1;311;-2.14748e+09;-2.95384e+06;0;0;0;0;0;0;417921449;424798961;28098659
1494;6.10309e-15;-353;1623;12480;12837;1;325;-2.14748e+09;-2.94772e+06;0;0;0;0;0;0;418039043;424931477;28136682
1494;6.04373e-15;-368;1633;12347;12754;1;311;-2.14748e+09;-2.94772e+06;0;0;0;0;0;0;418039043;424931477;28136682
1495;6.10309e-15;-353;1623;12480;12837;1;325;-2.14748e+09;-2.94151e+06;-1;0;0;0;-1;0;418156386;425063739;28174662
1495;6.04373e-15;-369;1633;12347;12754;1;311;-2.14748e+09;-2.94151e+06;0;0;0;0;0;0;418156386;425063739;28174662
1496;6.10309e-15;-354;1623;12480;12837;1;325;-2.14748e+09;-2.93522e+06;0;0;0;0;0;0;418273479;425195748;28212598
1496;6.04373e-15;-369;1633;12347;12754;1;311;-2.14748e+09;-2.93522e+06;-1;0;0;0;-1;0;418273479;425195748;28212598
1497;6.10309e-15;-354;1623;12480;12837;1;325;-2.14748e+09;-2.92905e+06;-1;0;0;0;-1;0;418390321;425327505;28250490
1497;6.04373e-15;-370;1633;12347;12754;1;311;-2.14748e+09;-2.92905e+06;0;0;0;0;0;0;418390321;425327505;28250490
1498;6.10309e-15;-355;1623;12480;12837;1;325;-2.14748e+09;-2.9229e+06;0;0;0;0;0;0;418506914;425459009;28288338
1498;6.04373e-15;-370;1633;12347;12754;1;311;-2.14748e+09;-2.9229e+06;-1;0;0;0;-1;0;418506914;425459009;28288338
1499;6.10309e-15;-356;1623;12480;12837;1;325;-2.14748e+09;-2.91676e+06;0;0;0;0;0;0;418623259;425590261;28326142
1499;6.04373e-15;-370;1633;12347;12754;1;311;-2.14748e+09;-2.91676e+06;-1;0;0;0;-1;0;418623259;425590261;28326142
1500;6.10309e-15;-357;1623;12480;12837;1;325;-2.14748e+09;-2.91073e+06;0;0;0;0;0;0;418739355;425721262;28363902
1500;6.04373e-15;-371;1633;12347;12754;1;311;-2.14748e+09;-2.91073e+06;0;0;0;0;0;0;418739355;425721262;28363902
1501;6.10309e-15;-358;1623;12480;12837;1;325;-2.14748e+09;-2.90452e+06;0;0;0;0;0;0;418855204;425852013;28401618
1501;6.04373e-15;-372;1633;12347;12754;1;311;-2.14748e+09;-2.90452e+06;0;0;0;0;0;0;418855204;425852013;28401618
1502;6.10309e-15;-359;1623;12480;12837;1;325;-2.14748e+09;-2.89843e+06;0;0;0;0;0;0;418970806;425982514;28439290
1502;6.04373e-15;-372;1633;12347;12754;1;311;-2.14748e+09;-2.89843e+06;-1;0;0;0;-1;0;418970806;425982514;28439290
1503;6.10309e-15;-359;1623;12480;12837;1;325;-2.14748e+09;-2.89235e+06;-1;0;0;0;-1;0;419086162;426112766;28476918
1503;6.04373e-15;-373;1633;12347;12754;1;311;-2.14748e+09;-2.89235e+06;0;0;0;0;0;0;419086162;426112766;28476918
1504;6.10309e-15;-359;1623;12480;12837;1;325;-2.14748e+09;-2.88629e+06;-1;0;0;0;-1;0;419201272;426242769;28514502
1504;6.04373e-15;-374;1633;12347;12754;1;311;-2.14748e+09;-2.88629e+06;0;0;0;0;0;0;419201272;426242769;28514502
1505;6.10309e-15;-360;1623;12480;12837;1;325;-2.14748e+09;-2.88024e+06;0;0;0;0;0;0;419316137;426372523;28552042
1505;6.04373e-15;-375;1633;12347;12754;1;311;-2.14748e+09;-2.88024e+06;0;0;0;0;0;0;419316137;426372523;28552042
1506;6.10309e-15;-361;1623;12480;12837;1;325;-2.14748e+09;-2.87421e+06;0;0;0;0;0;0;419430758;426502030;28589538
1506;6.04373e-15;-376;1633;12347;12754;1;311;-2.14748e+09;-2.87421e+06;0;0;0;0;0;0;419430758;426502030;28589538
1507;6.10309e-15;-361;1623;12480;12837;1;325;-2.14748e+09;-2.86819e+06;-1;0;0;0;-1;0;419545134;426631290;28626989
1507;6.04373e-15;-376;1633;12347;12754;1;311;-2.14748e+09;-2.86819e+06;-1;0;0;0;-1;0;419545134;426631290;28626989
1508;6.10309e-15;-362;1623;12480;12837;1;325;-2.14748e+09;-2.86219e+06;0;0;0;0;0;0;419659268;426760303;28664397
1508;6.04373e-15;-376;1633;12347;12754;1;311;-2.14748e+09;-2.86219e+06;-1;0;0;0;-1;0;419659268;426760303;28664397
1509;6.10309e-15;-363;1623;12480;12837;1;325;-2.14748e+09;-2.8562e+06;0;0;0;0;0;0;419773159;426889069;28701761
1509;6.04373e-15;-376;1633;12347;12754;1;311;-2.14748e+09;-2.8562e+06;-1;0;0;0;-1;0;419773159;426889069;28701761
1510;6.10309e-15;-363;1623;12480;12837;1;325;-2.14748e+09;-2.85033e+06;-1;0;0;0;-1;0;419886808;427017591;28739080
1510;6.04373e-15;-376;1633;12347;12754;1;311;-2.14748e+09;-2.85033e+06;-1;0;0;0;-1;0;419886808;427017591;28739080
1511;6.10309e-15;-363;1623;12480;12837;1;325;-2.14748e+09;-2.84427e+06;-1;0;0;0;-1;0;420000215;427145867;28776355
1511;6.04373e-15;-376;1633;12347;12754;1;311;-2.14748e+09;-2.84427e+06;-1;0;0;0;-1;0;420000215;427145867;28776355
1512;6.10309e-15;-363;1623;12480;12837;1;325;-2.14748e+09;-2.83843e+06;-1;0;0;0;-1;0;420113382;427273899;28813587
1512;6.04373e-15;-376;1633;12347;12754;1;311;-2.14748e+09;-2.83843e+06;-1;0;0;0;-1;0;420113382;427273899;28813587
1513;6.10309e-15;-364;1623;12480;12837;1;325;-2.14748e+09;-2.8324e+06;0;0;0;0;0;0;420226308;427401687;28850774
1513;6.04373e-15;-377;1633;12347;12754;1;311;-2.14748e+09;-2.8324e+06;0;0;0;0;0;0;420226308;427401687;28850774
1514;6.10309e-15;-365;1623;12480;12837;1;325;-2.14748e+09;-2.82659e+06;0;0;0;0;0;0;420338994;427529231;28887917
1514;6.04373e-15;-377;1633;12347;12754;1;311;-2.14748e+09;-2.82659e+06;-1;0;0;0;-1;0;420338994;427529231;28887917
1515;6.10309e-15;-365;1623;12480;12837;1;325;-2.14748e+09;-2.8207e+06;-1;0;0;0;-1;0;420451442;427656533;28925015
1515;6.04373e-15;-378;1633;12347;12754;1;311;-2.14748e+09;-2.8207e+06;0;0;0;0;0;0;420451442;427656533;28925015
1516;6.10309e-15;-366;1623;12480;12837;1;325;-2.14748e+09;-2.81472e+06;0;0;0;0;0;0;420563651;427783592;28962070
1516;6.04373e-15;-378;1633;12347;12754;1;311;-2.14748e+09;-2.81472e+06;-1;0;0;0;-1;0;420563651;427783592;28962070
1517;6.10309e-15;-367;1623;12480;12837;1;325;-2.14748e+09;-2.80885e+06;0;0;0;0;0;0;420675622;427910409;28999081
1517;6.04373e-15;-379;1633;12347;12754;1;311;-2.14748e+09;-2.80885e+06;0;0;0;0;0;0;420675622;427910409;28999081
1518;6.10309e-15;-368;1623;12480;12837;1;325;-2.14748e+09;-2.803e+06;0;0;0;0;0;0;420787355;428036985;29036047
1518;6.04373e-15;-379;1633;12347;12754;1;311;-2.14748e+09;-2.803e+06;-1;0;0;0;-1;0;420787355;428036985;29036047
1519;6.10309e-15;-368;1623;12480;12837;1;325;-2.14748e+09;-2.79716e+06;-1;0;0;0;-1;0;420898852;428163321;29072969
1519;6.04373e-15;-380;1633;12347;12754;1;311;-2.14748e+09;-2.79716e+06;0;0;0;0;0;0;420898852;428163321;29072969
1520;6.10309e-15;-369;1623;12480;12837;1;325;-2.14748e+09;-2.79134e+06;0;0;0;0;0;0;421010113;428289416;29109847
1520;6.04373e-15;-380;1633;12347;12754;1;311;-2.14748e+09;-2.79134e+06;-1;0;0;0;-1;0;421010113;428289416;29109847
1521;6.10309e-15;-370;1623;12480;12837;1;325;-2.14748e+09;-2.78553e+06;0;0;0;0;0;0;421121138;428415271;29146680
1521;6.04373e-15;-380;1633;12347;12754;1;311;-2.14748e+09;-2.78553e+06;-1;0;0;0;-1;0;421121138;428415271;29146680
1522;6.10309e-15;-370;1623;12480;12837;1;325;-2.14748e+09;-2.77983e+06;-1;0;0;0;-1;0;421231928;428540887;29183470
1522;6.04373e-15;-380;1633;12347;12754;1;311;-2.14748e+09;-2.77983e+06;-1;0;0;0;-1;0;421231928;428540887;29183470
1523;6.10309e-15;-370;1623;12480;12837;1;325;-2.14748e+09;-2.77395e+06;-1;0;0;0;-1;0;421342484;428666265;29220215
1523;6.04373e-15;-380;1633;12347;12754;1;311;-2.14748e+09;-2.77395e+06;-1;0;0;0;-1;0;421342484;428666265;29220215
1524;6.10309e-15;-370;1623;12480;12837;1;325;-2.14748e+09;-2.76819e+06;-1;0;0;0;-1;0;421452805;428791404;29256916
1524;6.04373e-15;-381;1633;12347;12754;1;311;-2.14748e+09;-2.76819e+06;0;0;0;0;0;0;421452805;428791404;29256916
1525;6.10309e-15;-370;1623;12480;12837;1;325;-2.14748e+09;-2.76244e+06;-1;0;0;0;-1;0;421562894;428916306;29293573
1525;6.04373e-15;-382;1633;12347;12754;1;311;-2.14748e+09;-2.76244e+06;0;0;0;0;0;0;421562894;428916306;29293573
1526;6.10309e-15;-370;1623;12480;12837;1;325;-2.14748e+09;-2.7567e+06;-1;0;0;0;-1;0;421672750;429040971;29330186
1526;6.04373e-15;-382;1633;12347;12754;1;311;-2.14748e+09;-2.7567e+06;-1;0;0;0;-1;0;421672750;429040971;29330186
1527;6.10309e-15;-370;1623;12480;12837;1;325;-2.14748e+09;-2.75098e+06;-1;0;0;0;-1;0;421782373;429165399;29366754
1527;6.04373e-15;-382;1633;12347;12754;1;311;-2.14748e+09;-2.75098e+06;-1;0;0;0;-1;0;421782373;429165399;29366754
1528;6.10309e-15;-370;1623;12480;12837;1;325;-2.14748e+09;-2.74527e+06;-1;0;0;0;-1;0;421891765;429289591;29403278
1528;6.04373e-15;-383;1633;12347;12754;1;311;-2.14748e+09;-2.74527e+06;0;0;0;0;0;0;421891765;429289591;29403278
1529;6.10309e-15;-371;1623;12480;12837;1;325;-2.14748e+09;-2.73958e+06;0;0;0;0;0;0;422000926;429413548;29439758
1529;6.04373e-15;-384;1633;12347;12754;1;311;-2.14748e+09;-2.73958e+06;0;0;0;0;0;0;422000926;429413548;29439758
1530;6.10309e-15;-372;1623;12480;12837;1;325;-2.14748e+09;-2.7339e+06;0;0;0;0;0;0;422109856;429537269;29476193
1530;6.04373e-15;-385;1633;12347;12754;1;311;-2.14748e+09;-2.7339e+06;0;0;0;0;0;0;422109856;429537269;29476193
1531;6.10309e-15;-373;1623;12480;12837;1;325;-2.14748e+09;-2.72833e+06;0;0;0;0;0;0;422218556;429660756;29512585
1531;6.04373e-15;-386;1633;12347;12754;1;311;-2.14748e+09;-2.72833e+06;0;0;0;0;0;0;422218556;429660756;29512585
1532;6.10309e-15;-373;1623;12480;12837;1;325;-2.14748e+09;-2.72268e+06;-1;0;0;0;-1;0;422327027;429784009;29548932
1532;6.04373e-15;-386;1633;12347;12754;1;311;-2.14748e+09;-2.72268e+06;-1;0;0;0;-1;0;422327027;429784009;29548932
1533;6.10309e-15;-373;1623;12480;12837;1;325;-2.14748e+09;-2.71704e+06;-1;0;0;0;-1;0;422435269;429907028;29585235
1533;6.04373e-15;-387;1633;12347;12754;1;311;-2.14748e+09;-2.71704e+06;0;0;0;0;0;0;422435269;429907028;29585235
1534;6.10309e-15;-373;1623;12480;12837;1;325;-2.14748e+09;-2.71132e+06;-1;0;0;0;-1;0;422543283;430029814;29621493
1534;6.04373e-15;-387;1633;12347;12754;1;311;-2.14748e+09;-2.71132e+06;-1;0;0;0;-1;0;422543283;430029814;29621493
1535;6.10309e-15;-373;1623;12480;12837;1;325;-2.14748e+09;-2.70571e+06;-1;0;0;0;-1;0;422651069;430152368;29657707
1535;6.04373e-15;-387;1633;12347;12754;1;311;-2.14748e+09;-2.70571e+06;-1;0;0;0;-1;0;422651069;430152368;29657707
1536;6.10309e-15;-373;1623;12480;12837;1;325;-2.14748e+09;-2.70011e+06;-1;0;0;0;-1;0;422758628;430274690;29693877
1536;6.04373e-15;-388;1633;12347;12754;1;311;-2.14748e+09;-2.70011e+06;0;0;0;0;0;0;422758628;430274690;29693877
1537;6.10309e-15;-373;1623;12480;12837;1;325;-2.14748e+09;-2.69453e+06;-1;0;0;0;-1;0;422865960;430396780;29730003
1537;6.04373e-15;-388;1633;12347;12754;1;311;-2.14748e+09;-2.69453e+06;-1;0;0;0;-1;0;422865960;430396780;29730003
1538;6.10309e-15;-374;1623;12480;12837;1;325;-2.14748e+09;-2.68896e+06;0;0;0;0;0;0;422973066;430518639;29766085
1538;6.04373e-15;-388;1633;12347;12754;1;311;-2.14748e+09;-2.68896e+06;-1;0;0;0;-1;0;422973066;430518639;29766085
1539;6.10309e-15;-374;1623;12480;12837;1;325;-2.14748e+09;-2.68341e+06;-1;0;0;0;-1;0;423079947;430640268;29802122
1539;6.04373e-15;-388;1633;12347;12754;1;311;-2.14748e+09;-2.68341e+06;-1;0;0;0;-1;0;423079947;430640268;29802122
1540;6.10309e-15;-374;1623;12480;12837;1;325;-2.14748e+09;-2.67786e+06;-1;0;0;0;-1;0;423186602;430761666;29838115
1540;6.04373e-15;-388;1633;12347;12754;1;311;-2.14748e+09;-2.67786e+06;-1;0;0;0;-1;0;423186602;430761666;29838115
1541;6.10309e-15;-374;1623;12480;12837;1;325;-2.14748e+09;-2.67234e+06;-1;0;0;0;-1;0;423293034;430882835;29874064
1541;6.04373e-15;-388;1633;12347;12754;1;311;-2.14748e+09;-2.67234e+06;-1;0;0;0;-1;0;423293034;430882835;29874064
1542;6.10309e-15;-375;1623;12480;12837;1;325;-2.14748e+09;-2.66682e+06;0;0;0;0;0;0;423399241;431003776;29909968
1542;6.04373e-15;-389;1633;12347;12754;1;311;-2.14748e+09;-2.66682e+06;0;0;0;0;0;0;423399241;431003776;29909968
1543;6.10309e-15;-376;1623;12480;12837;1;325;-2.14748e+09;-2.66132e+06;0;0;0;0;0;0;423505225;431124487;29945828
1543;6.04373e-15;-390;1633;12347;12754;1;311;-2.14748e+09;-2.66132e+06;0;0;0;0;0;0;423505225;431124487;29945828
1544;6.10309e-15;-377;1623;12480;12837;1;325;-2.14748e+09;-2.65584e+06;0;0;0;0;0;0;423610986;431244970;29981644
1544;6.04373e-15;-390;1633;12347;12754;1;311;-2.14748e+09;-2.65584e+06;-1;0;0;0;-1;0;423610986;431244970;29981644
1545;6.10309e-15;-377;1623;12480;12837;1;325;-2.14748e+09;-2.65036e+06;-1;0;0;0;-1;0;423716525;431365226;30017416
1545;6.04373e-15;-390;1633;12347;12754;1;311;-2.14748e+09;-2.65036e+06;-1;0;0;0;-1;0;423716525;431365226;30017416
1546;6.10309e-15;-377;1623;12480;12837;1;325;-2.14748e+09;-2.6449e+06;-1;0;0;0;-1;0;423821842;431485255;30053143
1546;6.04373e-15;-390;1633;12347;12754;1;311;-2.14748e+09;-2.6449e+06;-1;0;0;0;-1;0;423821842;431485255;30053143
1547;6.10309e-15;-377;1623;12480;12837;1;325;-2.14748e+09;-2.63946e+06;-1;0;0;0;-1;0;423926938;431605057;30088826
1547;6.04373e-15;-390;1633;12347;12754;1;311;-2.14748e+09;-2.63946e+06;-1;0;0;0;-1;0;423926938;431605057;30088826
1548;6.10309e-15;-377;1623;12480;12837;1;325;-2.14748e+09;-2.63402e+06;-1;0;0;0;-1;0;424031813;431724633;30124465
1548;6.04373e-15;-390;1633;12347;12754;1;311;-2.14748e+09;-2.63402e+06;-1;0;0;0;-1;0;424031813;431724633;30124465
1549;6.10309e-15;-377;1623;12480;12837;1;325;-2.14748e+09;-2.6286e+06;-1;0;0;0;-1;0;424136468;431843983;30160060
1549;6.04373e-15;-391;1633;12347;12754;1;311;-2.14748e+09;-2.6286e+06;0;0;0;0;0;0;424136468;431843983;30160060
1550;6.10309e-15;-378;1623;12480;12837;1;325;-2.14748e+09;-2.62319e+06;0;0;0;0;0;0;424240903;431963109;30195610
1550;6.04373e-15;-392;1633;12347;12754;1;311;-2.14748e+09;-2.62319e+06;0;0;0;0;0;0;424240903;431963109;30195610
1551;6.10309e-15;-378;1623;12480;12837;1;325;-2.14748e+09;-2.6178e+06;-1;0;0;0;-1;0;424345119;432082009;30231116
1551;6.04373e-15;-392;1633;12347;12754;1;311;-2.14748e+09;-2.6178e+06;-1;0;0;0;-1;0;424345119;432082009;30231116
1552;6.10309e-15;-378;1623;12480;12837;1;325;-2.14748e+09;-2.61242e+06;-1;0;0;0;-1;0;424449117;432200685;30266578
1552;6.04373e-15;-393;1633;12347;12754;1;311;-2.14748e+09;-2.61242e+06;0;0;0;0;0;0;424449117;432200685;30266578
1553;6.10309e-15;-378;1623;12480;12837;1;325;-2.14748e+09;-2.60705e+06;-1;0;0;0;-1;0;424552897;432319138;30301995
1553;6.04373e-15;-394;1633;12347;12754;1;311;-2.14748e+09;-2.60705e+06;0;0;0;0;0;0;424552897;432319138;30301995
1554;6.10309e-15;-379;1623;12480;12837;1;325;-2.14748e+09;-2.6017e+06;0;0;0;0;0;0;424656459;432437367;30337369
1554;6.04373e-15;-395;1633;12347;12754;1;311;-2.14748e+09;-2.6017e+06;0;0;0;0;0;0;424656459;432437367;30337369
1555;6.10309e-15;-379;1623;12480;12837;1;325;-2.14748e+09;-2.59636e+06;-1;0;0;0;-1;0;424759804;432555374;30372698
1555;6.04373e-15;-396;1633;12347;12754;1;311;-2.14748e+09;-2.59636e+06;0;0;0;0;0;0;424759804;432555374;30372698
1556;6.10309e-15;-380;1623;12480;12837;1;325;-2.14748e+09;-2.59103e+06;0;0;0;0;0;0;424862932;432673158;30407983
1556;6.04373e-15;-397;1633;12347;12754;1;311;-2.14748e+09;-2.59103e+06;0;0;0;0;0;0;424862932;432673158;30407983
1557;6.10309e-15;-381;1623;12480;12837;1;325;-2.14748e+09;-2.58571e+06;0;0;0;0;0;0;424965845;432790721;30443223
1557;6.04373e-15;-398;1633;12347;12754;1;311;-2.14748e+09;-2.58571e+06;0;0;0;0;0;0;424965845;432790721;30443223
1558;6.10309e-15;-381;1623;12480;12837;1;325;-2.14748e+09;-2.58041e+06;-1;0;0;0;-1;0;425068542;432908062;30478420
1558;6.04373e-15;-398;1633;12347;12754;1;311;-2.14748e+09;-2.58041e+06;-1;0;0;0;-1;0;425068542;432908062;30478420
1559;6.10309e-15;-381;1623;12480;12837;1;325;-2.14748e+09;-2.57512e+06;-1;0;0;0;-1;0;425171024;433025182;30513572
1559;6.04373e-15;-399;1633;12347;12754;1;311;-2.14748e+09;-2.57512e+06;0;0;0;0;0;0;425171024;433025182;30513572
1560;6.10309e-15;-381;1623;12480;12837;1;325;-2.14748e+09;-2.56984e+06;-1;0;0;0;-1;0;425273291;433142082;30548680
1560;6.04373e-15;-400;1633;12347;12754;1;311;-2.14748e+09;-2.56984e+06;0;0;0;0;0;0;425273291;433142082;30548680
1561;6.10309e-15;-382;1623;12480;12837;1;325;-2.14748e+09;-2.56458e+06;0;0;0;0;0;0;425375345;433258762;30583744
1561;6.04373e-15;-400;1633;12347;12754;1;311;-2.14748e+09;-2.56458e+06;-1;0;0;0;-1;0;425375345;433258762;30583744
1562;6.10309e-15;-382;1623;12480;12837;1;325;-2.14748e+09;-2.55932e+06;-1;0;0;0;-1;0;425477185;433375222;30618763
1562;6.04373e-15;-400;1633;12347;12754;1;311;-2.14748e+09;-2.55932e+06;-1;0;0;0;-1;0;425477185;433375222;30618763
1563;6.10309e-15;-382;1623;12480;12837;1;325;-2.14748e+09;-2.55408e+06;-1;0;0;0;-1;0;425578813;433491464;30653739
1563;6.04373e-15;-401;1633;12347;12754;1;311;-2.14748e+09;-2.55408e+06;0;0;0;0;0;0;425578813;433491464;30653739
1564;6.10309e-15;-382;1623;12480;12837;1;325;-2.14748e+09;-2.54886e+06;-1;0;0;0;-1;0;425680228;433607487;30688670
1564;6.04373e-15;-401;1633;12347;12754;1;311;-2.14748e+09;-2.54886e+06;-1;0;0;0;-1;0;425680228;433607487;30688670
1565;6.10309e-15;-382;1623;12480;12837;1;325;-2.14748e+09;-2.54374e+06;-1;0;0;0;-1;0;425781431;433723292;30723557
1565;6.04373e-15;-402;1633;12347;12754;1;311;-2.14748e+09;-2.54374e+06;0;0;0;0;0;0;425781431;433723292;30723557
1566;6.10309e-15;-383;1623;12480;12837;1;325;-2.14748e+09;-2.53844e+06;0;0;0;0;0;0;425882423;433838879;30758400
1566;6.04373e-15;-403;1633;12347;12754;1;311;-2.14748e+09;-2.53844e+06;0;0;0;0;0;0;425882423;433838879;30758400
1567;6.10309e-15;-384;1623;12480;12837;1;325;-2.14748e+09;-2.53335e+06;0;0;0;0;0;0;425983204;433954249;30793199
1567;6.04373e-15;-404;1633;12347;12754;1;311;-2.14748e+09;-2.53335e+06;0;0;0;0;0;0;425983204;433954249;30793199
1568;6.10309e-15;-384;1623;12480;12837;1;325;-2.14748e+09;-2.52808e+06;-1;0;0;0;-1;0;426083774;434069402;30827953
1568;6.04373e-15;-404;1633;12347;12754;1;311;-2.14748e+09;-2.52808e+06;-1;0;0;0;-1;0;426083774;434069402;30827953
1569;6.10309e-15;-385;1623;12480;12837;1;325;-2.14748e+09;-2.52291e+06;0;0;0;0;0;0;426184134;434184339;30862664
1569;6.04373e-15;-404;1633;12347;12754;1;311;-2.14748e+09;-2.52291e+06;-1;0;0;0;-1;0;426184134;434184339;30862664
1570;6.10309e-15;-386;1623;12480;12837;1;325;-2.14748e+09;-2.51776e+06;0;0;0;0;0;0;426284286;434299060;30897330
1570;6.04373e-15;-404;1633;12347;12754;1;311;-2.14748e+09;-2.51776e+06;-1;0;0;0;-1;0;426284286;434299060;30897330
1571;6.10309e-15;-386;1623;12480;12837;1;325;-2.14748e+09;-2.51262e+06;-1;0;0;0;-1;0;426384228;434413566;30931952
1571;6.04373e-15;-405;1633;12347;12754;1;311;-2.14748e+09;-2.51262e+06;0;0;0;0;0;0;426384228;434413566;30931952
1572;6.10309e-15;-387;1623;12480;12837;1;325;-2.14748e+09;-2.5075e+06;0;0;0;0;0;0;426483962;434527857;30966530
1572;6.04373e-15;-406;1633;12347;12754;1;311;-2.14748e+09;-2.5075e+06;0;0;0;0;0;0;426483962;434527857;30966530
1573;6.10309e-15;-387;1623;12480;12837;1;325;-2.14748e+09;-2.50248e+06;-1;0;0;0;-1;0;426583488;434641934;31001064
1573;6.04373e-15;-406;1633;12347;12754;1;311;-2.14748e+09;-2.50248e+06;-1;0;0;0;-1;0;426583488;434641934;31001064
1574;6.10309e-15;-388;1623;12480;12837;1;325;-2.14748e+09;-2.49728e+06;0;0;0;0;0;0;426682806;434755796;31035554
1574;6.04373e-15;-407;1633;12347;12754;1;311;-2.14748e+09;-2.49728e+06;0;0;0;0;0;0;426682806;434755796;31035554
1575;6.10309e-15;-389;1623;12480;12837;1;325;-2.14748e+09;-2.49219e+06;0;0;0;0;0;0;426781918;434869445;31070000
1575;6.04373e-15;-408;1633;12347;12754;1;311;-2.14748e+09;-2.49219e+06;0;0;0;0;0;0;426781918;434869445;31070000
1576;6.10309e-15;-389;1623;12480;12837;1;325;-2.14748e+09;-2.48711e+06;-1;0;0;0;-1;0;426880823;434982881;31104401
1576;6.04373e-15;-409;1633;12347;12754;1;311;-2.14748e+09;-2.48711e+06;0;0;0;0;0;0;426880823;434982881;31104401
1577;6.10309e-15;-389;1623;12480;12837;1;325;-2.14748e+09;-2.48204e+06;-1;0;0;0;-1;0;426979522;435096104;31138759
1577;6.04373e-15;-409;1633;12347;12754;1;311;-2.14748e+09;-2.48204e+06;-1;0;0;0;-1;0;426979522;435096104;31138759
1578;6.10309e-15;-389;1623;12480;12837;1;325;-2.14748e+09;-2.47699e+06;-1;0;0;0;-1;0;427078016;435209115;31173072
1578;6.04373e-15;-409;1633;12347;12754;1;311;-2.14748e+09;-2.47699e+06;-1;0;0;0;-1;0;427078016;435209115;31173072
1579;6.10309e-15;-389;1623;12480;12837;1;325;-2.14748e+09;-2.47195e+06;-1;0;0;0;-1;0;427176305;435321915;31207342
1579;6.04373e-15;-410;1633;12347;12754;1;311;-2.14748e+09;-2.47195e+06;0;0;0;0;0;0;427176305;435321915;31207342
1580;6.10309e-15;-390;1623;12480;12837;1;325;-2.14748e+09;-2.46692e+06;0;0;0;0;0;0;427274389;435434503;31241567
1580;6.04373e-15;-410;1633;12347;12754;1;311;-2.14748e+09;-2.46692e+06;-1;0;0;0;-1;0;427274389;435434503;31241567
1581;6.10309e-15;-391;1623;12480;12837;1;325;-2.14748e+09;-2.4619e+06;0;0;0;0;0;0;427372269;435546880;31275748
1581;6.04373e-15;-410;1633;12347;12754;1;311;-2.14748e+09;-2.4619e+06;-1;0;0;0;-1;0;427372269;435546880;31275748
1582;6.10309e-15;-391;1623;12480;12837;1;325;-2.14748e+09;-2.45689e+06;-1;0;0;0;-1;0;427469946;435659046;31309886
1582;6.04373e-15;-411;1633;12347;12754;1;311;-2.14748e+09;-2.45689e+06;0;0;0;0;0;0;427469946;435659046;31309886
1583;6.10309e-15;-391;1623;12480;12837;1;325;-2.14748e+09;-2.452e+06;-1;0;0;0;-1;0;427567419;435771003;31343979
1583;6.04373e-15;-412;1633;12347;12754;1;311;-2.14748e+09;-2.452e+06;0;0;0;0;0;0;427567419;435771003;31343979
1584;6.10309e-15;-391;1623;12480;12837;1;325;-2.14748e+09;-2.44692e+06;-1;0;0;0;-1;0;427664690;435882750;31378029
1584;6.04373e-15;-413;1633;12347;12754;1;311;-2.14748e+09;-2.44692e+06;0;0;0;0;0;0;427664690;435882750;31378029
1585;6.10309e-15;-392;1623;12480;12837;1;325;-2.14748e+09;-2.44204e+06;0;0;0;0;0;0;427761759;435994288;31412034
1585;6.04373e-15;-413;1633;12347;12754;1;311;-2.14748e+09;-2.44204e+06;-1;0;0;0;-1;0;427761759;435994288;31412034
1586;6.10309e-15;-392;1623;12480;12837;1;325;-2.14748e+09;-2.43699e+06;-1;0;0;0;-1;0;427858627;436105618;31445995
1586;6.04373e-15;-413;1633;12347;12754;1;311;-2.14748e+09;-2.43699e+06;-1;0;0;0;-1;0;427858627;436105618;31445995
1587;6.10309e-15;-392;1623;12480;12837;1;325;-2.14748e+09;-2.43204e+06;-1;0;0;0;-1;0;427955293;436216739;31479913
1587;6.04373e-15;-414;1633;12347;12754;1;311;-2.14748e+09;-2.43204e+06;0;0;0;0;0;0;427955293;436216739;31479913
1588;6.10309e-15;-393;1623;12480;12837;1;325;-2.14748e+09;-2.4272e+06;0;0;0;0;0;0;428051759;436327652;31513786
1588;6.04373e-15;-414;1633;12347;12754;1;311;-2.14748e+09;-2.4272e+06;-1;0;0;0;-1;0;428051759;436327652;31513786
1589;6.10309e-15;-394;1623;12480;12837;1;325;-2.14748e+09;-2.42218e+06;0;0;0;0;0;0;428148024;436438358;31547616
1589;6.04373e-15;-415;1633;12347;12754;1;311;-2.14748e+09;-2.42218e+06;0;0;0;0;0;0;428148024;436438358;31547616
1590;6.10309e-15;-395;1623;12480;12837;1;325;-2.14748e+09;-2.41727e+06;0;0;0;0;0;0;428244090;436548857;31581402
1590;6.04373e-15;-415;1633;12347;12754;1;311;-2.14748e+09;-2.41727e+06;-1;0;0;0;-1;0;428244090;436548857;31581402
1591;6.10309e-15;-396;1623;12480;12837;1;325;-2.14748e+09;-2.41237e+06;0;0;0;0;0;0;428339956;436659149;31615143
1591;6.04373e-15;-416;1633;12347;12754;1;311;-2.14748e+09;-2.41237e+06;0;0;0;0;0;0;428339956;436659149;31615143
1592;6.10309e-15;-396;1623;12480;12837;1;325;-2.14748e+09;-2.40748e+06;0;0;-1;0;0;-1;428435623;436769235;31648841
1592;6.04373e-15;-416;1633;12347;12754;1;311;-2.14748e+09;-2.40748e+06;-1;0;0;0;-1;0;428435623;436769235;31648841
1593;6.10309e-15;-396;1623;12480;12837;1;325;-2.14748e+09;-2.4026e+06;-1;0;0;0;-1;0;428531093;436879116;31682495
1593;6.04373e-15;-417;1633;12347;12754;1;311;-2.14748e+09;-2.4026e+06;0;0;0;0;0;0;428531093;436879116;31682495
1594;6.10309e-15;-397;1623;12480;12837;1;325;-2.14748e+09;-2.39774e+06;0;0;0;0;0;0;428626364;436988791;31716105
1594;6.04373e-15;-418;1633;12347;12754;1;311;-2.14748e+09;-2.39774e+06;0;0;0;0;0;0;428626364;436988791;31716105
1595;6.10309e-15;-398;1623;12480;12837;1;325;-2.14748e+09;-2.39288e+06;0;0;0;0;0;0;428721438;437098262;31749672
1595;6.04373e-15;-418;1633;12347;12754;1;311;-2.14748e+09;-2.39288e+06;-1;0;0;0;-1;0;428721438;437098262;31749672
1596;6.10309e-15;-399;1623;12480;12837;1;325;-2.14748e+09;-2.38804e+06;0;0;0;0;0;0;428816315;437207528;31783194
1596;6.04373e-15;-419;1633;12347;12754;1;311;-2.14748e+09;-2.38804e+06;0;0;0;0;0;0;428816315;437207528;31783194
1597;6.10309e-15;-399;1623;12480;12837;1;325;-2.14748e+09;-2.38331e+06;-1;0;0;0;-1;0;428910996;437316590;31816673
1597;6.04373e-15;-420;1633;12347;12754;1;311;-2.14748e+09;-2.38331e+06;0;0;0;0;0;0;428910996;437316590;31816673
1598;6.10309e-15;-400;1623;12480;12837;1;325;-2.14748e+09;-2.37838e+06;0;0;0;0;0;0;429005480;437425449;31850108
1598;6.04373e-15;-421;1633;12347;12754;1;311;-2.14748e+09;-2.37838e+06;0;0;0;0;0;0;429005480;437425449;31850108
1599;6.10309e-15;-401;1623;12480;12837;1;325;-2.14748e+09;-2.37368e+06;0;0;0;0;0;0;429099769;437534105;31883499
1599;6.04373e-15;-421;1633;12347;12754;1;311;-2.14748e+09;-2.37368e+06;-1;0;0;0;-1;0;429099769;437534105;31883499
1600;6.10309e-15;-401;1623;12480;12837;1;325;-2.14748e+09;-2.36888e+06;-1;0;0;0;-1;0;429193863;437642557;31916846
1600;6.04373e-15;-421;1633;12347;12754;1;311;-2.14748e+09;-2.36888e+06;-1;0;0;0;-1;0;429193863;437642557;31916846
1601;6.10309e-15;-401;1623;12480;12837;1;325;-2.14748e+09;-2.36399e+06;-1;0;0;0;-1;0;429287762;437750808;31950150
1601;6.04373e-15;-421;1633;12347;12754;1;311;-2.14748e+09;-2.36399e+06;-1;0;0;0;-1;0;429287762;437750808;31950150
1602;6.10309e-15;-402;1623;12480;12837;1;325;-2.14748e+09;-2.35922e+06;0;0;0;0;0;0;429381467;437858857;31983409
1602;6.04373e-15;-422;1633;12347;12754;1;311;-2.14748e+09;-2.35922e+06;0;0;0;0;0;0;429381467;437858857;31983409
1603;6.10309e-15;-403;1623;12480;12837;1;325;-2.14748e+09;-2.35445e+06;0;0;0;0;0;0;429474978;437966704;32016626
1603;6.04373e-15;-422;1633;12347;12754;1;311;-2.14748e+09;-2.35445e+06;-1;0;0;0;-1;0;429474978;437966704;32016626
1604;6.10309e-15;-403;1623;12480;12837;1;325;-2.14748e+09;-2.3497e+06;-1;0;0;0;-1;0;429568296;438074350;32049798
1604;6.04373e-15;-422;1633;12347;12754;1;311;-2.14748e+09;-2.3497e+06;-1;0;0;0;-1;0;429568296;438074350;32049798
1605;6.10309e-15;-403;1623;12480;12837;1;325;-2.14748e+09;-2.34496e+06;-1;0;0;0;-1;0;429661421;438181796;32082927
1605;6.04373e-15;-423;1633;12347;12754;1;311;-2.14748e+09;-2.34496e+06;0;0;0;0;0;0;429661421;438181796;32082927
1606;6.10309e-15;-404;1623;12480;12837;1;325;-2.14748e+09;-2.34023e+06;0;0;0;0;0;0;429754354;438289041;32116012
1606;6.04373e-15;-423;1633;12347;12754;1;311;-2.14748e+09;-2.34023e+06;-1;0;0;0;-1;0;429754354;438289041;32116012
1607;6.10309e-15;-405;1623;12480;12837;1;325;-2.14748e+09;-2.33551e+06;0;0;0;0;0;0;429847095;438396087;32149053
1607;6.04373e-15;-424;1633;12347;12754;1;311;-2.14748e+09;-2.33551e+06;0;0;0;0;0;0;429847095;438396087;32149053
1608;6.10309e-15;-406;1623;12480;12837;1;325;-2.14748e+09;-2.3308e+06;0;0;0;0;0;0;429939644;438502933;32182051
1608;6.04373e-15;-424;1633;12347;12754;1;311;-2.14748e+09;-2.3308e+06;-1;0;0;0;-1;0;429939644;438502933;32182051
1609;6.10309e-15;-406;1623;12480;12837;1;325;-2.14748e+09;-2.3261e+06;-1;0;0;0;-1;0;430032002;438609580;32215005
1609;6.04373e-15;-424;1633;12347;12754;1;311;-2.14748e+09;-2.3261e+06;-1;0;0;0;-1;0;430032002;438609580;32215005
1610;6.10309e-15;-407;1623;12480;12837;1;325;-2.14748e+09;-2.32141e+06;0;0;0;0;0;0;430124170;438716028;32247916
1610;6.04373e-15;-424;1633;12347;12754;1;311;-2.14748e+09;-2.32141e+06;-1;0;0;0;-1;0;430124170;438716028;32247916
1611;6.10309e-15;-407;1623;12480;12837;1;325;-2.14748e+09;-2.31674e+06;-1;0;0;0;-1;0;430216148;438822279;32280783
1611;6.04373e-15;-425;1633;12347;12754;1;311;-2.14748e+09;-2.31674e+06;0;0;0;0;0;0;430216148;438822279;32280783
1612;6.10309e-15;-408;1623;12480;12837;1;325;-2.14748e+09;-2.31207e+06;0;0;0;0;0;0;430307935;438928331;32313606
1612;6.04373e-15;-425;1633;12347;12754;1;311;-2.14748e+09;-2.31207e+06;-1;0;0;0;-1;0;430307935;438928331;32313606
1613;6.10309e-15;-409;1623;12480;12837;1;325;-2.14748e+09;-2.30742e+06;0;0;0;0;0;0;430399534;439034187;32346386
1613;6.04373e-15;-426;1633;12347;12754;1;311;-2.14748e+09;-2.30742e+06;0;0;0;0;0;0;430399534;439034187;32346386
1614;6.10309e-15;-409;1623;12480;12837;1;325;-2.14748e+09;-2.30277e+06;-1;0;0;0;-1;0;430490943;439139845;32379122
1614;6.04373e-15;-426;1633;12347;12754;1;311;-2.14748e+09;-2.30277e+06;-1;0;0;0;-1;0;430490943;439139845;32379122
1615;6.10309e-15;-410;1623;12480;12837;1;325;-2.14748e+09;-2.29814e+06;0;0;0;0;0;0;430582165;439245307;32411815
1615;6.04373e-15;-426;1633;12347;12754;1;311;-2.14748e+09;-2.29814e+06;-1;0;0;0;-1;0;430582165;439245307;32411815
1616;6.10309e-15;-411;1623;12480;12837;1;325;-2.14748e+09;-2.29362e+06;0;0;0;0;0;0;430673198;439350573;32444464
1616;6.04373e-15;-427;1633;12347;12754;1;311;-2.14748e+09;-2.29362e+06;0;0;0;0;0;0;430673198;439350573;32444464
1617;6.10309e-15;-411;1623;12480;12837;1;325;-2.14748e+09;-2.28891e+06;-1;0;0;0;-1;0;430764044;439455643;32477070
1617;6.04373e-15;-428;1633;12347;12754;1;311;-2.14748e+09;-2.28891e+06;0;0;0;0;0;0;430764044;439455643;32477070
1618;6.10309e-15;-412;1623;12480;12837;1;325;-2.14748e+09;-2.28431e+06;0;0;0;0;0;0;430854702;439560517;32509633
1618;6.04373e-15;-429;1633;12347;12754;1;311;-2.14748e+09;-2.28431e+06;0;0;0;0;0;0;430854702;439560517;32509633
1619;6.10309e-15;-413;1623;12480;12837;1;325;-2.14748e+09;-2.27972e+06;0;0;0;0;0;0;430945174;439665197;32542152
1619;6.04373e-15;-430;1633;12347;12754;1;311;-2.14748e+09;-2.27972e+06;0;0;0;0;0;0;430945174;439665197;32542152
1620;6.10309e-15;-413;1623;12480;12837;1;325;-2.14748e+09;-2.27514e+06;-1;0;0;0;-1;0;431035460;439769682;32574627
1620;6.04373e-15;-430;1633;12347;12754;1;311;-2.14748e+09;-2.27514e+06;-1;0;0;0;-1;0;431035460;439769682;32574627
1621;6.10309e-15;-413;1623;12480;12837;1;325;-2.14748e+09;-2.27057e+06;-1;0;0;0;-1;0;431125560;439873973;32607059
1621;6.04373e-15;-431;1633;12347;12754;1;311;-2.14748e+09;-2.27057e+06;0;0;0;0;0;0;431125560;439873973;32607059
1622;6.10309e-15;-414;1623;12480;12837;1;325;-2.14748e+09;-2.26601e+06;0;0;0;0;0;0;431215475;439978071;32639448
1622;6.04373e-15;-431;1633;12347;12754;1;311;-2.14748e+09;-2.26601e+06;-1;0;0;0;-1;0;431215475;439978071;32639448
1623;6.10309e-15;-414;1623;12480;12837;1;325;-2.14748e+09;-2.26156e+06;-1;0;0;0;-1;0;431305204;440081974;32671794
1623;6.04373e-15;-432;1633;12347;12754;1;311;-2.14748e+09;-2.26156e+06;0;0;0;0;0;0;431305204;440081974;32671794
1624;6.10309e-15;-415;1623;12480;12837;1;325;-2.14748e+09;-2.25692e+06;0;0;0;0;0;0;431394749;440185685;32704096
1624;6.04373e-15;-433;1633;12347;12754;1;311;-2.14748e+09;-2.25692e+06;0;0;0;0;0;0;431394749;440185685;32704096
1625;6.10309e-15;-416;1623;12480;12837;1;325;-2.14748e+09;-2.2524e+06;0;0;0;0;0;0;431484110;440289204;32736355
1625;6.04373e-15;-434;1633;12347;12754;1;311;-2.14748e+09;-2.2524e+06;0;0;0;0;0;0;431484110;440289204;32736355
1626;6.10309e-15;-417;1623;12480;12837;1;325;-2.14748e+09;-2.24788e+06;0;0;0;0;0;0;431573288;440392530;32768570
1626;6.04373e-15;-434;1633;12347;12754;1;311;-2.14748e+09;-2.24788e+06;-1;0;0;0;-1;0;431573288;440392530;32768570
1627;6.10309e-15;-417;1623;12480;12837;1;325;-2.14748e+09;-2.24347e+06;-1;0;0;0;-1;0;431662282;440495664;32800743
1627;6.04373e-15;-434;1633;12347;12754;1;311;-2.14748e+09;-2.24347e+06;-1;0;0;0;-1;0;431662282;440495664;32800743
1628;6.10309e-15;-417;1623;12480;12837;1;325;-2.14748e+09;-2.23888e+06;-1;0;0;0;-1;0;431751093;440598607;32832872
1628;6.04373e-15;-435;1633;12347;12754;1;311;-2.14748e+09;-2.23888e+06;0;0;0;0;0;0;431751093;440598607;32832872
1629;6.10309e-15;-417;1623;12480;12837;1;325;-2.14748e+09;-2.23449e+06;-1;0;0;0;-1;0;431839722;440701359;32864958
1629;6.04373e-15;-436;1633;12347;12754;1;311;-2.14748e+09;-2.23449e+06;0;0;0;0;0;0;431839722;440701359;32864958
1630;6.10309e-15;-418;1623;12480;12837;1;325;-2.14748e+09;-2.22992e+06;0;0;0;0;0;0;431928169;440803920;32897000
1630;6.04373e-15;-437;1633;12347;12754;1;311;-2.14748e+09;-2.22992e+06;0;0;0;0;0;0;431928169;440803920;32897000
1631;6.10309e-15;-419;1623;12480;12837;1;325;-2.14748e+09;-2.22555e+06;0;0;0;0;0;0;432016434;440906292;32929000
1631;6.04373e-15;-437;1633;12347;12754;1;311;-2.14748e+09;-2.22555e+06;-1;0;0;0;-1;0;432016434;440906292;32929000
1632;6.10309e-15;-419;1623;12480;12837;1;325;-2.14748e+09;-2.221e+06;-1;0;0;0;-1;0;432104518;441008473;32960956
1632;6.04373e-15;-438;1633;12347;12754;1;311;-2.14748e+09;-2.221e+06;0;0;0;0;0;0;432104518;441008473;32960956
1633;6.10309e-15;-420;1623;12480;12837;1;325;-2.14748e+09;-2.21655e+06;0;0;0;0;0;0;432192422;441110465;32992869
1633;6.04373e-15;-438;1633;12347;12754;1;311;-2.14748e+09;-2.21655e+06;-1;0;0;0;-1;0;432192422;441110465;32992869
1634;6.10309e-15;-421;1623;12480;12837;1;325;-2.14748e+09;-2.21212e+06;0;0;0;0;0;0;432280145;441212268;33024740
1634;6.04373e-15;-438;1633;12347;12754;1;311;-2.14748e+09;-2.21212e+06;-1;0;0;0;-1;0;432280145;441212268;33024740
1635;6.10309e-15;-421;1623;12480;12837;1;325;-2.14748e+09;-2.2077e+06;-1;0;0;0;-1;0;432367688;441313882;33056567
1635;6.04373e-15;-439;1633;12347;12754;1;311;-2.14748e+09;-2.2077e+06;0;0;0;0;0;0;432367688;441313882;33056567
1636;6.10309e-15;-421;1623;12480;12837;1;325;-2.14748e+09;-2.20328e+06;-1;0;0;0;-1;0;432455052;441415307;33088351
1636;6.04373e-15;-440;1633;12347;12754;1;311;-2.14748e+09;-2.20328e+06;0;0;0;0;0;0;432455052;441415307;33088351
1637;6.10309e-15;-421;1623;12480;12837;1;325;-2.14748e+09;-2.19888e+06;-1;0;0;0;-1;0;432542236;441516545;33120091
1637;6.04373e-15;-441;1633;12347;12754;1;311;-2.14748e+09;-2.19888e+06;0;0;0;0;0;0;432542236;441516545;33120091
1638;6.10309e-15;-422;1623;12480;12837;1;325;-2.14748e+09;-2.19448e+06;0;0;0;0;0;0;432629242;441617595;33151789
1638;6.04373e-15;-441;1633;12347;12754;1;311;-2.14748e+09;-2.19448e+06;-1;0;0;0;-1;0;432629242;441617595;33151789
1639;6.10309e-15;-423;1623;12480;12837;1;325;-2.14748e+09;-2.1901e+06;0;0;0;0;0;0;432716070;441718458;33183444
1639;6.04373e-15;-442;1633;12347;12754;1;311;-2.14748e+09;-2.1901e+06;0;0;0;0;0;0;432716070;441718458;33183444
1640;6.10309e-15;-423;1623;12480;12837;1;325;-2.14748e+09;-2.18572e+06;-1;0;0;0;-1;0;432802720;441819135;33215056
1640;6.04373e-15;-443;1633;12347;12754;1;311;-2.14748e+09;-2.18572e+06;0;0;0;0;0;0;432802720;441819135;33215056
1641;6.10309e-15;-423;1623;12480;12837;1;325;-2.14748e+09;-2.18136e+06;-1;0;0;0;-1;0;432889192;441919625;33246625
1641;6.04373e-15;-443;1633;12347;12754;1;311;-2.14748e+09;-2.18136e+06;-1;0;0;0;-1;0;432889192;441919625;33246625
1642;6.10309e-15;-423;1623;12480;12837;1;325;-2.14748e+09;-2.17701e+06;-1;0;0;0;-1;0;432975488;442019928;33278151
1642;6.04373e-15;-444;1633;12347;12754;1;311;-2.14748e+09;-2.17701e+06;0;0;0;0;0;0;432975488;442019928;33278151
1643;6.10309e-15;-424;1623;12480;12837;1;325;-2.14748e+09;-2.17266e+06;0;0;0;0;0;0;433061607;442120047;33309634
1643;6.04373e-15;-445;1633;12347;12754;1;311;-2.14748e+09;-2.17266e+06;0;0;0;0;0;0;433061607;442120047;33309634
1644;6.10309e-15;-424;1623;12480;12837;1;325;-2.14748e+09;-2.16833e+06;-1;0;0;0;-1;0;433147549;442219979;33341075
1644;6.04373e-15;-445;1633;12347;12754;1;311;-2.14748e+09;-2.16833e+06;-1;0;0;0;-1;0;433147549;442219979;33341075
1645;6.10309e-15;-425;1623;12480;12837;1;325;-2.14748e+09;-2.164e+06;0;0;0;0;0;0;433233316;442319727;33372472
1645;6.04373e-15;-446;1633;12347;12754;1;311;-2.14748e+09;-2.164e+06;0;0;0;0;0;0;433233316;442319727;33372472
1646;6.10309e-15;-426;1623;12480;12837;1;325;-2.14748e+09;-2.15969e+06;0;0;0;0;0;0;433318907;442419291;33403827
1646;6.04373e-15;-447;1633;12347;12754;1;311;-2.14748e+09;-2.15969e+06;0;0;0;0;0;0;433318907;442419291;33403827
1647;6.10309e-15;-427;1623;12480;12837;1;325;-2.14748e+09;-2.15548e+06;0;0;0;0;0;0;433404324;442518670;33435139
1647;6.04373e-15;-447;1633;12347;12754;1;311;-2.14748e+09;-2.15548e+06;-1;0;0;0;-1;0;433404324;442518670;33435139
1648;6.10309e-15;-428;1623;12480;12837;1;325;-2.14748e+09;-2.15109e+06;0;0;0;0;0;0;433489565;442617865;33466408
1648;6.04373e-15;-448;1633;12347;12754;1;311;-2.14748e+09;-2.15109e+06;0;0;0;0;0;0;433489565;442617865;33466408
1649;6.10309e-15;-428;1623;12480;12837;1;325;-2.14748e+09;-2.1468e+06;-1;0;0;0;-1;0;433574633;442716877;33497634
1649;6.04373e-15;-448;1633;12347;12754;1;311;-2.14748e+09;-2.1468e+06;-1;0;0;0;-1;0;433574633;442716877;33497634
1650;6.10309e-15;-429;1623;12480;12837;1;325;-2.14748e+09;-2.14263e+06;0;0;0;0;0;0;433659527;442815706;33528818
1650;6.04373e-15;-448;1633;12347;12754;1;311;-2.14748e+09;-2.14263e+06;-1;0;0;0;-1;0;433659527;442815706;33528818
1651;6.10309e-15;-430;1623;12480;12837;1;325;-2.14748e+09;-2.13836e+06;0;0;0;0;0;0;433744247;442914352;33559959
1651;6.04373e-15;-448;1633;12347;12754;1;311;-2.14748e+09;-2.13836e+06;-1;0;0;0;-1;0;433744247;442914352;33559959
1652;6.10309e-15;-431;1623;12480;12837;1;325;-2.14748e+09;-2.13401e+06;0;0;0;0;0;0;433828794;443012816;33591057
1652;6.04373e-15;-448;1633;12347;12754;1;311;-2.14748e+09;-2.13401e+06;-1;0;0;0;-1;0;433828794;443012816;33591057
1653;6.10309e-15;-432;1623;12480;12837;1;325;-2.14748e+09;-2.12986e+06;0;0;0;0;0;0;433913169;443111098;33622112
1653;6.04373e-15;-448;1633;12347;12754;1;311;-2.14748e+09;-2.12986e+06;-1;0;0;0;-1;0;433913169;443111098;33622112
1654;6.10309e-15;-432;1623;12480;12837;1;325;-2.14748e+09;-2.12552e+06;-1;0;0;0;-1;0;433997371;443209198;33653125
1654;6.04373e-15;-449;1633;12347;12754;1;311;-2.14748e+09;-2.12552e+06;0;0;0;0;0;0;433997371;443209198;33653125
1655;6.10309e-15;-432;1623;12480;12837;1;325;-2.14748e+09;-2.1213e+06;-1;0;0;0;-1;0;434081401;443307117;33684096
1655;6.04373e-15;-450;1633;12347;12754;1;311;-2.14748e+09;-2.1213e+06;0;0;0;0;0;0;434081401;443307117;33684096
1656;6.10309e-15;-433;1623;12480;12837;1;325;-2.14748e+09;-2.11708e+06;0;0;0;0;0;0;434165260;443404855;33715023
1656;6.04373e-15;-451;1633;12347;12754;1;311;-2.14748e+09;-2.11708e+06;0;0;0;0;0;0;434165260;443404855;33715023
1657;6.10309e-15;-434;1623;12480;12837;1;325;-2.14748e+09;-2.11287e+06;0;0;0;0;0;0;434248948;443502413;33745909
1657;6.04373e-15;-451;1633;12347;12754;1;311;-2.14748e+09;-2.11287e+06;-1;0;0;0;-1;0;434248948;443502413;33745909
1658;6.10309e-15;-435;1623;12480;12837;1;325;-2.14748e+09;-2.10877e+06;0;0;0;0;0;0;434332466;443599791;33776751
1658;6.04373e-15;-452;1633;12347;12754;1;311;-2.14748e+09;-2.10877e+06;0;0;0;0;0;0;434332466;443599791;33776751
1659;6.10309e-15;-435;1623;12480;12837;1;325;-2.14748e+09;-2.10448e+06;-1;0;0;0;-1;0;434415813;443696988;33807552
1659;6.04373e-15;-452;1633;12347;12754;1;311;-2.14748e+09;-2.10448e+06;-1;0;0;0;-1;0;434415813;443696988;33807552
1660;6.10309e-15;-435;1623;12480;12837;1;325;-2.14748e+09;-2.1004e+06;-1;0;0;0;-1;0;434498990;443794007;33838309
1660;6.04373e-15;-452;1633;12347;12754;1;311;-2.14748e+09;-2.1004e+06;-1;0;0;0;-1;0;434498990;443794007;33838309
1661;6.10309e-15;-436;1623;12480;12837;1;325;-2.14748e+09;-2.09623e+06;0;0;0;0;0;0;434581997;443890846;33869025
1661;6.04373e-15;-453;1633;12347;12754;1;311;-2.14748e+09;-2.09623e+06;0;0;0;0;0;0;434581997;443890846;33869025
1662;6.10309e-15;-436;1623;12480;12837;1;325;-2.14748e+09;-2.09197e+06;-1;0;0;0;-1;0;434664835;443987506;33899698
1662;6.04373e-15;-454;1633;12347;12754;1;311;-2.14748e+09;-2.09197e+06;0;0;0;0;0;0;434664835;443987506;33899698
1663;6.10309e-15;-437;1623;12480;12837;1;325;-2.14748e+09;-2.08782e+06;0;0;0;0;0;0;434747505;444083988;33930328
1663;6.04373e-15;-455;1633;12347;12754;1;311;-2.14748e+09;-2.08782e+06;0;0;0;0;0;0;434747505;444083988;33930328
1664;6.10309e-15;-437;1623;12480;12837;1;325;-2.14748e+09;-2.08367e+06;-1;0;0;0;-1;0;434830006;444180292;33960916
1664;6.04373e-15;-456;1633;12347;12754;1;311;-2.14748e+09;-2.08367e+06;0;0;0;0;0;0;434830006;444180292;33960916
1665;6.10309e-15;-437;1623;12480;12837;1;325;-2.14748e+09;-2.07954e+06;-1;0;0;0;-1;0;434912340;444276419;33991462
1665;6.04373e-15;-456;1633;12347;12754;1;311;-2.14748e+09;-2.07954e+06;-1;0;0;0;-1;0;434912340;444276419;33991462
1666;6.10309e-15;-437;1623;12480;12837;1;325;-2.14748e+09;-2.07542e+06;-1;0;0;0;-1;0;434994505;444372368;34021966
1666;6.04373e-15;-456;1633;12347;12754;1;311;-2.14748e+09;-2.07542e+06;-1;0;0;0;-1;0;434994505;444372368;34021966
1667;6.10309e-15;-437;1623;12480;12837;1;325;-2.14748e+09;-2.0713e+06;-1;0;0;0;-1;0;435076504;444468140;34052427
1667;6.04373e-15;-457;1633;12347;12754;1;311;-2.14748e+09;-2.0713e+06;0;0;0;0;0;0;435076504;444468140;34052427
1668;6.10309e-15;-437;1623;12480;12837;1;325;-2.14748e+09;-2.0672e+06;-1;0;0;0;-1;0;435158335;444563736;34082846
1668;6.04373e-15;-458;1633;12347;12754;1;311;-2.14748e+09;-2.0672e+06;0;0;0;0;0;0;435158335;444563736;34082846
1669;6.10309e-15;-438;1623;12480;12837;1;325;-2.14748e+09;-2.0632e+06;0;0;0;0;0;0;435240001;444659155;34113223
1669;6.04373e-15;-458;1633;12347;12754;1;311;-2.14748e+09;-2.0632e+06;-1;0;0;0;-1;0;435240001;444659155;34113223
1670;6.10309e-15;-439;1623;12480;12837;1;325;-2.14748e+09;-2.05901e+06;0;0;0;0;0;0;435321499;444754399;34143558
1670;6.04373e-15;-459;1633;12347;12754;1;311;-2.14748e+09;-2.05901e+06;0;0;0;0;0;0;435321499;444754399;34143558
1671;6.10309e-15;-439;1623;12480;12837;1;325;-2.14748e+09;-2.05503e+06;-1;0;0;0;-1;0;435402833;444849467;34173850
1671;6.04373e-15;-460;1633;12347;12754;1;311;-2.14748e+09;-2.05503e+06;0;0;0;0;0;0;435402833;444849467;34173850
1672;6.10309e-15;-439;1623;12480;12837;1;325;-2.14748e+09;-2.05086e+06;-1;0;0;0;-1;0;435484001;444944359;34204101
1672;6.04373e-15;-461;1633;12347;12754;1;311;-2.14748e+09;-2.05087e+06;0;0;0;0;0;0;435484001;444944359;34204101
1673;6.10309e-15;-440;1623;12480;12837;1;325;-2.14748e+09;-2.0468e+06;0;0;0;0;0;0;435565004;445039077;34234309
1673;6.04373e-15;-462;1633;12347;12754;1;311;-2.14748e+09;-2.0468e+06;0;0;0;0;0;0;435565004;445039077;34234309
1674;6.10309e-15;-441;1623;12480;12837;1;325;-2.14748e+09;-2.04275e+06;0;0;0;0;0;0;435645842;445133621;34264475
1674;6.04373e-15;-462;1633;12347;12754;1;311;-2.14748e+09;-2.04275e+06;-1;0;0;0;-1;0;435645842;445133621;34264475
1675;6.10309e-15;-441;1623;12480;12837;1;325;-2.14748e+09;-2.03881e+06;-1;0;0;0;-1;0;435726516;445227990;34294599
1675;6.04373e-15;-463;1633;12347;12754;1;311;-2.14748e+09;-2.03881e+06;0;0;0;0;0;0;435726516;445227990;34294599
1676;6.10309e-15;-441;1623;12480;12837;1;325;-2.14748e+09;-2.03468e+06;-1;0;0;0;-1;0;435807027;445322185;34324681
1676;6.04373e-15;-463;1633;12347;12754;1;311;-2.14748e+09;-2.03468e+06;-1;0;0;0;-1;0;435807027;445322185;34324681
1677;6.10309e-15;-441;1623;12480;12837;1;325;-2.14748e+09;-2.03076e+06;-1;0;0;0;-1;0;435887373;445416207;34354721
1677;6.04373e-15;-463;1633;12347;12754;1;311;-2.14748e+09;-2.03075e+06;-1;0;0;0;-1;0;435887373;445416207;34354721
1678;6.10309e-15;-442;1623;12480;12837;1;325;-2.14748e+09;-2.02674e+06;0;0;0;0;0;0;435967557;445510056;34384720
1678;6.04373e-15;-463;1633;12347;12754;1;311;-2.14748e+09;-2.02674e+06;-1;0;0;0;-1;0;435967557;445510056;34384720
1679;6.10309e-15;-443;1623;12480;12837;1;325;-2.14748e+09;-2.02273e+06;0;0;0;0;0;0;436047578;445603732;34414676
1679;6.04373e-15;-464;1633;12347;12754;1;311;-2.14748e+09;-2.02273e+06;0;0;0;0;0;0;436047578;445603732;34414676
1680;6.10309e-15;-444;1623;12480;12837;1;325;-2.14748e+09;-2.01864e+06;0;0;0;0;0;0;436127436;445697236;34444590
1680;6.04373e-15;-464;1633;12347;12754;1;311;-2.14748e+09;-2.01864e+06;-1;0;0;0;-1;0;436127436;445697236;34444590
1681;6.10309e-15;-444;1623;12480;12837;1;325;-2.14748e+09;-2.01465e+06;-1;0;0;0;-1;0;436207133;445790568;34474463
1681;6.04373e-15;-464;1633;12347;12754;1;311;-2.14748e+09;-2.01465e+06;-1;0;0;0;-1;0;436207133;445790568;34474463
1682;6.10309e-15;-444;1623;12480;12837;1;325;-2.14748e+09;-2.01067e+06;-1;0;0;0;-1;0;436286668;445883728;34504293
1682;6.04373e-15;-465;1633;12347;12754;1;311;-2.14748e+09;-2.01067e+06;0;0;0;0;0;0;436286668;445883728;34504293
1683;6.10309e-15;-445;1623;12480;12837;1;325;-2.14748e+09;-2.0067e+06;0;0;0;0;0;0;436366041;445976716;34534082
1683;6.04373e-15;-465;1633;12347;12754;1;311;-2.14748e+09;-2.0067e+06;-1;0;0;0;-1;0;436366041;445976716;34534082
1684;6.10309e-15;-445;1623;12480;12837;1;325;-2.14748e+09;-2.00274e+06;-1;0;0;0;-1;0;436445254;446069533;34563829
1684;6.04373e-15;-465;1633;12347;12754;1;311;-2.14748e+09;-2.00274e+06;-1;0;0;0;-1;0;436445254;446069533;34563829
1685;6.10309e-15;-446;1623;12480;12837;1;325;-2.14748e+09;-1.99878e+06;0;0;0;0;0;0;436524306;446162180;34593535
1685;6.04373e-15;-466;1633;12347;12754;1;311;-2.14748e+09;-1.99878e+06;0;0;0;0;0;0;436524306;446162180;34593535
1686;6.10309e-15;-447;1623;12480;12837;1;325;-2.14748e+09;-1.99484e+06;0;0;0;0;0;0;436603198;446254656;34623198
1686;6.04373e-15;-467;1633;12347;12754;1;311;-2.14748e+09;-1.99484e+06;0;0;0;0;0;0;436603198;446254656;34623198
1687;6.10309e-15;-448;1623;12480;12837;1;325;-2.14748e+09;-1.9909e+06;0;0;0;0;0;0;436681930;446346962;34652820
1687;6.04373e-15;-467;1633;12347;12754;1;311;-2.14748e+09;-1.99091e+06;-1;0;0;0;-1;0;436681930;446346962;34652820
1688;6.10309e-15;-449;1623;12480;12837;1;325;-2.14748e+09;-1.98698e+06;0;0;0;0;0;0;436760502;446439099;34682400
1688;6.04373e-15;-467;1633;12347;12754;1;311;-2.14748e+09;-1.98698e+06;-1;0;0;0;-1;0;436760502;446439099;34682400
1689;6.10309e-15;-449;1623;12480;12837;1;325;-2.14748e+09;-1.98306e+06;-1;0;0;0;-1;0;436838916;446531066;34711939
1689;6.04373e-15;-468;1633;12347;12754;1;311;-2.14748e+09;-1.98306e+06;0;0;0;0;0;0;436838916;446531066;34711939
1690;6.10309e-15;-449;1623;12480;12837;1;325;-2.14748e+09;-1.97915e+06;-1;0;0;0;-1;0;436917170;446622864;34741436
1690;6.04373e-15;-468;1633;12347;12754;1;311;-2.14748e+09;-1.97915e+06;-1;0;0;0;-1;0;436917170;446622864;34741436
1691;6.10309e-15;-450;1623;12480;12837;1;325;-2.14748e+09;-1.97525e+06;0;0;0;0;0;0;436995267;446714493;34770892
1691;6.04373e-15;-468;1633;12347;12754;1;311;-2.14748e+09;-1.97525e+06;-1;0;0;0;-1;0;436995267;446714493;34770892
1692;6.10309e-15;-450;1623;12480;12837;1;325;-2.14748e+09;-1.97136e+06;-1;0;0;0;-1;0;437073205;446805954;34800305
1692;6.04373e-15;-468;1633;12347;12754;1;311;-2.14748e+09;-1.97136e+06;-1;0;0;0;-1;0;437073205;446805954;34800305
1693;6.10309e-15;-450;1623;12480;12837;1;325;-2.14748e+09;-1.96747e+06;-1;0;0;0;-1;0;437150985;446897247;34829678
1693;6.04373e-15;-469;1633;12347;12754;1;311;-2.14748e+09;-1.96747e+06;0;0;0;0;0;0;437150985;446897247;34829678
1694;6.10309e-15;-451;1623;12480;12837;1;325;-2.14748e+09;-1.9636e+06;0;0;0;0;0;0;437228608;446988372;34859009
1694;6.04373e-15;-470;1633;12347;12754;1;311;-2.14748e+09;-1.9636e+06;0;0;0;0;0;0;437228608;446988372;34859009
1695;6.10309e-15;-451;1623;12480;12837;1;325;-2.14748e+09;-1.95973e+06;-1;0;0;0;-1;0;437306074;447079330;34888298
1695;6.04373e-15;-470;1633;12347;12754;1;311;-2.14748e+09;-1.95973e+06;-1;0;0;0;-1;0;437306074;447079330;34888298
1696;6.10309e-15;-451;1623;12480;12837;1;325;-2.14748e+09;-1.95598e+06;-1;0;0;0;-1;0;437383383;447170120;34917547
1696;6.04373e-15;-471;1633;12347;12754;1;311;-2.14748e+09;-1.95598e+06;0;0;0;0;0;0;437383383;447170120;34917547
1697;6.10309e-15;-451;1623;12480;12837;1;325;-2.14748e+09;-1.95203e+06;-1;0;0;0;-1;0;437460536;447260744;34946753
1697;6.04373e-15;-472;1633;12347;12754;1;311;-2.14748e+09;-1.95203e+06;0;0;0;0;0;0;437460536;447260744;34946753
1698;6.10309e-15;-452;1623;12480;12837;1;325;-2.14748e+09;-1.94818e+06;0;0;0;0;0;0;437537534;447351202;34975919
1698;6.04373e-15;-472;1633;12347;12754;1;311;-2.14748e+09;-1.94818e+06;-1;0;0;0;-1;0;437537534;447351202;34975919
1699;6.10309e-15;-453;1623;12480;12837;1;325;-2.14748e+09;-1.94445e+06;0;0;0;0;0;0;437614375;447441493;35005043
1699;6.04373e-15;-472;1633;12347;12754;1;311;-2.14748e+09;-1.94445e+06;-1;0;0;0;-1;0;437614375;447441493;35005043
1700;6.10309e-15;-453;1623;12480;12837;1;325;-2.14748e+09;-1.94053e+06;-1;0;0;0;-1;0;437691061;447531619;35034126
1700;6.04373e-15;-472;1633;12347;12754;1;311;-2.14748e+09;-1.94053e+06;-1;0;0;0;-1;0;437691061;447531619;35034126
1701;6.10309e-15;-454;1623;12480;12837;1;325;-2.14748e+09;-1.93671e+06;0;0;0;0;0;0;437767593;447621579;35063167
1701;6.04373e-15;-472;1633;12347;12754;1;311;-2.14748e+09;-1.93671e+06;-1;0;0;0;-1;0;437767593;447621579;35063167
1702;6.10309e-15;-455;1623;12480;12837;1;325;-2.14748e+09;-1.9329e+06;0;0;0;0;0;0;437843969;447711374;35092167
1702;6.04373e-15;-472;1633;12347;12754;1;311;-2.14748e+09;-1.93291e+06;-1;0;0;0;-1;0;437843969;447711374;35092167
1703;6.10309e-15;-456;1623;12480;12837;1;325;-2.14748e+09;-1.92911e+06;0;0;0;0;0;0;437920192;447801005;35121127
1703;6.04373e-15;-473;1633;12347;12754;1;311;-2.14748e+09;-1.92911e+06;0;0;0;0;0;0;437920192;447801004;35121127
1704;6.10309e-15;-457;1623;12480;12837;1;325;-2.14748e+09;-1.92531e+06;0;0;0;0;0;0;437996261;447890470;35150045
1704;6.04373e-15;-473;1633;12347;12754;1;311;-2.14748e+09;-1.92531e+06;-1;0;0;0;-1;0;437996261;447890470;35150045
1705;6.10309e-15;-458;1623;12480;12837;1;325;-2.14748e+09;-1.92153e+06;0;0;0;0;0;0;438072176;447979772;35178921
1705;6.04373e-15;-473;1633;12347;12754;1;311;-2.14748e+09;-1.92153e+06;-1;0;0;0;-1;0;438072176;447979772;35178921
1706;6.10309e-15;-459;1623;12480;12837;1;325;-2.14748e+09;-1.91776e+06;0;0;0;0;0;0;438147938;448068910;35207757
1706;6.04373e-15;-474;1633;12347;12754;1;311;-2.14748e+09;-1.91776e+06;0;0;0;0;0;0;438147938;448068910;35207757
1707;6.10309e-15;-460;1623;12480;12837;1;325;-2.14748e+09;-1.91409e+06;0;0;0;0;0;0;438223547;448157884;35236552
1707;6.04373e-15;-475;1633;12347;12754;1;311;-2.14748e+09;-1.91409e+06;0;0;0;0;0;0;438223547;448157884;35236552
1708;6.10309e-15;-460;1623;12480;12837;1;325;-2.14748e+09;-1.91024e+06;-1;0;0;0;-1;0;438299003;448246696;35265306
1708;6.04373e-15;-476;1633;12347;12754;1;311;-2.14748e+09;-1.91024e+06;0;0;0;0;0;0;438299003;448246696;35265306
1709;6.10309e-15;-461;1623;12480;12837;1;325;-2.14748e+09;-1.90649e+06;0;0;0;0;0;0;438374308;448335344;35294018
1709;6.04373e-15;-476;1633;12347;12754;1;311;-2.14748e+09;-1.90649e+06;-1;0;0;0;-1;0;438374308;448335344;35294018
1710;6.10309e-15;-461;1623;12480;12837;1;325;-2.14748e+09;-1.90275e+06;-1;0;0;0;-1;0;438449460;448423830;35322690
1710;6.04373e-15;-477;1633;12347;12754;1;311;-2.14748e+09;-1.90274e+06;0;0;0;0;0;0;438449460;448423830;35322690
1711;6.10309e-15;-461;1623;12480;12837;1;325;-2.14748e+09;-1.89901e+06;-1;0;0;0;-1;0;438524461;448512153;35351321
1711;6.04373e-15;-478;1633;12347;12754;1;311;-2.14748e+09;-1.89901e+06;0;0;0;0;0;0;438524461;448512153;35351321
1712;6.10309e-15;-462;1623;12480;12837;1;325;-2.14748e+09;-1.89529e+06;0;0;0;0;0;0;438599311;448600315;35379911
1712;6.04373e-15;-478;1633;12347;12754;1;311;-2.14748e+09;-1.89529e+06;-1;0;0;0;-1;0;438599311;448600315;35379911
1713;6.10309e-15;-462;1623;12480;12837;1;325;-2.14748e+09;-1.89167e+06;-1;0;0;0;-1;0;438674010;448688315;35408460
1713;6.04373e-15;-478;1633;12347;12754;1;311;-2.14748e+09;-1.89167e+06;-1;0;0;0;-1;0;438674010;448688315;35408460
1714;6.10309e-15;-463;1623;12480;12837;1;325;-2.14748e+09;-1.88786e+06;0;0;0;0;0;0;438748559;448776154;35436968
1714;6.04373e-15;-479;1633;12347;12754;1;311;-2.14748e+09;-1.88786e+06;0;0;0;0;0;0;438748559;448776154;35436968
1715;6.10309e-15;-463;1623;12480;12837;1;325;-2.14748e+09;-1.88426e+06;-1;0;0;0;-1;0;438822957;448863832;35465436
1715;6.04373e-15;-479;1633;12347;12754;1;311;-2.14748e+09;-1.88416e+06;-1;0;0;0;-1;0;438822957;448863832;35465436
1716;6.10309e-15;-463;1623;12480;12837;1;325;-2.14748e+09;-1.88057e+06;-1;0;0;0;-1;0;438897206;448951349;35493863
1716;6.04373e-15;-480;1633;12347;12754;1;311;-2.14748e+09;-1.88057e+06;0;0;0;0;0;0;438897206;448951349;35493863
1717;6.10309e-15;-463;1623;12480;12837;1;325;-2.14748e+09;-1.87678e+06;-1;0;0;0;-1;0;438971305;449038706;35522249
1717;6.04373e-15;-481;1633;12347;12754;1;311;-2.14748e+09;-1.87678e+06;0;0;0;0;0;0;438971305;449038706;35522249
1718;6.10309e-15;-464;1623;12480;12837;1;325;-2.14748e+09;-1.87311e+06;0;0;0;0;0;0;439045255;449125903;35550594
1718;6.04373e-15;-481;1633;12347;12754;1;311;-2.14748e+09;-1.87311e+06;-1;0;0;0;-1;0;439045255;449125903;35550594
1719;6.10309e-15;-465;1623;12480;12837;1;325;-2.14748e+09;-1.86944e+06;0;0;0;0;0;0;439119056;449212940;35578899
1719;6.04373e-15;-482;1633;12347;12754;1;311;-2.14748e+09;-1.86944e+06;0;0;0;0;0;0;439119056;449212940;35578899
1720;6.10309e-15;-465;1623;12480;12837;1;325;-2.14748e+09;-1.86588e+06;-1;0;0;0;-1;0;439192709;449299818;35607163
1720;6.04373e-15;-482;1633;12347;12754;1;311;-2.14748e+09;-1.86588e+06;-1;0;0;0;-1;0;439192709;449299818;35607163
1721;6.10309e-15;-465;1623;12480;12837;1;325;-2.14748e+09;-1.86213e+06;-1;0;0;0;-1;0;439266213;449386536;35635386
1721;6.04373e-15;-482;1633;12347;12754;1;311;-2.14748e+09;-1.86213e+06;-1;0;0;0;-1;0;439266213;449386536;35635386
1722;6.10309e-15;-466;1623;12480;12837;1;325;-2.14748e+09;-1.85848e+06;0;0;0;0;0;0;439339570;449473096;35663569
1722;6.04373e-15;-482;1633;12347;12754;1;311;-2.14748e+09;-1.85848e+06;-1;0;0;0;-1;0;439339570;449473096;35663569
1723;6.10309e-15;-467;1623;12480;12837;1;325;-2.14748e+09;-1.85495e+06;0;0;0;0;0;0;439412779;449559498;35691711
1723;6.04373e-15;-482;1633;12347;12754;1;311;-2.14748e+09;-1.85495e+06;-1;0;0;0;-1;0;439412779;449559498;35691711
1724;6.10309e-15;-467;1623;12480;12837;1;325;-2.14748e+09;-1.85122e+06;-1;0;0;0;-1;0;439485841;449645741;35719813
1724;6.04373e-15;-483;1633;12347;12754;1;311;-2.14748e+09;-1.85122e+06;0;0;0;0;0;0;439485841;449645741;35719813
1725;6.10309e-15;-468;1623;12480;12837;1;325;-2.14748e+09;-1.8477e+06;0;0;0;0;0;0;439558756;449731826;35747875
1725;6.04373e-15;-483;1633;12347;12754;1;311;-2.14748e+09;-1.8477e+06;-1;0;0;0;-1;0;439558756;449731826;35747875
1726;6.10309e-15;-468;1623;12480;12837;1;325;-2.14748e+09;-1.84399e+06;-1;0;0;0;-1;0;439631524;449817754;35775896
1726;6.04373e-15;-483;1633;12347;12754;1;311;-2.14748e+09;-1.84398e+06;-1;0;0;0;-1;0;439631524;449817754;35775896
1727;6.10309e-15;-468;1623;12480;12837;1;325;-2.14748e+09;-1.84038e+06;-1;0;0;0;-1;0;439704146;449903525;35803876
1727;6.04373e-15;-483;1633;12347;12754;1;311;-2.14748e+09;-1.84038e+06;-1;0;0;0;-1;0;439704146;449903525;35803876
1728;6.10309e-15;-469;1623;12480;12837;1;325;-2.14748e+09;-1.83678e+06;0;0;0;0;0;0;439776623;449989138;35831817
1728;6.04373e-15;-483;1633;12347;12754;1;311;-2.14748e+09;-1.83678e+06;-1;0;0;0;-1;0;439776623;449989138;35831817
1729;6.10309e-15;-469;1623;12480;12837;1;325;-2.14748e+09;-1.83319e+06;-1;0;0;0;-1;0;439848954;450074595;35859717
1729;6.04373e-15;-484;1633;12347;12754;1;311;-2.14748e+09;-1.83319e+06;0;0;0;0;0;0;439848954;450074595;35859717
1730;6.10309e-15;-469;1623;12480;12837;1;325;-2.14748e+09;-1.82971e+06;-1;0;0;0;-1;0;439921139;450159896;35887576
1730;6.04373e-15;-484;1633;12347;12754;1;311;-2.14748e+09;-1.82971e+06;-1;0;0;0;-1;0;439921139;450159896;35887576
1731;6.10309e-15;-469;1623;12480;12837;1;325;-2.14748e+09;-1.82604e+06;-1;0;0;0;-1;0;439993180;450245041;35915396
1731;6.04373e-15;-485;1633;12347;12754;1;311;-2.14748e+09;-1.82604e+06;0;0;0;0;0;0;439993180;450245041;35915396
1732;6.10309e-15;-470;1623;12480;12837;1;325;-2.14748e+09;-1.82247e+06;0;0;0;0;0;0;440065076;450330030;35943175
1732;6.04373e-15;-485;1633;12347;12754;1;311;-2.14748e+09;-1.82247e+06;-1;0;0;0;-1;0;440065076;450330030;35943175
1733;6.10309e-15;-470;1623;12480;12837;1;325;-2.14748e+09;-1.81891e+06;-1;0;0;0;-1;0;440136828;450414863;35970914
1733;6.04373e-15;-485;1633;12347;12754;1;311;-2.14748e+09;-1.81891e+06;-1;0;0;0;-1;0;440136828;450414863;35970914
1734;6.10309e-15;-471;1623;12480;12837;1;325;-2.14748e+09;-1.81536e+06;0;0;0;0;0;0;440208435;450499542;35998613
1734;6.04373e-15;-486;1633;12347;12754;1;311;-2.14748e+09;-1.81536e+06;0;0;0;0;0;0;440208435;450499542;35998613
1735;6.10309e-15;-472;1623;12480;12837;1;325;-2.14748e+09;-1.81192e+06;0;0;0;0;0;0;440279899;450584065;36026272
1735;6.04373e-15;-486;1633;12347;12754;1;311;-2.14748e+09;-1.81192e+06;-1;0;0;0;-1;0;440279899;450584065;36026272
1736;6.10309e-15;-472;1623;12480;12837;1;325;-2.14748e+09;-1.80828e+06;-1;0;0;0;-1;0;440351220;450668434;36053891
1736;6.04373e-15;-486;1633;12347;12754;1;311;-2.14748e+09;-1.80828e+06;-1;0;0;0;-1;0;440351220;450668434;36053891
1737;6.10309e-15;-473;1623;12480;12837;1;325;-2.14748e+09;-1.80476e+06;0;0;0;0;0;0;440422398;450752649;36081469
1737;6.04373e-15;-487;1633;12347;12754;1;311;-2.14748e+09;-1.80476e+06;0;0;0;0;0;0;440422398;450752649;36081469
1738;6.10309e-15;-473;1623;12480;12837;1;325;-2.14748e+09;-1.80123e+06;-1;0;0;0;-1;0;440493433;450836710;36109008
1738;6.04373e-15;-488;1633;12347;12754;1;311;-2.14748e+09;-1.80123e+06;0;0;0;0;0;0;440493433;450836710;36109008
1739;6.10309e-15;-474;1623;12480;12837;1;325;-2.14748e+09;-1.79772e+06;0;0;0;0;0;0;440564326;450920617;36136507
1739;6.04373e-15;-489;1633;12347;12754;1;311;-2.14748e+09;-1.79772e+06;0;0;0;0;0;0;440564326;450920617;36136507
1740;6.10309e-15;-474;1623;12480;12837;1;325;-2.14748e+09;-1.79422e+06;-1;0;0;0;-1;0;440635076;451004371;36163966
1740;6.04373e-15;-489;1633;12347;12754;1;311;-2.14748e+09;-1.79422e+06;-1;0;0;0;-1;0;440635076;451004371;36163966
1741;6.10309e-15;-474;1623;12480;12837;1;325;-2.14748e+09;-1.79072e+06;-1;0;0;0;-1;0;440705685;451087972;36191385
1741;6.04373e-15;-490;1633;12347;12754;1;311;-2.14748e+09;-1.79072e+06;0;0;0;0;0;0;440705685;451087972;36191385
1742;6.10309e-15;-475;1623;12480;12837;1;325;-2.14748e+09;-1.78723e+06;0;0;0;0;0;0;440776152;451171421;36218764
1742;6.04373e-15;-490;1633;12347;12754;1;311;-2.14748e+09;-1.78723e+06;-1;0;0;0;-1;0;440776152;451171421;36218764
1743;6.10309e-15;-475;1623;12480;12837;1;325;-2.14748e+09;-1.78375e+06;-1;0;0;0;-1;0;440846479;451254716;36246103
1743;6.04373e-15;-490;1633;12347;12754;1;311;-2.14748e+09;-1.78375e+06;-1;0;0;0;-1;0;440846479;451254716;36246103
1744;6.10309e-15;-475;1623;12480;12837;1;325;-2.14748e+09;-1.78037e+06;-1;0;0;0;-1;0;440916664;451337860;36273402
1744;6.04373e-15;-490;1633;12347;12754;1;311;-2.14748e+09;-1.78037e+06;-1;0;0;0;-1;0;440916664;451337860;36273402
1745;6.10309e-15;-476;1623;12480;12837;1;325;-2.14748e+09;-1.7768e+06;0;0;0;0;0;0;440986709;451420852;36300662
1745;6.04373e-15;-490;1633;12347;12754;1;311;-2.14748e+09;-1.7768e+06;-1;0;0;0;-1;0;440986709;451420852;36300662
1746;6.10309e-15;-476;1623;12480;12837;1;325;-2.14748e+09;-1.77334e+06;-1;0;0;0;-1;0;441056613;451503692;36327882
1746;6.04373e-15;-491;1633;12347;12754;1;311;-2.14748e+09;-1.77334e+06;0;0;0;0;0;0;441056613;451503692;36327882
1747;6.10309e-15;-477;1623;12480;12837;1;325;-2.14748e+09;-1.76989e+06;0;0;0;0;0;0;441126378;451586381;36355063
1747;6.04373e-15;-492;1633;12347;12754;1;311;-2.14748e+09;-1.76989e+06;0;0;0;0;0;0;441126378;451586381;36355063
1748;6.10309e-15;-477;1623;12480;12837;1;325;-2.14748e+09;-1.76644e+06;-1;0;0;0;-1;0;441196003;451668919;36382203
1748;6.04373e-15;-492;1633;12347;12754;1;311;-2.14748e+09;-1.76644e+06;-1;0;0;0;-1;0;441196003;451668919;36382203
1749;6.10309e-15;-478;1623;12480;12837;1;325;-2.14748e+09;-1.76301e+06;0;0;0;0;0;0;441265489;451751306;36409304
1749;6.04373e-15;-493;1633;12347;12754;1;311;-2.14748e+09;-1.76301e+06;0;0;0;0;0;0;441265489;451751306;36409304
1750;6.10309e-15;-478;1623;12480;12837;1;325;-2.14748e+09;-1.75958e+06;-1;0;0;0;-1;0;441334836;451833543;36436366
1750;6.04373e-15;-494;1633;12347;12754;1;311;-2.14748e+09;-1.75958e+06;0;0;0;0;0;0;441334836;451833543;36436366
1751;6.10309e-15;-478;1623;12480;12837;1;325;-2.14748e+09;-1.75615e+06;-1;0;0;0;-1;0;441404044;451915629;36463388
1751;6.04373e-15;-495;1633;12347;12754;1;311;-2.14748e+09;-1.75615e+06;0;0;0;0;0;0;441404044;451915629;36463388
1752;6.10309e-15;-478;1623;12480;12837;1;325;-2.14748e+09;-1.75274e+06;-1;0;0;0;-1;0;441473114;451997566;36490371
1752;6.04373e-15;-496;1633;12347;12754;1;311;-2.14748e+09;-1.75274e+06;0;0;0;0;0;0;441473114;451997566;36490371
1753;6.10309e-15;-479;1623;12480;12837;1;325;-2.14748e+09;-1.74933e+06;0;0;0;0;0;0;441542045;452079354;36517314
1753;6.04373e-15;-496;1633;12347;12754;1;311;-2.14748e+09;-1.74933e+06;-1;0;0;0;-1;0;441542045;452079354;36517314
1754;6.10309e-15;-479;1623;12480;12837;1;325;-2.14748e+09;-1.74593e+06;-1;0;0;0;-1;0;441610839;452160992;36544217
1754;6.04373e-15;-497;1633;12347;12754;1;311;-2.14748e+09;-1.74593e+06;0;0;0;0;0;0;441610839;452160992;36544217
1755;6.10309e-15;-479;1623;12480;12837;1;325;-2.14748e+09;-1.74253e+06;-1;0;0;0;-1;0;441679496;452242481;36571082
1755;6.04373e-15;-497;1633;12347;12754;1;311;-2.14748e+09;-1.74253e+06;-1;0;0;0;-1;0;441679496;452242481;36571082
1756;6.10309e-15;-479;1623;12480;12837;1;325;-2.14748e+09;-1.73914e+06;-1;0;0;0;-1;0;441748015;452323821;36597907
1756;6.04373e-15;-498;1633;12347;12754;1;311;-2.14748e+09;-1.73914e+06;0;0;0;0;0;0;441748015;452323821;36597907
1757;6.10309e-15;-480;1623;12480;12837;1;325;-2.14748e+09;-1.73576e+06;0;0;0;0;0;0;441816397;452405014;36624692
1757;6.04373e-15;-499;1633;12347;12754;1;311;-2.14748e+09;-1.73576e+06;0;0;0;0;0;0;441816397;452405014;36624692
1758;6.10309e-15;-480;1623;12480;12837;1;325;-2.14748e+09;-1.73239e+06;-1;0;0;0;-1;0;441884643;452486058;36651439
1758;6.04373e-15;-500;1633;12347;12754;1;311;-2.14748e+09;-1.73239e+06;0;0;0;0;0;0;441884643;452486058;36651439
1759;6.10309e-15;-480;1623;12480;12837;1;325;-2.14748e+09;-1.72903e+06;-1;0;0;0;-1;0;441952752;452566954;36678146
1759;6.04373e-15;-501;1633;12347;12754;1;311;-2.14748e+09;-1.72903e+06;0;0;0;0;0;0;441952752;452566954;36678146
1760;6.10309e-15;-480;1623;12480;12837;1;325;-2.14748e+09;-1.72567e+06;-1;0;0;0;-1;0;442020726;452647702;36704814
1760;6.04373e-15;-502;1633;12347;12754;1;311;-2.14748e+09;-1.72567e+06;0;0;0;0;0;0;442020726;452647702;36704814
1761;6.10309e-15;-480;1623;12480;12837;1;325;-2.14748e+09;-1.72232e+06;-1;0;0;0;-1;0;442088564;452728304;36731442
1761;6.04373e-15;-502;1633;12347;12754;1;311;-2.14748e+09;-1.72232e+06;-1;0;0;0;-1;0;442088564;452728304;36731442
1762;6.10309e-15;-481;1623;12480;12837;1;325;-2.14748e+09;-1.71898e+06;0;0;0;0;0;0;442156266;452808758;36758032
1762;6.04373e-15;-503;1633;12347;12754;1;311;-2.14748e+09;-1.71898e+06;0;0;0;0;0;0;442156266;452808758;36758032
1763;6.10309e-15;-481;1623;12480;12837;1;325;-2.14748e+09;-1.71564e+06;-1;0;0;0;-1;0;442223833;452889066;36784583
1763;6.04373e-15;-504;1633;12347;12754;1;311;-2.14748e+09;-1.71564e+06;0;0;0;0;0;0;442223833;452889066;36784583
1764;6.10309e-15;-482;1623;12480;12837;1;325;-2.14748e+09;-1.71231e+06;0;0;0;0;0;0;442291266;452969227;36811094
1764;6.04373e-15;-504;1633;12347;12754;1;311;-2.14748e+09;-1.71231e+06;-1;0;0;0;-1;0;442291266;452969227;36811094
1765;6.10309e-15;-482;1623;12480;12837;1;325;-2.14748e+09;-1.70909e+06;-1;0;0;0;-1;0;442358564;453049243;36837567
1765;6.04373e-15;-504;1633;12347;12754;1;311;-2.14748e+09;-1.70909e+06;-1;0;0;0;-1;0;442358564;453049243;36837567
1766;6.10309e-15;-482;1623;12480;12837;1;325;-2.14748e+09;-1.70567e+06;-1;0;0;0;-1;0;442425728;453129112;36864000
1766;6.04373e-15;-504;1633;12347;12754;1;311;-2.14748e+09;-1.70567e+06;-1;0;0;0;-1;0;442425728;453129112;36864000
1767;6.10309e-15;-483;1623;12480;12837;1;325;-2.14748e+09;-1.70246e+06;0;0;0;0;0;0;442492758;453208836;36890395
1767;6.04373e-15;-505;1633;12347;12754;1;311;-2.14748e+09;-1.70246e+06;0;0;0;0;0;0;442492758;453208836;36890395
1768;6.10309e-15;-484;1623;12480;12837;1;325;-2.14748e+09;-1.69906e+06;0;0;0;0;0;0;442559654;453288414;36916750
1768;6.04373e-15;-506;1633;12347;12754;1;311;-2.14748e+09;-1.69906e+06;0;0;0;0;0;0;442559654;453288414;36916750
1769;6.10309e-15;-485;1623;12480;12837;1;325;-2.14748e+09;-1.69577e+06;0;0;0;0;0;0;442626417;453367848;36943067
1769;6.04373e-15;-507;1633;12347;12754;1;311;-2.14748e+09;-1.69577e+06;0;0;0;0;0;0;442626417;453367848;36943067
1770;6.10309e-15;-486;1623;12480;12837;1;325;-2.14748e+09;-1.69248e+06;0;0;0;0;0;0;442693046;453447137;36969345
1770;6.04373e-15;-507;1633;12347;12754;1;311;-2.14748e+09;-1.69248e+06;-1;0;0;0;-1;0;442693046;453447137;36969345
1771;6.10309e-15;-486;1623;12480;12837;1;325;-2.14748e+09;-1.6892e+06;-1;0;0;0;-1;0;442759543;453526281;36995584
1771;6.04373e-15;-507;1633;12347;12754;1;311;-2.14748e+09;-1.6892e+06;-1;0;0;0;-1;0;442759543;453526281;36995584
1772;6.10309e-15;-487;1623;12480;12837;1;325;-2.14748e+09;-1.68592e+06;0;0;0;0;0;0;442825908;453605281;37021785
1772;6.04373e-15;-508;1633;12347;12754;1;311;-2.14748e+09;-1.68592e+06;0;0;0;0;0;0;442825908;453605281;37021785
1773;6.10309e-15;-487;1623;12480;12837;1;325;-2.14748e+09;-1.68266e+06;-1;0;0;0;-1;0;442892140;453684138;37047947
1773;6.04373e-15;-509;1633;12347;12754;1;311;-2.14748e+09;-1.68266e+06;0;0;0;0;0;0;442892140;453684138;37047947
1774;6.10309e-15;-487;1623;12480;12837;1;325;-2.14748e+09;-1.6795e+06;-1;0;0;0;-1;0;442958241;453762850;37074070
1774;6.04373e-15;-509;1633;12347;12754;1;311;-2.14748e+09;-1.6794e+06;-1;0;0;0;-1;0;442958241;453762850;37074070
1775;6.10309e-15;-487;1623;12480;12837;1;325;-2.14748e+09;-1.67615e+06;-1;0;0;0;-1;0;443024210;453841420;37100154
1775;6.04373e-15;-509;1633;12347;12754;1;311;-2.14748e+09;-1.67615e+06;-1;0;0;0;-1;0;443024210;453841420;37100154
1776;6.10309e-15;-488;1623;12480;12837;1;325;-2.14748e+09;-1.6729e+06;0;0;0;0;0;0;443090047;453919846;37126200
1776;6.04373e-15;-509;1633;12347;12754;1;311;-2.14748e+09;-1.6729e+06;-1;0;0;0;-1;0;443090047;453919846;37126200
1777;6.10309e-15;-488;1623;12480;12837;1;325;-2.14748e+09;-1.66976e+06;-1;0;0;0;-1;0;443155754;453998129;37152207
1777;6.04373e-15;-509;1633;12347;12754;1;311;-2.14748e+09;-1.66976e+06;-1;0;0;0;-1;0;443155754;453998129;37152207
1778;6.10309e-15;-489;1623;12480;12837;1;325;-2.14748e+09;-1.66643e+06;0;0;0;0;0;0;443221330;454076270;37178176
1778;6.04373e-15;-509;1633;12347;12754;1;311;-2.14748e+09;-1.66643e+06;-1;0;0;0;-1;0;443221330;454076270;37178176
1779;6.10309e-15;-489;1623;12480;12837;1;325;-2.14748e+09;-1.6633e+06;-1;0;0;0;-1;0;443286775;454154269;37204106
1779;6.04373e-15;-509;1633;12347;12754;1;311;-2.14748e+09;-1.6633e+06;-1;0;0;0;-1;0;443286775;454154269;37204106
1780;6.10309e-15;-490;1623;12480;12837;1;325;-2.14748e+09;-1.66009e+06;0;0;0;0;0;0;443352090;454232125;37229998
1780;6.04373e-15;-509;1633;12347;12754;1;311;-2.14748e+09;-1.66009e+06;-1;0;0;0;-1;0;443352090;454232125;37229998
1781;6.10309e-15;-490;1623;12480;12837;1;325;-2.14748e+09;-1.65677e+06;-1;0;0;0;-1;0;443417275;454309840;37255851
1781;6.04373e-15;-509;1633;12347;12754;1;311;-2.14748e+09;-1.65677e+06;-1;0;0;0;-1;0;443417275;454309840;37255851
1782;6.10309e-15;-491;1623;12480;12837;1;325;-2.14748e+09;-1.65367e+06;0;0;0;0;0;0;443482331;454387414;37281666
1782;6.04373e-15;-510;1633;12347;12754;1;311;-2.14748e+09;-1.65367e+06;0;0;0;0;0;0;443482331;454387414;37281666
1783;6.10309e-15;-492;1623;12480;12837;1;325;-2.14748e+09;-1.65037e+06;0;0;0;0;0;0;443547257;454464846;37307443
1783;6.04373e-15;-511;1633;12347;12754;1;311;-2.14748e+09;-1.65037e+06;0;0;0;0;0;0;443547257;454464846;37307443
1784;6.10309e-15;-493;1623;12480;12837;1;325;-2.14748e+09;-1.64718e+06;0;0;0;0;0;0;443612054;454542137;37333182
1784;6.04373e-15;-511;1633;12347;12754;1;311;-2.14748e+09;-1.64718e+06;-1;0;0;0;-1;0;443612054;454542137;37333182
1785;6.10309e-15;-494;1623;12480;12837;1;325;-2.14748e+09;-1.644e+06;0;0;0;0;0;0;443676723;454619288;37358882
1785;6.04373e-15;-512;1633;12347;12754;1;311;-2.14748e+09;-1.644e+06;0;0;0;0;0;0;443676723;454619288;37358882
1786;6.10309e-15;-495;1623;12480;12837;1;325;-2.14748e+09;-1.64082e+06;0;0;0;0;0;0;443741263;454696298;37384544
1786;6.04373e-15;-512;1633;12347;12754;1;311;-2.14748e+09;-1.64082e+06;-1;0;0;0;-1;0;443741263;454696298;37384544
1787;6.10309e-15;-496;1623;12480;12837;1;325;-2.14748e+09;-1.63765e+06;0;0;0;0;0;0;443805674;454773168;37410167
1787;6.04373e-15;-513;1633;12347;12754;1;311;-2.14748e+09;-1.63765e+06;0;0;0;0;0;0;443805674;454773168;37410167
1788;6.10309e-15;-496;1623;12480;12837;1;325;-2.14748e+09;-1.63448e+06;-1;0;0;0;-1;0;443869958;454849899;37435753
1788;6.04373e-15;-513;1633;12347;12754;1;311;-2.14748e+09;-1.63448e+06;-1;0;0;0;-1;0;443869958;454849899;37435753
1789;6.10309e-15;-497;1623;12480;12837;1;325;-2.14748e+09;-1.63132e+06;0;0;0;0;0;0;443934114;454926490;37461301
1789;6.04373e-15;-514;1633;12347;12754;1;311;-2.14748e+09;-1.63132e+06;0;0;0;0;0;0;443934114;454926490;37461301
1790;6.10309e-15;-497;1623;12480;12837;1;325;-2.14748e+09;-1.62817e+06;-1;0;0;0;-1;0;443998142;455002941;37486810
1790;6.04373e-15;-514;1633;12347;12754;1;311;-2.14748e+09;-1.62817e+06;-1;0;0;0;-1;0;443998142;455002941;37486810
1791;6.10309e-15;-498;1623;12480;12837;1;325;-2.14748e+09;-1.62503e+06;0;0;0;0;0;0;444062044;455079253;37512282
1791;6.04373e-15;-515;1633;12347;12754;1;311;-2.14748e+09;-1.62503e+06;0;0;0;0;0;0;444062044;455079253;37512282
1792;6.10309e-15;-499;1623;12480;12837;1;325;-2.14748e+09;-1.62189e+06;0;0;0;0;0;0;444125819;455155427;37537715
1792;6.04373e-15;-515;1633;12347;12754;1;311;-2.14748e+09;-1.62189e+06;-1;0;0;0;-1;0;444125819;455155427;37537715
1793;6.10309e-15;-499;1623;12480;12837;1;325;-2.14748e+09;-1.61876e+06;-1;0;0;0;-1;0;444189467;455231462;37563111
1793;6.04373e-15;-516;1633;12347;12754;1;311;-2.14748e+09;-1.61876e+06;0;0;0;0;0;0;444189467;455231462;37563111
1794;6.10309e-15;-500;1623;12480;12837;1;325;-2.14748e+09;-1.61563e+06;0;0;0;0;0;0;444252988;455307359;37588468
1794;6.04373e-15;-516;1633;12347;12754;1;311;-2.14748e+09;-1.61563e+06;-1;0;0;0;-1;0;444252988;455307359;37588468
1795;6.10309e-15;-501;1623;12480;12837;1;325;-2.14748e+09;-1.61252e+06;0;0;0;0;0;0;444316384;455383118;37613788
1795;6.04373e-15;-516;1633;12347;12754;1;311;-2.14748e+09;-1.61252e+06;-1;0;0;0;-1;0;444316384;455383118;37613788
1796;6.10309e-15;-502;1623;12480;12837;1;325;-2.14748e+09;-1.6094e+06;0;0;0;0;0;0;444379654;455458739;37639070
1796;6.04373e-15;-516;1633;12347;12754;1;311;-2.14748e+09;-1.6094e+06;-1;0;0;0;-1;0;444379654;455458739;37639070
1797;6.10309e-15;-502;1623;12480;12837;1;325;-2.14748e+09;-1.6063e+06;-1;0;0;0;-1;0;444442799;455534223;37664314
1797;6.04373e-15;-517;1633;12347;12754;1;311;-2.14748e+09;-1.6063e+06;0;0;0;0;0;0;444442799;455534223;37664314
1798;6.10309e-15;-503;1623;12480;12837;1;325;-2.14748e+09;-1.6032e+06;0;0;0;0;0;0;444505818;455609569;37689520
1798;6.04373e-15;-518;1633;12347;12754;1;311;-2.14748e+09;-1.6032e+06;0;0;0;0;0;0;444505818;455609569;37689520
1799;6.10309e-15;-503;1623;12480;12837;1;325;-2.14748e+09;-1.60011e+06;-1;0;0;0;-1;0;444568712;455684779;37714689
1799;6.04373e-15;-519;1633;12347;12754;1;311;-2.14748e+09;-1.60011e+06;0;0;0;0;0;0;444568712;455684779;37714689
1800;6.10309e-15;-503;1623;12480;12837;1;325;-2.14748e+09;-1.59702e+06;-1;0;0;0;-1;0;444631482;455759852;37739820
1800;6.04373e-15;-519;1633;12347;12754;1;311;-2.14748e+09;-1.59702e+06;-1;0;0;0;-1;0;444631482;455759852;37739820
1801;6.10309e-15;-504;1623;12480;12837;1;325;-2.14748e+09;-1.59404e+06;0;0;0;0;0;0;444694127;455834788;37764913
1801;6.04373e-15;-519;1633;12347;12754;1;311;-2.14748e+09;-1.59404e+06;-1;0;0;0;-1;0;444694127;455834788;37764913
1802;6.10309e-15;-504;1623;12480;12837;1;325;-2.14748e+09;-1.59087e+06;-1;0;0;0;-1;0;444756648;455909588;37789969
1802;6.04373e-15;-519;1633;12347;12754;1;311;-2.14748e+09;-1.59087e+06;-1;0;0;0;-1;0;444756648;455909588;37789969
1803;6.10309e-15;-505;1623;12480;12837;1;325;-2.14748e+09;-1.5879e+06;0;0;0;0;0;0;444819045;455984253;37814987
1803;6.04373e-15;-519;1633;12347;12754;1;311;-2.14748e+09;-1.5879e+06;-1;0;0;0;-1;0;444819045;455984253;37814987
1804;6.10309e-15;-505;1623;12480;12837;1;325;-2.14748e+09;-1.58474e+06;-1;0;0;0;-1;0;444881319;456058781;37839968
1804;6.04373e-15;-520;1633;12347;12754;1;311;-2.14748e+09;-1.58474e+06;0;0;0;0;0;0;444881319;456058781;37839968
1805;6.10309e-15;-506;1623;12480;12837;1;325;-2.14748e+09;-1.58179e+06;0;0;0;0;0;0;444943469;456133175;37864911
1805;6.04373e-15;-521;1633;12347;12754;1;311;-2.14748e+09;-1.58179e+06;0;0;0;0;0;0;444943469;456133175;37864911
1806;6.10309e-15;-506;1623;12480;12837;1;325;-2.14748e+09;-1.57864e+06;-1;0;0;0;-1;0;445005496;456207433;37889817
1806;6.04373e-15;-521;1633;12347;12754;1;311;-2.14748e+09;-1.57864e+06;-1;0;0;0;-1;0;445005496;456207433;37889817
1807;6.10309e-15;-506;1623;12480;12837;1;325;-2.14748e+09;-1.5757e+06;-1;0;0;0;-1;0;445067400;456281556;37914685
1807;6.04373e-15;-521;1633;12347;12754;1;311;-2.14748e+09;-1.5757e+06;-1;0;0;0;-1;0;445067400;456281556;37914685
1808;6.10309e-15;-507;1623;12480;12837;1;325;-2.14748e+09;-1.57257e+06;0;0;0;0;0;0;445129182;456355544;37939516
1808;6.04373e-15;-521;1633;12347;12754;1;311;-2.14748e+09;-1.57257e+06;-1;0;0;0;-1;0;445129182;456355544;37939516
1809;6.10309e-15;-507;1623;12480;12837;1;325;-2.14748e+09;-1.56954e+06;-1;0;0;0;-1;0;445190842;456429399;37964310
1809;6.04373e-15;-521;1633;12347;12754;1;311;-2.14748e+09;-1.56954e+06;-1;0;0;0;-1;0;445190842;456429399;37964310
1810;6.10309e-15;-507;1623;12480;12837;1;325;-2.14748e+09;-1.56662e+06;-1;0;0;0;-1;0;445252379;456503119;37989067
1810;6.04373e-15;-521;1633;12347;12754;1;311;-2.14748e+09;-1.56662e+06;-1;0;0;0;-1;0;445252379;456503119;37989067
1811;6.10309e-15;-507;1623;12480;12837;1;325;-2.14748e+09;-1.5635e+06;-1;0;0;0;-1;0;445313795;456576705;38013786
1811;6.04373e-15;-521;1633;12347;12754;1;311;-2.14748e+09;-1.5635e+06;-1;0;0;0;-1;0;445313795;456576705;38013786
1812;6.10309e-15;-508;1623;12480;12837;1;325;-2.14748e+09;-1.56049e+06;0;0;0;0;0;0;445375089;456650158;38038468
1812;6.04373e-15;-522;1633;12347;12754;1;311;-2.14748e+09;-1.56049e+06;0;0;0;0;0;0;445375089;456650158;38038468
1813;6.10309e-15;-509;1623;12480;12837;1;325;-2.14748e+09;-1.55759e+06;0;0;0;0;0;0;445436262;456723477;38063113
1813;6.04373e-15;-522;1633;12347;12754;1;311;-2.14748e+09;-1.55759e+06;-1;0;0;0;-1;0;445436262;456723477;38063113
1814;6.10309e-15;-510;1623;12480;12837;1;325;-2.14748e+09;-1.55459e+06;0;0;0;0;0;0;445497314;456796663;38087720
1814;6.04373e-15;-523;1633;12347;12754;1;311;-2.14748e+09;-1.55459e+06;0;0;0;0;0;0;445497314;456796663;38087720
1815;6.10309e-15;-510;1623;12480;12837;1;325;-2.14748e+09;-1.5515e+06;-1;0;0;0;-1;0;445558245;456869716;38112291
1815;6.04373e-15;-523;1633;12347;12754;1;311;-2.14748e+09;-1.5515e+06;-1;0;0;0;-1;0;445558245;456869716;38112291
1816;6.10309e-15;-511;1623;12480;12837;1;325;-2.14748e+09;-1.54852e+06;0;0;0;0;0;0;445619056;456942637;38136825
1816;6.04373e-15;-524;1633;12347;12754;1;311;-2.14748e+09;-1.54852e+06;0;0;0;0;0;0;445619056;456942637;38136825
1817;6.10309e-15;-512;1623;12480;12837;1;325;-2.14748e+09;-1.54554e+06;0;0;0;0;0;0;445679747;457015425;38161321
1817;6.04373e-15;-525;1633;12347;12754;1;311;-2.14748e+09;-1.54554e+06;0;0;0;0;0;0;445679747;457015425;38161321
1818;6.10309e-15;-512;1623;12480;12837;1;325;-2.14748e+09;-1.54257e+06;-1;0;0;0;-1;0;445740318;457088081;38185781
1818;6.04373e-15;-525;1633;12347;12754;1;311;-2.14748e+09;-1.54257e+06;-1;0;0;0;-1;0;445740318;457088081;38185781
1819;6.10309e-15;-513;1623;12480;12837;1;325;-2.14748e+09;-1.5396e+06;0;0;0;0;0;0;445800768;457160605;38210203
1819;6.04373e-15;-526;1633;12347;12754;1;311;-2.14748e+09;-1.5396e+06;0;0;0;0;0;0;445800768;457160605;38210203
1820;6.10309e-15;-514;1623;12480;12837;1;325;-2.14748e+09;-1.53664e+06;0;0;0;0;0;0;445861100;457232998;38234589
1820;6.04373e-15;-527;1633;12347;12754;1;311;-2.14748e+09;-1.53664e+06;0;0;0;0;0;0;445861100;457232998;38234589
1821;6.10309e-15;-515;1623;12480;12837;1;325;-2.14748e+09;-1.53379e+06;0;0;0;0;0;0;445921312;457305259;38258938
1821;6.04373e-15;-527;1633;12347;12754;1;311;-2.14748e+09;-1.53379e+06;-1;0;0;0;-1;0;445921312;457305259;38258938
1822;6.10309e-15;-515;1623;12480;12837;1;325;-2.14748e+09;-1.53084e+06;-1;0;0;0;-1;0;445981406;457377390;38283250
1822;6.04373e-15;-528;1633;12347;12754;1;311;-2.14748e+09;-1.53084e+06;0;0;0;0;0;0;445981406;457377390;38283250
1823;6.10309e-15;-516;1623;12480;12837;1;325;-2.14748e+09;-1.5279e+06;0;0;0;0;0;0;446041381;457449389;38307526
1823;6.04373e-15;-529;1633;12347;12754;1;311;-2.14748e+09;-1.5279e+06;0;0;0;0;0;0;446041381;457449389;38307526
1824;6.10309e-15;-517;1623;12480;12837;1;325;-2.14748e+09;-1.52497e+06;0;0;0;0;0;0;446101237;457521258;38331764
1824;6.04373e-15;-529;1633;12347;12754;1;311;-2.14748e+09;-1.52497e+06;-1;0;0;0;-1;0;446101237;457521258;38331764
1825;6.10309e-15;-518;1623;12480;12837;1;325;-2.14748e+09;-1.52194e+06;0;0;0;0;0;0;446160975;457592996;38355966
1825;6.04373e-15;-530;1633;12347;12754;1;311;-2.14748e+09;-1.52194e+06;0;0;0;0;0;0;446160975;457592996;38355966
1826;6.10309e-15;-519;1623;12480;12837;1;325;-2.14748e+09;-1.51902e+06;0;0;0;0;0;0;446220595;457664604;38380132
1826;6.04373e-15;-530;1633;12347;12754;1;311;-2.14748e+09;-1.51902e+06;-1;0;0;0;-1;0;446220595;457664604;38380132
1827;6.10309e-15;-520;1623;12480;12837;1;325;-2.14748e+09;-1.5161e+06;0;0;0;0;0;0;446280098;457736082;38404261
1827;6.04373e-15;-531;1633;12347;12754;1;311;-2.14748e+09;-1.5161e+06;0;0;0;0;0;0;446280098;457736082;38404261
1828;6.10309e-15;-521;1623;12480;12837;1;325;-2.14748e+09;-1.51319e+06;0;0;0;0;0;0;446339483;457807431;38428353
1828;6.04373e-15;-532;1633;12347;12754;1;311;-2.14748e+09;-1.51319e+06;0;0;0;0;0;0;446339483;457807431;38428353
1829;6.10309e-15;-522;1623;12480;12837;1;325;-2.14748e+09;-1.51038e+06;0;0;0;0;0;0;446398751;457878650;38452408
1829;6.04373e-15;-532;1633;12347;12754;1;311;-2.14748e+09;-1.51038e+06;-1;0;0;0;-1;0;446398751;457878650;38452408
1830;6.10309e-15;-522;1623;12480;12837;1;325;-2.14748e+09;-1.50738e+06;-1;0;0;0;-1;0;446457902;457949740;38476428
1830;6.04373e-15;-532;1633;12347;12754;1;311;-2.14748e+09;-1.50738e+06;-1;0;0;0;-1;0;446457902;457949740;38476428
1831;6.10309e-15;-523;1623;12480;12837;1;325;-2.14748e+09;-1.50449e+06;0;0;0;0;0;0;446516937;458020702;38500410
1831;6.04373e-15;-533;1633;12347;12754;1;311;-2.14748e+09;-1.50449e+06;0;0;0;0;0;0;446516937;458020702;38500410
1832;6.10309e-15;-523;1623;12480;12837;1;325;-2.14748e+09;-1.5016e+06;-1;0;0;0;-1;0;446575855;458091534;38524357
1832;6.04373e-15;-534;1633;12347;12754;1;311;-2.14748e+09;-1.5016e+06;0;0;0;0;0;0;446575855;458091534;38524357
1833;6.10309e-15;-523;1623;12480;12837;1;325;-2.14748e+09;-1.49872e+06;-1;0;0;0;-1;0;446634657;458162238;38548267
1833;6.04373e-15;-534;1633;12347;12754;1;311;-2.14748e+09;-1.49872e+06;-1;0;0;0;-1;0;446634657;458162238;38548267
1834;6.10309e-15;-524;1623;12480;12837;1;325;-2.14748e+09;-1.49595e+06;0;0;0;0;0;0;446693343;458232814;38572140
1834;6.04373e-15;-535;1633;12347;12754;1;311;-2.14748e+09;-1.49595e+06;0;0;0;0;0;0;446693343;458232814;38572140
1835;6.10309e-15;-524;1623;12480;12837;1;325;-2.14748e+09;-1.49308e+06;-1;0;0;0;-1;0;446751913;458303262;38595978
1835;6.04373e-15;-536;1633;12347;12754;1;311;-2.14748e+09;-1.49308e+06;0;0;0;0;0;0;446751913;458303262;38595978
1836;6.10309e-15;-525;1623;12480;12837;1;325;-2.14748e+09;-1.49022e+06;0;0;0;0;0;0;446810368;458373582;38619779
1836;6.04373e-15;-536;1633;12347;12754;1;311;-2.14748e+09;-1.49022e+06;-1;0;0;0;-1;0;446810368;458373582;38619779
1837;6.10309e-15;-525;1623;12480;12837;1;325;-2.14748e+09;-1.48726e+06;-1;0;0;0;-1;0;446868708;458443775;38643544
1837;6.04373e-15;-537;1633;12347;12754;1;311;-2.14748e+09;-1.48726e+06;0;0;0;0;0;0;446868708;458443775;38643544
1838;6.10309e-15;-525;1623;12480;12837;1;325;-2.14748e+09;-1.48441e+06;-1;0;0;0;-1;0;446926932;458513840;38667272
1838;6.04373e-15;-537;1633;12347;12754;1;311;-2.14748e+09;-1.48441e+06;-1;0;0;0;-1;0;446926932;458513840;38667272
1839;6.10309e-15;-525;1623;12480;12837;1;325;-2.14748e+09;-1.48156e+06;-1;0;0;0;-1;0;446985042;458583779;38690965
1839;6.04373e-15;-537;1633;12347;12754;1;311;-2.14748e+09;-1.48156e+06;-1;0;0;0;-1;0;446985042;458583779;38690965
1840;6.10309e-15;-526;1623;12480;12837;1;325;-2.14748e+09;-1.47872e+06;0;0;0;0;0;0;447043038;458653591;38714622
1840;6.04373e-15;-538;1633;12347;12754;1;311;-2.14748e+09;-1.47872e+06;0;0;0;0;0;0;447043038;458653591;38714622
1841;6.10309e-15;-527;1623;12480;12837;1;325;-2.14748e+09;-1.47589e+06;0;0;0;0;0;0;447100919;458723276;38738242
1841;6.04373e-15;-539;1633;12347;12754;1;311;-2.14748e+09;-1.47589e+06;0;0;0;0;0;0;447100919;458723276;38738242
1842;6.10309e-15;-528;1623;12480;12837;1;325;-2.14748e+09;-1.47306e+06;0;0;0;0;0;0;447158687;458792835;38761827
1842;6.04373e-15;-539;1633;12347;12754;1;311;-2.14748e+09;-1.47306e+06;-1;0;0;0;-1;0;447158687;458792835;38761827
1843;6.10309e-15;-529;1623;12480;12837;1;325;-2.14748e+09;-1.47024e+06;0;0;0;0;0;0;447216341;458862268;38785375
1843;6.04373e-15;-540;1633;12347;12754;1;311;-2.14748e+09;-1.47024e+06;0;0;0;0;0;0;447216341;458862268;38785375
1844;6.10309e-15;-530;1623;12480;12837;1;325;-2.14748e+09;-1.46752e+06;0;0;0;0;0;0;447273881;458931575;38808888
1844;6.04373e-15;-540;1633;12347;12754;1;311;-2.14748e+09;-1.46752e+06;-1;0;0;0;-1;0;447273881;458931575;38808888
1845;6.10309e-15;-530;1623;12480;12837;1;325;-2.14748e+09;-1.46472e+06;-1;0;0;0;-1;0;447331308;459000756;38832365
1845;6.04373e-15;-541;1633;12347;12754;1;311;-2.14748e+09;-1.46472e+06;0;0;0;0;0;0;447331308;459000756;38832365
1846;6.10309e-15;-530;1623;12480;12837;1;325;-2.14748e+09;-1.46181e+06;-1;0;0;0;-1;0;447388622;459069813;38855806
1846;6.04373e-15;-541;1633;12347;12754;1;311;-2.14748e+09;-1.46181e+06;-1;0;0;0;-1;0;447388622;459069813;38855806
1847;6.10309e-15;-530;1623;12480;12837;1;325;-2.14748e+09;-1.45901e+06;-1;0;0;0;-1;0;447445823;459138744;38879211
1847;6.04373e-15;-542;1633;12347;12754;1;311;-2.14748e+09;-1.45901e+06;0;0;0;0;0;0;447445823;459138744;38879211
1848;6.10309e-15;-531;1623;12480;12837;1;325;-2.14748e+09;-1.45622e+06;0;0;0;0;0;0;447502912;459207550;38902580
1848;6.04373e-15;-543;1633;12347;12754;1;311;-2.14748e+09;-1.45622e+06;0;0;0;0;0;0;447502912;459207550;38902580
1849;6.10309e-15;-531;1623;12480;12837;1;325;-2.14748e+09;-1.45353e+06;-1;0;0;0;-1;0;447559889;459276232;38925914
1849;6.04373e-15;-543;1633;12347;12754;1;311;-2.14748e+09;-1.45353e+06;-1;0;0;0;-1;0;447559889;459276232;38925914
1850;6.10309e-15;-532;1623;12480;12837;1;325;-2.14748e+09;-1.45075e+06;0;0;0;0;0;0;447616753;459344789;38949212
1850;6.04373e-15;-543;1633;12347;12754;1;311;-2.14748e+09;-1.45075e+06;-1;0;0;0;-1;0;447616753;459344789;38949212
1851;6.10309e-15;-532;1623;12480;12837;1;325;-2.14748e+09;-1.44787e+06;-1;0;0;0;-1;0;447673506;459413222;38972474
1851;6.04373e-15;-544;1633;12347;12754;1;311;-2.14748e+09;-1.44787e+06;0;0;0;0;0;0;447673506;459413222;38972474
1852;6.10309e-15;-533;1623;12480;12837;1;325;-2.14748e+09;-1.4451e+06;0;0;0;0;0;0;447730147;459481531;38995701
1852;6.04373e-15;-545;1633;12347;12754;1;311;-2.14748e+09;-1.4451e+06;0;0;0;0;0;0;447730147;459481531;38995701
1853;6.10309e-15;-534;1623;12480;12837;1;325;-2.14748e+09;-1.44234e+06;0;0;0;0;0;0;447786677;459549716;39018892
1853;6.04373e-15;-545;1633;12347;12754;1;311;-2.14748e+09;-1.44234e+06;-1;0;0;0;-1;0;447786677;459549716;39018892
1854;6.10309e-15;-535;1623;12480;12837;1;325;-2.14748e+09;-1.43958e+06;0;0;0;0;0;0;447843096;459617778;39042048
1854;6.04373e-15;-546;1633;12347;12754;1;311;-2.14748e+09;-1.43958e+06;0;0;0;0;0;0;447843096;459617778;39042048
1855;6.10309e-15;-535;1623;12480;12837;1;325;-2.14748e+09;-1.43683e+06;-1;0;0;0;-1;0;447899404;459685717;39065168
1855;6.04373e-15;-546;1633;12347;12754;1;311;-2.14748e+09;-1.43683e+06;-1;0;0;0;-1;0;447899404;459685717;39065168
1856;6.10309e-15;-536;1623;12480;12837;1;325;-2.14748e+09;-1.43408e+06;0;0;0;0;0;0;447955601;459753533;39088253
1856;6.04373e-15;-547;1633;12347;12754;1;311;-2.14748e+09;-1.43408e+06;0;0;0;0;0;0;447955601;459753533;39088253
1857;6.10309e-15;-537;1623;12480;12837;1;325;-2.14748e+09;-1.43134e+06;0;0;0;0;0;0;448011688;459821226;39111302
1857;6.04373e-15;-548;1633;12347;12754;1;311;-2.14748e+09;-1.43134e+06;0;0;0;0;0;0;448011688;459821226;39111302
1858;6.10309e-15;-537;1623;12480;12837;1;325;-2.14748e+09;-1.4286e+06;-1;0;0;0;-1;0;448067664;459888796;39134316
1858;6.04373e-15;-549;1633;12347;12754;1;311;-2.14748e+09;-1.4286e+06;0;0;0;0;0;0;448067664;459888796;39134316
1859;6.10309e-15;-537;1623;12480;12837;1;325;-2.14748e+09;-1.42597e+06;-1;0;0;0;-1;0;448123531;459956244;39157295
1859;6.04373e-15;-550;1633;12347;12754;1;311;-2.14748e+09;-1.42597e+06;0;0;0;0;0;0;448123531;459956244;39157295
1860;6.10309e-15;-537;1623;12480;12837;1;325;-2.14748e+09;-1.42315e+06;-1;0;0;0;-1;0;448179288;460023570;39180238
1860;6.04373e-15;-551;1633;12347;12754;1;311;-2.14748e+09;-1.42315e+06;0;0;0;0;0;0;448179288;460023570;39180238
1861;6.10309e-15;-537;1623;12480;12837;1;325;-2.14748e+09;-1.42043e+06;-1;0;0;0;-1;0;448234936;460090774;39203146
1861;6.04373e-15;-551;1633;12347;12754;1;311;-2.14748e+09;-1.42043e+06;-1;0;0;0;-1;0;448234936;460090774;39203146
1862;6.10309e-15;-538;1623;12480;12837;1;325;-2.14748e+09;-1.41771e+06;0;0;0;0;0;0;448290474;460157857;39226019
1862;6.04373e-15;-551;1633;12347;12754;1;311;-2.14748e+09;-1.41771e+06;-1;0;0;0;-1;0;448290474;460157857;39226019
1863;6.10309e-15;-539;1623;12480;12837;1;325;-2.14748e+09;-1.41501e+06;0;0;0;0;0;0;448345904;460224818;39248857
1863;6.04373e-15;-551;1633;12347;12754;1;311;-2.14748e+09;-1.41501e+06;-1;0;0;0;-1;0;448345904;460224818;39248857
1864;6.10309e-15;-540;1623;12480;12837;1;325;-2.14748e+09;-1.4123e+06;0;0;0;0;0;0;448401224;460291657;39271660
1864;6.04373e-15;-552;1633;12347;12754;1;311;-2.14748e+09;-1.4123e+06;0;0;0;0;0;0;448401224;460291657;39271660
1865;6.10309e-15;-540;1623;12480;12837;1;325;-2.14748e+09;-1.40961e+06;-1;0;0;0;-1;0;448456437;460358376;39294428
1865;6.04373e-15;-553;1633;12347;12754;1;311;-2.14748e+09;-1.40961e+06;0;0;0;0;0;0;448456437;460358376;39294428
1866;6.10309e-15;-540;1623;12480;12837;1;325;-2.14748e+09;-1.40691e+06;-1;0;0;0;-1;0;448511540;460424974;39317160
1866;6.04373e-15;-553;1633;12347;12754;1;311;-2.14748e+09;-1.40691e+06;-1;0;0;0;-1;0;448511540;460424974;39317160
1867;6.10309e-15;-540;1623;12480;12837;1;325;-2.14748e+09;-1.40423e+06;-1;0;0;0;-1;0;448566536;460491452;39339858
1867;6.04373e-15;-554;1633;12347;12754;1;311;-2.14748e+09;-1.40423e+06;0;0;0;0;0;0;448566536;460491452;39339858
1868;6.10309e-15;-540;1623;12480;12837;1;325;-2.14748e+09;-1.40165e+06;-1;0;0;0;-1;0;448621424;460557810;39362521
1868;6.04373e-15;-555;1633;12347;12754;1;311;-2.14748e+09;-1.40165e+06;0;0;0;0;0;0;448621424;460557810;39362521
1869;6.10309e-15;-540;1623;12480;12837;1;325;-2.14748e+09;-1.39887e+06;-1;0;0;0;-1;0;448676204;460624047;39385149
1869;6.04373e-15;-556;1633;12347;12754;1;311;-2.14748e+09;-1.39887e+06;0;0;0;0;0;0;448676204;460624047;39385149
1870;6.10309e-15;-541;1623;12480;12837;1;325;-2.14748e+09;-1.3962e+06;0;0;0;0;0;0;448730877;460690164;39407742
1870;6.04373e-15;-556;1633;12347;12754;1;311;-2.14748e+09;-1.3962e+06;-1;0;0;0;-1;0;448730877;460690164;39407742
1871;6.10309e-15;-541;1623;12480;12837;1;325;-2.14748e+09;-1.39354e+06;-1;0;0;0;-1;0;448785443;460756162;39430300
1871;6.04373e-15;-557;1633;12347;12754;1;311;-2.14748e+09;-1.39354e+06;0;0;0;0;0;0;448785443;460756162;39430300
1872;6.10309e-15;-542;1623;12480;12837;1;325;-2.14748e+09;-1.39098e+06;0;0;0;0;0;0;448839902;460822041;39452823
1872;6.04373e-15;-557;1633;12347;12754;1;311;-2.14748e+09;-1.39098e+06;-1;0;0;0;-1;0;448839902;460822041;39452823
1873;6.10309e-15;-542;1623;12480;12837;1;325;-2.14748e+09;-1.38823e+06;-1;0;0;0;-1;0;448894254;460887800;39475312
1873;6.04373e-15;-557;1633;12347;12754;1;311;-2.14748e+09;-1.38823e+06;-1;0;0;0;-1;0;448894254;460887800;39475312
1874;6.10309e-15;-543;1623;12480;12837;1;325;-2.14748e+09;-1.38558e+06;0;0;0;0;0;0;448948499;460953440;39497766
1874;6.04373e-15;-558;1633;12347;12754;1;311;-2.14748e+09;-1.38558e+06;0;0;0;0;0;0;448948499;460953440;39497766
1875;6.10309e-15;-543;1623;12480;12837;1;325;-2.14748e+09;-1.38294e+06;-1;0;0;0;-1;0;449002638;461018962;39520185
1875;6.04373e-15;-558;1633;12347;12754;1;311;-2.14748e+09;-1.38294e+06;-1;0;0;0;-1;0;449002638;461018962;39520185
1876;6.10309e-15;-543;1623;12480;12837;1;325;-2.14748e+09;-1.3803e+06;-1;0;0;0;-1;0;449056672;461084365;39542570
1876;6.04373e-15;-559;1633;12347;12754;1;311;-2.14748e+09;-1.3803e+06;0;0;0;0;0;0;449056672;461084365;39542570
1877;6.10309e-15;-544;1623;12480;12837;1;325;-2.14748e+09;-1.37767e+06;0;0;0;0;0;0;449110599;461149650;39564920
1877;6.04373e-15;-559;1633;12347;12754;1;311;-2.14748e+09;-1.37767e+06;-1;0;0;0;-1;0;449110599;461149650;39564920
1878;6.10309e-15;-545;1623;12480;12837;1;325;-2.14748e+09;-1.37514e+06;0;0;0;0;0;0;449164421;461214817;39587235
1878;6.04373e-15;-560;1633;12347;12754;1;311;-2.14748e+09;-1.37514e+06;0;0;0;0;0;0;449164421;461214817;39587235
1879;6.10309e-15;-545;1623;12480;12837;1;325;-2.14748e+09;-1.37242e+06;-1;0;0;0;-1;0;449218137;461279866;39609516
1879;6.04373e-15;-561;1633;12347;12754;1;311;-2.14748e+09;-1.37242e+06;0;0;0;0;0;0;449218137;461279866;39609516
1880;6.10309e-15;-546;1623;12480;12837;1;325;-2.14748e+09;-1.3698e+06;0;0;0;0;0;0;449271749;461344797;39631763
1880;6.04373e-15;-561;1633;12347;12754;1;311;-2.14748e+09;-1.3698e+06;-1;0;0;0;-1;0;449271749;461344797;39631763
1881;6.10309e-15;-547;1623;12480;12837;1;325;-2.14748e+09;-1.36729e+06;0;0;0;0;0;0;449325255;461409611;39653975
1881;6.04373e-15;-561;1633;12347;12754;1;311;-2.14748e+09;-1.36729e+06;-1;0;0;0;-1;0;449325255;461409611;39653975
1882;6.10309e-15;-547;1623;12480;12837;1;325;-2.14748e+09;-1.36469e+06;-1;0;0;0;-1;0;449378657;461474307;39676153
1882;6.04373e-15;-562;1633;12347;12754;1;311;-2.14748e+09;-1.36469e+06;0;0;0;0;0;0;449378657;461474307;39676153
1883;6.10309e-15;-548;1623;12480;12837;1;325;-2.14748e+09;-1.36209e+06;0;0;0;0;0;0;449431954;461538887;39698296
1883;6.04373e-15;-563;1633;12347;12754;1;311;-2.14748e+09;-1.36209e+06;0;0;0;0;0;0;449431954;461538887;39698296
1884;6.10309e-15;-548;1623;12480;12837;1;325;-2.14748e+09;-1.35939e+06;-1;0;0;0;-1;0;449485147;461603350;39720406
1884;6.04373e-15;-564;1633;12347;12754;1;311;-2.14748e+09;-1.35939e+06;0;0;0;0;0;0;449485147;461603350;39720406
1885;6.10309e-15;-548;1623;12480;12837;1;325;-2.14748e+09;-1.3569e+06;-1;0;0;0;-1;0;449538236;461667697;39742481
1885;6.04373e-15;-565;1633;12347;12754;1;311;-2.14748e+09;-1.3569e+06;0;0;0;0;0;0;449538236;461667697;39742481
1886;6.10309e-15;-549;1623;12480;12837;1;325;-2.14748e+09;-1.35432e+06;0;0;0;0;0;0;449591221;461731927;39764521
1886;6.04373e-15;-566;1633;12347;12754;1;311;-2.14748e+09;-1.35432e+06;0;0;0;0;0;0;449591221;461731927;39764521
1887;6.10309e-15;-550;1623;12480;12837;1;325;-2.14748e+09;-1.35174e+06;0;0;0;0;0;0;449644102;461796041;39786528
1887;6.04373e-15;-566;1633;12347;12754;1;311;-2.14748e+09;-1.35174e+06;-1;0;0;0;-1;0;449644102;461796041;39786528
1888;6.10309e-15;-550;1623;12480;12837;1;325;-2.14748e+09;-1.34907e+06;-1;0;0;0;-1;0;449696880;461860039;39808500
1888;6.04373e-15;-567;1633;12347;12754;1;311;-2.14748e+09;-1.34907e+06;0;0;0;0;0;0;449696880;461860039;39808500
1889;6.10309e-15;-551;1623;12480;12837;1;325;-2.14748e+09;-1.3466e+06;0;0;0;0;0;0;449749555;461923921;39830439
1889;6.04373e-15;-567;1633;12347;12754;1;311;-2.14748e+09;-1.3466e+06;-1;0;0;0;-1;0;449749555;461923921;39830439
1890;6.10309e-15;-551;1623;12480;12837;1;325;-2.14748e+09;-1.34393e+06;-1;0;0;0;-1;0;449802126;461987688;39852343
1890;6.04373e-15;-567;1633;12347;12754;1;311;-2.14748e+09;-1.34393e+06;-1;0;0;0;-1;0;449802126;461987688;39852343
1891;6.10309e-15;-551;1623;12480;12837;1;325;-2.14748e+09;-1.34138e+06;-1;0;0;0;-1;0;449854596;462051340;39874213
1891;6.04373e-15;-568;1633;12347;12754;1;311;-2.14748e+09;-1.34138e+06;0;0;0;0;0;0;449854596;462051340;39874213
1892;6.10309e-15;-552;1623;12480;12837;1;325;-2.14748e+09;-1.33882e+06;0;0;0;0;0;0;449906962;462114877;39896050
1892;6.04373e-15;-568;1633;12347;12754;1;311;-2.14748e+09;-1.33882e+06;-1;0;0;0;-1;0;449906962;462114877;39896050
1893;6.10309e-15;-553;1623;12480;12837;1;325;-2.14748e+09;-1.33628e+06;0;0;0;0;0;0;449959226;462178299;39917852
1893;6.04373e-15;-569;1633;12347;12754;1;311;-2.14748e+09;-1.33628e+06;0;0;0;0;0;0;449959226;462178299;39917852
1894;6.10309e-15;-553;1623;12480;12837;1;325;-2.14748e+09;-1.33373e+06;-1;0;0;0;-1;0;450011388;462241606;39939621
1894;6.04373e-15;-569;1633;12347;12754;1;311;-2.14748e+09;-1.33373e+06;-1;0;0;0;-1;0;450011388;462241606;39939621
1895;6.10309e-15;-553;1623;12480;12837;1;325;-2.14748e+09;-1.3312e+06;-1;0;0;0;-1;0;450063449;462304799;39961355
1895;6.04373e-15;-570;1633;12347;12754;1;311;-2.14748e+09;-1.3312e+06;0;0;0;0;0;0;450063449;462304799;39961355
1896;6.10309e-15;-553;1623;12480;12837;1;325;-2.14748e+09;-1.32866e+06;-1;0;0;0;-1;0;450115407;462367878;39983056
1896;6.04373e-15;-571;1633;12347;12754;1;311;-2.14748e+09;-1.32866e+06;0;0;0;0;0;0;450115407;462367878;39983056
1897;6.10309e-15;-553;1623;12480;12837;1;325;-2.14748e+09;-1.32614e+06;-1;0;0;0;-1;0;450167264;462430843;40004723
1897;6.04373e-15;-572;1633;12347;12754;1;311;-2.14748e+09;-1.32614e+06;0;0;0;0;0;0;450167264;462430843;40004723
1898;6.10309e-15;-553;1623;12480;12837;1;325;-2.14748e+09;-1.32361e+06;-1;0;0;0;-1;0;450219020;462493694;40026357
1898;6.04373e-15;-572;1633;12347;12754;1;311;-2.14748e+09;-1.32361e+06;-1;0;0;0;-1;0;450219020;462493694;40026357
1899;6.10309e-15;-553;1623;12480;12837;1;325;-2.14748e+09;-1.3211e+06;-1;0;0;0;-1;0;450270675;462556431;40047957
1899;6.04373e-15;-572;1633;12347;12754;1;311;-2.14748e+09;-1.3211e+06;-1;0;0;0;-1;0;450270675;462556431;40047957
1900;6.10309e-15;-553;1623;12480;12837;1;325;-2.14748e+09;-1.31858e+06;-1;0;0;0;-1;0;450322229;462619055;40069523
1900;6.04373e-15;-572;1633;12347;12754;1;311;-2.14748e+09;-1.31858e+06;-1;0;0;0;-1;0;450322229;462619055;40069523
1901;6.10309e-15;-554;1623;12480;12837;1;325;-2.14748e+09;-1.31608e+06;0;0;0;0;0;0;450373682;462681566;40091055
1901;6.04373e-15;-573;1633;12347;12754;1;311;-2.14748e+09;-1.31608e+06;0;0;0;0;0;0;450373682;462681566;40091055
1902;6.10309e-15;-555;1623;12480;12837;1;325;-2.14748e+09;-1.31358e+06;0;0;0;0;0;0;450425035;462743964;40112554
1902;6.04373e-15;-574;1633;12347;12754;1;311;-2.14748e+09;-1.31358e+06;0;0;0;0;0;0;450425035;462743964;40112554
1903;6.10309e-15;-556;1623;12480;12837;1;325;-2.14748e+09;-1.31108e+06;0;0;0;0;0;0;450476288;462806250;40134020
1903;6.04373e-15;-575;1633;12347;12754;1;311;-2.14748e+09;-1.31108e+06;0;0;0;0;0;0;450476288;462806250;40134020
1904;6.10309e-15;-556;1623;12480;12837;1;325;-2.14748e+09;-1.30869e+06;-1;0;0;0;-1;0;450527440;462868423;40155452
1904;6.04373e-15;-576;1633;12347;12754;1;311;-2.14748e+09;-1.30869e+06;0;0;0;0;0;0;450527440;462868423;40155452
1905;6.10309e-15;-556;1623;12480;12837;1;325;-2.14748e+09;-1.3061e+06;-1;0;0;0;-1;0;450578493;462930483;40176850
1905;6.04373e-15;-577;1633;12347;12754;1;311;-2.14748e+09;-1.3061e+06;0;0;0;0;0;0;450578493;462930483;40176850
1906;6.10309e-15;-556;1623;12480;12837;1;325;-2.14748e+09;-1.30372e+06;-1;0;0;0;-1;0;450629447;462992432;40198215
1906;6.04373e-15;-577;1633;12347;12754;1;311;-2.14748e+09;-1.30372e+06;-1;0;0;0;-1;0;450629447;462992432;40198215
1907;6.10309e-15;-556;1623;12480;12837;1;325;-2.14748e+09;-1.30114e+06;-1;0;0;0;-1;0;450680300;463054268;40219547
1907;6.04373e-15;-577;1633;12347;12754;1;311;-2.14748e+09;-1.30114e+06;-1;0;0;0;-1;0;450680300;463054268;40219547
1908;6.10309e-15;-556;1623;12480;12837;1;325;-2.14748e+09;-1.29867e+06;-1;0;0;0;-1;0;450731055;463115993;40240846
1908;6.04373e-15;-577;1633;12347;12754;1;311;-2.14748e+09;-1.29867e+06;-1;0;0;0;-1;0;450731055;463115993;40240846
1909;6.10309e-15;-557;1623;12480;12837;1;325;-2.14748e+09;-1.2963e+06;0;0;0;0;0;0;450781711;463177607;40262111
1909;6.04373e-15;-578;1633;12347;12754;1;311;-2.14748e+09;-1.2963e+06;0;0;0;0;0;0;450781711;463177607;40262111
1910;6.10309e-15;-558;1623;12480;12837;1;325;-2.14748e+09;-1.29374e+06;0;0;0;0;0;0;450832268;463239109;40283343
1910;6.04373e-15;-578;1633;12347;12754;1;311;-2.14748e+09;-1.29374e+06;-1;0;0;0;-1;0;450832268;463239109;40283343
1911;6.10309e-15;-559;1623;12480;12837;1;325;-2.14748e+09;-1.29129e+06;0;0;0;0;0;0;450882727;463300501;40304542
1911;6.04373e-15;-578;1633;12347;12754;1;311;-2.14748e+09;-1.29129e+06;-1;0;0;0;-1;0;450882727;463300501;40304542
1912;6.10309e-15;-560;1623;12480;12837;1;325;-2.14748e+09;-1.28894e+06;0;0;0;0;0;0;450933087;463361781;40325707
1912;6.04373e-15;-579;1633;12347;12754;1;311;-2.14748e+09;-1.28894e+06;0;0;0;0;0;0;450933087;463361781;40325707
1913;6.10309e-15;-560;1623;12480;12837;1;325;-2.14748e+09;-1.28639e+06;-1;0;0;0;-1;0;450983349;463422951;40346840
1913;6.04373e-15;-579;1633;12347;12754;1;311;-2.14748e+09;-1.28639e+06;-1;0;0;0;-1;0;450983349;463422951;40346840
1914;6.10309e-15;-561;1623;12480;12837;1;325;-2.14748e+09;-1.28395e+06;0;0;0;0;0;0;451033513;463484010;40367940
1914;6.04373e-15;-579;1633;12347;12754;1;311;-2.14748e+09;-1.28395e+06;-1;0;0;0;-1;0;451033513;463484010;40367940
1915;6.10309e-15;-561;1623;12480;12837;1;325;-2.14748e+09;-1.28151e+06;-1;0;0;0;-1;0;451083580;463544959;40389006
1915;6.04373e-15;-580;1633;12347;12754;1;311;-2.14748e+09;-1.28151e+06;0;0;0;0;0;0;451083580;463544959;40389006
1916;6.10309e-15;-562;1623;12480;12837;1;325;-2.14748e+09;-1.27918e+06;0;0;0;0;0;0;451133549;463605798;40410040
1916;6.04373e-15;-580;1633;12347;12754;1;311;-2.14748e+09;-1.27918e+06;-1;0;0;0;-1;0;451133549;463605798;40410040
1917;6.10309e-15;-562;1623;12480;12837;1;325;-2.14748e+09;-1.27675e+06;-1;0;0;0;-1;0;451183420;463666527;40431040
1917;6.04373e-15;-581;1633;12347;12754;1;311;-2.14748e+09;-1.27675e+06;0;0;0;0;0;0;451183420;463666527;40431040
1918;6.10309e-15;-562;1623;12480;12837;1;325;-2.14748e+09;-1.27423e+06;-1;0;0;0;-1;0;451233195;463727147;40452008
1918;6.04373e-15;-581;1633;12347;12754;1;311;-2.14748e+09;-1.27423e+06;-1;0;0;0;-1;0;451233195;463727147;40452008
1919;6.10309e-15;-563;1623;12480;12837;1;325;-2.14748e+09;-1.27181e+06;0;0;0;0;0;0;451282873;463787657;40472943
1919;6.04373e-15;-581;1633;12347;12754;1;311;-2.14748e+09;-1.27181e+06;-1;0;0;0;-1;0;451282873;463787657;40472943
1920;6.10309e-15;-564;1623;12480;12837;1;325;-2.14748e+09;-1.2694e+06;0;0;0;0;0;0;451332453;463848058;40493845
1920;6.04373e-15;-581;1633;12347;12754;1;311;-2.14748e+09;-1.2694e+06;-1;0;0;0;-1;0;451332453;463848058;40493845
1921;6.10309e-15;-564;1623;12480;12837;1;325;-2.14748e+09;-1.26699e+06;-1;0;0;0;-1;0;451381938;463908350;40514714
1921;6.04373e-15;-582;1633;12347;12754;1;311;-2.14748e+09;-1.26699e+06;0;0;0;0;0;0;451381938;463908350;40514714
1922;6.10309e-15;-564;1623;12480;12837;1;325;-2.14748e+09;-1.26459e+06;-1;0;0;0;-1;0;451431326;463968533;40535551
1922;6.04373e-15;-582;1633;12347;12754;1;311;-2.14748e+09;-1.26459e+06;-1;0;0;0;-1;0;451431326;463968533;40535551
1923;6.10309e-15;-564;1623;12480;12837;1;325;-2.14748e+09;-1.26219e+06;-1;0;0;0;-1;0;451480618;464028608;40556354
1923;6.04373e-15;-583;1633;12347;12754;1;311;-2.14748e+09;-1.26219e+06;0;0;0;0;0;0;451480618;464028608;40556354
1924;6.10309e-15;-564;1623;12480;12837;1;325;-2.14748e+09;-1.2598e+06;-1;0;0;0;-1;0;451529814;464088574;40577126
1924;6.04373e-15;-583;1633;12347;12754;1;311;-2.14748e+09;-1.2598e+06;-1;0;0;0;-1;0;451529814;464088574;40577126
1925;6.10309e-15;-564;1623;12480;12837;1;325;-2.14748e+09;-1.25741e+06;-1;0;0;0;-1;0;451578914;464148432;40597864
1925;6.04373e-15;-584;1633;12347;12754;1;311;-2.14748e+09;-1.25741e+06;0;0;0;0;0;0;451578914;464148432;40597864
1926;6.10309e-15;-565;1623;12480;12837;1;325;-2.14748e+09;-1.25502e+06;0;0;0;0;0;0;451627919;464208181;40618570
1926;6.04373e-15;-584;1633;12347;12754;1;311;-2.14748e+09;-1.25502e+06;-1;0;0;0;-1;0;451627919;464208181;40618570
1927;6.10309e-15;-566;1623;12480;12837;1;325;-2.14748e+09;-1.25265e+06;0;0;0;0;0;0;451676829;464267823;40639244
1927;6.04373e-15;-584;1633;12347;12754;1;311;-2.14748e+09;-1.25265e+06;-1;0;0;0;-1;0;451676829;464267823;40639244
1928;6.10309e-15;-567;1623;12480;12837;1;325;-2.14748e+09;-1.25027e+06;0;0;0;0;0;0;451725643;464327358;40659885
1928;6.04373e-15;-585;1633;12347;12754;1;311;-2.14748e+09;-1.25027e+06;0;0;0;0;0;0;451725643;464327358;40659885
1929;6.10309e-15;-567;1623;12480;12837;1;325;-2.14748e+09;-1.2479e+06;-1;0;0;0;-1;0;451774362;464386785;40680493
1929;6.04373e-15;-585;1633;12347;12754;1;311;-2.14748e+09;-1.2479e+06;-1;0;0;0;-1;0;451774362;464386785;40680493
1930;6.10309e-15;-567;1623;12480;12837;1;325;-2.14748e+09;-1.24554e+06;-1;0;0;0;-1;0;451822987;464446105;40701069
1930;6.04373e-15;-585;1633;12347;12754;1;311;-2.14748e+09;-1.24554e+06;-1;0;0;0;-1;0;451822987;464446105;40701069
1931;6.10309e-15;-567;1623;12480;12837;1;325;-2.14748e+09;-1.24318e+06;-1;0;0;0;-1;0;451871517;464505317;40721613
1931;6.04373e-15;-586;1633;12347;12754;1;311;-2.14748e+09;-1.24318e+06;0;0;0;0;0;0;451871517;464505317;40721613
1932;6.10309e-15;-568;1623;12480;12837;1;325;-2.14748e+09;-1.24082e+06;0;0;0;0;0;0;451919953;464564423;40742125
1932;6.04373e-15;-587;1633;12347;12754;1;311;-2.14748e+09;-1.24082e+06;0;0;0;0;0;0;451919953;464564423;40742125
1933;6.10309e-15;-568;1623;12480;12837;1;325;-2.14748e+09;-1.23847e+06;-1;0;0;0;-1;0;451968295;464623423;40762604
1933;6.04373e-15;-587;1633;12347;12754;1;311;-2.14748e+09;-1.23847e+06;-1;0;0;0;-1;0;451968295;464623423;40762604
1934;6.10309e-15;-568;1623;12480;12837;1;325;-2.14748e+09;-1.23623e+06;-1;0;0;0;-1;0;452016543;464682316;40783051
1934;6.04373e-15;-587;1633;12347;12754;1;311;-2.14748e+09;-1.23623e+06;-1;0;0;0;-1;0;452016543;464682316;40783051
1935;6.10309e-15;-568;1623;12480;12837;1;325;-2.14748e+09;-1.23378e+06;-1;0;0;0;-1;0;452064697;464741102;40803465
1935;6.04373e-15;-587;1633;12347;12754;1;311;-2.14748e+09;-1.23378e+06;-1;0;0;0;-1;0;452064697;464741102;40803465
1936;6.10309e-15;-569;1623;12480;12837;1;325;-2.14748e+09;-1.23145e+06;0;0;0;0;0;0;452112758;464799783;40823848
1936;6.04373e-15;-587;1633;12347;12754;1;311;-2.14748e+09;-1.23145e+06;-1;0;0;0;-1;0;452112758;464799783;40823848
1937;6.10309e-15;-569;1623;12480;12837;1;325;-2.14748e+09;-1.22912e+06;-1;0;0;0;-1;0;452160725;464858358;40844198
1937;6.04373e-15;-587;1633;12347;12754;1;311;-2.14748e+09;-1.22912e+06;-1;0;0;0;-1;0;452160725;464858358;40844198
1938;6.10309e-15;-570;1623;12480;12837;1;325;-2.14748e+09;-1.22679e+06;0;0;0;0;0;0;452208599;464916827;40864517
1938;6.04373e-15;-588;1633;12347;12754;1;311;-2.14748e+09;-1.22679e+06;0;0;0;0;0;0;452208599;464916827;40864517
1939;6.10309e-15;-571;1623;12480;12837;1;325;-2.14748e+09;-1.22447e+06;0;0;0;0;0;0;452256380;464975190;40884803
1939;6.04373e-15;-589;1633;12347;12754;1;311;-2.14748e+09;-1.22447e+06;0;0;0;0;0;0;452256380;464975190;40884803
1940;6.10309e-15;-572;1623;12480;12837;1;325;-2.14748e+09;-1.22215e+06;0;0;0;0;0;0;452304068;465033449;40905057
1940;6.04373e-15;-590;1633;12347;12754;1;311;-2.14748e+09;-1.22215e+06;0;0;0;0;0;0;452304068;465033449;40905057
1941;6.10309e-15;-573;1623;12480;12837;1;325;-2.14748e+09;-1.21994e+06;0;0;0;0;0;0;452351664;465091602;40925280
1941;6.04373e-15;-590;1633;12347;12754;1;311;-2.14748e+09;-1.21994e+06;-1;0;0;0;-1;0;452351664;465091602;40925280
1942;6.10309e-15;-573;1623;12480;12837;1;325;-2.14748e+09;-1.21753e+06;-1;0;0;0;-1;0;452399167;465149650;40945470
1942;6.04373e-15;-590;1633;12347;12754;1;311;-2.14748e+09;-1.21753e+06;-1;0;0;0;-1;0;452399167;465149650;40945470
1943;6.10309e-15;-573;1623;12480;12837;1;325;-2.14748e+09;-1.21522e+06;-1;0;0;0;-1;0;452446578;465207594;40965629
1943;6.04373e-15;-591;1633;12347;12754;1;311;-2.14748e+09;-1.21522e+06;0;0;0;0;0;0;452446578;465207594;40965629
1944;6.10309e-15;-574;1623;12480;12837;1;325;-2.14748e+09;-1.21293e+06;0;0;0;0;0;0;452493897;465265434;40985755
1944;6.04373e-15;-591;1633;12347;12754;1;311;-2.14748e+09;-1.21293e+06;-1;0;0;0;-1;0;452493897;465265434;40985755
1945;6.10309e-15;-574;1623;12480;12837;1;325;-2.14748e+09;-1.21063e+06;-1;0;0;0;-1;0;452541125;465323168;41005850
1945;6.04373e-15;-591;1633;12347;12754;1;311;-2.14748e+09;-1.21063e+06;-1;0;0;0;-1;0;452541125;465323168;41005850
1946;6.10309e-15;-575;1623;12480;12837;1;325;-2.14748e+09;-1.20834e+06;0;0;0;0;0;0;452588260;465380799;41025914
1946;6.04373e-15;-591;1633;12347;12754;1;311;-2.14748e+09;-1.20834e+06;-1;0;0;0;-1;0;452588260;465380799;41025914
1947;6.10309e-15;-576;1623;12480;12837;1;325;-2.14748e+09;-1.20606e+06;0;0;0;0;0;0;452635305;465438326;41045945
1947;6.04373e-15;-591;1633;12347;12754;1;311;-2.14748e+09;-1.20606e+06;-1;0;0;0;-1;0;452635305;465438326;41045945
1948;6.10309e-15;-577;1623;12480;12837;1;325;-2.14748e+09;-1.20377e+06;0;0;0;0;0;0;452682258;465495749;41065945
1948;6.04373e-15;-591;1633;12347;12754;1;311;-2.14748e+09;-1.20377e+06;-1;0;0;0;-1;0;452682258;465495749;41065945
1949;6.10309e-15;-577;1623;12480;12837;1;325;-2.14748e+09;-1.2015e+06;-1;0;0;0;-1;0;452729119;465553069;41085913
1949;6.04373e-15;-591;1633;12347;12754;1;311;-2.14748e+09;-1.2015e+06;-1;0;0;0;-1;0;452729119;465553069;41085913
1950;6.10309e-15;-578;1623;12480;12837;1;325;-2.14748e+09;-1.19923e+06;0;0;0;0;0;0;452775890;465610286;41105850
1950;6.04373e-15;-592;1633;12347;12754;1;311;-2.14748e+09;-1.19923e+06;0;0;0;0;0;0;452775890;465610286;41105850
1951;6.10309e-15;-579;1623;12480;12837;1;325;-2.14748e+09;-1.19696e+06;0;0;0;0;0;0;452822571;465667399;41125755
1951;6.04373e-15;-592;1633;12347;12754;1;311;-2.14748e+09;-1.19696e+06;-1;0;0;0;-1;0;452822571;465667399;41125755
1952;6.10309e-15;-580;1623;12480;12837;1;325;-2.14748e+09;-1.1947e+06;0;0;0;0;0;0;452869161;465724409;41145628
1952;6.04373e-15;-592;1633;12347;12754;1;311;-2.14748e+09;-1.1947e+06;-1;0;0;0;-1;0;452869161;465724409;41145628
1953;6.10309e-15;-580;1623;12480;12837;1;325;-2.14748e+09;-1.19244e+06;-1;0;0;0;-1;0;452915660;465781316;41165470
1953;6.04373e-15;-592;1633;12347;12754;1;311;-2.14748e+09;-1.19244e+06;-1;0;0;0;-1;0;452915660;465781316;41165470
1954;6.10309e-15;-580;1623;12480;12837;1;325;-2.14748e+09;-1.19018e+06;-1;0;0;0;-1;0;452962069;465838121;41185281
1954;6.04373e-15;-592;1633;12347;12754;1;311;-2.14748e+09;-1.19018e+06;-1;0;0;0;-1;0;452962069;465838121;41185281
1955;6.10309e-15;-580;1623;12480;12837;1;325;-2.14748e+09;-1.18793e+06;-1;0;0;0;-1;0;453008389;465894824;41205060
1955;6.04373e-15;-592;1633;12347;12754;1;311;-2.14748e+09;-1.18793e+06;-1;0;0;0;-1;0;453008389;465894824;41205060
1956;6.10309e-15;-580;1623;12480;12837;1;325;-2.14748e+09;-1.18569e+06;-1;0;0;0;-1;0;453054619;465951424;41224808
1956;6.04373e-15;-592;1633;12347;12754;1;311;-2.14748e+09;-1.18569e+06;-1;0;0;0;-1;0;453054619;465951424;41224808
1957;6.10309e-15;-580;1623;12480;12837;1;325;-2.14748e+09;-1.18345e+06;-1;0;0;0;-1;0;453100759;466007922;41244525
1957;6.04373e-15;-593;1633;12347;12754;1;311;-2.14748e+09;-1.18345e+06;0;0;0;0;0;0;453100759;466007922;41244525
1958;6.10309e-15;-580;1623;12480;12837;1;325;-2.14748e+09;-1.18121e+06;-1;0;0;0;-1;0;453146809;466064319;41264210
1958;6.04373e-15;-594;1633;12347;12754;1;311;-2.14748e+09;-1.18121e+06;0;0;0;0;0;0;453146809;466064319;41264210
1959;6.10309e-15;-581;1623;12480;12837;1;325;-2.14748e+09;-1.17898e+06;0;0;0;0;0;0;453192771;466120613;41283864
1959;6.04373e-15;-594;1633;12347;12754;1;311;-2.14748e+09;-1.17898e+06;-1;0;0;0;-1;0;453192771;466120613;41283864
1960;6.10309e-15;-582;1623;12480;12837;1;325;-2.14748e+09;-1.17675e+06;0;0;0;0;0;0;453238644;466176807;41303487
1960;6.04373e-15;-594;1633;12347;12754;1;311;-2.14748e+09;-1.17675e+06;-1;0;0;0;-1;0;453238644;466176807;41303487
1961;6.10309e-15;-582;1623;12480;12837;1;325;-2.14748e+09;-1.17453e+06;-1;0;0;0;-1;0;453284427;466232899;41323079
1961;6.04373e-15;-594;1633;12347;12754;1;311;-2.14748e+09;-1.17453e+06;-1;0;0;0;-1;0;453284427;466232899;41323079
1962;6.10309e-15;-582;1623;12480;12837;1;325;-2.14748e+09;-1.17231e+06;-1;0;0;0;-1;0;453330122;466288889;41342639
1962;6.04373e-15;-595;1633;12347;12754;1;311;-2.14748e+09;-1.17231e+06;0;0;0;0;0;0;453330122;466288889;41342639
1963;6.10309e-15;-582;1623;12480;12837;1;325;-2.14748e+09;-1.1701e+06;-1;0;0;0;-1;0;453375729;466344779;41362169
1963;6.04373e-15;-596;1633;12347;12754;1;311;-2.14748e+09;-1.1701e+06;0;0;0;0;0;0;453375729;466344779;41362169
1964;6.10309e-15;-583;1623;12480;12837;1;325;-2.14748e+09;-1.16789e+06;0;0;0;0;0;0;453421247;466400569;41381668
1964;6.04373e-15;-596;1633;12347;12754;1;311;-2.14748e+09;-1.16789e+06;-1;0;0;0;-1;0;453421247;466400569;41381668
1965;6.10309e-15;-583;1623;12480;12837;1;325;-2.14748e+09;-1.16568e+06;-1;0;0;0;-1;0;453466677;466456258;41401135
1965;6.04373e-15;-597;1633;12347;12754;1;311;-2.14748e+09;-1.16568e+06;0;0;0;0;0;0;453466677;466456258;41401135
1966;6.10309e-15;-583;1623;12480;12837;1;325;-2.14748e+09;-1.16348e+06;-1;0;0;0;-1;0;453512020;466511846;41420572
1966;6.04373e-15;-598;1633;12347;12754;1;311;-2.14748e+09;-1.16348e+06;0;0;0;0;0;0;453512020;466511846;41420572
1967;6.10309e-15;-584;1623;12480;12837;1;325;-2.14748e+09;-1.16129e+06;0;0;0;0;0;0;453557274;466567334;41439978
1967;6.04373e-15;-599;1633;12347;12754;1;311;-2.14748e+09;-1.16129e+06;0;0;0;0;0;0;453557274;466567334;41439978
1968;6.10309e-15;-584;1623;12480;12837;1;325;-2.14748e+09;-1.1591e+06;-1;0;0;0;-1;0;453602441;466622722;41459353
1968;6.04373e-15;-600;1633;12347;12754;1;311;-2.14748e+09;-1.1591e+06;0;0;0;0;0;0;453602441;466622722;41459353
1969;6.10309e-15;-585;1623;12480;12837;1;325;-2.14748e+09;-1.15691e+06;0;0;0;0;0;0;453647521;466678011;41478697
1969;6.04373e-15;-601;1633;12347;12754;1;311;-2.14748e+09;-1.15691e+06;0;0;0;0;0;0;453647521;466678011;41478697
1970;6.10309e-15;-586;1623;12480;12837;1;325;-2.14748e+09;-1.15472e+06;0;0;0;0;0;0;453692513;466733200;41498010
1970;6.04373e-15;-601;1633;12347;12754;1;311;-2.14748e+09;-1.15472e+06;-1;0;0;0;-1;0;453692513;466733200;41498010
1971;6.10309e-15;-586;1623;12480;12837;1;325;-2.14748e+09;-1.15255e+06;-1;0;0;0;-1;0;453737418;466788289;41517292
1971;6.04373e-15;-602;1633;12347;12754;1;311;-2.14748e+09;-1.15255e+06;0;0;0;0;0;0;453737418;466788289;41517292
1972;6.10309e-15;-586;1623;12480;12837;1;325;-2.14748e+09;-1.15047e+06;-1;0;0;0;-1;0;453782237;466843279;41536544
1972;6.04373e-15;-602;1633;12347;12754;1;311;-2.14748e+09;-1.15047e+06;-1;0;0;0;-1;0;453782237;466843279;41536544
1973;6.10309e-15;-587;1623;12480;12837;1;325;-2.14748e+09;-1.1482e+06;0;0;0;0;0;0;453826968;466898170;41555766
1973;6.04373e-15;-602;1633;12347;12754;1;311;-2.14748e+09;-1.1482e+06;-1;0;0;0;-1;0;453826968;466898170;41555766
1974;6.10309e-15;-588;1623;12480;12837;1;325;-2.14748e+09;-1.14604e+06;0;0;0;0;0;0;453871614;466952962;41574956
1974;6.04373e-15;-602;1633;12347;12754;1;311;-2.14748e+09;-1.14604e+06;-1;0;0;0;-1;0;453871614;466952962;41574956
1975;6.10309e-15;-588;1623;12480;12837;1;325;-2.14748e+09;-1.14387e+06;-1;0;0;0;-1;0;453916173;467007656;41594116
1975;6.04373e-15;-603;1633;12347;12754;1;311;-2.14748e+09;-1.14387e+06;0;0;0;0;0;0;453916173;467007656;41594116
1976;6.10309e-15;-589;1623;12480;12837;1;325;-2.14748e+09;-1.14172e+06;0;0;0;0;0;0;453960646;467062251;41613246
1976;6.04373e-15;-603;1633;12347;12754;1;311;-2.14748e+09;-1.14172e+06;-1;0;0;0;-1;0;453960646;467062251;41613246
1977;6.10309e-15;-589;1623;12480;12837;1;325;-2.14748e+09;-1.13956e+06;-1;0;0;0;-1;0;454005033;467116747;41632345
1977;6.04373e-15;-604;1633;12347;12754;1;311;-2.14748e+09;-1.13956e+06;0;0;0;0;0;0;454005033;467116747;41632345
1978;6.10309e-15;-590;1623;12480;12837;1;325;-2.14748e+09;-1.13751e+06;0;0;0;0;0;0;454049334;467171146;41651413
1978;6.04373e-15;-605;1633;12347;12754;1;311;-2.14748e+09;-1.13751e+06;0;0;0;0;0;0;454049334;467171146;41651413
1979;6.10309e-15;-590;1623;12480;12837;1;325;-2.14748e+09;-1.13527e+06;-1;0;0;0;-1;0;454093549;467225446;41670451
1979;6.04373e-15;-605;1633;12347;12754;1;311;-2.14748e+09;-1.13527e+06;-1;0;0;0;-1;0;454093549;467225446;41670451
1980;6.10309e-15;-590;1623;12480;12837;1;325;-2.14748e+09;-1.13323e+06;-1;0;0;0;-1;0;454137679;467279649;41689459
1980;6.04373e-15;-606;1633;12347;12754;1;311;-2.14748e+09;-1.13323e+06;0;0;0;0;0;0;454137679;467279649;41689459
1981;6.10309e-15;-591;1623;12480;12837;1;325;-2.14748e+09;-1.13099e+06;0;0;0;0;0;0;454181724;467333754;41708436
1981;6.04373e-15;-606;1633;12347;12754;1;311;-2.14748e+09;-1.13099e+06;-1;0;0;0;-1;0;454181724;467333754;41708436
1982;6.10309e-15;-591;1623;12480;12837;1;325;-2.14748e+09;-1.12886e+06;-1;0;0;0;-1;0;454225684;467387761;41727384
1982;6.04373e-15;-607;1633;12347;12754;1;311;-2.14748e+09;-1.12886e+06;0;0;0;0;0;0;454225684;467387761;41727384
1983;6.10309e-15;-591;1623;12480;12837;1;325;-2.14748e+09;-1.12673e+06;-1;0;0;0;-1;0;454269559;467441672;41746300
1983;6.04373e-15;-608;1633;12347;12754;1;311;-2.14748e+09;-1.12673e+06;0;0;0;0;0;0;454269559;467441672;41746300
1984;6.10309e-15;-591;1623;12480;12837;1;325;-2.14748e+09;-1.12461e+06;-1;0;0;0;-1;0;454313349;467495485;41765187
1984;6.04373e-15;-608;1633;12347;12754;1;311;-2.14748e+09;-1.12461e+06;-1;0;0;0;-1;0;454313349;467495485;41765187
1985;6.10309e-15;-591;1623;12480;12837;1;325;-2.14748e+09;-1.12249e+06;-1;0;0;0;-1;0;454357054;467549201;41784044
1985;6.04373e-15;-608;1633;12347;12754;1;311;-2.14748e+09;-1.12249e+06;-1;0;0;0;-1;0;454357054;467549201;41784044
1986;6.10309e-15;-591;1623;12480;12837;1;325;-2.14748e+09;-1.12037e+06;-1;0;0;0;-1;0;454400675;467602821;41802870
1986;6.04373e-15;-609;1633;12347;12754;1;311;-2.14748e+09;-1.12037e+06;0;0;0;0;0;0;454400675;467602821;41802870
1987;6.10309e-15;-592;1623;12480;12837;1;325;-2.14748e+09;-1.11826e+06;0;0;0;0;0;0;454444212;467656343;41821666
1987;6.04373e-15;-609;1633;12347;12754;1;311;-2.14748e+09;-1.11826e+06;-1;0;0;0;-1;0;454444212;467656343;41821666
1988;6.10309e-15;-592;1623;12480;12837;1;325;-2.14748e+09;-1.11616e+06;-1;0;0;0;-1;0;454487665;467709770;41840432
1988;6.04373e-15;-610;1633;12347;12754;1;311;-2.14748e+09;-1.11616e+06;0;0;0;0;0;0;454487665;467709770;41840432
1989;6.10309e-15;-592;1623;12480;12837;1;325;-2.14748e+09;-1.11405e+06;-1;0;0;0;-1;0;454531034;467763100;41859169
1989;6.04373e-15;-610;1633;12347;12754;1;311;-2.14748e+09;-1.11405e+06;-1;0;0;0;-1;0;454531034;467763100;41859169
1990;6.10309e-15;-592;1623;12480;12837;1;325;-2.14748e+09;-1.11196e+06;-1;0;0;0;-1;0;454574320;467816335;41877875
1990;6.04373e-15;-611;1633;12347;12754;1;311;-2.14748e+09;-1.11196e+06;0;0;0;0;0;0;454574320;467816335;41877875
1991;6.10309e-15;-592;1623;12480;12837;1;325;-2.14748e+09;-1.10986e+06;-1;0;0;0;-1;0;454617521;467869473;41896551
1991;6.04373e-15;-611;1633;12347;12754;1;311;-2.14748e+09;-1.10986e+06;-1;0;0;0;-1;0;454617521;467869473;41896551
1992;6.10309e-15;-593;1623;12480;12837;1;325;-2.14748e+09;-1.10777e+06;0;0;0;0;0;0;454660640;467922516;41915197
1992;6.04373e-15;-611;1633;12347;12754;1;311;-2.14748e+09;-1.10777e+06;-1;0;0;0;-1;0;454660640;467922516;41915197
1993;6.10309e-15;-593;1623;12480;12837;1;325;-2.14748e+09;-1.10568e+06;-1;0;0;0;-1;0;454703675;467975463;41933814
1993;6.04373e-15;-611;1633;12347;12754;1;311;-2.14748e+09;-1.10568e+06;-1;0;0;0;-1;0;454703675;467975463;41933814
1994;6.10309e-15;-593;1623;12480;12837;1;325;-2.14748e+09;-1.1036e+06;-1;0;0;0;-1;0;454746627;468028315;41952401
1994;6.04373e-15;-612;1633;12347;12754;1;311;-2.14748e+09;-1.1036e+06;0;0;0;0;0;0;454746627;468028315;41952401
1995;6.10309e-15;-594;1623;12480;12837;1;325;-2.14748e+09;-1.10162e+06;0;0;0;0;0;0;454789497;468081072;41970957
1995;6.04373e-15;-613;1633;12347;12754;1;311;-2.14748e+09;-1.10162e+06;0;0;0;0;0;0;454789497;468081072;41970957
1996;6.10309e-15;-594;1623;12480;12837;1;325;-2.14748e+09;-1.09945e+06;-1;0;0;0;-1;0;454832283;468133734;41989485
1996;6.04373e-15;-614;1633;12347;12754;1;311;-2.14748e+09;-1.09945e+06;0;0;0;0;0;0;454832283;468133734;41989485
1997;6.10309e-15;-595;1623;12480;12837;1;325;-2.14748e+09;-1.09748e+06;0;0;0;0;0;0;454874988;468186301;42007982
1997;6.04373e-15;-614;1633;12347;12754;1;311;-2.14748e+09;-1.09748e+06;-1;0;0;0;-1;0;454874988;468186301;42007982
1998;6.10309e-15;-595;1623;12480;12837;1;325;-2.14748e+09;-1.09532e+06;-1;0;0;0;-1;0;454917609;468238773;42026450
1998;6.04373e-15;-615;1633;12347;12754;1;311;-2.14748e+09;-1.09532e+06;0;0;0;0;0;0;454917609;468238773;42026450
1999;6.10309e-15;-595;1623;12480;12837;1;325;-2.14748e+09;-1.09325e+06;-1;0;0;0;-1;0;454960149;468291151;42044888
1999;6.04373e-15;-615;1633;12347;12754;1;311;-2.14748e+09;-1.09325e+06;-1;0;0;0;-1;0;454960149;468291151;42044888
