step;volume;A_0;B_0;C;L;p;Compl;Aext;Bext;A_ingresso;A_uscita;B_ingresso;B_uscita;A_netto;B_netto;Avicino;Amedio;Alontano
0;4.18816e-15;362;400;97;10000;1;3;1062;1100;508;146;501;147;362;354;980;2;0
1;4.18816e-15;344;411;99;10000;1;1;1104;1176;486;141;546;140;345;406;943;0;0
2;4.18816e-15;472;500;100;10002;1;1;1146;1250;588;214;597;246;374;351;909;5;0
3;4.18942e-15;539;561;98;10002;1;3;1107;1220;547;262;625;261;285;364;892;7;0
4;4.18942e-15;544;600;96;10003;1;6;1149;1288;549;273;605;290;276;315;866;7;0
5;4.19005e-15;519;661;95;10003;1;7;1178;1352;583;285;688;311;298;377;842;8;0
6;4.19005e-15;529;710;97;10003;1;7;1330;1514;593;263;655;318;330;337;808;8;0
7;4.19005e-15;614;732;95;10005;1;9;1243;1474;678;299;772;363;379;409;794;8;0
8;4.19131e-15;656;755;98;10005;1;9;1375;1631;670;282;770;368;388;402;763;7;0
9;4.19131e-15;625;792;97;10005;1;11;1404;1686;680;330;847;417;350;430;744;7;0
10;4.19131e-15;658;875;95;10005;1;14;1448;1739;709;322;820;385;387;435;723;7;0
11;4.19131e-15;710;810;92;10006;1;19;1451;1789;788;349;862;450;439;412;701;7;0
12;4.19195e-15;694;814;95;10006;1;19;1474;1838;771;373;948;442;398;506;680;6;0
13;4.19195e-15;720;884;99;10008;1;18;1394;1784;744;358;894;417;386;477;671;6;0
14;4.19321e-15;720;957;100;10008;1;21;1423;1829;662;379;899;434;283;465;653;6;0
15;4.19321e-15;686;971;107;10008;1;18;1549;1972;670;358;946;473;312;473;626;6;0
16;4.19321e-15;736;1021;105;10008;1;23;1584;2014;804;359;968;470;445;498;611;6;0
17;4.19321e-15;755;993;101;10009;1;29;1581;2054;799;417;982;537;382;445;596;6;0
18;4.19384e-15;788;1009;105;10009;1;29;1498;1992;799;374;992;472;425;520;588;6;0
19;4.19384e-15;769;1011;112;10009;1;27;1617;2129;757;382;995;515;375;480;568;6;0
20;4.19384e-15;780;1045;109;10009;1;32;1630;2165;786;391;1049;551;395;498;555;6;0
21;4.19384e-15;811;1072;118;10010;1;30;1565;2099;750;364;1110;485;386;625;548;6;0
22;4.19447e-15;807;1052;125;10012;1;28;1654;2232;777;372;1046;535;405;511;528;6;0
23;4.19574e-15;790;1083;127;10012;1;32;1669;2264;819;435;1157;533;384;624;515;6;0
24;4.19574e-15;810;1085;129;10013;1;34;1678;2294;860;422;1097;562;438;535;503;6;0
25;4.19637e-15;796;1157;135;10015;1;32;1687;2324;838;421;1173;549;417;624;492;6;0
26;4.19763e-15;840;1142;139;10015;1;34;1692;2352;845;391;1163;576;454;587;480;6;0
27;4.19763e-15;832;1140;149;10017;1;30;1695;2380;900;386;1091;581;514;510;470;7;0
28;4.1989e-15;818;1145;147;10018;1;35;1725;2406;841;408;1201;551;433;650;461;7;0
29;4.19953e-15;880;1145;144;10019;1;43;1731;2432;853;399;1203;576;454;627;453;7;0
30;4.20016e-15;857;1144;149;10022;1;44;1719;2456;923;440;1175;611;483;564;443;7;0
31;4.20206e-15;816;1138;150;10022;1;48;1731;2480;866;462;1219;588;404;631;432;8;0
32;4.20206e-15;822;1222;167;10025;1;45;1663;2403;808;450;1266;606;358;660;428;8;0
33;4.20395e-15;820;1171;170;10025;1;46;1747;2525;787;393;1136;617;394;519;413;8;0
34;4.20395e-15;857;1268;176;10025;1;46;1748;2547;924;426;1265;590;498;675;404;9;0
35;4.20395e-15;900;1250;175;10027;1;53;1757;2567;865;424;1230;680;441;550;396;9;0
36;4.20522e-15;925;1288;187;10027;1;51;1784;2587;884;434;1316;578;450;738;388;9;0
37;4.20522e-15;872;1249;193;10028;1;53;1788;2607;888;473;1307;626;415;681;380;10;0
38;4.20585e-15;869;1211;194;10029;1;61;1791;2626;872;416;1291;667;456;624;373;10;0
39;4.20648e-15;904;1236;197;10031;1;67;1795;2644;864;400;1239;645;464;594;367;10;0
40;4.20775e-15;921;1301;212;10031;1;63;1800;2661;917;450;1374;652;467;722;360;11;0
41;4.20775e-15;911;1284;226;10031;1;60;1802;2678;838;422;1361;656;416;705;353;11;0
42;4.20775e-15;885;1284;231;10031;1;63;1810;2695;871;469;1344;673;402;671;345;12;0
43;4.20775e-15;937;1357;243;10033;1;66;1809;2711;905;435;1361;626;470;735;339;12;0
44;4.20901e-15;909;1354;256;10035;1;68;1813;2726;899;476;1325;699;423;626;333;12;0
45;4.21028e-15;899;1387;257;10035;1;73;1817;2741;908;452;1370;670;456;700;327;13;0
46;4.21028e-15;881;1343;263;10036;1;79;1796;2755;878;461;1390;678;417;712;321;14;0
47;4.21091e-15;830;1318;281;10038;1;76;1799;2769;887;438;1406;655;449;751;315;14;0
48;4.21217e-15;850;1297;293;10039;1;77;1823;2783;901;442;1379;690;459;689;310;15;0
49;4.21281e-15;867;1378;310;10039;1;75;1828;2796;841;449;1401;648;392;753;305;15;0
50;4.21281e-15;880;1453;317;10041;1;79;1807;2809;920;458;1365;627;462;738;299;16;0
51;4.21407e-15;881;1384;318;10043;1;87;1831;2821;909;436;1334;738;473;596;295;16;0
52;4.21534e-15;890;1374;340;10046;1;80;1832;2833;901;435;1461;685;466;776;291;17;0
53;4.21724e-15;911;1394;352;10049;1;83;1811;2845;874;434;1358;680;440;678;286;17;0
54;4.21914e-15;912;1444;348;10049;1;98;1813;2856;885;486;1513;704;399;809;281;17;0
55;4.21914e-15;889;1405;357;10051;1;105;1837;2868;889;430;1398;722;459;676;277;18;0
56;4.2204e-15;966;1458;365;10052;1;114;1835;2878;945;437;1455;684;508;771;274;18;0
57;4.22103e-15;908;1425;379;10054;1;120;1832;2889;946;469;1402;739;477;663;270;19;0
58;4.2223e-15;920;1484;385;10056;1;128;1838;2899;892;442;1460;675;450;785;267;19;0
59;4.22357e-15;895;1383;400;10057;1;135;1814;2909;871;468;1510;736;403;774;265;20;0
60;4.2242e-15;921;1422;424;10061;1;133;1836;2918;968;464;1380;696;504;684;260;20;0
61;4.22673e-15;896;1420;443;10061;1;137;1813;2928;917;445;1483;731;472;752;256;21;0
62;4.22673e-15;851;1416;474;10062;1;135;1811;2937;907;447;1350;719;460;631;251;21;0
63;4.22737e-15;898;1437;512;10063;1;127;1834;2945;899;405;1481;720;494;761;247;22;0
64;4.228e-15;847;1400;533;10065;1;129;1805;2954;944;429;1432;745;515;687;244;22;0
65;4.22927e-15;880;1438;525;10069;1;150;1828;2962;876;397;1409;727;479;682;242;23;0
66;4.2318e-15;854;1406;534;10071;1;163;1804;2971;941;424;1499;725;517;774;239;24;0
67;4.23307e-15;875;1398;557;10076;1;164;1806;2979;877;441;1529;729;436;800;236;24;0
68;4.23624e-15;860;1415;585;10077;1;163;1809;2986;984;452;1464;708;532;756;232;25;0
69;4.23687e-15;817;1438;616;10077;1;161;1829;2994;948;422;1591;706;526;885;230;26;0
70;4.23687e-15;848;1514;642;10081;1;160;1810;3001;906;413;1473;692;493;781;226;26;0
71;4.23941e-15;837;1484;687;10082;1;153;1807;3008;915;428;1487;775;487;712;223;26;0
72;4.24004e-15;834;1492;720;10089;1;151;1832;3015;902;449;1487;747;453;740;221;27;0
73;4.24448e-15;824;1543;747;10096;1;162;1731;2922;911;435;1470;691;476;779;221;28;0
74;4.24892e-15;859;1464;768;10098;1;172;1816;3029;808;411;1504;740;397;764;217;29;0
75;4.25019e-15;900;1513;785;10100;1;186;1838;3035;894;398;1545;703;496;842;213;29;0
76;4.25146e-15;893;1486;799;10106;1;199;1813;3042;934;410;1494;742;524;752;211;30;0
77;4.25527e-15;834;1501;832;10107;1;203;1832;3048;954;402;1585;746;552;839;208;31;0
78;4.2559e-15;839;1450;864;10111;1;207;1826;3054;936;402;1605;762;534;843;206;31;0
79;4.25844e-15;873;1502;890;10116;1;217;1827;3060;871;436;1510;754;435;756;204;31;0
80;4.26162e-15;877;1505;912;10123;1;229;1809;3066;879;441;1492;727;438;765;202;32;0
81;4.26606e-15;874;1523;942;10135;1;232;1832;3071;917;446;1568;769;471;799;199;33;0
82;4.27369e-15;858;1485;980;10140;1;236;1806;3077;929;443;1554;740;486;814;197;34;0
83;4.27687e-15;826;1447;1012;10148;1;239;1802;3082;940;447;1597;765;493;832;195;35;0
84;4.28196e-15;855;1465;1054;10153;1;245;1827;3088;877;432;1556;718;445;838;194;35;0
85;4.28514e-15;844;1460;1083;10155;1;254;1829;3093;903;443;1495;744;460;751;191;36;0
86;4.28641e-15;874;1507;1126;10162;1;261;1829;3098;869;435;1538;734;434;804;189;36;0
87;4.29087e-15;862;1475;1139;10170;1;284;1706;3003;892;451;1482;785;441;697;190;37;0
88;4.29596e-15;852;1480;1164;10176;1;306;1810;3108;835;420;1487;744;415;743;186;37;0
89;4.29978e-15;866;1546;1211;10181;1;308;1808;3112;873;408;1505;770;465;735;185;38;0
90;4.30297e-15;810;1483;1271;10188;1;313;1828;3117;946;411;1529;752;535;777;183;39;0
91;4.30743e-15;828;1443;1321;10196;1;326;1806;3122;916;432;1624;753;484;871;182;39;0
92;4.31253e-15;814;1523;1352;10207;1;346;1731;3026;882;439;1543;725;443;818;183;40;0
93;4.31954e-15;823;1481;1399;10215;1;353;1833;3130;845;426;1465;735;419;730;181;41;0
94;4.32465e-15;805;1508;1476;10227;1;344;1805;3135;909;470;1531;765;439;766;179;41;0
95;4.33231e-15;803;1456;1514;10233;1;357;1801;3139;914;412;1543;781;502;762;177;42;0
96;4.33614e-15;822;1477;1547;10245;1;379;1724;3043;879;394;1542;737;485;805;178;43;0
97;4.34381e-15;827;1463;1592;10256;1;398;1801;3147;836;387;1466;760;449;706;174;43;0
98;4.35084e-15;834;1493;1630;10264;1;424;1825;3151;915;452;1587;751;463;836;173;43;0
99;4.35596e-15;857;1510;1687;10273;1;440;1819;3155;906;383;1565;780;523;785;172;44;0
100;4.36172e-15;841;1502;1756;10285;1;443;1696;3059;935;464;1516;763;471;753;173;44;0
101;4.3694e-15;766;1495;1817;10294;1;455;1818;3162;918;407;1560;706;511;854;168;45;0
102;4.37517e-15;798;1484;1931;10305;1;442;1720;3066;858;387;1598;731;471;867;169;46;0
103;4.38222e-15;785;1466;1999;10315;1;447;1703;3070;806;408;1548;761;398;787;168;46;0
104;4.38863e-15;846;1467;2094;10327;1;444;1825;3173;888;377;1601;683;511;918;165;46;0
105;4.39633e-15;834;1509;2151;10336;1;465;1795;3177;906;426;1596;779;480;817;164;47;0
106;4.40211e-15;793;1499;2200;10348;1;495;1819;3180;896;427;1626;716;469;910;163;48;0
107;4.40982e-15;842;1541;2276;10360;1;508;1790;3184;936;398;1611;761;538;850;162;49;0
108;4.41753e-15;779;1559;2331;10385;1;540;1815;3187;882;414;1612;731;468;881;161;49;0
109;4.43361e-15;822;1473;2434;10399;1;534;1790;3190;921;397;1570;763;524;807;161;50;0
110;4.44262e-15;775;1545;2465;10408;1;580;1813;3193;925;427;1628;755;498;873;159;51;0
111;4.44842e-15;759;1513;2549;10420;1;604;1783;3196;901;359;1665;789;542;876;159;51;0
112;4.45615e-15;768;1508;2628;10432;1;626;1811;3199;818;407;1601;757;411;844;158;52;0
113;4.46389e-15;805;1451;2724;10442;1;637;1782;3203;904;367;1626;761;537;865;157;53;0
114;4.47034e-15;754;1514;2787;10462;1;680;1776;3206;924;383;1605;720;541;885;157;53;0
115;4.48326e-15;781;1536;2894;10481;1;684;1800;3208;898;389;1638;744;509;894;156;54;0
116;4.49554e-15;771;1466;2993;10507;1;706;1796;3211;931;380;1609;782;551;827;155;54;0
117;4.51236e-15;787;1470;3045;10520;1;749;1770;3214;894;364;1616;744;530;872;154;55;0
118;4.52078e-15;809;1484;3164;10533;1;758;1768;3217;866;397;1592;730;469;862;153;55;0
119;4.5292e-15;746;1508;3286;10554;1;762;1768;3220;900;386;1599;725;514;874;152;56;0
120;4.54282e-15;745;1502;3413;10575;1;766;1771;3222;885;400;1650;733;485;917;151;56;0
121;4.55645e-15;721;1427;3526;10586;1;784;1768;3225;823;347;1527;799;476;728;150;57;0
122;4.5636e-15;757;1510;3646;10605;1;796;1765;3228;876;370;1675;727;506;948;150;58;0
123;4.57595e-15;732;1519;3803;10629;1;788;1791;3230;850;388;1640;721;462;919;150;58;0
124;4.59157e-15;745;1510;3891;10661;1;822;1763;3233;904;356;1675;724;548;951;149;59;0
125;4.61243e-15;797;1566;4003;10686;1;842;1687;3135;858;360;1632;719;498;913;150;60;0
126;4.62874e-15;760;1423;4126;10709;1;862;1761;3238;835;374;1580;763;461;817;148;60;0
127;4.64377e-15;726;1488;4258;10729;1;868;1787;3240;838;380;1658;693;458;965;146;60;0
128;4.65685e-15;737;1422;4359;10751;1;913;1682;3143;903;390;1534;746;513;788;147;61;0
129;4.67125e-15;700;1369;4466;10782;1;953;1780;3245;844;317;1647;692;527;955;144;61;0
130;4.69157e-15;766;1399;4656;10803;1;938;1776;3248;861;383;1612;671;478;941;143;62;0
131;4.70535e-15;712;1445;4761;10832;1;978;1774;3250;882;352;1629;710;530;919;142;62;0
132;4.7244e-15;674;1471;4880;10861;1;1013;1779;3252;854;410;1608;734;444;874;141;62;0
133;4.74348e-15;660;1479;5047;10877;1;1027;1753;3254;894;330;1703;752;564;951;141;63;0
134;4.75401e-15;685;1481;5157;10905;1;1067;1775;3257;880;333;1618;771;547;847;140;64;0
135;4.77247e-15;663;1493;5303;10926;1;1078;1767;3259;863;328;1630;738;535;892;140;64;0
136;4.78633e-15;677;1497;5472;10971;1;1084;1767;3261;886;345;1648;757;541;891;139;64;0
137;4.81608e-15;712;1434;5643;10995;1;1090;1763;3263;866;320;1682;701;546;981;139;64;0
138;4.83197e-15;680;1461;5765;11026;1;1139;1734;3265;902;302;1634;740;600;894;139;64;0
139;4.85252e-15;671;1524;5943;11059;1;1142;1732;3267;859;319;1628;753;540;875;140;64;0
140;4.87442e-15;660;1499;6113;11092;1;1162;1756;3269;863;331;1647;749;532;898;139;65;0
141;4.89636e-15;677;1474;6273;11122;1;1188;1652;3171;901;333;1643;709;568;934;140;66;0
142;4.91634e-15;693;1372;6431;11154;1;1215;1726;3273;851;322;1619;726;529;893;137;67;0
143;4.93767e-15;680;1419;6574;11181;1;1259;1722;3275;870;353;1559;758;517;801;138;67;0
144;4.9557e-15;667;1416;6690;11199;1;1317;1719;3277;893;314;1698;690;579;1008;137;68;0
145;4.96773e-15;658;1412;6850;11224;1;1357;1745;3279;811;316;1660;670;495;990;136;68;0
146;4.98445e-15;633;1463;7024;11269;1;1382;1745;3281;796;299;1638;675;497;963;135;68;0
147;5.0146e-15;622;1494;7229;11316;1;1397;1719;3283;875;334;1654;747;541;907;134;68;0
148;5.04616e-15;623;1501;7415;11349;1;1414;1714;3285;886;342;1689;703;544;986;134;68;0
149;5.06836e-15;653;1454;7590;11399;1;1430;1639;3187;838;307;1603;739;531;864;136;69;0
150;5.10205e-15;586;1420;7727;11428;1;1484;1709;3289;841;322;1525;684;519;841;133;70;0
151;5.12162e-15;606;1398;7924;11463;1;1501;1703;3291;854;302;1616;723;552;893;132;70;0
152;5.14528e-15;621;1388;8095;11498;1;1538;1699;3292;864;281;1661;751;583;910;131;71;0
153;5.16898e-15;566;1406;8275;11528;1;1568;1698;3294;847;312;1572;696;535;876;131;71;0
154;5.18932e-15;601;1490;8453;11565;1;1607;1722;3296;819;271;1677;700;548;977;131;71;0
155;5.21444e-15;629;1420;8611;11607;1;1649;1691;3298;887;334;1663;743;553;920;131;71;0
156;5.24301e-15;580;1415;8850;11649;1;1658;1686;3299;893;315;1666;704;578;962;131;72;0
157;5.27163e-15;586;1437;9040;11696;1;1692;1684;3301;827;274;1598;717;553;881;131;72;0
158;5.30371e-15;609;1399;9242;11740;1;1721;1709;3303;810;279;1670;697;531;973;130;71;0
159;5.33381e-15;591;1392;9438;11779;1;1762;1702;3304;862;279;1594;696;583;898;130;72;0
160;5.36054e-15;584;1446;9649;11820;1;1788;1674;3306;853;295;1623;724;558;899;130;72;0
161;5.38868e-15;561;1417;9857;11868;1;1819;1669;3308;873;285;1680;698;588;982;130;72;0
162;5.42169e-15;561;1388;10110;11913;1;1811;1666;3309;820;270;1649;715;550;934;130;72;0
163;5.4527e-15;558;1394;10293;11970;1;1861;1663;3311;850;276;1633;665;574;968;129;74;0
164;5.49207e-15;531;1361;10498;12015;1;1890;1685;3312;901;289;1611;724;612;887;129;74;0
165;5.52321e-15;585;1479;10708;12064;1;1914;1682;3314;906;300;1626;716;606;910;129;74;0
166;5.55719e-15;580;1426;10905;12109;1;1952;1679;3315;828;270;1702;727;558;975;129;74;0
167;5.58846e-15;542;1378;11106;12151;1;1999;1650;3317;858;291;1633;712;567;921;128;74;0
168;5.61769e-15;565;1435;11321;12199;1;2025;1651;3318;799;282;1658;665;517;993;128;75;0
169;5.65117e-15;571;1380;11518;12242;1;2070;1648;3320;806;282;1672;743;524;929;128;75;0
170;5.68121e-15;543;1391;11701;12296;1;2127;1672;3321;864;282;1725;713;582;1012;128;76;0
171;5.71902e-15;545;1382;11974;12354;1;2136;1644;3323;788;275;1634;702;513;932;127;75;0
172;5.75972e-15;537;1390;12181;12398;1;2184;1642;3324;830;284;1655;705;546;950;127;76;0
173;5.79066e-15;486;1377;12383;12456;1;2224;1644;3326;798;286;1654;692;512;962;127;76;0
174;5.83152e-15;498;1379;12624;12502;1;2239;1643;3327;793;259;1652;710;534;942;127;77;0
175;5.86401e-15;514;1403;12975;12551;1;2208;1668;3329;818;244;1601;718;574;883;127;78;0
176;5.89867e-15;583;1387;13137;12605;1;2275;1636;3330;853;275;1684;728;578;956;126;78;0
177;5.93696e-15;528;1354;13377;12663;1;2299;1538;3231;815;295;1675;731;520;944;128;78;0
178;5.97817e-15;474;1351;13591;12724;1;2351;1666;3333;774;256;1569;702;518;867;126;79;0
179;6.02161e-15;504;1392;13835;12778;1;2375;1664;3334;789;246;1613;669;543;944;126;79;0
180;6.06016e-15;530;1363;14139;12840;1;2363;1657;3336;845;227;1728;724;618;1004;126;79;0
181;6.10452e-15;534;1413;14338;12903;1;2414;1631;3337;809;275;1678;679;534;999;126;79;0
182;6.1497e-15;531;1388;14561;12962;1;2446;1658;3338;816;274;1661;714;542;947;125;81;0
183;6.19212e-15;533;1426;14808;13019;1;2463;1628;3340;871;291;1650;688;580;962;126;81;0
184;6.23319e-15;502;1374;15063;13080;1;2495;1524;3241;827;278;1680;674;549;1006;127;82;0
185;6.27725e-15;464;1303;15276;13138;1;2546;1653;3342;772;255;1647;681;517;966;125;82;0
186;6.31923e-15;491;1341;15564;13189;1;2551;1653;3343;824;243;1672;618;581;1054;124;82;0
187;6.35623e-15;461;1362;15808;13245;1;2580;1651;3345;770;257;1614;678;513;936;125;82;0
188;6.39694e-15;514;1392;16029;13306;1;2632;1621;3346;837;253;1713;691;584;1022;124;82;0
189;6.44137e-15;495;1422;16261;13368;1;2682;1618;3347;869;257;1620;711;612;909;124;83;0
190;6.48665e-15;476;1375;16574;13414;1;2687;1614;3349;799;239;1743;715;560;1028;125;82;0
191;6.52031e-15;491;1381;16826;13475;1;2725;1639;3350;810;227;1685;706;583;979;124;83;0
192;6.56503e-15;486;1330;17033;13548;1;2791;1636;3351;810;229;1661;706;581;955;124;83;0
193;6.61868e-15;473;1352;17288;13613;1;2826;1634;3352;786;234;1662;655;552;1007;124;83;0
194;6.66658e-15;502;1362;17601;13677;1;2821;1600;3353;842;236;1644;699;606;945;124;83;0
195;6.71386e-15;488;1395;17876;13737;1;2838;1602;3355;771;260;1599;706;511;893;124;84;0
196;6.75828e-15;484;1350;18153;13813;1;2857;1628;3356;829;249;1674;733;580;941;125;83;0
197;6.81468e-15;504;1385;18421;13883;1;2890;1628;3357;775;251;1679;699;524;980;124;83;0
198;6.86678e-15;479;1376;18723;13952;1;2894;1602;3358;871;272;1660;694;599;966;123;83;0
199;6.91826e-15;445;1433;18990;14016;1;2906;1630;3359;784;243;1599;659;541;940;123;84;0
200;6.96612e-15;468;1356;19264;14093;1;2924;1627;3360;760;247;1710;686;513;1024;124;83;0
201;7.02385e-15;491;1377;19566;14156;1;2925;1599;3362;808;242;1690;686;566;1004;123;83;0
202;7.0712e-15;449;1386;19832;14227;1;2949;1627;3363;800;262;1677;702;538;975;122;84;0
203;7.1247e-15;449;1391;20060;14296;1;2990;1626;3364;790;243;1596;679;547;917;122;84;0
204;7.17681e-15;423;1408;20343;14382;1;3013;1623;3365;826;221;1686;717;605;969;122;84;0
205;7.24195e-15;458;1390;20673;14459;1;2990;1597;3366;787;239;1689;701;548;988;122;85;0
206;7.30043e-15;464;1374;20931;14528;1;3025;1623;3367;821;257;1688;694;564;994;123;84;0
207;7.35297e-15;476;1348;21068;14609;1;3133;1623;3368;810;228;1739;666;582;1073;122;84;0
208;7.41481e-15;456;1404;21275;14680;1;3213;1623;3369;837;239;1658;666;598;992;122;84;0
209;7.46916e-15;474;1427;21561;14748;1;3243;1595;3370;777;234;1736;692;543;1044;122;85;0
210;7.52134e-15;425;1387;21811;14829;1;3280;1524;3271;736;213;1666;716;523;950;124;86;0
211;7.58365e-15;428;1298;22101;14900;1;3287;1598;3373;714;218;1648;648;496;1000;122;86;0
212;7.63841e-15;450;1356;22313;14972;1;3341;1493;3274;821;249;1679;646;572;1033;124;85;0
213;7.69407e-15;472;1347;22569;15058;1;3386;1522;3275;723;204;1578;712;519;866;124;86;0
214;7.76073e-15;451;1370;22791;15124;1;3446;1595;3376;778;227;1726;695;551;1031;124;85;0
215;7.81203e-15;474;1300;23142;15199;1;3429;1597;3377;745;231;1687;673;514;1014;124;86;0
216;7.87045e-15;468;1333;23419;15261;1;3467;1623;3378;783;225;1664;682;558;982;123;86;0
217;7.91886e-15;479;1347;23663;15341;1;3529;1595;3379;783;227;1605;689;556;916;123;85;0
218;7.98146e-15;479;1394;23953;15417;1;3546;1590;3380;839;220;1725;643;619;1082;122;85;0
219;8.04109e-15;458;1412;24160;15497;1;3627;1588;3381;793;233;1793;706;560;1087;121;86;0
220;8.10402e-15;443;1336;24443;15580;1;3671;1586;3382;779;237;1737;724;542;1013;122;86;0
221;8.16948e-15;455;1358;24651;15637;1;3742;1614;3383;782;229;1661;702;553;959;122;87;0
222;8.21453e-15;476;1370;24907;15709;1;3792;1590;3384;775;245;1645;682;530;963;122;87;0
223;8.27157e-15;496;1343;25177;15776;1;3829;1518;3285;781;238;1675;691;543;984;123;88;0
224;8.32476e-15;478;1356;25456;15860;1;3870;1617;3386;759;233;1613;694;526;919;121;87;0
225;8.3916e-15;447;1328;25722;15946;1;3904;1515;3287;767;239;1624;697;528;927;122;87;0
226;8.46023e-15;417;1326;25994;16031;1;3940;1613;3388;783;204;1686;660;579;1026;120;87;0
227;8.52823e-15;458;1365;26271;16108;1;3975;1590;3389;741;225;1749;729;516;1020;120;87;0
228;8.59e-15;447;1380;26548;16167;1;4011;1617;3390;784;217;1673;730;567;943;120;87;0
229;8.63743e-15;463;1356;26891;16253;1;4007;1587;3390;780;191;1691;688;589;1003;120;87;0
230;8.70672e-15;487;1313;27131;16339;1;4063;1586;3391;780;240;1663;684;540;979;120;87;0
231;8.77619e-15;463;1308;27381;16411;1;4119;1611;3392;820;218;1741;679;602;1062;122;87;0
232;8.83449e-15;457;1368;27610;16490;1;4191;1609;3393;763;200;1681;635;563;1046;121;87;0
233;8.89862e-15;434;1364;27884;16570;1;4227;1576;3394;819;206;1703;719;613;984;121;88;0
234;8.96371e-15;414;1379;28134;16627;1;4274;1606;3395;766;248;1663;707;518;956;122;87;0
235;9.01018e-15;466;1353;28450;16709;1;4271;1570;3396;887;210;1699;672;677;1027;121;88;0
236;9.07718e-15;456;1349;28743;16769;1;4300;1570;3397;785;208;1700;695;577;1005;122;88;0
237;9.12631e-15;459;1411;28993;16839;1;4355;1573;3398;700;226;1770;684;474;1086;122;88;0
238;9.18374e-15;447;1414;29306;16911;1;4368;1571;3399;822;234;1668;712;588;956;122;87;0
239;9.24294e-15;434;1435;29572;16990;1;4415;1568;3400;791;230;1660;690;561;970;122;87;0
240;9.30803e-15;442;1387;29887;17065;1;4432;1566;3400;764;247;1618;695;517;923;123;87;0
241;9.36998e-15;424;1321;30225;17135;1;4422;1595;3401;763;219;1597;726;544;871;122;88;0
242;9.42791e-15;413;1352;30446;17207;1;4471;1570;3402;765;232;1769;677;533;1092;122;89;0
243;9.48763e-15;424;1414;30751;17292;1;4501;1569;3403;773;187;1728;669;586;1059;122;89;0
244;9.55829e-15;400;1333;31041;17375;1;4535;1571;3404;762;184;1723;749;578;974;121;89;0
245;9.62746e-15;460;1400;31375;17463;1;4533;1566;3405;795;209;1656;630;586;1026;121;90;0
246;9.70097e-15;435;1429;31619;17533;1;4584;1565;3406;845;220;1696;676;625;1020;120;90;0
247;9.75959e-15;454;1355;31916;17610;1;4612;1565;3406;814;236;1690;727;578;963;119;90;0
248;9.8242e-15;447;1442;32172;17690;1;4673;1591;3407;805;213;1667;643;592;1024;118;90;0
249;9.89147e-15;456;1397;32493;17786;1;4688;1586;3408;863;219;1735;720;644;1015;118;89;0
250;9.97241e-15;460;1419;32796;17855;1;4709;1585;3409;826;222;1665;717;604;948;118;90;0
251;1.00307e-14;420;1389;33139;17929;1;4720;1587;3410;766;223;1774;667;543;1107;117;89;0
252;1.00934e-14;437;1374;33464;18010;1;4733;1586;3411;799;208;1704;743;591;961;117;89;0
253;1.01621e-14;426;1411;33715;18073;1;4794;1555;3411;808;196;1656;701;612;955;117;89;0
254;1.02157e-14;422;1386;34051;18150;1;4798;1556;3412;744;227;1681;700;517;981;117;89;0
255;1.02813e-14;391;1363;34351;18231;1;4821;1586;3413;734;215;1727;683;519;1044;117;89;0
256;1.03505e-14;392;1384;34657;18309;1;4837;1559;3414;844;222;1651;692;622;959;117;90;0
257;1.04172e-14;410;1483;35014;18383;1;4832;1558;3415;777;187;1698;708;590;990;118;90;0
258;1.04807e-14;444;1405;35390;18488;1;4819;1556;3415;783;173;1688;711;610;977;117;90;0
259;1.05709e-14;446;1366;35681;18579;1;4872;1588;3416;715;231;1822;741;484;1081;117;90;0
260;1.06494e-14;422;1432;35920;18654;1;4940;1560;3417;801;226;1721;685;575;1036;118;90;0
261;1.07141e-14;413;1384;36291;18730;1;4913;1559;3418;785;209;1725;715;576;1010;118;91;0
262;1.07799e-14;444;1386;36568;18802;1;4961;1556;3419;769;191;1723;696;578;1027;118;91;0
263;1.08424e-14;442;1400;36828;18904;1;5023;1555;3419;793;232;1717;738;561;979;118;92;0
264;1.09311e-14;448;1406;37155;18991;1;5039;1554;3420;778;226;1697;678;552;1019;117;91;0
265;1.10069e-14;401;1348;37436;19074;1;5078;1555;3421;769;235;1691;664;534;1027;117;92;0
266;1.10794e-14;433;1448;37709;19164;1;5108;1583;3422;762;213;1722;668;549;1054;117;92;0
267;1.11582e-14;418;1386;37995;19243;1;5143;1548;3422;852;220;1745;687;632;1058;117;92;0
268;1.12275e-14;432;1380;38285;19321;1;5165;1549;3423;752;229;1805;664;523;1141;116;91;0
269;1.12961e-14;429;1340;38584;19417;1;5194;1545;3424;798;208;1726;739;590;987;116;92;0
270;1.13807e-14;391;1454;38813;19502;1;5275;1546;3425;770;203;1719;688;567;1031;116;92;0
271;1.14558e-14;410;1366;39165;19599;1;5278;1472;3325;809;202;1725;715;607;1010;117;94;1
272;1.15417e-14;421;1360;39368;19684;1;5351;1547;3426;771;186;1655;657;585;998;116;92;1
273;1.16171e-14;396;1409;39666;19772;1;5371;1548;3427;769;232;1788;691;537;1097;116;92;1
274;1.16954e-14;428;1387;39966;19840;1;5383;1576;3428;769;201;1706;701;568;1005;116;92;1
275;1.1756e-14;435;1417;40251;19930;1;5422;1547;3428;796;236;1664;666;560;998;116;92;1
276;1.18364e-14;436;1400;40564;20019;1;5442;1548;3429;778;220;1714;663;558;1051;116;93;1
277;4.19447e-15;388;973;15106;10086.5;1;5173;1526;3430;786;156;1702;382;630;1320;116;93;1
278;4.24321e-15;411;1075;15995;10172.5;1;4909;1490;3431;799;212;1803;510;587;1293;116;93;1
279;4.29787e-15;383;1136;16859;10276.5;1;4654;1497;3431;722;186;1736;498;536;1238;117;93;1
280;4.36428e-15;346;1125;17649;10369.5;1;4450;1475;3432;724;187;1752;591;537;1161;117;94;1
281;4.42396e-15;341;1101;18418;10479.5;1;4242;1446;3433;742;180;1709;577;562;1132;116;94;1
282;4.49489e-15;364;1164;19058;10594.5;1;4127;1438;3433;732;181;1713;549;551;1164;117;95;1
283;4.56945e-15;347;1191;19676;10694.5;1;4003;1293;3334;685;159;1678;657;526;1021;118;95;1
284;4.63462e-15;317;1139;20324;10796.5;1;3857;1298;3435;590;185;1633;567;405;1066;118;94;1
285;4.70141e-15;323;1217;20913;10898.5;1;3719;1338;3435;681;164;1754;571;517;1183;117;96;1
286;4.76852e-15;299;1232;21579;11018.5;1;3556;1240;3436;681;149;1767;629;532;1138;117;96;1
287;4.84787e-15;285;1249;22187;11135.5;1;3402;1284;3437;642;152;1745;615;490;1130;117;96;1
288;4.92567e-15;289;1281;22744;11250.5;1;3299;1212;3438;653;147;1750;620;506;1130;117;96;1
289;5.00254e-15;272;1331;23196;11370.5;1;3241;1236;3438;583;144;1784;674;439;1110;117;98;1
290;5.08317e-15;281;1301;23725;11474.5;1;3139;1216;3439;656;145;1761;640;511;1121;117;97;1
291;5.1534e-15;255;1274;24172;11585.5;1;3078;1202;3440;596;151;1619;673;445;946;116;98;1
292;5.22872e-15;280;1348;24665;11685.5;1;2993;1159;3440;584;118;1764;634;466;1130;117;95;1
293;5.29688e-15;253;1358;25182;11790.5;1;2888;1102;3441;622;135;1665;650;487;1015;117;95;1
294;5.36877e-15;275;1376;25695;11900.5;1;2779;1089;3442;567;126;1669;679;441;990;117;95;1
295;5.44443e-15;281;1388;26039;12004.5;1;2767;1084;3442;520;129;1744;693;391;1051;117;95;1
296;5.51629e-15;267;1423;26414;12123.5;1;2735;1137;3443;565;142;1729;646;423;1083;117;95;1
297;5.59889e-15;254;1392;26788;12240.5;1;2698;1105;3444;546;129;1678;711;417;967;117;96;1
298;5.68051e-15;247;1392;27152;12381.5;1;2660;1121;3444;552;150;1643;691;402;952;117;97;1
299;5.7794e-15;248;1393;27467;12499.5;1;2661;1053;3445;540;122;1694;711;418;983;116;96;1
300;5.86259e-15;242;1368;27779;12601.5;1;2642;1105;3445;562;108;1773;739;454;1034;116;97;1
301;5.93483e-15;243;1329;28124;12702.5;1;2614;1092;3446;579;112;1697;705;467;992;117;97;1
302;6.00664e-15;260;1364;28321;12838.5;1;2673;1092;3447;530;132;1772;703;398;1069;116;96;1
303;6.1038e-15;240;1408;28670;12956.5;1;2653;1092;3447;556;130;1694;694;426;1000;116;97;1
304;6.18852e-15;271;1400;29014;13081.5;1;2632;1061;3448;552;112;1771;704;440;1067;115;97;1
305;6.2787e-15;253;1343;29336;13192.5;1;2629;1078;3449;516;96;1686;695;420;991;114;98;1
306;6.35913e-15;251;1383;29609;13307.5;1;2639;1024;3449;513;138;1720;700;375;1020;115;97;1
307;6.44283e-15;226;1403;29872;13414.5;1;2653;1039;3450;494;100;1734;682;394;1052;115;97;1
308;6.52104e-15;237;1420;30152;13518.5;1;2635;1053;3451;507;124;1760;676;383;1084;113;97;1
309;6.59735e-15;264;1480;30487;13631.5;1;2599;1014;3451;526;120;1753;687;406;1066;114;97;1
310;6.68061e-15;240;1460;30764;13781.5;1;2592;1030;3452;493;130;1732;737;363;995;113;97;1
311;6.79166e-15;230;1396;31054;13879.5;1;2581;1051;3452;502;114;1799;745;388;1054;113;98;1
312;6.86454e-15;237;1436;31367;14006.5;1;2569;969;3353;473;120;1718;698;353;1020;115;97;1
313;6.95938e-15;229;1400;31618;14127.5;1;2566;1066;3454;517;108;1581;702;409;879;114;96;1
314;7.05014e-15;235;1377;31936;14255.5;1;2528;1047;3454;503;121;1713;714;382;999;114;96;1
315;7.14659e-15;247;1450;32135;14386.5;1;2564;1008;3455;523;122;1707;721;401;986;114;96;1
316;7.24574e-15;258;1450;32319;14502.5;1;2617;1041;3455;518;105;1722;736;413;986;115;96;1
317;7.33392e-15;234;1432;32604;14613.5;1;2604;1036;3456;550;115;1747;714;435;1033;115;98;1
318;7.41864e-15;252;1477;32834;14712.5;1;2618;1032;3457;531;126;1748;770;405;978;114;96;1
319;7.49447e-15;245;1501;33057;14822.5;1;2637;1050;3457;543;106;1679;783;437;896;115;98;1
320;7.57903e-15;251;1514;33296;14944.5;1;2659;1050;3458;548;116;1759;733;432;1026;113;97;1
321;7.67318e-15;249;1421;33526;15038.5;1;2681;1053;3458;540;132;1714;798;408;916;113;98;1
322;7.74599e-15;242;1521;33756;15149.5;1;2707;1016;3459;531;123;1724;700;408;1024;113;98;1
323;7.83226e-15;227;1523;34007;15254.5;1;2714;1053;3460;496;120;1734;689;376;1045;114;99;1
324;7.91417e-15;216;1525;34247;15354.5;1;2719;1033;3460;542;120;1693;766;422;927;114;99;1
325;7.99243e-15;263;1551;34521;15446.5;1;2707;1055;3461;504;136;1700;710;368;990;113;98;1
326;8.06467e-15;271;1481;34690;15544.5;1;2762;1017;3461;535;125;1726;808;410;918;114;97;1
327;8.14185e-15;259;1472;34887;15654.5;1;2789;1052;3462;520;121;1696;703;399;993;113;98;1
328;8.22878e-15;287;1487;35152;15740.5;1;2799;1033;3462;503;129;1779;715;374;1064;113;96;1
329;8.29696e-15;237;1436;35319;15851.5;1;2865;950;3363;539;130;1648;708;409;940;114;97;1
330;8.38523e-15;263;1421;35542;15964.5;1;2872;1014;3464;456;105;1703;732;351;971;112;97;1
331;8.47541e-15;244;1499;35780;16080.5;1;2878;995;3464;548;123;1731;740;425;991;113;97;1
332;8.56833e-15;245;1527;36046;16190.5;1;2875;1046;3465;560;99;1817;732;461;1085;112;97;1
333;8.65675e-15;280;1480;36325;16290.5;1;2860;1008;3465;523;127;1756;774;396;982;111;98;1
334;8.73739e-15;243;1477;36523;16376.5;1;2895;1049;3466;472;150;1740;746;322;994;112;98;2
335;8.80694e-15;238;1474;36742;16498.5;1;2919;989;3466;538;132;1670;775;406;895;112;98;2
336;8.90593e-15;241;1498;37015;16583.5;1;2903;1003;3467;514;101;1796;691;413;1105;112;98;2
337;8.97512e-15;232;1431;37276;16672.5;1;2903;984;3467;514;112;1732;784;402;948;111;97;2
338;9.04775e-15;251;1456;37545;16784.5;1;2882;977;3468;567;103;1757;698;464;1059;111;97;2
339;9.13943e-15;242;1485;37785;16901.5;1;2881;1032;3469;524;121;1667;738;403;929;110;98;2
340;9.23553e-15;235;1501;37980;17009.5;1;2918;1030;3469;518;135;1776;740;383;1036;110;97;2
341;9.32454e-15;251;1517;38157;17106.5;1;2964;1016;3470;521;128;1768;760;393;1008;110;97;2
342;9.40472e-15;253;1452;38379;17196.5;1;2978;988;3470;518;123;1694;766;395;928;110;96;2
343;9.47933e-15;255;1529;38606;17302.5;1;2984;1024;3471;476;118;1655;732;358;923;109;96;2
344;9.56745e-15;250;1531;38890;17404.5;1;2957;987;3471;531;144;1740;737;387;1003;109;97;2
345;9.6525e-15;258;1491;39089;17487.5;1;2986;1043;3472;496;124;1766;715;372;1051;109;98;2
346;9.72189e-15;270;1456;39274;17603.5;1;3016;1041;3472;530;148;1637;740;382;897;109;97;2
347;9.81916e-15;249;1491;39493;17685.5;1;3036;1040;3473;520;140;1734;730;380;1004;108;96;2
348;9.88811e-15;276;1484;39722;17787.5;1;3038;1022;3473;502;140;1752;772;362;980;108;96;2
349;9.9741e-15;249;1553;39878;17889.5;1;3099;1041;3474;534;151;1681;760;383;921;108;97;2
350;1.00603e-14;264;1498;40069;17985.5;1;3141;1021;3474;504;113;1711;762;391;949;108;97;2
351;1.01417e-14;235;1467;40282;18076.5;1;3155;985;3475;543;143;1760;751;400;1009;108;98;2
352;1.02191e-14;255;1475;40512;18169.5;1;3163;1019;3475;526;108;1714;744;418;970;108;96;2
353;1.02984e-14;221;1449;40732;18262.5;1;3181;1038;3476;494;126;1838;745;368;1093;108;97;2
354;1.03778e-14;249;1451;40913;18354.5;1;3219;1035;3476;546;127;1760;770;419;990;108;96;2
355;1.04566e-14;264;1471;41137;18446.5;1;3225;977;3477;513;134;1762;741;379;1021;108;96;2
356;1.05356e-14;248;1478;41351;18550.5;1;3240;982;3477;502;136;1793;731;366;1062;107;96;2
357;1.06252e-14;225;1519;41547;18652.5;1;3264;979;3478;495;102;1774;753;393;1021;108;96;2
358;1.07133e-14;232;1515;41803;18729.5;1;3260;1036;3479;473;123;1800;733;350;1067;107;96;2
359;1.07799e-14;269;1490;42014;18860.5;1;3275;1037;3479;506;118;1728;762;388;966;107;97;2
360;1.08936e-14;268;1502;42217;18963.5;1;3295;987;3480;504;132;1778;800;372;978;107;96;2
361;1.09833e-14;240;1515;42392;19050.5;1;3337;1043;3480;495;137;1733;764;358;969;107;97;2
362;1.10593e-14;263;1478;42571;19166.5;1;3374;983;3481;579;140;1700;769;439;931;107;96;2
363;1.11608e-14;252;1446;42799;19250.5;1;3375;985;3481;487;120;1730;777;367;953;106;95;2
364;1.12345e-14;246;1545;43037;19332.5;1;3378;1041;3482;471;109;1659;745;362;914;106;96;2
365;1.13067e-14;244;1465;43220;19434.5;1;3420;982;3482;550;130;1705;771;420;934;105;96;2
366;1.13966e-14;256;1466;43393;19515.5;1;3462;984;3482;495;121;1604;745;374;859;105;96;2
367;1.14682e-14;255;1450;43637;19601.5;1;3452;985;3483;468;112;1740;770;356;970;105;97;2
368;1.15443e-14;264;1513;43824;19705.5;1;3478;1023;3483;468;124;1715;726;344;989;105;96;2
369;1.16367e-14;267;1522;44020;19815.5;1;3507;925;3384;517;151;1768;737;366;1031;106;97;2
370;1.17346e-14;247;1436;44251;19898.5;1;3513;1027;3484;475;121;1722;767;354;955;104;97;2
371;1.18086e-14;271;1501;44427;19995.5;1;3539;1023;3485;521;117;1808;737;404;1071;104;97;2
372;1.18954e-14;254;1513;44641;20083.5;1;3570;983;3485;521;124;1738;716;397;1022;103;96;2
373;4.21471e-15;250;1034;16284;10142.7;1;3396;984;3486;447;86;1707;441;361;1266;103;95;2
374;4.27878e-15;261;1208;16922;10243.7;1;3197;901;3386;501;109;1774;563;392;1211;104;96;2
375;4.34317e-15;218;1275;17485;10349.7;1;3031;955;3487;423;113;1753;615;310;1138;103;94;2
376;4.4111e-15;230;1253;18128;10445.7;1;2828;897;3387;483;119;1746;653;364;1093;104;95;2
377;4.47292e-15;226;1333;18678;10545.7;1;2664;891;3488;462;103;1750;608;359;1142;103;96;2
378;4.53763e-15;214;1406;19217;10638.7;1;2511;850;3388;475;111;1776;678;364;1098;104;96;2
379;4.59809e-15;209;1369;19771;10737.7;1;2340;822;3389;453;98;1667;676;355;991;103;96;2
380;4.66274e-15;201;1414;20174;10837.7;1;2247;860;3489;435;107;1633;703;328;930;102;96;2
381;4.72834e-15;195;1405;20576;10940.7;1;2162;841;3490;440;95;1682;699;345;983;102;96;2
382;4.79624e-15;206;1508;20976;11048.7;1;2068;874;3490;432;92;1730;691;340;1039;101;96;2
383;4.86778e-15;202;1498;21342;11155.7;1;2010;788;3491;432;105;1731;747;327;984;101;95;2
384;4.93901e-15;201;1437;21740;11261.7;1;1914;810;3491;442;95;1830;773;347;1057;101;95;2
385;5.00991e-15;198;1513;22040;11364.7;1;1865;817;3491;433;104;1756;707;329;1049;101;94;2
386;5.07913e-15;216;1531;22331;11475.7;1;1826;842;3492;388;100;1776;735;288;1041;101;94;3
387;5.15408e-15;187;1492;22655;11559.7;1;1775;774;3492;398;89;1746;729;309;1017;102;94;3
388;5.21104e-15;166;1451;22978;11677.7;1;1712;798;3493;375;96;1817;731;279;1086;102;95;3
389;5.29142e-15;181;1490;23273;11786.7;1;1672;718;3393;414;81;1744;691;333;1053;103;95;3
390;5.36602e-15;179;1417;23512;11895.7;1;1658;716;3394;354;94;1805;718;260;1087;103;94;3
391;5.44098e-15;178;1493;23757;12002.7;1;1627;717;3394;347;87;1760;692;260;1068;103;94;3
392;5.5149e-15;176;1452;23986;12117.7;1;1611;764;3495;370;81;1721;743;289;978;101;95;3
393;5.59472e-15;206;1507;24231;12211.7;1;1584;819;3495;364;103;1711;729;261;982;101;95;3
394;5.66025e-15;189;1517;24450;12316.7;1;1583;821;3496;419;98;1780;793;321;987;100;95;3
395;5.73374e-15;198;1482;24661;12417.7;1;1585;713;3396;415;98;1681;737;317;944;101;94;3
396;5.80474e-15;175;1485;24888;12518.7;1;1570;756;3496;349;81;1727;748;268;979;100;95;3
397;5.87603e-15;172;1546;25124;12622.7;1;1550;809;3497;391;87;1787;717;304;1070;99;95;3
398;5.94973e-15;190;1523;25357;12743.7;1;1548;749;3497;426;80;1773;759;346;1014;99;95;3
399;6.03588e-15;175;1590;25597;12844.7;1;1528;804;3498;362;87;1665;742;275;923;98;94;3
400;6.1081e-15;215;1591;25878;12945.7;1;1475;703;3398;370;94;1815;743;276;1072;99;94;3
401;6.18061e-15;150;1529;26099;13058.7;1;1460;809;3499;329;92;1678;802;237;876;98;94;3
402;6.26207e-15;177;1582;26303;13166.7;1;1456;801;3499;425;83;1764;733;342;1031;98;94;3
403;6.34026e-15;176;1613;26459;13257.7;1;1476;665;3499;401;89;1724;782;312;942;98;94;3
404;6.4064e-15;157;1525;26634;13359.7;1;1473;696;3500;327;85;1777;764;242;1013;98;93;3
405;6.4808e-15;191;1486;26778;13458.7;1;1488;695;3500;362;65;1744;758;297;986;97;93;3
406;6.55329e-15;178;1607;26950;13577.7;1;1505;670;3501;305;91;1705;742;214;963;97;93;3
407;6.64078e-15;166;1587;27134;13686.7;1;1510;683;3501;347;84;1686;764;263;922;97;93;3
408;6.72125e-15;169;1573;27352;13788.7;1;1486;680;3502;318;97;1705;814;221;891;96;93;3
409;6.79686e-15;181;1621;27539;13888.7;1;1473;657;3502;357;82;1794;795;275;999;96;92;3
410;6.87125e-15;177;1610;27685;13991.7;1;1490;598;3502;320;87;1735;815;233;920;96;92;3
411;6.94816e-15;154;1580;27847;14074.7;1;1491;594;3503;298;81;1813;785;217;1028;95;93;3
412;7.01034e-15;130;1554;28019;14181.7;1;1483;568;3503;273;99;1785;804;174;981;95;92;3
413;7.09078e-15;142;1604;28212;14276.7;1;1456;576;3504;262;59;1762;756;203;1006;95;92;3
414;7.16245e-15;140;1601;28407;14378.7;1;1435;558;3504;298;89;1795;741;209;1054;95;91;3
415;7.23967e-15;151;1566;28574;14460.7;1;1418;523;3505;292;70;1767;793;222;974;95;91;3
416;7.30195e-15;127;1586;28748;14547.7;1;1394;545;3505;287;77;1804;811;210;993;94;90;3
417;7.36823e-15;125;1589;28908;14640.7;1;1385;529;3505;261;58;1825;799;203;1026;94;91;3
418;7.43929e-15;129;1698;29059;14721.7;1;1370;522;3506;289;62;1812;762;227;1050;93;90;3
419;7.50137e-15;139;1673;29236;14829.7;1;1344;498;3506;289;67;1700;814;222;886;93;90;3
420;7.58442e-15;131;1648;29390;14931.7;1;1326;528;3507;259;64;1676;817;195;859;93;90;3
421;7.66313e-15;145;1569;29475;15011.7;1;1354;524;3507;258;50;1705;815;208;890;93;90;3
422;7.72505e-15;132;1589;29641;15103.7;1;1338;531;3507;254;64;1753;750;190;1003;94;89;3
423;7.79647e-15;121;1584;29777;15186.7;1;1336;523;3508;249;75;1736;779;174;957;93;90;3
424;7.86109e-15;115;1573;29939;15275.7;1;1317;539;3508;289;46;1722;793;243;929;94;90;3
425;7.93058e-15;111;1661;30101;15381.7;1;1290;501;3509;268;59;1781;819;209;962;93;90;3
426;8.01361e-15;135;1652;30263;15478.7;1;1266;527;3509;279;67;1758;785;212;973;93;91;3
427;8.08984e-15;134;1682;30397;15569.7;1;1263;463;3509;307;52;1703;808;255;895;93;90;3
428;8.16158e-15;107;1614;30529;15656.7;1;1255;490;3510;251;60;1707;839;191;868;93;90;3
429;8.23036e-15;118;1602;30645;15756.7;1;1248;555;3510;248;70;1727;809;178;918;92;89;3
430;8.30966e-15;131;1622;30777;15851.7;1;1242;542;3511;289;67;1750;817;222;933;91;89;3
431;8.38523e-15;158;1628;30876;15941.7;1;1253;519;3511;237;73;1745;787;164;958;91;89;3
432;8.45703e-15;140;1670;30922;16027.7;1;1308;537;3511;260;58;1724;785;202;939;91;88;3
433;8.52583e-15;143;1618;31037;16111.7;1;1318;430;3412;264;60;1665;849;204;816;92;88;3
434;8.59321e-15;101;1608;31198;16199.7;1;1299;533;3512;198;65;1632;794;133;838;91;87;4
435;8.66399e-15;135;1604;31354;16297.7;1;1271;547;3513;257;75;1787;805;182;982;91;88;4
436;8.74304e-15;144;1612;31513;16382.7;1;1249;510;3513;263;61;1805;760;202;1045;90;87;4
437;8.8118e-15;135;1636;31597;16457.7;1;1270;516;3513;248;64;1746;812;184;934;91;87;4
438;8.87262e-15;136;1565;31732;16550.7;1;1266;520;3514;239;61;1795;816;178;979;90;87;4
439;8.94823e-15;155;1615;31817;16641.7;1;1284;503;3514;251;71;1828;753;180;1075;90;86;4
440;9.02243e-15;156;1554;31945;16733.7;1;1281;538;3514;242;77;1771;767;165;1004;90;86;4
441;9.09764e-15;128;1634;32065;16816.7;1;1290;499;3515;272;57;1705;755;215;950;89;85;4
442;9.16568e-15;120;1663;32184;16921.7;1;1284;534;3515;241;60;1736;805;181;931;90;85;4
443;9.25199e-15;126;1663;32247;17027.7;1;1309;522;3516;267;79;1771;814;188;957;90;85;4
444;9.3394e-15;130;1632;32377;17107.7;1;1306;541;3516;266;63;1787;815;203;972;90;85;4
445;9.40555e-15;132;1585;32453;17199.7;1;1335;540;3516;299;76;1743;846;223;897;90;85;4
446;9.48182e-15;135;1629;32575;17289.7;1;1333;531;3517;273;76;1725;847;197;878;89;84;4
447;9.55663e-15;127;1650;32682;17361.7;1;1340;523;3517;241;77;1763;763;164;1000;89;84;4
448;9.61661e-15;142;1620;32792;17451.7;1;1342;532;3517;277;78;1758;841;199;917;89;84;4
449;9.69177e-15;141;1644;32882;17535.7;1;1351;553;3518;245;65;1719;829;180;890;88;83;4
450;9.7621e-15;140;1647;32954;17622.7;1;1382;516;3518;258;70;1798;808;188;990;88;82;4
451;9.83512e-15;140;1693;33033;17707.7;1;1400;493;3519;260;61;1756;869;199;887;88;82;4
452;9.90663e-15;116;1629;33147;17798.7;1;1399;504;3519;235;57;1736;837;178;899;87;81;4
453;9.98339e-15;119;1637;33256;17865.7;1;1398;539;3519;237;75;1700;798;162;902;86;81;4
454;1.004e-14;148;1633;33377;17944.7;1;1387;548;3520;275;77;1779;810;198;969;86;81;4
455;1.01069e-14;152;1635;33488;18020.7;1;1397;539;3520;287;73;1839;792;214;1047;87;80;4
456;1.01715e-14;172;1601;33584;18079.7;1;1421;520;3520;250;63;1752;836;187;916;86;80;4
457;1.02216e-14;138;1660;33695;18159.7;1;1434;543;3521;237;82;1735;832;155;903;85;80;4
458;1.02898e-14;152;1642;33811;18240.7;1;1438;509;3521;309;64;1687;791;245;896;84;81;4
459;1.0359e-14;144;1646;33909;18324.7;1;1458;522;3521;250;68;1820;827;182;993;85;81;4
460;1.04309e-14;141;1676;34026;18401.7;1;1461;539;3522;274;66;1782;823;208;959;85;80;4
461;1.0497e-14;132;1661;34131;18474.7;1;1461;538;3522;280;80;1764;862;200;902;85;80;4
462;1.05597e-14;163;1610;34210;18541.7;1;1485;522;3523;259;61;1805;856;198;949;85;79;4
463;1.06174e-14;139;1616;34271;18624.7;1;1521;505;3523;251;73;1780;786;178;994;84;79;4
464;1.06891e-14;150;1614;34417;18717.7;1;1507;532;3523;243;77;1808;812;166;996;84;79;4
465;1.07695e-14;149;1587;34544;18799.7;1;1500;522;3524;264;83;1705;812;181;893;84;79;4
466;1.08406e-14;154;1589;34674;18892.7;1;1493;534;3524;233;82;1760;758;151;1002;83;79;4
467;1.09215e-14;145;1596;34767;18973.7;1;1509;551;3524;298;76;1774;831;222;943;83;78;4
468;1.09921e-14;156;1597;34853;19052.7;1;1533;548;3525;244;57;1688;798;187;890;83;78;4
469;1.1061e-14;168;1656;34941;19126.7;1;1550;498;3525;251;75;1718;837;176;881;83;78;4
470;1.11258e-14;133;1640;35054;19216.7;1;1551;519;3525;247;77;1754;844;170;910;82;78;4
471;1.12047e-14;160;1668;35192;19286.7;1;1530;499;3526;241;69;1757;792;172;965;83;78;4
472;1.12662e-14;152;1668;35289;19387.7;1;1541;535;3526;249;89;1774;818;160;956;83;78;4
473;1.13551e-14;154;1722;35407;19472.7;1;1539;507;3526;267;61;1758;859;206;899;83;78;4
474;1.14301e-14;145;1699;35477;19540.7;1;1570;525;3527;289;71;1795;824;218;971;83;77;4
475;1.14903e-14;154;1641;35571;19614.7;1;1588;543;3527;261;67;1772;865;194;907;83;77;4
476;1.15559e-14;175;1646;35636;19689.7;1;1616;542;3527;290;73;1667;808;217;859;83;77;4
477;1.16224e-14;143;1589;35741;19769.7;1;1632;526;3528;258;81;1790;820;177;970;82;77;4
478;1.16936e-14;154;1611;35883;19846.7;1;1617;555;3528;298;79;1716;789;219;927;82;76;4
479;1.17622e-14;136;1638;35998;19927.7;1;1628;535;3528;275;80;1770;823;195;947;81;76;4
480;1.18346e-14;132;1648;36108;20005.7;1;1634;531;3529;277;63;1731;808;214;923;81;76;4
481;4.19005e-15;134;1268;13013;10057.9;1;1552;542;3529;269;37;1769;481;232;1288;80;76;4
482;4.22483e-15;150;1406;13376;10136.9;1;1426;473;3529;245;71;1872;679;174;1193;80;75;4
483;4.27496e-15;130;1374;13728;10218.9;1;1301;516;3530;207;57;1768;718;150;1050;80;75;4
484;4.3272e-15;149;1451;14055;10298.9;1;1189;471;3530;239;68;1752;722;171;1030;80;75;5
485;4.37837e-15;122;1474;14359;10381.9;1;1088;479;3530;231;68;1744;780;163;964;79;74;5
486;4.43168e-15;141;1533;14623;10462.9;1;1002;499;3531;245;48;1788;762;197;1026;80;73;5
487;4.4839e-15;117;1540;14810;10536.9;1;967;439;3531;257;75;1731;778;182;953;80;73;5
488;4.53179e-15;134;1599;15037;10622.9;1;910;473;3531;195;54;1708;821;141;887;80;74;5
489;4.58767e-15;131;1662;15208;10708.9;1;879;407;3532;242;79;1752;842;163;910;79;73;5
490;4.64377e-15;110;1620;15364;10803.9;1;860;448;3532;218;63;1767;827;155;940;79;73;5
491;4.706e-15;109;1637;15575;10886.9;1;798;472;3532;197;63;1790;778;134;1012;79;72;5
492;4.7606e-15;132;1613;15693;10957.9;1;798;429;3533;239;60;1739;803;179;936;79;72;5
493;4.80748e-15;120;1614;15853;11047.9;1;768;451;3533;192;67;1743;792;125;951;78;72;5
494;4.86712e-15;158;1679;15987;11137.9;1;752;439;3533;234;53;1664;819;181;845;78;71;5
495;4.927e-15;126;1685;16161;11216.9;1;722;442;3534;229;70;1790;856;159;934;78;71;5
496;4.97977e-15;124;1633;16295;11288.9;1;711;430;3534;262;62;1773;868;200;905;78;71;5
497;5.02802e-15;112;1578;16431;11381.9;1;691;429;3534;208;72;1798;807;136;991;78;71;5
498;5.09058e-15;119;1587;16544;11468.9;1;672;433;3535;186;65;1827;804;121;1023;78;70;5
499;5.14934e-15;118;1678;16670;11552.9;1;653;439;3535;216;62;1780;802;154;978;78;70;5
500;5.20629e-15;122;1719;16763;11619.9;1;652;429;3535;223;51;1782;823;172;959;78;69;5
501;5.25186e-15;100;1707;16878;11705.9;1;646;444;3536;236;57;1681;857;179;824;77;68;5
502;5.31055e-15;121;1728;16996;11775.9;1;631;414;3536;222;51;1740;824;171;916;77;68;5
503;5.35848e-15;125;1644;17127;11854.9;1;616;443;3536;208;57;1767;782;151;985;77;69;5
504;5.41275e-15;117;1640;17219;11917.9;1;618;433;3537;252;61;1760;813;191;947;77;68;5
505;5.45615e-15;127;1706;17324;12000.9;1;618;464;3537;222;55;1796;820;167;976;77;69;5
506;5.51352e-15;118;1667;17387;12070.9;1;642;429;3537;219;60;1883;829;159;1054;77;68;5
507;5.56205e-15;144;1696;17496;12155.9;1;633;467;3537;207;65;1809;821;142;988;77;68;5
508;5.62118e-15;145;1725;17601;12235.9;1;624;403;3538;231;53;1760;841;178;919;76;68;5
509;5.67702e-15;123;1695;17706;12302.9;1;620;423;3538;191;67;1816;828;124;988;75;68;5
510;5.72392e-15;120;1625;17803;12385.9;1;615;396;3538;222;52;1676;878;170;798;74;67;5
511;5.78221e-15;102;1701;17876;12455.9;1;635;407;3539;202;47;1783;792;155;991;74;67;5
512;5.83152e-15;110;1652;17987;12527.9;1;618;414;3539;216;51;1713;861;165;852;74;68;5
513;5.88239e-15;135;1687;18064;12601.9;1;618;430;3539;209;48;1829;789;161;1040;74;68;5
514;5.93483e-15;157;1683;18142;12683.9;1;627;383;3540;221;73;1698;859;148;839;74;69;5
515;5.99311e-15;112;1628;18205;12757.9;1;648;410;3540;202;54;1736;869;148;867;74;69;5
516;6.04587e-15;118;1719;18272;12830.9;1;664;348;3540;193;68;1741;845;125;896;73;69;5
517;6.09807e-15;95;1673;18377;12906.9;1;650;357;3541;160;48;1815;858;112;957;73;70;5
518;6.15258e-15;110;1677;18462;12977.9;1;644;360;3541;183;62;1730;824;121;906;73;70;5
519;6.20364e-15;111;1665;18572;13039.9;1;632;329;3541;174;49;1790;842;125;948;73;70;5
520;6.24835e-15;104;1668;18647;13113.9;1;626;340;3541;140;53;1728;859;87;869;73;70;5
521;6.30185e-15;100;1683;18717;13185.9;1;637;340;3542;172;49;1749;820;123;929;73;69;5
522;6.35405e-15;116;1740;18838;13275.9;1;610;359;3542;169;48;1772;841;121;931;73;69;5
523;6.41951e-15;114;1700;18926;13350.9;1;604;382;3542;175;52;1754;833;123;921;73;68;5
524;6.47422e-15;111;1680;18976;13437.9;1;627;376;3543;168;45;1759;834;123;925;73;68;5
525;6.53789e-15;98;1689;19091;13509.9;1;606;343;3543;200;40;1775;829;160;946;73;69;5
526;6.59074e-15;94;1664;19197;13568.9;1;587;378;3543;183;48;1831;812;135;1019;72;69;5
527;6.63415e-15;110;1646;19276;13642.9;1;588;341;3544;184;54;1733;804;130;929;72;68;5
528;6.68873e-15;88;1655;19368;13704.9;1;581;358;3544;195;50;1781;800;145;981;72;68;5
529;6.73457e-15;94;1703;19440;13769.9;1;582;382;3544;156;50;1723;855;106;868;72;69;5
530;6.78275e-15;103;1717;19520;13853.9;1;579;376;3544;180;49;1782;855;131;927;72;67;5
531;6.84518e-15;120;1653;19627;13931.9;1;566;374;3545;175;46;1826;837;129;989;70;67;5
532;6.90332e-15;107;1696;19670;14008.9;1;585;363;3545;158;65;1752;848;93;904;71;66;5
533;6.96088e-15;93;1741;19728;14075.9;1;595;302;3545;183;64;1752;812;119;940;70;67;5
534;7.01109e-15;76;1733;19802;14153.9;1;590;320;3546;139;36;1844;849;103;995;70;67;5
535;7.0697e-15;90;1730;19863;14223.9;1;591;302;3546;176;50;1758;899;126;859;70;66;5
536;7.12243e-15;90;1766;19962;14282.9;1;570;275;3546;149;46;1795;829;103;966;70;67;5
537;7.16699e-15;88;1823;20029;14339.9;1;573;349;3546;114;54;1783;879;60;904;69;67;5
538;7.21011e-15;106;1722;20111;14417.9;1;572;281;3547;181;41;1773;851;140;922;69;68;6
539;7.26927e-15;83;1690;20186;14487.9;1;565;347;3547;146;50;1782;862;96;920;69;69;6
540;7.3225e-15;97;1671;20230;14563.9;1;575;345;3547;176;55;1829;869;121;960;69;68;6
541;7.38044e-15;106;1770;20286;14624.9;1;579;344;3548;151;51;1839;820;100;1019;69;68;6
542;7.42705e-15;104;1737;20351;14692.9;1;590;332;3548;166;40;1708;907;126;801;70;68;6
543;7.47913e-15;103;1759;20408;14778.9;1;596;314;3548;192;46;1836;829;146;1007;69;68;6
544;7.54517e-15;89;1682;20474;14853.9;1;594;337;3548;159;45;1790;927;114;863;69;69;6
545;7.60291e-15;103;1685;20576;14917.9;1;570;343;3549;165;50;1741;850;115;891;69;69;6
546;7.65231e-15;108;1752;20629;14970.9;1;580;306;3549;185;48;1786;830;137;956;68;68;6
547;7.6933e-15;94;1706;20698;15039.9;1;578;282;3549;156;49;1778;871;107;907;68;68;6
548;7.74677e-15;84;1685;20783;15097.9;1;565;254;3550;123;59;1773;866;64;907;69;67;6
549;7.79181e-15;65;1648;20830;15165.9;1;568;283;3550;129;45;1856;830;84;1026;68;68;6
550;7.84473e-15;96;1663;20906;15242.9;1;556;316;3550;157;35;1719;822;122;897;68;68;6
551;7.90479e-15;80;1717;20947;15301.9;1;568;272;3550;142;50;1778;817;92;961;68;67;6
552;7.95092e-15;93;1739;20991;15369.9;1;572;314;3551;143;30;1766;860;113;906;67;66;6
553;8.0042e-15;89;1670;21048;15432.9;1;573;294;3551;141;38;1799;837;103;962;67;66;6
554;8.05366e-15;97;1714;21122;15504.9;1;564;296;3551;139;43;1812;836;96;976;67;66;6
555;8.11032e-15;86;1761;21198;15559.9;1;558;318;3551;151;47;1812;815;104;997;67;66;6
556;8.15369e-15;107;1816;21253;15630.9;1;561;323;3552;153;47;1857;914;106;943;67;66;6
557;8.20979e-15;97;1692;21320;15693.9;1;558;317;3552;157;53;1767;851;104;916;67;65;6
558;8.25967e-15;87;1711;21381;15750.9;1;553;298;3552;159;52;1831;851;107;980;66;64;6
559;8.3049e-15;102;1693;21415;15814.9;1;564;270;3553;131;46;1762;851;85;911;66;65;6
560;8.35577e-15;85;1711;21463;15875.9;1;569;311;3553;132;45;1743;836;87;907;66;64;6
561;8.40436e-15;108;1734;21534;15937.9;1;558;2.14749e+08;-2.14748e+09;152;39;1805;838;113;967;66;64;6
562;8.45383e-15;108;1732;21534;15937.9;1;558;3.13773e+08;-2.06399e+09;0;0;-1;0;0;-1;65;63;6
563;8.45383e-15;108;1730;21534;15937.9;1;558;6.19576e+08;-1.98428e+09;0;0;-1;0;0;-1;65;63;6
564;8.45383e-15;108;1729;21534;15937.9;1;558;8.10393e+08;-1.90817e+09;0;0;-1;0;0;-1;416;414;6
565;8.45383e-15;108;1729;21534;15937.9;1;558;9.93942e+08;-1.83548e+09;0;0;-1;0;0;-1;1764;1761;6
566;8.45383e-15;108;1729;21534;15937.9;1;558;9.55798e+08;-1.76604e+09;0;0;-1;0;0;-1;5004;5001;6
567;8.45383e-15;109;1728;21534;15937.9;1;558;1.34052e+09;-1.69969e+09;0;0;-1;0;0;-1;11232;11230;6
568;8.45383e-15;111;1727;21534;15937.9;1;558;1.28939e+09;-1.63627e+09;1;0;-1;0;1;-1;21712;21710;6
569;8.45383e-15;112;1727;21534;15937.9;1;558;1.55433e+09;-1.57565e+09;0;0;-1;0;0;-1;37837;37834;6
570;8.45383e-15;114;1726;21534;15937.9;1;558;1.7061e+09;-1.51768e+09;1;0;-1;0;1;-1;61099;61096;6
571;8.45383e-15;115;1725;21534;15937.9;1;558;1.9597e+09;-1.46224e+09;1;0;-1;0;1;-1;93064;93061;6
572;8.45383e-15;117;1724;21534;15937.9;1;558;1.88587e+09;-1.40921e+09;0;0;-1;0;0;-1;135348;135345;6
573;8.45383e-15;118;1724;21534;15937.9;1;558;2.02172e+09;-1.35846e+09;1;0;-1;0;1;-1;189593;189590;6
574;8.45383e-15;118;1724;21534;15937.9;1;558;-2.14748e+09;-1.30989e+09;0;0;-1;0;0;-1;257453;257450;6
575;8.45383e-15;117;1724;21534;15937.9;1;558;-2.14748e+09;-1.2634e+09;0;0;-1;0;0;-1;340574;340572;6
576;8.45383e-15;117;1724;21534;15937.9;1;558;-2.14748e+09;-1.21888e+09;0;0;-1;0;0;-1;440587;440584;6
577;8.45383e-15;114;1724;21534;15937.9;1;558;-2.14748e+09;-1.17625e+09;-1;0;0;0;-1;0;559086;559083;6
578;8.45383e-15;114;1724;21534;15937.9;1;558;-2.14748e+09;-1.13541e+09;0;0;-1;0;0;-1;697627;697624;6
579;8.45383e-15;114;1723;21534;15937.9;1;558;-2.14748e+09;-1.09627e+09;0;0;-1;0;0;-1;857717;857715;6
580;8.45383e-15;113;1723;21534;15937.9;1;558;-2.14748e+09;-1.05877e+09;-1;0;0;0;-1;0;1040806;1040803;6
581;8.45383e-15;112;1723;21534;15937.9;1;558;-2.14748e+09;-1.02281e+09;0;0;-1;0;0;-1;1248279;1248276;6
582;8.45383e-15;111;1723;21534;15937.9;1;558;-2.14748e+09;-9.88342e+08;0;0;-1;0;0;-1;1481457;1481455;6
583;8.45383e-15;111;1723;21534;15937.9;1;558;-2.14748e+09;-9.5528e+08;-1;0;0;0;-1;0;1741590;1741587;6
584;8.45383e-15;111;1723;21534;15937.9;1;558;-2.14748e+09;-9.23566e+08;-1;0;0;0;-1;0;2029853;2029850;6
585;8.45383e-15;111;1723;21534;15937.9;1;558;-2.14748e+09;-8.93136e+08;-1;0;0;0;-1;0;2347347;2347344;6
586;8.45383e-15;111;1721;21534;15937.9;1;558;-2.14748e+09;-8.63933e+08;0;0;-1;0;0;-1;2695095;2695092;6
587;8.45383e-15;111;1721;21534;15937.9;1;558;-2.14748e+09;-8.359e+08;0;0;-1;0;0;-1;3074045;3074042;6
588;8.45383e-15;111;1721;21534;15937.9;1;558;-2.14748e+09;-8.08984e+08;-1;0;0;0;-1;0;3485064;3485062;6
589;8.45383e-15;111;1721;21534;15937.9;1;558;-2.14748e+09;-7.83135e+08;0;0;-1;0;0;-1;3928947;3928944;6
590;8.45383e-15;111;1720;21534;15937.9;1;558;-2.14748e+09;-7.58305e+08;-1;0;0;0;-1;0;4406407;4406404;6
591;8.45383e-15;111;1720;21534;15937.9;1;558;-2.14748e+09;-7.34449e+08;0;0;-1;0;0;-1;4918086;4918083;6
592;8.45383e-15;110;1720;21534;15937.9;1;558;-2.14748e+09;-7.11523e+08;-1;0;0;0;-1;0;5464550;5464547;7
593;8.45383e-15;105;1720;21534;15937.9;1;558;-2.14748e+09;-6.89486e+08;-1;0;0;0;-1;0;6046293;6046291;7
594;8.45383e-15;105;1719;21534;15937.9;1;558;-2.14748e+09;-6.68298e+08;0;0;-1;0;0;-1;6663741;6663738;7
595;8.45383e-15;104;1719;21534;15937.9;1;558;-2.14748e+09;-6.47923e+08;-1;0;0;0;-1;0;7317248;7317245;7
596;8.45383e-15;104;1719;21534;15937.9;1;558;-2.14748e+09;-6.28325e+08;-1;0;0;0;-1;0;8007105;8007102;7
597;8.45383e-15;104;1719;21534;15937.9;1;558;-2.14748e+09;-6.0947e+08;-1;0;0;0;-1;0;8733537;8733534;7
598;8.45383e-15;104;1719;21534;15937.9;1;558;-2.14748e+09;-5.91326e+08;-1;0;0;0;-1;0;9496710;9496707;8
599;8.45383e-15;103;1719;21534;15937.9;1;558;-2.14748e+09;-5.73862e+08;0;0;-1;0;0;-1;10296729;10296727;8
600;8.45383e-15;103;1719;21534;15937.9;1;558;-2.14748e+09;-5.57049e+08;-1;0;0;0;-1;0;11133645;11133642;9
601;8.45383e-15;103;1719;21534;15937.9;1;558;-2.14748e+09;-5.40859e+08;-1;0;0;0;-1;0;12007452;12007450;9
602;8.45383e-15;102;1719;21534;15937.9;1;558;-2.14748e+09;-5.25265e+08;-1;0;0;0;-1;0;12918097;12918094;10
603;8.45383e-15;102;1719;21534;15937.9;1;558;-2.14748e+09;-5.10244e+08;-1;0;0;0;-1;0;13865473;13865471;11
604;8.45383e-15;102;1719;21534;15937.9;1;558;-2.14748e+09;-4.95769e+08;0;0;-1;0;0;-1;14849432;14849430;12
605;8.45383e-15;102;1719;21534;15937.9;1;558;-2.14748e+09;-4.81819e+08;0;0;-1;0;0;-1;15869779;15869777;13
606;8.45383e-15;100;1717;21534;15937.9;1;558;-2.14748e+09;-4.68371e+08;-1;0;0;0;-1;0;16926279;16926277;15
607;8.45383e-15;100;1717;21534;15937.9;1;558;-2.14748e+09;-4.55404e+08;-1;0;0;0;-1;0;18018659;18018657;17
608;8.45383e-15;95;1717;21534;15937.9;1;558;-2.14748e+09;-4.429e+08;-1;0;0;0;-1;0;19146609;19146607;19
609;8.45383e-15;95;1717;21534;15937.9;1;558;-2.14748e+09;-4.30837e+08;0;0;-1;0;0;-1;20309783;20309782;22
610;8.45383e-15;93;1716;21534;15937.9;1;558;-2.14748e+09;-4.192e+08;-1;0;0;0;-1;0;21507808;21507806;25
611;8.45383e-15;92;1715;21534;15937.9;1;558;-2.14748e+09;-4.07969e+08;-1;0;0;0;-1;0;22740277;22740275;29
612;8.45383e-15;91;1715;21534;15937.9;1;558;-2.14748e+09;-3.97129e+08;-1;0;0;0;-1;0;24006757;24006756;33
613;8.45383e-15;91;1715;21534;15937.9;1;558;-2.14748e+09;-3.86664e+08;0;0;-1;0;0;-1;25306792;25306791;39
614;8.45383e-15;91;1715;21534;15937.9;1;558;-2.14748e+09;-3.76558e+08;0;0;-1;0;0;-1;26639899;26639898;45
615;8.45383e-15;86;1715;21534;15937.9;1;558;-2.14748e+09;-3.66798e+08;-1;0;0;0;-1;0;28005576;28005576;52
616;8.45383e-15;86;1715;21534;15937.9;1;558;-2.14748e+09;-3.57369e+08;0;0;-1;0;0;-1;29403302;29403302;60
617;8.45383e-15;86;1715;21534;15937.9;1;558;-2.14748e+09;-3.48258e+08;-1;0;0;0;-1;0;30832536;30832537;69
618;8.45383e-15;85;1715;21534;15937.9;1;558;-2.14748e+09;-3.39454e+08;-1;0;0;0;-1;0;32292724;32292725;79
619;8.45383e-15;85;1715;21534;15937.9;1;558;-2.14748e+09;-3.30943e+08;-1;0;0;0;-1;0;33783295;33783296;91
620;8.45383e-15;84;1715;21534;15937.9;1;558;-2.14748e+09;-3.22714e+08;-1;0;0;0;-1;0;35303666;35303669;105
621;8.45383e-15;84;1714;21534;15937.9;1;558;-2.14748e+09;-3.14757e+08;-1;0;0;0;-1;0;36853245;36853247;121
622;8.45383e-15;83;1713;21534;15937.9;1;558;-2.14748e+09;-3.07061e+08;-1;0;0;0;-1;0;38431426;38431429;138
623;8.45383e-15;83;1713;21534;15937.9;1;558;-2.14748e+09;-2.99615e+08;-1;0;0;0;-1;0;40037598;40037603;158
624;8.45383e-15;83;1713;21534;15937.9;1;558;-2.14748e+09;-2.92411e+08;0;0;-1;0;0;-1;41671142;41671148;180
625;8.45383e-15;83;1713;21534;15937.9;1;558;-2.14748e+09;-2.85438e+08;-1;0;0;0;-1;0;43331432;43331439;205
626;8.45383e-15;83;1713;21534;15937.9;1;558;-2.14748e+09;-2.78689e+08;-1;0;0;0;-1;0;45017839;45017848;233
627;8.45383e-15;83;1713;21534;15937.9;1;558;-2.14748e+09;-2.72154e+08;-1;0;0;0;-1;0;46729729;46729739;264
628;8.45383e-15;81;1713;21534;15937.9;1;558;-2.14748e+09;-2.65826e+08;-1;0;0;0;-1;0;48466466;48466476;299
629;8.45383e-15;81;1713;21534;15937.9;1;558;-2.14748e+09;-2.59696e+08;-1;0;0;0;-1;0;50227410;50227423;338
630;8.45383e-15;80;1713;21534;15937.9;1;558;-2.14748e+09;-2.53759e+08;-1;0;0;0;-1;0;52011925;52011940;381
631;8.45383e-15;80;1713;21534;15937.9;1;558;-2.14748e+09;-2.48005e+08;-1;0;0;0;-1;0;53819371;53819388;429
632;8.45383e-15;80;1713;21534;15937.9;1;558;-2.14748e+09;-2.42429e+08;-1;0;0;0;-1;0;55649111;55649131;481
633;8.45383e-15;80;1713;21534;15937.9;1;558;-2.14748e+09;-2.37024e+08;-1;0;0;0;-1;0;57500510;57500531;539
634;8.45383e-15;78;1713;21534;15937.9;1;558;-2.14748e+09;-2.31784e+08;-1;0;0;0;-1;0;59372932;59372957;603
635;8.45383e-15;77;1713;21534;15937.9;1;558;-2.14748e+09;-2.26703e+08;-1;0;0;0;-1;0;61265750;61265777;674
636;8.45383e-15;75;1713;21534;15937.9;1;558;-2.14748e+09;-2.21775e+08;-1;0;0;0;-1;0;63178335;63178365;751
637;8.45383e-15;75;1713;21534;15937.9;1;558;-2.14748e+09;-2.16994e+08;-1;0;0;0;-1;0;65110065;65110100;835
638;8.45383e-15;75;1713;21534;15937.9;1;558;-2.14748e+09;-2.12356e+08;-1;0;0;0;-1;0;67060324;67060363;927
639;8.45383e-15;75;1713;21534;15937.9;1;558;-2.14748e+09;-2.07855e+08;-1;0;0;0;-1;0;69028499;69028543;1028
640;8.45383e-15;74;1713;21534;15937.9;1;558;-2.14748e+09;-2.03486e+08;-1;0;0;0;-1;0;71013983;71014033;1137
641;8.45383e-15;74;1713;21534;15937.9;1;558;-2.14748e+09;-1.99245e+08;-1;0;0;0;-1;0;73016177;73016233;1257
642;8.45383e-15;74;1713;21534;15937.9;1;558;-2.14748e+09;-1.95127e+08;-1;0;0;0;-1;0;75034487;75034549;1386
643;8.45383e-15;74;1713;21534;15937.9;1;558;-2.14748e+09;-1.91128e+08;0;0;-1;0;0;-1;77068327;77068396;1527
644;8.45383e-15;73;1713;21534;15937.9;1;558;-2.14748e+09;-1.87243e+08;-1;0;0;0;-1;0;79117118;79117193;1680
645;8.45383e-15;73;1712;21534;15937.9;1;558;-2.14748e+09;-1.83469e+08;-1;0;0;0;-1;0;81180287;81180369;1844
646;8.45383e-15;73;1712;21534;15937.9;1;558;-2.14748e+09;-1.79803e+08;-1;0;0;0;-1;0;83257270;83257361;2022
647;8.45383e-15;73;1712;21534;15937.9;1;558;-2.14748e+09;-1.76239e+08;-1;0;0;0;-1;0;85347512;85347613;2215
648;8.45383e-15;73;1712;21534;15937.9;1;558;-2.14748e+09;-1.72776e+08;0;0;-1;0;0;-1;87450466;87450575;2422
649;8.45383e-15;70;1712;21534;15937.9;1;558;-2.14748e+09;-1.69408e+08;-1;0;0;0;-1;0;89565591;89565711;2644
650;8.45383e-15;70;1712;21534;15937.9;1;558;-2.14748e+09;-1.66134e+08;-1;0;0;0;-1;0;91692358;91692490;2884
651;8.45383e-15;70;1712;21534;15937.9;1;558;-2.14748e+09;-1.6295e+08;-1;0;0;0;-1;0;93830245;93830389;3141
652;8.45383e-15;70;1712;21534;15937.9;1;558;-2.14748e+09;-1.59852e+08;-1;0;0;0;-1;0;95978738;95978895;3417
653;8.45383e-15;66;1712;21534;15937.9;1;558;-2.14748e+09;-1.56839e+08;-1;0;0;0;-1;0;98137335;98137506;3712
654;8.45383e-15;65;1712;21534;15937.9;1;558;-2.14748e+09;-1.53907e+08;-1;0;0;0;-1;0;100305538;100305725;4028
655;8.45383e-15;65;1712;21534;15937.9;1;558;-2.14748e+09;-1.51054e+08;-1;0;0;0;-1;0;102482865;102483067;4366
656;8.45383e-15;63;1712;21534;15937.9;1;558;-2.14748e+09;-1.48277e+08;-1;0;0;0;-1;0;104668836;104669056;4726
657;8.45383e-15;63;1712;21534;15937.9;1;558;-2.14748e+09;-1.45573e+08;-1;0;0;0;-1;0;106862986;106863224;5111
658;8.45383e-15;61;1712;21534;15937.9;1;558;-2.14748e+09;-1.42941e+08;-1;0;0;0;-1;0;109064855;109065113;5521
659;8.45383e-15;60;1712;21534;15937.9;1;558;-2.14748e+09;-1.40378e+08;-1;0;0;0;-1;0;111273995;111274274;5957
660;8.45383e-15;58;1712;21534;15937.9;1;558;-2.14748e+09;-1.37881e+08;-1;0;0;0;-1;0;113489966;113490268;6421
661;8.45383e-15;58;1712;21534;15937.9;1;558;-2.14748e+09;-1.35448e+08;-1;0;0;0;-1;0;115712338;115712664;6914
662;8.45383e-15;57;1712;21534;15937.9;1;558;-2.14748e+09;-1.33079e+08;-1;0;0;0;-1;0;117940689;117941040;7438
663;8.45383e-15;54;1712;21534;15937.9;1;558;-2.14748e+09;-1.30769e+08;-1;0;0;0;-1;0;120174606;120174985;7993
664;8.45383e-15;54;1712;21534;15937.9;1;558;-2.14748e+09;-1.28518e+08;-1;0;0;0;-1;0;122413688;122414096;8581
665;8.45383e-15;54;1712;21534;15937.9;1;558;-2.14748e+09;-1.26325e+08;-1;0;0;0;-1;0;124657539;124657977;9204
666;8.45383e-15;54;1712;21534;15937.9;1;558;-2.14748e+09;-1.24186e+08;-1;0;0;0;-1;0;126905774;126906246;9862
667;8.45383e-15;54;1712;21534;15937.9;1;558;-2.14748e+09;-1.221e+08;-1;0;0;0;-1;0;129158017;129158524;10559
668;8.45383e-15;54;1712;21534;15937.9;1;558;-2.14748e+09;-1.20066e+08;-1;0;0;0;-1;0;131413902;131414446;11294
669;8.45383e-15;53;1712;21534;15937.9;1;558;-2.14748e+09;-1.18082e+08;-1;0;0;0;-1;0;133673070;133673651;12070
670;8.45383e-15;53;1712;21534;15937.9;1;558;-2.14748e+09;-1.16147e+08;-1;0;0;0;-1;0;135935168;135935792;12889
671;8.45383e-15;53;1712;21534;15937.9;1;558;-2.14748e+09;-1.14258e+08;-1;0;0;0;-1;0;138199859;138200525;13751
672;8.45383e-15;53;1712;21534;15937.9;1;558;-2.14748e+09;-1.12415e+08;-1;0;0;0;-1;0;140466807;140467519;14659
673;8.45383e-15;53;1712;21534;15937.9;1;558;-2.14748e+09;-1.10617e+08;-1;0;0;0;-1;0;142735689;142736449;15614
674;8.45383e-15;52;1712;21534;15937.9;1;558;-2.14748e+09;-1.08861e+08;-1;0;0;0;-1;0;145006187;145006998;16619
675;8.45383e-15;52;1712;21534;15937.9;1;558;-2.14748e+09;-1.07148e+08;-1;0;0;0;-1;0;147277994;147278859;17674
676;8.45383e-15;50;1712;21534;15937.9;1;558;-2.14748e+09;-1.05474e+08;0;0;-1;0;0;-1;149550810;149551731;18782
677;8.45383e-15;50;1712;21534;15937.9;1;558;-2.14748e+09;-1.0384e+08;-1;0;0;0;-1;0;151824342;151825322;19944
678;8.45383e-15;50;1712;21534;15937.9;1;558;-2.14748e+09;-1.02244e+08;-1;0;0;0;-1;0;154098305;154099348;21163
679;8.45383e-15;50;1712;21534;15937.9;1;558;-2.14748e+09;-1.00684e+08;-1;0;0;0;-1;0;156372424;156373533;22441
680;8.45383e-15;50;1712;21534;15937.9;1;558;-2.14748e+09;-9.9161e+07;-1;0;0;0;-1;0;158646429;158647607;23779
681;8.45383e-15;50;1712;21534;15937.9;1;558;-2.14748e+09;-9.76725e+07;-1;0;0;0;-1;0;160920057;160921308;25179
682;8.45383e-15;50;1712;21534;15937.9;1;558;-2.14748e+09;-9.62178e+07;-1;0;0;0;-1;0;163193056;163194382;26643
683;8.45383e-15;43;1712;21534;15937.9;1;558;-2.14748e+09;-9.4796e+07;-1;0;0;0;-1;0;165465176;165466582;28174
684;8.45383e-15;43;1712;21534;15937.9;1;558;-2.14748e+09;-9.34062e+07;-1;0;0;0;-1;0;167736178;167737668;29773
685;8.45383e-15;42;1712;21534;15937.9;1;558;-2.14748e+09;-9.20473e+07;-1;0;0;0;-1;0;170005829;170007407;31443
686;8.45383e-15;42;1712;21534;15937.9;1;558;-2.14748e+09;-9.07186e+07;-1;0;0;0;-1;0;172273901;172275571;33185
687;8.45383e-15;42;1712;21534;15937.9;1;558;-2.14748e+09;-8.94192e+07;-1;0;0;0;-1;0;174540177;174541942;35002
688;8.45383e-15;41;1712;21534;15937.9;1;558;-2.14748e+09;-8.81483e+07;-1;0;0;0;-1;0;176804441;176806306;36896
689;8.45383e-15;41;1712;21534;15937.9;1;558;-2.14748e+09;-8.69051e+07;-1;0;0;0;-1;0;179066487;179068456;38870
690;8.45383e-15;41;1712;21534;15937.9;1;558;-2.14748e+09;-8.56888e+07;-1;0;0;0;-1;0;181326114;181328193;40924
691;8.45383e-15;41;1712;21534;15937.9;1;558;-2.14748e+09;-8.44987e+07;-1;0;0;0;-1;0;183583128;183585322;43063
692;8.45383e-15;41;1712;21534;15937.9;1;558;-2.14748e+09;-8.33341e+07;-1;0;0;0;-1;0;185837342;185839654;45287
693;8.45383e-15;41;1712;21534;15937.9;1;558;-2.14748e+09;-8.21942e+07;-1;0;0;0;-1;0;188088571;188091008;47600
694;8.45383e-15;40;1712;21534;15937.9;1;558;-2.14748e+09;-8.10785e+07;0;0;-1;0;0;-1;190336640;190339206;50003
695;8.45383e-15;40;1712;21534;15937.9;1;558;-2.14748e+09;-7.99862e+07;-1;0;0;0;-1;0;192581378;192584079;52499
696;8.45383e-15;40;1712;21534;15937.9;1;558;-2.14748e+09;-7.89167e+07;-1;0;0;0;-1;0;194822618;194825460;55091
697;8.45383e-15;36;1712;21534;15937.9;1;558;-2.14748e+09;-7.78694e+07;-1;0;0;0;-1;0;197060202;197063191;57780
698;8.45383e-15;36;1712;21534;15937.9;1;558;-2.14748e+09;-7.68437e+07;-1;0;0;0;-1;0;199293975;199297116;60569
699;8.45383e-15;36;1712;21534;15937.9;1;558;-2.14748e+09;-7.58391e+07;-1;0;0;0;-1;0;201523786;201527085;63461
700;8.45383e-15;35;1712;21534;15937.9;1;558;-2.14748e+09;-7.4855e+07;-1;0;0;0;-1;0;203749491;203752956;66458
701;8.45383e-15;35;1712;21534;15937.9;1;558;-2.14748e+09;-7.38908e+07;-1;0;0;0;-1;0;205970953;205974588;69562
702;8.45383e-15;35;1712;21534;15937.9;1;558;-2.14748e+09;-7.2946e+07;-1;0;0;0;-1;0;208188036;208191848;72776
703;8.45383e-15;35;1712;21534;15937.9;1;558;-2.14748e+09;-7.20202e+07;-1;0;0;0;-1;0;210400609;210404606;76103
704;8.45383e-15;35;1712;21534;15937.9;1;558;-2.14748e+09;-7.11128e+07;0;0;-1;0;0;-1;212608547;212612737;79544
705;8.45383e-15;33;1712;21534;15937.9;1;558;-2.14748e+09;-7.02234e+07;-1;0;0;0;-1;0;214811731;214816119;83103
706;8.45383e-15;33;1712;21534;15937.9;1;558;-2.14748e+09;-6.93515e+07;-1;0;0;0;-1;0;217010043;217014638;86781
707;8.45383e-15;32;1712;21534;15937.9;1;558;-2.14748e+09;-6.84966e+07;-1;0;0;0;-1;0;219203372;219208180;90583
708;8.45383e-15;32;1712;21534;15937.9;1;558;-2.14748e+09;-6.76584e+07;-1;0;0;0;-1;0;221391609;221396640;94509
709;8.45383e-15;32;1712;21534;15937.9;1;558;-2.14748e+09;-6.68363e+07;-1;0;0;0;-1;0;223574652;223579913;98563
710;8.45383e-15;31;1712;21534;15937.9;1;558;-2.14748e+09;-6.60301e+07;-1;0;0;0;-1;0;225752401;225757899;102747
711;8.45383e-15;31;1712;21534;15937.9;1;558;-2.14748e+09;-6.52393e+07;-1;0;0;0;-1;0;227924759;227930504;107063
712;8.45383e-15;30;1712;21534;15937.9;1;558;-2.14748e+09;-6.44635e+07;-1;0;0;0;-1;0;230091635;230097636;111516
713;8.45383e-15;30;1712;21534;15937.9;1;558;-2.14748e+09;-6.37023e+07;-1;0;0;0;-1;0;232252940;232259205;116106
714;8.45383e-15;29;1712;21534;15937.9;1;558;-2.14748e+09;-6.29555e+07;-1;0;0;0;-1;0;234408588;234415128;120836
715;8.45383e-15;27;1711;21534;15937.9;1;558;-2.14748e+09;-6.22226e+07;-1;0;0;0;-1;0;236558502;236565325;125710
716;8.45383e-15;27;1711;21534;15937.9;1;558;-2.14748e+09;-6.15032e+07;-1;0;0;0;-1;0;238702602;238709718;130730
717;8.45383e-15;27;1711;21534;15937.9;1;558;-2.14748e+09;-6.07972e+07;-1;0;0;0;-1;0;240840814;240848231;135898
718;8.45383e-15;27;1711;21534;15937.9;1;558;-2.14748e+09;-6.01041e+07;-1;0;0;0;-1;0;242973066;242980795;141217
719;8.45383e-15;27;1711;21534;15937.9;1;558;-2.14748e+09;-5.94236e+07;-1;0;0;0;-1;0;245099291;245107342;146689
720;8.45383e-15;27;1711;21534;15937.9;1;558;-2.14748e+09;-5.87555e+07;-1;0;0;0;-1;0;247219423;247227805;152318
721;8.45383e-15;25;1711;21534;15937.9;1;558;-2.14748e+09;-5.80994e+07;-1;0;0;0;-1;0;249333401;249342126;158106
722;8.45383e-15;25;1711;21534;15937.9;1;558;-2.14748e+09;-5.74551e+07;-1;0;0;0;-1;0;251441166;251450244;164055
723;8.45383e-15;25;1711;21534;15937.9;1;558;-2.14748e+09;-5.68223e+07;-1;0;0;0;-1;0;253542662;253552105;170168
724;8.45383e-15;25;1711;21534;15937.9;1;558;-2.14748e+09;-5.62006e+07;-1;0;0;0;-1;0;255637835;255647654;176448
725;8.45383e-15;25;1711;21534;15937.9;1;558;-2.14748e+09;-5.559e+07;-1;0;0;0;-1;0;257726633;257736841;182897
726;8.45383e-15;23;1711;21534;15937.9;1;558;-2.14748e+09;-5.499e+07;-1;0;0;0;-1;0;259809009;259819619;189519
727;8.45383e-15;23;1711;21534;15937.9;1;558;-2.14748e+09;-5.44004e+07;-1;0;0;0;-1;0;261884921;261895942;196315
728;8.45383e-15;23;1711;21534;15937.9;1;558;-2.14748e+09;-5.38211e+07;-1;0;0;0;-1;0;263954323;263965767;203288
729;8.45383e-15;23;1711;21534;15937.9;1;558;-2.14748e+09;-5.32517e+07;-1;0;0;0;-1;0;266017174;266029054;210440
730;8.45383e-15;21;1711;21534;15937.9;1;558;-2.14748e+09;-5.26921e+07;-1;0;0;0;-1;0;268073436;268085764;217776
731;8.45383e-15;19;1711;21534;15937.9;1;558;-2.14748e+09;-5.2142e+07;-1;0;0;0;-1;0;270123074;270135864;225296
732;8.45383e-15;19;1711;21534;15937.9;1;558;-2.14748e+09;-5.16013e+07;-1;0;0;0;-1;0;272166054;272179319;233003
733;8.45383e-15;18;1711;21534;15937.9;1;558;-2.14748e+09;-5.10696e+07;-1;0;0;0;-1;0;274202342;274216097;240901
734;8.45383e-15;18;1711;21534;15937.9;1;558;-2.14748e+09;-5.05468e+07;-1;0;0;0;-1;0;276231911;276246169;248991
735;8.45383e-15;18;1711;21534;15937.9;1;558;-2.14748e+09;-5.00327e+07;-1;0;0;0;-1;0;278254734;278269508;257276
736;8.45383e-15;17;1711;21534;15937.9;1;558;-2.14748e+09;-4.95272e+07;-1;0;0;0;-1;0;280270783;280286089;265760
737;8.45383e-15;17;1711;21534;15937.9;1;558;-2.14748e+09;-4.90299e+07;-1;0;0;0;-1;0;282280034;282295887;274443
738;8.45383e-15;17;1711;21534;15937.9;1;558;-2.14748e+09;-4.85408e+07;-1;0;0;0;-1;0;284282468;284298879;283329
739;8.45383e-15;17;1711;21534;15937.9;1;558;-2.14748e+09;-4.80597e+07;-1;0;0;0;-1;0;286278063;286295049;292420
740;8.45383e-15;14;1711;21534;15937.9;1;558;-2.14748e+09;-4.75863e+07;-1;0;0;0;-1;0;288266801;288284379;301719
741;8.45383e-15;14;1711;21534;15937.9;1;558;-2.14748e+09;-4.71205e+07;-1;0;0;0;-1;0;290248665;290266850;311229
742;8.45383e-15;14;1711;21534;15937.9;1;558;-2.14748e+09;-4.66622e+07;-1;0;0;0;-1;0;292223641;292242449;320950
743;8.45383e-15;14;1711;21534;15937.9;1;558;-2.14748e+09;-4.62112e+07;-1;0;0;0;-1;0;294191713;294211162;330887
744;8.45383e-15;14;1711;21534;15937.9;1;558;-2.14748e+09;-4.57674e+07;-1;0;0;0;-1;0;296152872;296172978;341042
745;8.45383e-15;8;1711;21534;15937.9;1;558;-2.14748e+09;-4.53305e+07;-1;0;0;0;-1;0;298107108;298127886;351416
746;8.45383e-15;7;1711;21534;15937.9;1;558;-2.14748e+09;-4.49004e+07;-1;0;0;0;-1;0;300054405;300075878;362013
747;8.45383e-15;6;1711;21534;15937.9;1;558;-2.14748e+09;-4.44771e+07;-1;0;0;0;-1;0;301994764;302016944;372834
748;8.45383e-15;6;1711;21534;15937.9;1;558;-2.14748e+09;-4.40603e+07;-1;0;0;0;-1;0;303928179;303951083;383883
749;8.45383e-15;6;1711;21534;15937.9;1;558;-2.14748e+09;-4.36499e+07;-1;0;0;0;-1;0;305854640;305878287;395161
750;8.45383e-15;6;1711;21534;15937.9;1;558;-2.14748e+09;-4.32458e+07;-1;0;0;0;-1;0;307774146;307798554;406670
751;8.45383e-15;4;1711;21534;15937.9;1;558;-2.14748e+09;-4.28479e+07;-1;0;0;0;-1;0;309686695;309711881;418414
752;8.45383e-15;3;1711;21534;15937.9;1;558;-2.14748e+09;-4.2456e+07;0;0;-1;0;0;-1;311592283;311618268;430393
753;8.45383e-15;3;1711;21534;15937.9;1;558;-2.14748e+09;-4.207e+07;-1;0;0;0;-1;0;313490914;313517714;442612
754;8.45383e-15;2;1711;21534;15937.9;1;558;-2.14748e+09;-4.16897e+07;-1;0;0;0;-1;0;315382586;315410223;455071
755;8.45383e-15;2;1711;21534;15937.9;1;558;-2.14748e+09;-4.13152e+07;-1;0;0;0;-1;0;317267301;317295789;467773
756;8.45383e-15;2;1711;21534;15937.9;1;558;-2.14748e+09;-4.09462e+07;-1;0;0;0;-1;0;319145063;319174428;480720
757;8.45383e-15;2;1711;21534;15937.9;1;558;-2.14748e+09;-4.05826e+07;-1;0;0;0;-1;0;321015877;321046139;493915
758;8.45383e-15;2;1711;21534;15937.9;1;558;-2.14748e+09;-4.02244e+07;-1;0;0;0;-1;0;322879747;322910924;507359
759;8.45383e-15;0;1711;21534;15937.9;1;558;-2.14748e+09;-3.98714e+07;-1;0;0;0;-1;0;324736679;324768795;521055
760;8.45383e-15;0;1711;21534;15937.9;1;558;-2.14748e+09;-3.95235e+07;-1;0;0;0;-1;0;326586680;326619756;535005
761;8.45383e-15;0;1711;21534;15937.9;1;558;-2.14748e+09;-3.91807e+07;-1;0;0;0;-1;0;328429759;328463815;549210
762;8.45383e-15;0;1711;21534;15937.9;1;558;-2.14748e+09;-3.88428e+07;-1;0;0;0;-1;0;330265925;330300983;563674
763;8.45383e-15;0;1711;21534;15937.9;1;558;-2.14748e+09;-3.85097e+07;-1;0;0;0;-1;0;332095186;332131267;578397
764;8.45383e-15;-1;1711;21534;15937.9;1;558;-2.14748e+09;-3.81813e+07;0;0;0;0;0;0;333917553;333954680;593382
765;8.45383e-15;-2;1711;21534;15937.9;1;558;-2.14748e+09;-3.78576e+07;0;0;0;0;0;0;335733037;335771231;608631
766;8.45383e-15;-2;1711;21534;15937.9;1;558;-2.14748e+09;-3.75384e+07;-1;0;0;0;-1;0;337541650;337580934;624146
767;8.45383e-15;-3;1711;21534;15937.9;1;558;-2.14748e+09;-3.72237e+07;0;0;0;0;0;0;339343403;339383802;639929
768;8.45383e-15;-4;1711;21534;15937.9;1;558;-2.14748e+09;-3.69134e+07;0;0;0;0;0;0;341138311;341179849;655982
769;8.45383e-15;-4;1711;21534;15937.9;1;558;-2.14748e+09;-3.66073e+07;-1;0;0;0;-1;0;342926388;342969088;672306
770;8.45383e-15;-5;1711;21534;15937.9;1;558;-2.14748e+09;-3.63055e+07;0;0;0;0;0;0;344707647;344751533;688904
771;8.45383e-15;-6;1711;21534;15937.9;1;558;-2.14748e+09;-3.60078e+07;0;0;0;0;0;0;346482103;346527201;705776
772;8.45383e-15;-6;1711;21534;15937.9;1;558;-2.14748e+09;-3.57142e+07;-1;0;0;0;-1;0;348249773;348296107;722926
773;8.45383e-15;-7;1711;21534;15937.9;1;558;-2.14748e+09;-3.54246e+07;0;0;0;0;0;0;350010673;350058267;740355
774;8.45383e-15;-8;1711;21534;15937.9;1;558;-2.14748e+09;-3.51389e+07;0;0;0;0;0;0;351764818;351813700;758065
775;8.45383e-15;-8;1711;21534;15937.9;1;558;-2.14748e+09;-3.4857e+07;-1;0;0;0;-1;0;353512228;353562421;776057
776;8.45383e-15;-8;1711;21534;15937.9;1;558;-2.14748e+09;-3.45788e+07;-1;0;0;0;-1;0;355252919;355304449;794333
777;8.45383e-15;-9;1711;21534;15937.9;1;558;-2.14748e+09;-3.43044e+07;0;0;0;0;0;0;356986909;357039803;812894
778;8.45383e-15;-9;1711;21534;15937.9;1;558;-2.14748e+09;-3.40336e+07;-1;0;0;0;-1;0;358714217;358768501;831743
779;8.45383e-15;-9;1711;21534;15937.9;1;558;-2.14748e+09;-3.37664e+07;-1;0;0;0;-1;0;360434863;360490564;850881
780;8.45383e-15;-10;1711;21534;15937.9;1;558;-2.14748e+09;-3.35026e+07;0;0;0;0;0;0;362148866;362206011;870309
781;8.45383e-15;-11;1711;21534;15937.9;1;558;-2.14748e+09;-3.32423e+07;0;0;0;0;0;0;363856245;363914861;890030
782;8.45383e-15;-11;1711;21534;15937.9;1;558;-2.14748e+09;-3.29854e+07;-1;0;0;0;-1;0;365557022;365617139;910044
783;8.45383e-15;-11;1711;21534;15937.9;1;558;-2.14748e+09;-3.27317e+07;-1;0;0;0;-1;0;367251217;367312864;930353
784;8.45383e-15;-11;1711;21534;15937.9;1;558;-2.14748e+09;-3.24814e+07;-1;0;0;0;-1;0;368938851;369002055;950959
785;8.45383e-15;-11;1711;21534;15937.9;1;558;-2.14748e+09;-3.22342e+07;-1;0;0;0;-1;0;370619945;370684736;971863
786;8.45383e-15;-11;1711;21534;15937.9;1;558;-2.14748e+09;-3.19902e+07;-1;0;0;0;-1;0;372294521;372360929;993066
787;8.45383e-15;-12;1711;21534;15937.9;1;558;-2.14748e+09;-3.17492e+07;0;0;0;0;0;0;373962601;374030654;1014570
788;8.45383e-15;-12;1711;21534;15937.9;1;558;-2.14748e+09;-3.15113e+07;-1;0;0;0;-1;0;375624207;375693936;1036377
789;8.45383e-15;-12;1711;21534;15937.9;1;558;-2.14748e+09;-3.12764e+07;-1;0;0;0;-1;0;377279363;377350797;1058486
790;8.45383e-15;-12;1711;21534;15937.9;1;558;-2.14748e+09;-3.10444e+07;-1;0;0;0;-1;0;378928090;379001260;1080901
791;8.45383e-15;-12;1711;21534;15937.9;1;558;-2.14748e+09;-3.08153e+07;0;0;-1;0;0;-1;380570412;380645349;1103622
792;8.45383e-15;-13;1711;21534;15937.9;1;558;-2.14748e+09;-3.0589e+07;0;0;0;0;0;0;382206352;382283086;1126650
793;8.45383e-15;-14;1711;21534;15937.9;1;558;-2.14748e+09;-3.03654e+07;0;0;0;0;0;0;383835934;383914497;1149986
794;8.45383e-15;-15;1711;21534;15937.9;1;558;-2.14748e+09;-3.01447e+07;0;0;0;0;0;0;385459182;385539605;1173632
795;8.45383e-15;-16;1711;21534;15937.9;1;558;-2.14748e+09;-2.99265e+07;0;0;0;0;0;0;387076119;387158435;1197589
796;8.45383e-15;-17;1711;21534;15937.9;1;558;-2.14748e+09;-2.97111e+07;0;0;0;0;0;0;388686769;388771010;1221858
797;8.45383e-15;-17;1711;21534;15937.9;1;558;-2.14748e+09;-2.94982e+07;-1;0;0;0;-1;0;390291158;390377356;1246440
798;8.45383e-15;-18;1711;21534;15937.9;1;558;-2.14748e+09;-2.92879e+07;0;0;0;0;0;0;391889309;391977498;1271336
799;8.45383e-15;-18;1711;21534;15937.9;1;558;-2.14748e+09;-2.90801e+07;-1;0;0;0;-1;0;393481247;393571459;1296548
800;8.45383e-15;-19;1711;21534;15937.9;1;558;-2.14748e+09;-2.88747e+07;0;0;0;0;0;0;395066997;395159266;1322075
801;8.45383e-15;-20;1711;21534;15937.9;1;558;-2.14748e+09;-2.86718e+07;0;0;0;0;0;0;396646584;396740944;1347920
802;8.45383e-15;-21;1711;21534;15937.9;1;558;-2.14748e+09;-2.84713e+07;0;0;0;0;0;0;398220032;398316518;1374083
803;8.45383e-15;-21;1711;21534;15937.9;1;558;-2.14748e+09;-2.82731e+07;-1;0;0;0;-1;0;399787368;399886013;1400565
804;8.45383e-15;-22;1711;21534;15937.9;1;558;-2.14748e+09;-2.80773e+07;0;0;0;0;0;0;401348616;401449456;1427367
805;8.45383e-15;-22;1711;21534;15937.9;1;558;-2.14748e+09;-2.78837e+07;-1;0;0;0;-1;0;402903802;403006871;1454489
806;8.45383e-15;-23;1711;21534;15937.9;1;558;-2.14748e+09;-2.76923e+07;0;0;0;0;0;0;404452951;404558285;1481934
807;8.45383e-15;-24;1711;21534;15937.9;1;558;-2.14748e+09;-2.75032e+07;0;0;0;0;0;0;405996089;406103724;1509700
808;8.45383e-15;-24;1711;21534;15937.9;1;558;-2.14748e+09;-2.73162e+07;0;0;-1;0;0;-1;407533241;407643213;1537790
809;8.45383e-15;-25;1711;21534;15937.9;1;558;-2.14748e+09;-2.71313e+07;0;0;0;0;0;0;409064433;409176778;1566204
810;8.45383e-15;-26;1711;21534;15937.9;1;558;-2.14748e+09;-2.69485e+07;0;0;0;0;0;0;410589692;410704447;1594943
811;8.45383e-15;-26;1711;21534;15937.9;1;558;-2.14748e+09;-2.67678e+07;-1;0;0;0;-1;0;412109042;412226243;1624007
812;8.45383e-15;-27;1711;21534;15937.9;1;558;-2.14748e+09;-2.65892e+07;0;0;0;0;0;0;413622509;413742195;1653397
813;8.45383e-15;-27;1711;21534;15937.9;1;558;-2.14748e+09;-2.64125e+07;-1;0;0;0;-1;0;415130121;415252328;1683114
814;8.45383e-15;-27;1711;21534;15937.9;1;558;-2.14748e+09;-2.62378e+07;-1;0;0;0;-1;0;416631901;416756668;1713158
815;8.45383e-15;-27;1711;21534;15937.9;1;558;-2.14748e+09;-2.6065e+07;-1;0;0;0;-1;0;418127878;418255242;1743530
816;8.45383e-15;-28;1711;21534;15937.9;1;558;-2.14748e+09;-2.58941e+07;0;0;0;0;0;0;419618075;419748076;1774231
817;8.45383e-15;-28;1711;21534;15937.9;1;558;-2.14748e+09;-2.57251e+07;-1;0;0;0;-1;0;421102521;421235197;1805260
818;8.45383e-15;-28;1711;21534;15937.9;1;558;-2.14748e+09;-2.5558e+07;-1;0;0;0;-1;0;422581239;422716630;1836619
819;8.45383e-15;-29;1711;21534;15937.9;1;558;-2.14748e+09;-2.53927e+07;0;0;0;0;0;0;424054258;424192402;1868308
820;8.45383e-15;-30;1711;21534;15937.9;1;558;-2.14748e+09;-2.52292e+07;0;0;0;0;0;0;425521602;425662539;1900328
821;8.45383e-15;-30;1711;21534;15937.9;1;558;-2.14748e+09;-2.50674e+07;-1;0;0;0;-1;0;426983297;427127068;1932678
822;8.45383e-15;-30;1711;21534;15937.9;1;558;-2.14748e+09;-2.49074e+07;-1;0;0;0;-1;0;428439370;428586015;1965360
823;8.45383e-15;-31;1711;21534;15937.9;1;558;-2.14748e+09;-2.47491e+07;0;0;0;0;0;0;429889847;430039407;1998373
824;8.45383e-15;-32;1711;21534;15937.9;1;558;-2.14748e+09;-2.45924e+07;0;0;0;0;0;0;431334754;431487269;2031719
825;8.45383e-15;-32;1711;21534;15937.9;1;558;-2.14748e+09;-2.44375e+07;-1;0;0;0;-1;0;432774116;432929628;2065396
826;8.45383e-15;-32;1711;21534;15937.9;1;558;-2.14748e+09;-2.42841e+07;-1;0;0;0;-1;0;434207960;434366510;2099407
827;8.45383e-15;-32;1711;21534;15937.9;1;558;-2.14748e+09;-2.41324e+07;-1;0;0;0;-1;0;435636312;435797942;2133750
828;8.45383e-15;-32;1711;21534;15937.9;1;558;-2.14748e+09;-2.39823e+07;-1;0;0;0;-1;0;437059197;437223949;2168426
829;8.45383e-15;-32;1711;21534;15937.9;1;558;-2.14748e+09;-2.38337e+07;-1;0;0;0;-1;0;438476641;438644557;2203436
830;8.45383e-15;-33;1711;21534;15937.9;1;558;-2.14748e+09;-2.36867e+07;0;0;0;0;0;0;439888670;440059794;2238779
831;8.45383e-15;-33;1711;21534;15937.9;1;558;-2.14748e+09;-2.35412e+07;-1;0;0;0;-1;0;441295310;441469684;2274456
832;8.45383e-15;-34;1711;21534;15937.9;1;558;-2.14748e+09;-2.33972e+07;0;0;0;0;0;0;442696587;442874255;2310467
833;8.45383e-15;-34;1711;21534;15937.9;1;558;-2.14748e+09;-2.32547e+07;-1;0;0;0;-1;0;444092525;444273531;2346812
834;8.45383e-15;-35;1711;21534;15937.9;1;558;-2.14748e+09;-2.31136e+07;0;0;0;0;0;0;445483152;445667538;2383491
835;8.45383e-15;-36;1711;21534;15937.9;1;558;-2.14748e+09;-2.29739e+07;0;0;0;0;0;0;446868492;447056303;2420504
836;8.45383e-15;-36;1711;21534;15937.9;1;558;-2.14748e+09;-2.28357e+07;-1;0;0;0;-1;0;448248570;448439852;2457851
837;8.45383e-15;-36;1711;21534;15937.9;1;558;-2.14748e+09;-2.26989e+07;-1;0;0;0;-1;0;449623413;449818209;2495533
838;8.45383e-15;-36;1711;21534;15937.9;1;558;-2.14748e+09;-2.25634e+07;-1;0;0;0;-1;0;450993045;451191401;2533549
839;8.45383e-15;-37;1711;21534;15937.9;1;558;-2.14748e+09;-2.24293e+07;0;0;0;0;0;0;452357493;452559453;2571899
840;8.45383e-15;-38;1711;21534;15937.9;1;558;-2.14748e+09;-2.22965e+07;0;0;0;0;0;0;453716780;453922391;2610583
841;8.45383e-15;-38;1711;21534;15937.9;1;558;-2.14748e+09;-2.21651e+07;-1;0;0;0;-1;0;455070933;455280240;2649602
842;8.45383e-15;-39;1711;21534;15937.9;1;558;-2.14748e+09;-2.20349e+07;0;0;0;0;0;0;456419975;456633025;2688954
843;8.45383e-15;-39;1711;21534;15937.9;1;558;-2.14748e+09;-2.1906e+07;-1;0;0;0;-1;0;457763934;457980772;2728641
844;8.45383e-15;-39;1711;21534;15937.9;1;558;-2.14748e+09;-2.17784e+07;-1;0;0;0;-1;0;459102832;459323506;2768661
845;8.45383e-15;-40;1711;21534;15937.9;1;558;-2.14748e+09;-2.16521e+07;0;0;0;0;0;0;460436695;460661252;2809015
846;8.45383e-15;-40;1711;21534;15937.9;1;558;-2.14748e+09;-2.15269e+07;-1;0;0;0;-1;0;461765548;461994034;2849703
847;8.45383e-15;-40;1711;21534;15937.9;1;558;-2.14748e+09;-2.1403e+07;-1;0;0;0;-1;0;463089415;463321879;2890723
848;8.45383e-15;-41;1711;21534;15937.9;1;558;-2.14748e+09;-2.12802e+07;0;0;0;0;0;0;464408321;464644810;2932077
849;8.45383e-15;-41;1711;21534;15937.9;1;558;-2.14748e+09;-2.11587e+07;-1;0;0;0;-1;0;465722291;465962853;2973764
850;8.45383e-15;-42;1711;21534;15937.9;1;558;-2.14748e+09;-2.10383e+07;0;0;0;0;0;0;467031348;467276032;3015783
851;8.45383e-15;-42;1711;21534;15937.9;1;558;-2.14748e+09;-2.0919e+07;-1;0;0;0;-1;0;468335518;468584372;3058135
852;8.45383e-15;-42;1711;21534;15937.9;1;558;-2.14748e+09;-2.08009e+07;-1;0;0;0;-1;0;469634823;469887897;3100818
853;8.45383e-15;-42;1711;21534;15937.9;1;558;-2.14748e+09;-2.06839e+07;-1;0;0;0;-1;0;470929289;471186631;3143833
854;8.45383e-15;-42;1711;21534;15937.9;1;558;-2.14748e+09;-2.05679e+07;-1;0;0;0;-1;0;472218940;472480599;3187180
855;8.45383e-15;-43;1711;21534;15937.9;1;558;-2.14748e+09;-2.04531e+07;0;0;0;0;0;0;473503799;473769825;3230858
856;8.45383e-15;-43;1711;21534;15937.9;1;558;-2.14748e+09;-2.03394e+07;-1;0;0;0;-1;0;474783890;475054334;3274866
857;8.45383e-15;-43;1711;21534;15937.9;1;558;-2.14748e+09;-2.02267e+07;-1;0;0;0;-1;0;476059236;476334148;3319204
858;8.45383e-15;-43;1711;21534;15937.9;1;558;-2.14748e+09;-2.0115e+07;-1;0;0;0;-1;0;477329862;477609292;3363873
859;8.45383e-15;-44;1711;21534;15937.9;1;558;-2.14748e+09;-2.00044e+07;0;0;0;0;0;0;478595792;478879789;3408870
860;8.45383e-15;-44;1711;21534;15937.9;1;558;-2.14748e+09;-1.98948e+07;-1;0;0;0;-1;0;479857047;480145664;3454197
861;8.45383e-15;-44;1711;21534;15937.9;1;558;-2.14748e+09;-1.97862e+07;-1;0;0;0;-1;0;481113652;481406940;3499852
862;8.45383e-15;-44;1711;21534;15937.9;1;558;-2.14748e+09;-1.96786e+07;-1;0;0;0;-1;0;482365630;482663640;3545835
863;8.45383e-15;-45;1711;21534;15937.9;1;558;-2.14748e+09;-1.95719e+07;0;0;0;0;0;0;483613004;483915788;3592145
864;8.45383e-15;-46;1711;21534;15937.9;1;558;-2.14748e+09;-1.94663e+07;0;0;0;0;0;0;484855796;485163407;3638783
865;8.45383e-15;-46;1711;21534;15937.9;1;558;-2.14748e+09;-1.93615e+07;-1;0;0;0;-1;0;486094031;486406520;3685746
866;8.45383e-15;-47;1711;21534;15937.9;1;558;-2.14748e+09;-1.92578e+07;0;0;0;0;0;0;487327730;487645149;3733036
867;8.45383e-15;-48;1711;21534;15937.9;1;558;-2.14748e+09;-1.91549e+07;0;0;0;0;0;0;488556917;488879319;3780651
868;8.45383e-15;-48;1711;21534;15937.9;1;558;-2.14748e+09;-1.9053e+07;-1;0;0;0;-1;0;489781613;490109051;3828591
869;8.45383e-15;-48;1711;21534;15937.9;1;558;-2.14748e+09;-1.89519e+07;-1;0;0;0;-1;0;491001841;491334369;3876854
870;8.45383e-15;-49;1711;21534;15937.9;1;558;-2.14748e+09;-1.88518e+07;0;0;0;0;0;0;492217624;492555295;3925441
871;8.45383e-15;-50;1711;21534;15937.9;1;558;-2.14748e+09;-1.87526e+07;0;0;0;0;0;0;493428984;493771851;3974351
872;8.45383e-15;-51;1711;21534;15937.9;1;558;-2.14748e+09;-1.86542e+07;0;0;0;0;0;0;494635943;494984060;4023583
873;8.45383e-15;-51;1711;21534;15937.9;1;558;-2.14748e+09;-1.85566e+07;-1;0;0;0;-1;0;495838523;496191944;4073137
874;8.45383e-15;-52;1711;21534;15937.9;1;558;-2.14748e+09;-1.846e+07;0;0;0;0;0;0;497036746;497395526;4123011
875;8.45383e-15;-53;1711;21534;15937.9;1;558;-2.14748e+09;-1.83641e+07;0;0;0;0;0;0;498230633;498594826;4173206
876;8.45383e-15;-53;1711;21534;15937.9;1;558;-2.14748e+09;-1.82691e+07;-1;0;0;0;-1;0;499420207;499789868;4223720
877;8.45383e-15;-54;1711;21534;15937.9;1;558;-2.14748e+09;-1.8175e+07;0;0;0;0;0;0;500605489;500980672;4274552
878;8.45383e-15;-55;1711;21534;15937.9;1;558;-2.14748e+09;-1.80816e+07;0;0;0;0;0;0;501786500;502167262;4325703
879;8.45383e-15;-56;1711;21534;15937.9;1;558;-2.14748e+09;-1.7989e+07;0;0;0;0;0;0;502963261;503349657;4377170
880;8.45383e-15;-57;1711;21534;15937.9;1;558;-2.14748e+09;-1.78972e+07;0;0;0;0;0;0;504135795;504527880;4428954
881;8.45383e-15;-58;1711;21534;15937.9;1;558;-2.14748e+09;-1.78062e+07;0;0;0;0;0;0;505304121;505701952;4481054
882;8.45383e-15;-58;1711;21534;15937.9;1;558;-2.14748e+09;-1.7716e+07;-1;0;0;0;-1;0;506468262;506871894;4533468
883;8.45383e-15;-58;1711;21534;15937.9;1;558;-2.14748e+09;-1.76265e+07;-1;0;0;0;-1;0;507628238;508037727;4586197
884;8.45383e-15;-58;1711;21534;15937.9;1;558;-2.14748e+09;-1.75378e+07;-1;0;0;0;-1;0;508784069;509199473;4639238
885;8.45383e-15;-59;1711;21534;15937.9;1;558;-2.14748e+09;-1.74498e+07;0;0;0;0;0;0;509935777;510357152;4692592
886;8.45383e-15;-60;1711;21534;15937.9;1;558;-2.14748e+09;-1.73625e+07;0;0;0;0;0;0;511083382;511510785;4746258
887;8.45383e-15;-61;1711;21534;15937.9;1;558;-2.14748e+09;-1.7276e+07;0;0;0;0;0;0;512226905;512660392;4800234
888;8.45383e-15;-62;1711;21534;15937.9;1;558;-2.14748e+09;-1.71902e+07;0;0;0;0;0;0;513366365;513805994;4854519
889;8.45383e-15;-63;1711;21534;15937.9;1;558;-2.14748e+09;-1.71051e+07;0;0;0;0;0;0;514501783;514947613;4909114
890;8.45383e-15;-64;1711;21534;15937.9;1;558;-2.14748e+09;-1.70207e+07;0;0;0;0;0;0;515633179;516085266;4964016
891;8.45383e-15;-64;1711;21534;15937.9;1;558;-2.14748e+09;-1.6937e+07;-1;0;0;0;-1;0;516760573;517218977;5019226
892;8.45383e-15;-65;1711;21534;15937.9;1;558;-2.14748e+09;-1.6854e+07;0;0;0;0;0;0;517883986;518348763;5074741
893;8.45383e-15;-65;1711;21534;15937.9;1;558;-2.14748e+09;-1.67716e+07;-1;0;0;0;-1;0;519003436;519474645;5130562
894;8.45383e-15;-66;1711;21534;15937.9;1;558;-2.14748e+09;-1.66899e+07;0;0;0;0;0;0;520118944;520596644;5186687
895;8.45383e-15;-67;1711;21534;15937.9;1;558;-2.14748e+09;-1.66089e+07;0;0;0;0;0;0;521230528;521714778;5243115
896;8.45383e-15;-67;1711;21534;15937.9;1;558;-2.14748e+09;-1.65285e+07;-1;0;0;0;-1;0;522338210;522829068;5299846
897;8.45383e-15;-67;1711;21534;15937.9;1;558;-2.14748e+09;-1.64488e+07;-1;0;0;0;-1;0;523442007;523939532;5356878
898;8.45383e-15;-67;1711;21534;15937.9;1;558;-2.14748e+09;-1.63697e+07;-1;0;0;0;-1;0;524541939;525046191;5414210
899;8.45383e-15;-68;1711;21534;15937.9;1;558;-2.14748e+09;-1.62913e+07;0;0;0;0;0;0;525638025;526149064;5471842
900;8.45383e-15;-69;1711;21534;15937.9;1;558;-2.14748e+09;-1.62134e+07;0;0;0;0;0;0;526730284;527248169;5529772
901;8.45383e-15;-69;1711;21534;15937.9;1;558;-2.14748e+09;-1.61362e+07;-1;0;0;0;-1;0;527818736;528343527;5587999
902;8.45383e-15;-69;1711;21534;15937.9;1;558;-2.14748e+09;-1.60596e+07;-1;0;0;0;-1;0;528903398;529435155;5646523
903;8.45383e-15;-69;1711;21534;15937.9;1;558;-2.14748e+09;-1.59836e+07;-1;0;0;0;-1;0;529984291;530523073;5705342
904;8.45383e-15;-69;1711;21534;15937.9;1;558;-2.14748e+09;-1.59082e+07;-1;0;0;0;-1;0;531061431;531607300;5764455
905;8.45383e-15;-70;1711;21534;15937.9;1;558;-2.14748e+09;-1.58334e+07;0;0;0;0;0;0;532134838;532687854;5823861
906;8.45383e-15;-71;1711;21534;15937.9;1;558;-2.14748e+09;-1.57592e+07;0;0;0;0;0;0;533204529;533764753;5883559
907;8.45383e-15;-71;1711;21534;15937.9;1;558;-2.14748e+09;-1.56855e+07;-1;0;0;0;-1;0;534270524;534838017;5943548
908;8.45383e-15;-71;1711;21534;15937.9;1;558;-2.14748e+09;-1.56124e+07;-1;0;0;0;-1;0;535332841;535907663;6003828
909;8.45383e-15;-72;1711;21534;15937.9;1;558;-2.14748e+09;-1.55399e+07;0;0;0;0;0;0;536391497;536973710;6064396
910;8.45383e-15;-73;1711;21534;15937.9;1;558;-2.14748e+09;-1.54679e+07;0;0;0;0;0;0;537446510;538036176;6125252
911;8.45383e-15;-73;1711;21534;15937.9;1;558;-2.14748e+09;-1.53965e+07;-1;0;0;0;-1;0;538497899;539095078;6186394
912;8.45383e-15;-73;1711;21534;15937.9;1;558;-2.14748e+09;-1.53256e+07;-1;0;0;0;-1;0;539545680;540150435;6247822
913;8.45383e-15;-73;1711;21534;15937.9;1;558;-2.14748e+09;-1.52553e+07;-1;0;0;0;-1;0;540589872;541202265;6309535
914;8.45383e-15;-73;1711;21534;15937.9;1;558;-2.14748e+09;-1.51855e+07;-1;0;0;0;-1;0;541630493;542250584;6371531
915;8.45383e-15;-74;1711;21534;15937.9;1;558;-2.14748e+09;-1.51162e+07;0;0;0;0;0;0;542667558;543295411;6433809
916;8.45383e-15;-75;1711;21534;15937.9;1;558;-2.14748e+09;-1.50475e+07;0;0;0;0;0;0;543701087;544336764;6496368
917;8.45383e-15;-76;1711;21534;15937.9;1;558;-2.14748e+09;-1.49792e+07;0;0;0;0;0;0;544731095;545374658;6559206
918;8.45383e-15;-76;1711;21534;15937.9;1;558;-2.14748e+09;-1.49115e+07;-1;0;0;0;-1;0;545757601;546409113;6622324
919;8.45383e-15;-77;1711;21534;15937.9;1;558;-2.14748e+09;-1.48443e+07;0;0;0;0;0;0;546780621;547440144;6685719
920;8.45383e-15;-78;1711;21534;15937.9;1;558;-2.14748e+09;-1.47776e+07;0;0;0;0;0;0;547800172;548467770;6749391
921;8.45383e-15;-79;1711;21534;15937.9;1;558;-2.14748e+09;-1.47113e+07;0;0;0;0;0;0;548816270;549492006;6813337
922;8.45383e-15;-79;1711;21534;15937.9;1;558;-2.14748e+09;-1.46456e+07;-1;0;0;0;-1;0;549828934;550512870;6877558
923;8.45383e-15;-79;1711;21534;15937.9;1;558;-2.14748e+09;-1.45803e+07;-1;0;0;0;-1;0;550838178;551530379;6942052
924;8.45383e-15;-79;1711;21534;15937.9;1;558;-2.14748e+09;-1.45156e+07;-1;0;0;0;-1;0;551844020;552544548;7006817
925;8.45383e-15;-80;1711;21534;15937.9;1;558;-2.14748e+09;-1.44513e+07;0;0;0;0;0;0;552846477;553555395;7071853
926;8.45383e-15;-80;1711;21534;15937.9;1;558;-2.14748e+09;-1.43874e+07;-1;0;0;0;-1;0;553845563;554562937;7137158
927;8.45383e-15;-80;1711;21534;15937.9;1;558;-2.14748e+09;-1.43241e+07;-1;0;0;0;-1;0;554841296;555567188;7202731
928;8.45383e-15;-80;1711;21534;15937.9;1;558;-2.14748e+09;-1.42612e+07;-1;0;0;0;-1;0;555833692;556568167;7268571
929;8.45383e-15;-80;1711;21534;15937.9;1;558;-2.14748e+09;-1.41987e+07;-1;0;0;0;-1;0;556822767;557565888;7334676
930;8.45383e-15;-80;1711;21534;15937.9;1;558;-2.14748e+09;-1.41367e+07;-1;0;0;0;-1;0;557808536;558560368;7401046
931;8.45383e-15;-80;1711;21534;15937.9;1;558;-2.14748e+09;-1.40752e+07;-1;0;0;0;-1;0;558791016;559551622;7467679
932;8.45383e-15;-80;1711;21534;15937.9;1;558;-2.14748e+09;-1.4014e+07;-1;0;0;0;-1;0;559770222;560539668;7534574
933;8.45383e-15;-80;1711;21534;15937.9;1;558;-2.14748e+09;-1.39534e+07;-1;0;0;0;-1;0;560746169;561524519;7601730
934;8.45383e-15;-80;1711;21534;15937.9;1;558;-2.14748e+09;-1.38931e+07;-1;0;0;0;-1;0;561718874;562506193;7669145
935;8.45383e-15;-81;1711;21534;15937.9;1;558;-2.14748e+09;-1.38333e+07;0;0;0;0;0;0;562688352;563484704;7736819
936;8.45383e-15;-81;1711;21534;15937.9;1;558;-2.14748e+09;-1.37739e+07;-1;0;0;0;-1;0;563654618;564460069;7804749
937;8.45383e-15;-82;1711;21534;15937.9;1;558;-2.14748e+09;-1.37149e+07;0;0;0;0;0;0;564617688;565432301;7872935
938;8.45383e-15;-83;1711;21534;15937.9;1;558;-2.14748e+09;-1.36564e+07;0;0;0;0;0;0;565577576;566401418;7941376
939;8.45383e-15;-83;1711;21534;15937.9;1;558;-2.14748e+09;-1.35982e+07;-1;0;0;0;-1;0;566534297;567367433;8010070
940;8.45383e-15;-84;1711;21534;15937.9;1;558;-2.14748e+09;-1.35405e+07;0;0;0;0;0;0;567487868;568330362;8079015
941;8.45383e-15;-85;1711;21534;15937.9;1;558;-2.14748e+09;-1.34831e+07;0;0;0;0;0;0;568438301;569290220;8148212
942;8.45383e-15;-86;1711;21534;15937.9;1;558;-2.14748e+09;-1.34262e+07;0;0;0;0;0;0;569385614;570247022;8217657
943;8.45383e-15;-87;1711;21534;15937.9;1;558;-2.14748e+09;-1.33696e+07;0;0;0;0;0;0;570329819;571200782;8287351
944;8.45383e-15;-87;1711;21534;15937.9;1;558;-2.14748e+09;-1.33134e+07;-1;0;0;0;-1;0;571270932;572151516;8357292
945;8.45383e-15;-88;1711;21534;15937.9;1;558;-2.14748e+09;-1.32577e+07;0;0;0;0;0;0;572208966;573099238;8427478
946;8.45383e-15;-88;1711;21534;15937.9;1;558;-2.14748e+09;-1.32023e+07;0;0;-1;0;0;-1;573143938;574043962;8497909
947;8.45383e-15;-89;1711;21534;15937.9;1;558;-2.14748e+09;-1.31473e+07;0;0;0;0;0;0;574075861;574985703;8568583
948;8.45383e-15;-89;1711;21534;15937.9;1;558;-2.14748e+09;-1.30926e+07;-1;0;0;0;-1;0;575004748;575924476;8639498
949;8.45383e-15;-90;1711;21534;15937.9;1;558;-2.14748e+09;-1.30384e+07;0;0;0;0;0;0;575930616;576860294;8710654
950;8.45383e-15;-90;1711;21534;15937.9;1;558;-2.14748e+09;-1.29845e+07;-1;0;0;0;-1;0;576853477;577793172;8782049
951;8.45383e-15;-91;1711;21534;15937.9;1;558;-2.14748e+09;-1.29309e+07;0;0;0;0;0;0;577773345;578723123;8853681
952;8.45383e-15;-92;1711;21534;15937.9;1;558;-2.14748e+09;-1.28777e+07;0;0;0;0;0;0;578690235;579650163;8925551
953;8.45383e-15;-93;1711;21534;15937.9;1;558;-2.14748e+09;-1.28249e+07;0;0;0;0;0;0;579604160;580574304;8997655
954;8.45383e-15;-93;1711;21534;15937.9;1;558;-2.14748e+09;-1.27725e+07;-1;0;0;0;-1;0;580515134;581495561;9069994
955;8.45383e-15;-93;1711;21534;15937.9;1;558;-2.14748e+09;-1.27203e+07;-1;0;0;0;-1;0;581423171;582413947;9142565
956;8.45383e-15;-94;1711;21534;15937.9;1;558;-2.14748e+09;-1.26686e+07;0;0;0;0;0;0;582328285;583329476;9215367
957;8.45383e-15;-94;1711;21534;15937.9;1;558;-2.14748e+09;-1.26172e+07;-1;0;0;0;-1;0;583230488;584242162;9288400
958;8.45383e-15;-95;1711;21534;15937.9;1;558;-2.14748e+09;-1.25661e+07;0;0;0;0;0;0;584129794;585152018;9361661
959;8.45383e-15;-95;1711;21534;15937.9;1;558;-2.14748e+09;-1.25153e+07;-1;0;0;0;-1;0;585026217;586059057;9435149
960;8.45383e-15;-95;1711;21534;15937.9;1;558;-2.14748e+09;-1.24649e+07;-1;0;0;0;-1;0;585919770;586963293;9508864
961;8.45383e-15;-96;1711;21534;15937.9;1;558;-2.14748e+09;-1.24148e+07;0;0;0;0;0;0;586810467;587864739;9582804
962;8.45383e-15;-97;1711;21534;15937.9;1;558;-2.14748e+09;-1.23651e+07;0;0;0;0;0;0;587698319;588763408;9656967
963;8.45383e-15;-97;1711;21534;15937.9;1;558;-2.14748e+09;-1.23157e+07;-1;0;0;0;-1;0;588583340;589659314;9731352
964;8.45383e-15;-97;1711;21534;15937.9;1;558;-2.14748e+09;-1.22665e+07;-1;0;0;0;-1;0;589465544;590552469;9805958
965;8.45383e-15;-97;1711;21534;15937.9;1;558;-2.14748e+09;-1.22178e+07;-1;0;0;0;-1;0;590344943;591442886;9880784
966;8.45383e-15;-98;1711;21534;15937.9;1;558;-2.14748e+09;-1.21693e+07;0;0;0;0;0;0;591221549;592330578;9955828
967;8.45383e-15;-99;1711;21534;15937.9;1;558;-2.14748e+09;-1.21211e+07;0;0;0;0;0;0;592095376;593215558;10031088
968;8.45383e-15;-99;1711;21534;15937.9;1;558;-2.14748e+09;-1.20733e+07;-1;0;0;0;-1;0;592966436;594097838;10106565
969;8.45383e-15;-99;1711;21534;15937.9;1;558;-2.14748e+09;-1.20257e+07;-1;0;0;0;-1;0;593834742;594977432;10182256
970;8.45383e-15;-99;1711;21534;15937.9;1;558;-2.14748e+09;-1.19785e+07;-1;0;0;0;-1;0;594700306;595854351;10258159
971;8.45383e-15;-99;1711;21534;15937.9;1;558;-2.14748e+09;-1.19316e+07;-1;0;0;0;-1;0;595563141;596728608;10334275
972;8.45383e-15;-99;1711;21534;15937.9;1;558;-2.14748e+09;-1.18849e+07;-1;0;0;0;-1;0;596423258;597600216;10410600
973;8.45383e-15;-99;1711;21534;15937.9;1;558;-2.14748e+09;-1.18386e+07;-1;0;0;0;-1;0;597280671;598469187;10487135
974;8.45383e-15;-100;1711;21534;15937.9;1;558;-2.14748e+09;-1.17925e+07;0;0;0;0;0;0;598135391;599335532;10563878
975;8.45383e-15;-100;1711;21534;15937.9;1;558;-2.14748e+09;-1.17468e+07;-1;0;0;0;-1;0;598987431;600199265;10640827
976;8.45383e-15;-101;1711;21534;15937.9;1;558;-2.14748e+09;-1.17013e+07;0;0;0;0;0;0;599836802;601060396;10717981
977;8.45383e-15;-102;1711;21534;15937.9;1;558;-2.14748e+09;-1.16561e+07;0;0;0;0;0;0;600683517;601918939;10795338
978;8.45383e-15;-103;1711;21534;15937.9;1;558;-2.14748e+09;-1.16112e+07;0;0;0;0;0;0;601527587;602774905;10872898
979;8.45383e-15;-104;1711;21534;15937.9;1;558;-2.14748e+09;-1.15666e+07;0;0;0;0;0;0;602369025;603628306;10950660
980;8.45383e-15;-104;1711;21534;15937.9;1;558;-2.14748e+09;-1.15223e+07;-1;0;0;0;-1;0;603207841;604479154;11028621
981;8.45383e-15;-105;1711;21534;15937.9;1;558;-2.14748e+09;-1.14782e+07;0;0;0;0;0;0;604044048;605327460;11106781
982;8.45383e-15;-105;1711;21534;15937.9;1;558;-2.14748e+09;-1.14344e+07;-1;0;0;0;-1;0;604877658;606173237;11185138
983;8.45383e-15;-106;1711;21534;15937.9;1;558;-2.14748e+09;-1.13909e+07;0;0;0;0;0;0;605708681;607016495;11263690
984;8.45383e-15;-107;1711;21534;15937.9;1;558;-2.14748e+09;-1.13476e+07;0;0;0;0;0;0;606537129;607857246;11342438
985;8.45383e-15;-107;1711;21534;15937.9;1;558;-2.14748e+09;-1.13046e+07;-1;0;0;0;-1;0;607363015;608695501;11421378
986;8.45383e-15;-108;1711;21534;15937.9;1;558;-2.14748e+09;-1.12619e+07;0;0;0;0;0;0;608186348;609531273;11500511
987;8.45383e-15;-109;1711;21534;15937.9;1;558;-2.14748e+09;-1.12194e+07;0;0;0;0;0;0;609007140;610364571;11579834
988;8.45383e-15;-109;1711;21534;15937.9;1;558;-2.14748e+09;-1.11772e+07;-1;0;0;0;-1;0;609825403;611195408;11659347
989;8.45383e-15;-110;1711;21534;15937.9;1;558;-2.14748e+09;-1.11352e+07;0;0;0;0;0;0;610641148;612023795;11739047
990;8.45383e-15;-111;1711;21534;15937.9;1;558;-2.14748e+09;-1.10935e+07;0;0;0;0;0;0;611454385;612849742;11818935
991;8.45383e-15;-111;1711;21534;15937.9;1;558;-2.14748e+09;-1.10521e+07;-1;0;0;0;-1;0;612265126;613673261;11899008
992;8.45383e-15;-111;1711;21534;15937.9;1;558;-2.14748e+09;-1.10109e+07;-1;0;0;0;-1;0;613073382;614494362;11979265
993;8.45383e-15;-112;1711;21534;15937.9;1;558;-2.14748e+09;-1.09699e+07;0;0;0;0;0;0;613879163;615313057;12059704
994;8.45383e-15;-113;1711;21534;15937.9;1;558;-2.14748e+09;-1.09292e+07;0;0;0;0;0;0;614682481;616129356;12140326
995;8.45383e-15;-113;1711;21534;15937.9;1;558;-2.14748e+09;-1.08888e+07;-1;0;0;0;-1;0;615483345;616943270;12221127
996;8.45383e-15;-114;1711;21534;15937.9;1;558;-2.14748e+09;-1.08486e+07;0;0;0;0;0;0;616281768;617754809;12302108
997;8.45383e-15;-115;1711;21534;15937.9;1;558;-2.14748e+09;-1.08086e+07;0;0;0;0;0;0;617077758;618563985;12383266
998;8.45383e-15;-115;1711;21534;15937.9;1;558;-2.14748e+09;-1.07688e+07;-1;0;0;0;-1;0;617871328;619370807;12464600
999;8.45383e-15;-116;1711;21534;15937.9;1;558;-2.14748e+09;-1.07293e+07;0;0;0;0;0;0;618662487;620175287;12546110
1000;8.45383e-15;-116;1711;21534;15937.9;1;558;-2.14748e+09;-1.069e+07;-1;0;0;0;-1;0;619451246;620977435;12627793
1001;8.45383e-15;-116;1711;21534;15937.9;1;558;-2.14748e+09;-1.0651e+07;-1;0;0;0;-1;0;620237615;621777261;12709649
1002;8.45383e-15;-117;1711;21534;15937.9;1;558;-2.14748e+09;-1.06122e+07;0;0;0;0;0;0;621021604;622574775;12791676
1003;8.45383e-15;-117;1711;21534;15937.9;1;558;-2.14748e+09;-1.05736e+07;-1;0;0;0;-1;0;621803225;623369987;12873873
1004;8.45383e-15;-118;1711;21534;15937.9;1;558;-2.14748e+09;-1.05352e+07;0;0;0;0;0;0;622582486;624162908;12956239
1005;8.45383e-15;-118;1711;21534;15937.9;1;558;-2.14748e+09;-1.04971e+07;-1;0;0;0;-1;0;623359398;624953549;13038772
1006;8.45383e-15;-119;1711;21534;15937.9;1;558;-2.14748e+09;-1.04592e+07;0;0;0;0;0;0;624133972;625741918;13121471
1007;8.45383e-15;-119;1711;21534;15937.9;1;558;-2.14748e+09;-1.04215e+07;-1;0;0;0;-1;0;624906216;626528026;13204334
1008;8.45383e-15;-120;1711;21534;15937.9;1;558;-2.14748e+09;-1.0384e+07;0;0;0;0;0;0;625676142;627311882;13287362
1009;8.45383e-15;-120;1711;21534;15937.9;1;558;-2.14748e+09;-1.03467e+07;-1;0;0;0;-1;0;626443759;628093498;13370552
1010;8.45383e-15;-120;1711;21534;15937.9;1;558;-2.14748e+09;-1.03096e+07;-1;0;0;0;-1;0;627209076;628872882;13453902
1011;8.45383e-15;-121;1711;21534;15937.9;1;558;-2.14748e+09;-1.02728e+07;0;0;0;0;0;0;627972104;629650044;13537413
1012;8.45383e-15;-121;1711;21534;15937.9;1;558;-2.14748e+09;-1.02362e+07;-1;0;0;0;-1;0;628732853;630424994;13621081
1013;8.45383e-15;-121;1711;21534;15937.9;1;558;-2.14748e+09;-1.01998e+07;-1;0;0;0;-1;0;629491331;631197741;13704908
1014;8.45383e-15;-122;1711;21534;15937.9;1;558;-2.14748e+09;-1.01635e+07;0;0;0;0;0;0;630247549;631968296;13788890
1015;8.45383e-15;-123;1711;21534;15937.9;1;558;-2.14748e+09;-1.01275e+07;0;0;0;0;0;0;631001516;632736667;13873026
1016;8.45383e-15;-124;1711;21534;15937.9;1;558;-2.14748e+09;-1.00917e+07;0;0;0;0;0;0;631753242;633502865;13957316
1017;8.45383e-15;-125;1711;21534;15937.9;1;558;-2.14748e+09;-1.00561e+07;0;0;0;0;0;0;632502735;634266897;14041759
1018;8.45383e-15;-125;1711;21534;15937.9;1;558;-2.14748e+09;-1.00207e+07;-1;0;0;0;-1;0;633250006;635028775;14126352
1019;8.45383e-15;-126;1711;21534;15937.9;1;558;-2.14748e+09;-9.98552e+06;0;0;0;0;0;0;633995064;635788507;14211095
1020;8.45383e-15;-127;1711;21534;15937.9;1;558;-2.14748e+09;-9.95051e+06;0;0;0;0;0;0;634737918;636546102;14295987
1021;8.45383e-15;-128;1711;21534;15937.9;1;558;-2.14748e+09;-9.9157e+06;0;0;0;0;0;0;635478577;637301570;14381025
1022;8.45383e-15;-129;1711;21534;15937.9;1;558;-2.14748e+09;-9.88108e+06;0;0;0;0;0;0;636217051;638054919;14466210
1023;8.45383e-15;-129;1711;21534;15937.9;1;558;-2.14748e+09;-9.84666e+06;-1;0;0;0;-1;0;636953348;638806159;14551539
1024;8.45383e-15;-130;1711;21534;15937.9;1;558;-2.14748e+09;-9.81242e+06;0;0;0;0;0;0;637687478;639555299;14637012
1025;8.45383e-15;-130;1711;21534;15937.9;1;558;-2.14748e+09;-9.77838e+06;-1;0;0;0;-1;0;638419449;640302347;14722628
1026;8.45383e-15;-131;1711;21534;15937.9;1;558;-2.14748e+09;-9.74452e+06;0;0;0;0;0;0;639149271;641047313;14808384
1027;8.45383e-15;-131;1711;21534;15937.9;1;558;-2.14748e+09;-9.71085e+06;-1;0;0;0;-1;0;639876953;641790205;14894280
1028;8.45383e-15;-131;1711;21534;15937.9;1;558;-2.14748e+09;-9.67736e+06;-1;0;0;0;-1;0;640602503;642531033;14980315
1029;8.45383e-15;-131;1711;21534;15937.9;1;558;-2.14748e+09;-9.64406e+06;-1;0;0;0;-1;0;641325930;643269805;15066487
1030;8.45383e-15;-131;1711;21534;15937.9;1;558;-2.14748e+09;-9.61094e+06;-1;0;0;0;-1;0;642047243;644006529;15152796
1031;8.45383e-15;-131;1711;21534;15937.9;1;558;-2.14748e+09;-9.578e+06;-1;0;0;0;-1;0;642766450;644741215;15239239
1032;8.45383e-15;-131;1711;21534;15937.9;1;558;-2.14748e+09;-9.54524e+06;-1;0;0;0;-1;0;643483561;645473871;15325816
1033;8.45383e-15;-131;1711;21534;15937.9;1;558;-2.14748e+09;-9.51266e+06;-1;0;0;0;-1;0;644198584;646204505;15412526
1034;8.45383e-15;-131;1711;21534;15937.9;1;558;-2.14748e+09;-9.48025e+06;-1;0;0;0;-1;0;644911527;646933126;15499367
1035;8.45383e-15;-132;1711;21534;15937.9;1;558;-2.14748e+09;-9.44802e+06;0;0;0;0;0;0;645622399;647659743;15586339
1036;8.45383e-15;-132;1711;21534;15937.9;1;558;-2.14748e+09;-9.41596e+06;-1;0;0;0;-1;0;646331209;648384363;15673439
1037;8.45383e-15;-132;1711;21534;15937.9;1;558;-2.14748e+09;-9.38407e+06;-1;0;0;0;-1;0;647037964;649106996;15760667
1038;8.45383e-15;-132;1711;21534;15937.9;1;558;-2.14748e+09;-9.35236e+06;-1;0;0;0;-1;0;647742674;649827649;15848022
1039;8.45383e-15;-133;1711;21534;15937.9;1;558;-2.14748e+09;-9.32081e+06;0;0;0;0;0;0;648445346;650546331;15935502
1040;8.45383e-15;-134;1711;21534;15937.9;1;558;-2.14748e+09;-9.28943e+06;0;0;0;0;0;0;649145989;651263049;16023107
1041;8.45383e-15;-135;1711;21534;15937.9;1;558;-2.14748e+09;-9.25822e+06;0;0;0;0;0;0;649844611;651977813;16110834
1042;8.45383e-15;-135;1711;21534;15937.9;1;558;-2.14748e+09;-9.22718e+06;-1;0;0;0;-1;0;650541220;652690630;16198683
1043;8.45383e-15;-135;1711;21534;15937.9;1;558;-2.14748e+09;-9.1963e+06;-1;0;0;0;-1;0;651235824;653401508;16286654
1044;8.45383e-15;-135;1711;21534;15937.9;1;558;-2.14748e+09;-9.16558e+06;-1;0;0;0;-1;0;651928432;654110456;16374743
1045;8.45383e-15;-136;1711;21534;15937.9;1;558;-2.14748e+09;-9.13502e+06;0;0;0;0;0;0;652619051;654817480;16462951
1046;8.45383e-15;-137;1711;21534;15937.9;1;558;-2.14748e+09;-9.10463e+06;0;0;0;0;0;0;653307690;655522590;16551277
1047;8.45383e-15;-137;1711;21534;15937.9;1;558;-2.14748e+09;-9.07439e+06;-1;0;0;0;-1;0;653994356;656225793;16639718
1048;8.45383e-15;-138;1711;21534;15937.9;1;558;-2.14748e+09;-9.04431e+06;0;0;0;0;0;0;654679058;656927096;16728275
1049;8.45383e-15;-138;1711;21534;15937.9;1;558;-2.14748e+09;-9.01439e+06;-1;0;0;0;-1;0;655361803;657626508;16816945
1050;8.45383e-15;-139;1711;21534;15937.9;1;558;-2.14748e+09;-8.98462e+06;0;0;0;0;0;0;656042598;658324037;16905728
1051;8.45383e-15;-140;1711;21534;15937.9;1;558;-2.14748e+09;-8.95501e+06;0;0;0;0;0;0;656721453;659019689;16994622
1052;8.45383e-15;-140;1711;21534;15937.9;1;558;-2.14748e+09;-8.92556e+06;-1;0;0;0;-1;0;657398374;659713473;17083627
1053;8.45383e-15;-140;1711;21534;15937.9;1;558;-2.14748e+09;-8.89625e+06;-1;0;0;0;-1;0;658073369;660405397;17172740
1054;8.45383e-15;-141;1711;21534;15937.9;1;558;-2.14748e+09;-8.8671e+06;0;0;0;0;0;0;658746446;661095467;17261962
1055;8.45383e-15;-141;1711;21534;15937.9;1;558;-2.14748e+09;-8.83809e+06;-1;0;0;0;-1;0;659417613;661783692;17351291
1056;8.45383e-15;-141;1711;21534;15937.9;1;558;-2.14748e+09;-8.80924e+06;-1;0;0;0;-1;0;660086876;662470078;17440726
1057;8.45383e-15;-141;1711;21534;15937.9;1;558;-2.14748e+09;-8.78053e+06;-1;0;0;0;-1;0;660754244;663154634;17530266
1058;8.45383e-15;-141;1711;21534;15937.9;1;558;-2.14748e+09;-8.75197e+06;-1;0;0;0;-1;0;661419724;663837366;17619909
1059;8.45383e-15;-141;1711;21534;15937.9;1;558;-2.14748e+09;-8.72355e+06;-1;0;0;0;-1;0;662083324;664518282;17709654
1060;8.45383e-15;-141;1711;21534;15937.9;1;558;-2.14748e+09;-8.69528e+06;-1;0;0;0;-1;0;662745050;665197389;17799501
1061;8.45383e-15;-141;1711;21534;15937.9;1;558;-2.14748e+09;-8.66715e+06;-1;0;0;0;-1;0;663404911;665874696;17889449
1062;8.45383e-15;-142;1711;21534;15937.9;1;558;-2.14748e+09;-8.63917e+06;0;0;0;0;0;0;664062913;666550207;17979495
1063;8.45383e-15;-143;1711;21534;15937.9;1;558;-2.14748e+09;-8.61132e+06;0;0;0;0;0;0;664719064;667223932;18069640
1064;8.45383e-15;-144;1711;21534;15937.9;1;558;-2.14748e+09;-8.58362e+06;0;0;0;0;0;0;665373371;667895877;18159881
1065;8.45383e-15;-144;1711;21534;15937.9;1;558;-2.14748e+09;-8.55606e+06;-1;0;0;0;-1;0;666025842;668566049;18250218
1066;8.45383e-15;-145;1711;21534;15937.9;1;558;-2.14748e+09;-8.52863e+06;0;0;0;0;0;0;666676483;669234455;18340651
1067;8.45383e-15;-145;1711;21534;15937.9;1;558;-2.14748e+09;-8.50134e+06;-1;0;0;0;-1;0;667325301;669901102;18431177
1068;8.45383e-15;-146;1711;21534;15937.9;1;558;-2.14748e+09;-8.47419e+06;0;0;0;0;0;0;667972304;670565997;18521795
1069;8.45383e-15;-146;1711;21534;15937.9;1;558;-2.14748e+09;-8.44717e+06;-1;0;0;0;-1;0;668617498;671229148;18612505
1070;8.45383e-15;-146;1711;21534;15937.9;1;558;-2.14748e+09;-8.42028e+06;-1;0;0;0;-1;0;669260892;671890561;18703306
1071;8.45383e-15;-146;1711;21534;15937.9;1;558;-2.14748e+09;-8.39354e+06;-1;0;0;0;-1;0;669902490;672550242;18794196
1072;8.45383e-15;-147;1711;21534;15937.9;1;558;-2.14748e+09;-8.36692e+06;0;0;0;0;0;0;670542302;673208199;18885175
1073;8.45383e-15;-148;1711;21534;15937.9;1;558;-2.14748e+09;-8.34043e+06;0;0;0;0;0;0;671180333;673864439;18976240
1074;8.45383e-15;-148;1711;21534;15937.9;1;558;-2.14748e+09;-8.31407e+06;-1;0;0;0;-1;0;671816590;674518968;19067392
1075;8.45383e-15;-149;1711;21534;15937.9;1;558;-2.14748e+09;-8.28785e+06;0;0;0;0;0;0;672451080;675171793;19158630
1076;8.45383e-15;-150;1711;21534;15937.9;1;558;-2.14748e+09;-8.26175e+06;0;0;0;0;0;0;673083811;675822920;19249951
1077;8.45383e-15;-150;1711;21534;15937.9;1;558;-2.14748e+09;-8.23578e+06;-1;0;0;0;-1;0;673714788;676472357;19341356
1078;8.45383e-15;-150;1711;21534;15937.9;1;558;-2.14748e+09;-8.20994e+06;-1;0;0;0;-1;0;674344018;677120109;19432842
1079;8.45383e-15;-150;1711;21534;15937.9;1;558;-2.14748e+09;-8.18422e+06;-1;0;0;0;-1;0;674971508;677766184;19524410
1080;8.45383e-15;-150;1711;21534;15937.9;1;558;-2.14748e+09;-8.15862e+06;-1;0;0;0;-1;0;675597265;678410588;19616058
1081;8.45383e-15;-150;1711;21534;15937.9;1;558;-2.14748e+09;-8.13316e+06;-1;0;0;0;-1;0;676221296;679053327;19707784
1082;8.45383e-15;-151;1711;21534;15937.9;1;558;-2.14748e+09;-8.10781e+06;0;0;0;0;0;0;676843606;679694408;19799589
1083;8.45383e-15;-152;1711;21534;15937.9;1;558;-2.14748e+09;-8.08259e+06;0;0;0;0;0;0;677464202;680333837;19891470
1084;8.45383e-15;-152;1711;21534;15937.9;1;558;-2.14748e+09;-8.05748e+06;-1;0;0;0;-1;0;678083092;680971621;19983428
1085;8.45383e-15;-152;1711;21534;15937.9;1;558;-2.14748e+09;-8.0325e+06;-1;0;0;0;-1;0;678700281;681607765;20075460
1086;8.45383e-15;-152;1711;21534;15937.9;1;558;-2.14748e+09;-8.00764e+06;-1;0;0;0;-1;0;679315775;682242277;20167566
1087;8.45383e-15;-152;1711;21534;15937.9;1;558;-2.14748e+09;-7.9829e+06;-1;0;0;0;-1;0;679929582;682875162;20259745
1088;8.45383e-15;-152;1711;21534;15937.9;1;558;-2.14748e+09;-7.95827e+06;-1;0;0;0;-1;0;680541707;683506427;20351996
1089;8.45383e-15;-153;1711;21534;15937.9;1;558;-2.14748e+09;-7.93376e+06;0;0;0;0;0;0;681152157;684136078;20444318
1090;8.45383e-15;-154;1711;21534;15937.9;1;558;-2.14748e+09;-7.90937e+06;0;0;0;0;0;0;681760939;684764121;20536710
1091;8.45383e-15;-155;1711;21534;15937.9;1;558;-2.14748e+09;-7.8851e+06;0;0;0;0;0;0;682368057;685390563;20629171
1092;8.45383e-15;-156;1711;21534;15937.9;1;558;-2.14748e+09;-7.86094e+06;0;0;0;0;0;0;682973520;686015408;20721700
1093;8.45383e-15;-156;1711;21534;15937.9;1;558;-2.14748e+09;-7.83689e+06;-1;0;0;0;-1;0;683577332;686638664;20814295
1094;8.45383e-15;-157;1711;21534;15937.9;1;558;-2.14748e+09;-7.81296e+06;0;0;0;0;0;0;684179500;687260337;20906957
1095;8.45383e-15;-157;1711;21534;15937.9;1;558;-2.14748e+09;-7.78914e+06;-1;0;0;0;-1;0;684780030;687880432;20999684
1096;8.45383e-15;-157;1711;21534;15937.9;1;558;-2.14748e+09;-7.76543e+06;-1;0;0;0;-1;0;685378929;688498955;21092474
1097;8.45383e-15;-157;1711;21534;15937.9;1;558;-2.14748e+09;-7.74183e+06;-1;0;0;0;-1;0;685976202;689115912;21185328
1098;8.45383e-15;-158;1711;21534;15937.9;1;558;-2.14748e+09;-7.71834e+06;0;0;0;0;0;0;686571855;689731310;21278244
1099;8.45383e-15;-158;1711;21534;15937.9;1;558;-2.14748e+09;-7.69496e+06;-1;0;0;0;-1;0;687165894;690345154;21371221
1100;8.45383e-15;-158;1711;21534;15937.9;1;558;-2.14748e+09;-7.67169e+06;-1;0;0;0;-1;0;687758326;690957450;21464258
1101;8.45383e-15;-159;1711;21534;15937.9;1;558;-2.14748e+09;-7.64853e+06;0;0;0;0;0;0;688349156;691568203;21557354
1102;8.45383e-15;-159;1711;21534;15937.9;1;558;-2.14748e+09;-7.62547e+06;-1;0;0;0;-1;0;688938391;692177420;21650509
1103;8.45383e-15;-160;1711;21534;15937.9;1;558;-2.14748e+09;-7.60252e+06;0;0;0;0;0;0;689526035;692785106;21743721
1104;8.45383e-15;-161;1711;21534;15937.9;1;558;-2.14748e+09;-7.57968e+06;0;0;0;0;0;0;690112095;693391267;21836990
1105;8.45383e-15;-162;1711;21534;15937.9;1;558;-2.14748e+09;-7.55694e+06;0;0;0;0;0;0;690696577;693995908;21930314
1106;8.45383e-15;-163;1711;21534;15937.9;1;558;-2.14748e+09;-7.53431e+06;0;0;0;0;0;0;691279486;694599036;22023692
1107;8.45383e-15;-163;1711;21534;15937.9;1;558;-2.14748e+09;-7.51178e+06;-1;0;0;0;-1;0;691860829;695200656;22117124
1108;8.45383e-15;-164;1711;21534;15937.9;1;558;-2.14748e+09;-7.48936e+06;0;0;0;0;0;0;692440611;695800773;22210609
1109;8.45383e-15;-164;1711;21534;15937.9;1;558;-2.14748e+09;-7.46703e+06;-1;0;0;0;-1;0;693018837;696399393;22304146
1110;8.45383e-15;-165;1711;21534;15937.9;1;558;-2.14748e+09;-7.44481e+06;0;0;0;0;0;0;693595514;696996522;22397734
1111;8.45383e-15;-165;1711;21534;15937.9;1;558;-2.14748e+09;-7.42269e+06;-1;0;0;0;-1;0;694170647;697592165;22491371
1112;8.45383e-15;-165;1711;21534;15937.9;1;558;-2.14748e+09;-7.40066e+06;-1;0;0;0;-1;0;694744242;698186327;22585058
1113;8.45383e-15;-166;1711;21534;15937.9;1;558;-2.14748e+09;-7.37874e+06;0;0;0;0;0;0;695316303;698779014;22678793
1114;8.45383e-15;-166;1711;21534;15937.9;1;558;-2.14748e+09;-7.35692e+06;-1;0;0;0;-1;0;695886838;699370232;22772575
1115;8.45383e-15;-166;1711;21534;15937.9;1;558;-2.14748e+09;-7.33519e+06;-1;0;0;0;-1;0;696455851;699959985;22866404
1116;8.45383e-15;-166;1711;21534;15937.9;1;558;-2.14748e+09;-7.31357e+06;-1;0;0;0;-1;0;697023348;700548279;22960278
1117;8.45383e-15;-166;1711;21534;15937.9;1;558;-2.14748e+09;-7.29204e+06;-1;0;0;0;-1;0;697589334;701135120;23054196
1118;8.45383e-15;-166;1711;21534;15937.9;1;558;-2.14748e+09;-7.2706e+06;-1;0;0;0;-1;0;698153814;701720512;23148159
1119;8.45383e-15;-166;1711;21534;15937.9;1;558;-2.14748e+09;-7.24926e+06;-1;0;0;0;-1;0;698716795;702304462;23242164
1120;8.45383e-15;-167;1711;21534;15937.9;1;558;-2.14748e+09;-7.22802e+06;0;0;0;0;0;0;699278282;702886973;23336211
1121;8.45383e-15;-168;1711;21534;15937.9;1;558;-2.14748e+09;-7.20687e+06;0;0;0;0;0;0;699838279;703468052;23430300
1122;8.45383e-15;-168;1711;21534;15937.9;1;558;-2.14748e+09;-7.18582e+06;-1;0;0;0;-1;0;700396793;704047704;23524428
1123;8.45383e-15;-169;1711;21534;15937.9;1;558;-2.14748e+09;-7.16485e+06;0;0;0;0;0;0;700953828;704625933;23618596
1124;8.45383e-15;-169;1711;21534;15937.9;1;558;-2.14748e+09;-7.14398e+06;-1;0;0;0;-1;0;701509390;705202745;23712803
1125;8.45383e-15;-169;1711;21534;15937.9;1;558;-2.14748e+09;-7.12321e+06;-1;0;0;0;-1;0;702063484;705778145;23807047
1126;8.45383e-15;-170;1711;21534;15937.9;1;558;-2.14748e+09;-7.10252e+06;0;0;0;0;0;0;702616116;706352139;23901328
1127;8.45383e-15;-171;1711;21534;15937.9;1;558;-2.14748e+09;-7.08193e+06;0;0;0;0;0;0;703167290;706924730;23995645
1128;8.45383e-15;-172;1711;21534;15937.9;1;558;-2.14748e+09;-7.06142e+06;0;0;0;0;0;0;703717012;707495924;24089997
1129;8.45383e-15;-173;1711;21534;15937.9;1;558;-2.14748e+09;-7.04101e+06;0;0;0;0;0;0;704265286;708065727;24184383
1130;8.45383e-15;-173;1711;21534;15937.9;1;558;-2.14748e+09;-7.02068e+06;-1;0;0;0;-1;0;704812119;708634142;24278803
1131;8.45383e-15;-173;1711;21534;15937.9;1;558;-2.14748e+09;-7.00044e+06;-1;0;0;0;-1;0;705357515;709201176;24373256
1132;8.45383e-15;-173;1711;21534;15937.9;1;558;-2.14748e+09;-6.98029e+06;-1;0;0;0;-1;0;705901479;709766832;24467740
1133;8.45383e-15;-174;1711;21534;15937.9;1;558;-2.14748e+09;-6.96023e+06;0;0;0;0;0;0;706444016;710331117;24562255
1134;8.45383e-15;-175;1711;21534;15937.9;1;558;-2.14748e+09;-6.94026e+06;0;0;0;0;0;0;706985132;710894033;24656801
1135;8.45383e-15;-176;1711;21534;15937.9;1;558;-2.14748e+09;-6.92037e+06;0;0;0;0;0;0;707524831;711455588;24751375
1136;8.45383e-15;-176;1711;21534;15937.9;1;558;-2.14748e+09;-6.90056e+06;-1;0;0;0;-1;0;708063118;712015785;24845979
1137;8.45383e-15;-177;1711;21534;15937.9;1;558;-2.14748e+09;-6.88085e+06;0;0;0;0;0;0;708599998;712574629;24940610
1138;8.45383e-15;-178;1711;21534;15937.9;1;558;-2.14748e+09;-6.86121e+06;0;0;0;0;0;0;709135477;713132125;25035268
1139;8.45383e-15;-179;1711;21534;15937.9;1;558;-2.14748e+09;-6.84166e+06;0;0;0;0;0;0;709669559;713688277;25129952
1140;8.45383e-15;-180;1711;21534;15937.9;1;558;-2.14748e+09;-6.8222e+06;0;0;0;0;0;0;710202248;714243091;25224661
1141;8.45383e-15;-180;1711;21534;15937.9;1;558;-2.14748e+09;-6.80282e+06;-1;0;0;0;-1;0;710733550;714796570;25319395
1142;8.45383e-15;-180;1711;21534;15937.9;1;558;-2.14748e+09;-6.78352e+06;-1;0;0;0;-1;0;711263470;715348721;25414153
1143;8.45383e-15;-180;1711;21534;15937.9;1;558;-2.14748e+09;-6.7643e+06;-1;0;0;0;-1;0;711792013;715899547;25508934
1144;8.45383e-15;-180;1711;21534;15937.9;1;558;-2.14748e+09;-6.74516e+06;-1;0;0;0;-1;0;712319182;716449053;25603737
1145;8.45383e-15;-180;1711;21534;15937.9;1;558;-2.14748e+09;-6.72611e+06;-1;0;0;0;-1;0;712844984;716997243;25698561
1146;8.45383e-15;-181;1711;21534;15937.9;1;558;-2.14748e+09;-6.70713e+06;0;0;0;0;0;0;713369423;717544123;25793406
1147;8.45383e-15;-181;1711;21534;15937.9;1;558;-2.14748e+09;-6.68824e+06;-1;0;0;0;-1;0;713892502;718089696;25888271
1148;8.45383e-15;-181;1711;21534;15937.9;1;558;-2.14748e+09;-6.66942e+06;-1;0;0;0;-1;0;714414229;718633967;25983155
1149;8.45383e-15;-181;1711;21534;15937.9;1;558;-2.14748e+09;-6.65069e+06;-1;0;0;0;-1;0;714934605;719176941;26078057
1150;8.45383e-15;-182;1711;21534;15937.9;1;558;-2.14748e+09;-6.63203e+06;0;0;0;0;0;0;715453638;719718623;26172977
1151;8.45383e-15;-183;1711;21534;15937.9;1;558;-2.14748e+09;-6.61345e+06;0;0;0;0;0;0;715971330;720259016;26267914
1152;8.45383e-15;-183;1711;21534;15937.9;1;558;-2.14748e+09;-6.59495e+06;-1;0;0;0;-1;0;716487687;720798125;26362867
1153;8.45383e-15;-184;1711;21534;15937.9;1;558;-2.14748e+09;-6.57652e+06;0;0;0;0;0;0;717002714;721335954;26457835
1154;8.45383e-15;-184;1711;21534;15937.9;1;558;-2.14748e+09;-6.55818e+06;-1;0;0;0;-1;0;717516414;721872508;26552818
1155;8.45383e-15;-185;1711;21534;15937.9;1;558;-2.14748e+09;-6.5399e+06;0;0;0;0;0;0;718028793;722407792;26647814
1156;8.45383e-15;-185;1711;21534;15937.9;1;558;-2.14748e+09;-6.52171e+06;-1;0;0;0;-1;0;718539855;722941809;26742824
1157;8.45383e-15;-186;1711;21534;15937.9;1;558;-2.14748e+09;-6.50359e+06;0;0;0;0;0;0;719049604;723474564;26837846
1158;8.45383e-15;-186;1711;21534;15937.9;1;558;-2.14748e+09;-6.48554e+06;-1;0;0;0;-1;0;719558045;724006061;26932880
1159;8.45383e-15;-186;1711;21534;15937.9;1;558;-2.14748e+09;-6.46757e+06;-1;0;0;0;-1;0;720065182;724536305;27027924
1160;8.45383e-15;-187;1711;21534;15937.9;1;558;-2.14748e+09;-6.44967e+06;0;0;0;0;0;0;720571020;725065300;27122979
1161;8.45383e-15;-188;1711;21534;15937.9;1;558;-2.14748e+09;-6.43184e+06;0;0;0;0;0;0;721075563;725593049;27218044
1162;8.45383e-15;-189;1711;21534;15937.9;1;558;-2.14748e+09;-6.41409e+06;0;0;0;0;0;0;721578816;726119558;27313117
1163;8.45383e-15;-189;1711;21534;15937.9;1;558;-2.14748e+09;-6.39642e+06;-1;0;0;0;-1;0;722080783;726644830;27408198
1164;8.45383e-15;-189;1711;21534;15937.9;1;558;-2.14748e+09;-6.37881e+06;-1;0;0;0;-1;0;722581468;727168869;27503287
1165;8.45383e-15;-190;1711;21534;15937.9;1;558;-2.14748e+09;-6.36127e+06;0;0;0;0;0;0;723080876;727691680;27598382
1166;8.45383e-15;-190;1711;21534;15937.9;1;558;-2.14748e+09;-6.34381e+06;-1;0;0;0;-1;0;723579010;728213267;27693484
1167;8.45383e-15;-190;1711;21534;15937.9;1;558;-2.14748e+09;-6.32642e+06;-1;0;0;0;-1;0;724075876;728733634;27788590
1168;8.45383e-15;-190;1711;21534;15937.9;1;558;-2.14748e+09;-6.30909e+06;-1;0;0;0;-1;0;724571478;729252786;27883701
1169;8.45383e-15;-190;1711;21534;15937.9;1;558;-2.14748e+09;-6.29184e+06;-1;0;0;0;-1;0;725065819;729770725;27978817
1170;8.45383e-15;-190;1711;21534;15937.9;1;558;-2.14748e+09;-6.27466e+06;-1;0;0;0;-1;0;725558904;730287456;28073935
1171;8.45383e-15;-191;1711;21534;15937.9;1;558;-2.14748e+09;-6.25754e+06;0;0;0;0;0;0;726050738;730802984;28169056
1172;8.45383e-15;-192;1711;21534;15937.9;1;558;-2.14748e+09;-6.2405e+06;0;0;0;0;0;0;726541324;731317311;28264178
1173;8.45383e-15;-192;1711;21534;15937.9;1;558;-2.14748e+09;-6.22352e+06;-1;0;0;0;-1;0;727030666;731830443;28359302
1174;8.45383e-15;-192;1711;21534;15937.9;1;558;-2.14748e+09;-6.20661e+06;-1;0;0;0;-1;0;727518769;732342383;28454426
1175;8.45383e-15;-193;1711;21534;15937.9;1;558;-2.14748e+09;-6.18977e+06;0;0;0;0;0;0;728005637;732853135;28549551
1176;8.45383e-15;-193;1711;21534;15937.9;1;558;-2.14748e+09;-6.173e+06;-1;0;0;0;-1;0;728491274;733362703;28644674
1177;8.45383e-15;-193;1711;21534;15937.9;1;558;-2.14748e+09;-6.15629e+06;-1;0;0;0;-1;0;728975684;733871091;28739796
1178;8.45383e-15;-193;1711;21534;15937.9;1;558;-2.14748e+09;-6.13965e+06;-1;0;0;0;-1;0;729458871;734378303;28834916
1179;8.45383e-15;-194;1711;21534;15937.9;1;558;-2.14748e+09;-6.12307e+06;0;0;0;0;0;0;729940839;734884343;28930033
1180;8.45383e-15;-195;1711;21534;15937.9;1;558;-2.14748e+09;-6.10656e+06;0;0;0;0;0;0;730421593;735389214;29025146
1181;8.45383e-15;-195;1711;21534;15937.9;1;558;-2.14748e+09;-6.09012e+06;-1;0;0;0;-1;0;730901136;735892921;29120256
1182;8.45383e-15;-195;1711;21534;15937.9;1;558;-2.14748e+09;-6.07374e+06;-1;0;0;0;-1;0;731379471;736395466;29215360
1183;8.45383e-15;-195;1711;21534;15937.9;1;558;-2.14748e+09;-6.05743e+06;-1;0;0;0;-1;0;731856605;736896855;29310460
1184;8.45383e-15;-196;1711;21534;15937.9;1;558;-2.14748e+09;-6.04118e+06;0;0;0;0;0;0;732332539;737397091;29405553
1185;8.45383e-15;-196;1711;21534;15937.9;1;558;-2.14748e+09;-6.02499e+06;-1;0;0;0;-1;0;732807279;737896177;29500640
1186;8.45383e-15;-196;1711;21534;15937.9;1;558;-2.14748e+09;-6.00886e+06;-1;0;0;0;-1;0;733280827;738394117;29595719
1187;8.45383e-15;-196;1711;21534;15937.9;1;558;-2.14748e+09;-5.9928e+06;-1;0;0;0;-1;0;733753189;738890916;29690791
1188;8.45383e-15;-197;1711;21534;15937.9;1;558;-2.14748e+09;-5.97681e+06;0;0;0;0;0;0;734224367;739386576;29785854
1189;8.45383e-15;-197;1711;21534;15937.9;1;558;-2.14748e+09;-5.96087e+06;-1;0;0;0;-1;0;734694366;739881101;29880908
1190;8.45383e-15;-198;1711;21534;15937.9;1;558;-2.14748e+09;-5.945e+06;0;0;0;0;0;0;735163190;740374496;29975952
1191;8.45383e-15;-199;1711;21534;15937.9;1;558;-2.14748e+09;-5.92918e+06;0;0;0;0;0;0;735630842;740866764;30070986
1192;8.45383e-15;-199;1711;21534;15937.9;1;558;-2.14748e+09;-5.91343e+06;-1;0;0;0;-1;0;736097327;741357907;30166009
1193;8.45383e-15;-200;1711;21534;15937.9;1;558;-2.14748e+09;-5.89774e+06;0;0;0;0;0;0;736562647;741847931;30261021
1194;8.45383e-15;-200;1711;21534;15937.9;1;558;-2.14748e+09;-5.88211e+06;-1;0;0;0;-1;0;737026808;742336838;30356020
1195;8.45383e-15;-201;1711;21534;15937.9;1;558;-2.14748e+09;-5.86654e+06;0;0;0;0;0;0;737489812;742824633;30451006
1196;8.45383e-15;-201;1711;21534;15937.9;1;558;-2.14748e+09;-5.85103e+06;-1;0;0;0;-1;0;737951663;743311318;30545979
1197;8.45383e-15;-201;1711;21534;15937.9;1;558;-2.14748e+09;-5.83558e+06;-1;0;0;0;-1;0;738412366;743796898;30640939
1198;8.45383e-15;-201;1711;21534;15937.9;1;558;-2.14748e+09;-5.82019e+06;-1;0;0;0;-1;0;738871923;744281375;30735883
1199;8.45383e-15;-201;1711;21534;15937.9;1;558;-2.14748e+09;-5.80486e+06;-1;0;0;0;-1;0;739330339;744764754;30830813
1200;8.45383e-15;-201;1711;21534;15937.9;1;558;-2.14748e+09;-5.78959e+06;-1;0;0;0;-1;0;739787617;745247037;30925726
1201;8.45383e-15;-201;1711;21534;15937.9;1;558;-2.14748e+09;-5.77437e+06;-1;0;0;0;-1;0;740243761;745728229;31020624
1202;8.45383e-15;-201;1711;21534;15937.9;1;558;-2.14748e+09;-5.75921e+06;-1;0;0;0;-1;0;740698775;746208333;31115505
1203;8.45383e-15;-202;1711;21534;15937.9;1;558;-2.14748e+09;-5.74411e+06;0;0;0;0;0;0;741152661;746687352;31210368
1204;8.45383e-15;-202;1711;21534;15937.9;1;558;-2.14748e+09;-5.72907e+06;-1;0;0;0;-1;0;741605425;747165289;31305213
1205;8.45383e-15;-203;1711;21534;15937.9;1;558;-2.14748e+09;-5.71408e+06;0;0;0;0;0;0;742057069;747642149;31400040
1206;8.45383e-15;-204;1711;21534;15937.9;1;558;-2.14748e+09;-5.69915e+06;0;0;0;0;0;0;742507597;748117934;31494847
1207;8.45383e-15;-204;1711;21534;15937.9;1;558;-2.14748e+09;-5.68428e+06;-1;0;0;0;-1;0;742957013;748592648;31589635
1208;8.45383e-15;-205;1711;21534;15937.9;1;558;-2.14748e+09;-5.66946e+06;0;0;0;0;0;0;743405319;749066294;31684403
1209;8.45383e-15;-206;1711;21534;15937.9;1;558;-2.14748e+09;-5.6547e+06;0;0;0;0;0;0;743852521;749538876;31779150
1210;8.45383e-15;-206;1711;21534;15937.9;1;558;-2.14748e+09;-5.63999e+06;-1;0;0;0;-1;0;744298620;750010397;31873875
1211;8.45383e-15;-207;1711;21534;15937.9;1;558;-2.14748e+09;-5.62534e+06;0;0;0;0;0;0;744743622;750480860;31968579
1212;8.45383e-15;-208;1711;21534;15937.9;1;558;-2.14748e+09;-5.61074e+06;0;0;0;0;0;0;745187528;750950268;32063260
1213;8.45383e-15;-209;1711;21534;15937.9;1;558;-2.14748e+09;-5.5962e+06;0;0;0;0;0;0;745630344;751418626;32157918
1214;8.45383e-15;-210;1711;21534;15937.9;1;558;-2.14748e+09;-5.58171e+06;0;0;0;0;0;0;746072071;751885935;32252553
1215;8.45383e-15;-210;1711;21534;15937.9;1;558;-2.14748e+09;-5.56728e+06;-1;0;0;0;-1;0;746512714;752352200;32347164
1216;8.45383e-15;-210;1711;21534;15937.9;1;558;-2.14748e+09;-5.5529e+06;-1;0;0;0;-1;0;746952276;752817424;32441750
1217;8.45383e-15;-210;1711;21534;15937.9;1;558;-2.14748e+09;-5.53857e+06;-1;0;0;0;-1;0;747390761;753281609;32536311
1218;8.45383e-15;-211;1711;21534;15937.9;1;558;-2.14748e+09;-5.5243e+06;0;0;0;0;0;0;747828172;753744760;32630846
1219;8.45383e-15;-212;1711;21534;15937.9;1;558;-2.14748e+09;-5.51007e+06;0;0;0;0;0;0;748264511;754206878;32725356
1220;8.45383e-15;-213;1711;21534;15937.9;1;558;-2.14748e+09;-5.4959e+06;0;0;0;0;0;0;748699784;754667969;32819838
1221;8.45383e-15;-213;1711;21534;15937.9;1;558;-2.14748e+09;-5.48179e+06;-1;0;0;0;-1;0;749133992;755128034;32914294
1222;8.45383e-15;-214;1711;21534;15937.9;1;558;-2.14748e+09;-5.46772e+06;0;0;0;0;0;0;749567140;755587076;33008721
1223;8.45383e-15;-215;1711;21534;15937.9;1;558;-2.14748e+09;-5.45371e+06;0;0;0;0;0;0;749999230;756045100;33103121
1224;8.45383e-15;-216;1711;21534;15937.9;1;558;-2.14748e+09;-5.43974e+06;0;0;0;0;0;0;750430267;756502107;33197492
1225;8.45383e-15;-217;1711;21534;15937.9;1;558;-2.14748e+09;-5.42583e+06;0;0;0;0;0;0;750860253;756958102;33291833
1226;8.45383e-15;-218;1711;21534;15937.9;1;558;-2.14748e+09;-5.41197e+06;0;0;0;0;0;0;751289191;757413087;33386145
1227;8.45383e-15;-218;1711;21534;15937.9;1;558;-2.14748e+09;-5.39816e+06;-1;0;0;0;-1;0;751717085;757867066;33480427
1228;8.45383e-15;-218;1711;21534;15937.9;1;558;-2.14748e+09;-5.3844e+06;-1;0;0;0;-1;0;752143939;758320041;33574678
1229;8.45383e-15;-219;1711;21534;15937.9;1;558;-2.14748e+09;-5.37069e+06;0;0;0;0;0;0;752569755;758772015;33668898
1230;8.45383e-15;-219;1711;21534;15937.9;1;558;-2.14748e+09;-5.35702e+06;-1;0;0;0;-1;0;752994536;759222992;33763086
1231;8.45383e-15;-220;1711;21534;15937.9;1;558;-2.14748e+09;-5.34341e+06;0;0;0;0;0;0;753418286;759672975;33857242
1232;8.45383e-15;-221;1711;21534;15937.9;1;558;-2.14748e+09;-5.32985e+06;0;0;0;0;0;0;753841008;760121966;33951365
1233;8.45383e-15;-222;1711;21534;15937.9;1;558;-2.14748e+09;-5.31634e+06;0;0;0;0;0;0;754262706;760569968;34045455
1234;8.45383e-15;-223;1711;21534;15937.9;1;558;-2.14748e+09;-5.30287e+06;0;0;0;0;0;0;754683382;761016985;34139512
1235;8.45383e-15;-223;1711;21534;15937.9;1;558;-2.14748e+09;-5.28945e+06;-1;0;0;0;-1;0;755103039;761463020;34233534
1236;8.45383e-15;-224;1711;21534;15937.9;1;558;-2.14748e+09;-5.27608e+06;0;0;0;0;0;0;755521682;761908075;34327522
1237;8.45383e-15;-224;1711;21534;15937.9;1;558;-2.14748e+09;-5.26276e+06;-1;0;0;0;-1;0;755939312;762352154;34421475
1238;8.45383e-15;-225;1711;21534;15937.9;1;558;-2.14748e+09;-5.24949e+06;0;0;0;0;0;0;756355933;762795259;34515393
1239;8.45383e-15;-225;1711;21534;15937.9;1;558;-2.14748e+09;-5.23626e+06;-1;0;0;0;-1;0;756771548;763237393;34609274
1240;8.45383e-15;-225;1711;21534;15937.9;1;558;-2.14748e+09;-5.22308e+06;-1;0;0;0;-1;0;757186161;763678560;34703119
1241;8.45383e-15;-226;1711;21534;15937.9;1;558;-2.14748e+09;-5.20995e+06;0;0;0;0;0;0;757599773;764118761;34796927
1242;8.45383e-15;-226;1711;21534;15937.9;1;558;-2.14748e+09;-5.19686e+06;-1;0;0;0;-1;0;758012390;764558001;34890698
1243;8.45383e-15;-227;1711;21534;15937.9;1;558;-2.14748e+09;-5.18382e+06;0;0;0;0;0;0;758424012;764996281;34984431
1244;8.45383e-15;-227;1711;21534;15937.9;1;558;-2.14748e+09;-5.17083e+06;-1;0;0;0;-1;0;758834644;765433605;35078126
1245;8.45383e-15;-227;1711;21534;15937.9;1;558;-2.14748e+09;-5.15788e+06;-1;0;0;0;-1;0;759244289;765869976;35171783
1246;8.45383e-15;-228;1711;21534;15937.9;1;558;-2.14748e+09;-5.14498e+06;0;0;0;0;0;0;759652949;766305396;35265400
1247;8.45383e-15;-229;1711;21534;15937.9;1;558;-2.14748e+09;-5.13212e+06;0;0;0;0;0;0;760060627;766739868;35358977
1248;8.45383e-15;-229;1711;21534;15937.9;1;558;-2.14748e+09;-5.11931e+06;-1;0;0;0;-1;0;760467328;767173396;35452515
1249;8.45383e-15;-230;1711;21534;15937.9;1;558;-2.14748e+09;-5.10655e+06;0;0;0;0;0;0;760873052;767605981;35546012
1250;8.45383e-15;-231;1711;21534;15937.9;1;558;-2.14748e+09;-5.09382e+06;0;0;0;0;0;0;761277804;768037626;35639468
1251;8.45383e-15;-232;1711;21534;15937.9;1;558;-2.14748e+09;-5.08115e+06;0;0;0;0;0;0;761681587;768468335;35732884
1252;8.45383e-15;-233;1711;21534;15937.9;1;558;-2.14748e+09;-5.06852e+06;0;0;0;0;0;0;762084403;768898111;35826257
1253;8.45383e-15;-234;1711;21534;15937.9;1;558;-2.14748e+09;-5.05592e+06;0;0;0;0;0;0;762486256;769326955;35919588
1254;8.45383e-15;-235;1711;21534;15937.9;1;558;-2.14748e+09;-5.04338e+06;0;0;0;0;0;0;762887147;769754870;36012877
1255;8.45383e-15;-235;1711;21534;15937.9;1;558;-2.14748e+09;-5.03088e+06;-1;0;0;0;-1;0;763287081;770181860;36106123
1256;8.45383e-15;-235;1711;21534;15937.9;1;558;-2.14748e+09;-5.01842e+06;-1;0;0;0;-1;0;763686060;770607927;36199325
1257;8.45383e-15;-235;1711;21534;15937.9;1;558;-2.14748e+09;-5.006e+06;-1;0;0;0;-1;0;764084087;771033073;36292484
1258;8.45383e-15;-235;1711;21534;15937.9;1;558;-2.14748e+09;-4.99363e+06;-1;0;0;0;-1;0;764481165;771457302;36385598
1259;8.45383e-15;-235;1711;21534;15937.9;1;558;-2.14748e+09;-4.9813e+06;-1;0;0;0;-1;0;764877296;771880617;36478668
1260;8.45383e-15;-235;1711;21534;15937.9;1;558;-2.14748e+09;-4.96901e+06;-1;0;0;0;-1;0;765272484;772303018;36571692
1261;8.45383e-15;-236;1711;21534;15937.9;1;558;-2.14748e+09;-4.95677e+06;0;0;0;0;0;0;765666731;772724510;36664672
1262;8.45383e-15;-237;1711;21534;15937.9;1;558;-2.14748e+09;-4.94456e+06;0;0;0;0;0;0;766060041;773145096;36757605
1263;8.45383e-15;-238;1711;21534;15937.9;1;558;-2.14748e+09;-4.9324e+06;0;0;0;0;0;0;766452415;773564777;36850492
1264;8.45383e-15;-238;1711;21534;15937.9;1;558;-2.14748e+09;-4.92028e+06;-1;0;0;0;-1;0;766843858;773983556;36943333
1265;8.45383e-15;-238;1711;21534;15937.9;1;558;-2.14748e+09;-4.90821e+06;-1;0;0;0;-1;0;767234371;774401436;37036127
1266;8.45383e-15;-238;1711;21534;15937.9;1;558;-2.14748e+09;-4.89617e+06;-1;0;0;0;-1;0;767623957;774818419;37128873
1267;8.45383e-15;-238;1711;21534;15937.9;1;558;-2.14748e+09;-4.88417e+06;-1;0;0;0;-1;0;768012620;775234509;37221571
1268;8.45383e-15;-238;1711;21534;15937.9;1;558;-2.14748e+09;-4.87222e+06;-1;0;0;0;-1;0;768400361;775649707;37314221
1269;8.45383e-15;-239;1711;21534;15937.9;1;558;-2.14748e+09;-4.8603e+06;0;0;0;0;0;0;768787185;776064016;37406823
1270;8.45383e-15;-239;1711;21534;15937.9;1;558;-2.14748e+09;-4.84843e+06;-1;0;0;0;-1;0;769173092;776477439;37499376
1271;8.45383e-15;-239;1711;21534;15937.9;1;558;-2.14748e+09;-4.83659e+06;-1;0;0;0;-1;0;769558087;776889978;37591879
1272;8.45383e-15;-240;1711;21534;15937.9;1;558;-2.14748e+09;-4.8248e+06;0;0;0;0;0;0;769942172;777301636;37684333
1273;8.45383e-15;-241;1711;21534;15937.9;1;558;-2.14748e+09;-4.81304e+06;0;0;0;0;0;0;770325349;777712415;37776737
1274;8.45383e-15;-241;1711;21534;15937.9;1;558;-2.14748e+09;-4.80133e+06;-1;0;0;0;-1;0;770707622;778122319;37869090
1275;8.45383e-15;-242;1711;21534;15937.9;1;558;-2.14748e+09;-4.78965e+06;0;0;0;0;0;0;771088992;778531348;37961393
1276;8.45383e-15;-243;1711;21534;15937.9;1;558;-2.14748e+09;-4.77802e+06;0;0;0;0;0;0;771469464;778939506;38053644
1277;8.45383e-15;-243;1711;21534;15937.9;1;558;-2.14748e+09;-4.76642e+06;-1;0;0;0;-1;0;771849038;779346796;38145844
1278;8.45383e-15;-243;1711;21534;15937.9;1;558;-2.14748e+09;-4.75486e+06;-1;0;0;0;-1;0;772227718;779753219;38237992
1279;8.45383e-15;-244;1711;21534;15937.9;1;558;-2.14748e+09;-4.74334e+06;0;0;0;0;0;0;772605507;780158778;38330088
1280;8.45383e-15;-245;1711;21534;15937.9;1;558;-2.14748e+09;-4.73186e+06;0;0;0;0;0;0;772982407;780563476;38422131
1281;8.45383e-15;-245;1711;21534;15937.9;1;558;-2.14748e+09;-4.72042e+06;-1;0;0;0;-1;0;773358422;780967315;38514121
1282;8.45383e-15;-246;1711;21534;15937.9;1;558;-2.14748e+09;-4.70901e+06;0;0;0;0;0;0;773733552;781370298;38606058
1283;8.45383e-15;-247;1711;21534;15937.9;1;558;-2.14748e+09;-4.69764e+06;0;0;0;0;0;0;774107802;781772426;38697941
1284;8.45383e-15;-248;1711;21534;15937.9;1;558;-2.14748e+09;-4.68632e+06;0;0;0;0;0;0;774481173;782173703;38789771
1285;8.45383e-15;-249;1711;21534;15937.9;1;558;-2.14748e+09;-4.67502e+06;0;0;0;0;0;0;774853668;782574131;38881545
1286;8.45383e-15;-249;1711;21534;15937.9;1;558;-2.14748e+09;-4.66377e+06;-1;0;0;0;-1;0;775225290;782973711;38973266
1287;8.45383e-15;-250;1711;21534;15937.9;1;558;-2.14748e+09;-4.65255e+06;0;0;0;0;0;0;775596042;783372447;39064931
1288;8.45383e-15;-251;1711;21534;15937.9;1;558;-2.14748e+09;-4.64137e+06;0;0;0;0;0;0;775965925;783770341;39156541
1289;8.45383e-15;-252;1711;21534;15937.9;1;558;-2.14748e+09;-4.63022e+06;0;0;0;0;0;0;776334942;784167395;39248095
1290;8.45383e-15;-253;1711;21534;15937.9;1;558;-2.14748e+09;-4.61912e+06;0;0;0;0;0;0;776703097;784563611;39339593
1291;8.45383e-15;-253;1711;21534;15937.9;1;558;-2.14748e+09;-4.60805e+06;-1;0;0;0;-1;0;777070391;784958992;39431035
1292;8.45383e-15;-253;1711;21534;15937.9;1;558;-2.14748e+09;-4.59701e+06;-1;0;0;0;-1;0;777436827;785353541;39522420
1293;8.45383e-15;-253;1711;21534;15937.9;1;558;-2.14748e+09;-4.58601e+06;-1;0;0;0;-1;0;777802408;785747258;39613749
1294;8.45383e-15;-254;1711;21534;15937.9;1;558;-2.14748e+09;-4.57505e+06;0;0;0;0;0;0;778167135;786140148;39705019
1295;8.45383e-15;-255;1711;21534;15937.9;1;558;-2.14748e+09;-4.56412e+06;0;0;0;0;0;0;778531012;786532212;39796233
1296;8.45383e-15;-255;1711;21534;15937.9;1;558;-2.14748e+09;-4.55323e+06;-1;0;0;0;-1;0;778894041;786923452;39887388
1297;8.45383e-15;-255;1711;21534;15937.9;1;558;-2.14748e+09;-4.54238e+06;-1;0;0;0;-1;0;779256224;787313870;39978485
1298;8.45383e-15;-255;1711;21534;15937.9;1;558;-2.14748e+09;-4.53156e+06;-1;0;0;0;-1;0;779617564;787703470;40069523
1299;8.45383e-15;-256;1711;21534;15937.9;1;558;-2.14748e+09;-4.52077e+06;0;0;0;0;0;0;779978064;788092252;40160503
1300;8.45383e-15;-256;1711;21534;15937.9;1;558;-2.14748e+09;-4.51002e+06;-1;0;0;0;-1;0;780337724;788480220;40251423
1301;8.45383e-15;-257;1711;21534;15937.9;1;558;-2.14748e+09;-4.4993e+06;0;0;0;0;0;0;780696550;788867376;40342284
1302;8.45383e-15;-257;1711;21534;15937.9;1;558;-2.14748e+09;-4.48862e+06;-1;0;0;0;-1;0;781054541;789253721;40433085
1303;8.45383e-15;-257;1711;21534;15937.9;1;558;-2.14748e+09;-4.47798e+06;-1;0;0;0;-1;0;781411702;789639259;40523826
1304;8.45383e-15;-258;1711;21534;15937.9;1;558;-2.14748e+09;-4.46736e+06;0;0;0;0;0;0;781768033;790023991;40614507
1305;8.45383e-15;-258;1711;21534;15937.9;1;558;-2.14748e+09;-4.45678e+06;-1;0;0;0;-1;0;782123539;790407919;40705126
1306;8.45383e-15;-258;1711;21534;15937.9;1;558;-2.14748e+09;-4.44624e+06;-1;0;0;0;-1;0;782478220;790791046;40795685
1307;8.45383e-15;-259;1711;21534;15937.9;1;558;-2.14748e+09;-4.43573e+06;0;0;0;0;0;0;782832080;791173374;40886183
1308;8.45383e-15;-260;1711;21534;15937.9;1;558;-2.14748e+09;-4.42525e+06;0;0;0;0;0;0;783185121;791554905;40976618
1309;8.45383e-15;-261;1711;21534;15937.9;1;558;-2.14748e+09;-4.41481e+06;0;0;0;0;0;0;783537345;791935641;41066992
1310;8.45383e-15;-261;1711;21534;15937.9;1;558;-2.14748e+09;-4.4044e+06;-1;0;0;0;-1;0;783888754;792315585;41157304
1311;8.45383e-15;-262;1711;21534;15937.9;1;558;-2.14748e+09;-4.39402e+06;0;0;0;0;0;0;784239351;792694738;41247553
1312;8.45383e-15;-263;1711;21534;15937.9;1;558;-2.14748e+09;-4.38368e+06;0;0;0;0;0;0;784589139;793073102;41337740
1313;8.45383e-15;-263;1711;21534;15937.9;1;558;-2.14748e+09;-4.37336e+06;-1;0;0;0;-1;0;784938119;793450681;41427864
1314;8.45383e-15;-263;1711;21534;15937.9;1;558;-2.14748e+09;-4.36308e+06;-1;0;0;0;-1;0;785286293;793827475;41517924
1315;8.45383e-15;-264;1711;21534;15937.9;1;558;-2.14748e+09;-4.35284e+06;0;0;0;0;0;0;785633664;794203487;41607920
1316;8.45383e-15;-265;1711;21534;15937.9;1;558;-2.14748e+09;-4.34262e+06;0;0;0;0;0;0;785980235;794578720;41697853
1317;8.45383e-15;-266;1711;21534;15937.9;1;558;-2.14748e+09;-4.33244e+06;0;0;0;0;0;0;786326008;794953175;41787722
1318;8.45383e-15;-266;1711;21534;15937.9;1;558;-2.14748e+09;-4.32229e+06;-1;0;0;0;-1;0;786670984;795326854;41877526
1319;8.45383e-15;-266;1711;21534;15937.9;1;558;-2.14748e+09;-4.31218e+06;-1;0;0;0;-1;0;787015166;795699759;41967266
1320;8.45383e-15;-267;1711;21534;15937.9;1;558;-2.14748e+09;-4.30209e+06;0;0;0;0;0;0;787358557;796071893;42056940
1321;8.45383e-15;-267;1711;21534;15937.9;1;558;-2.14748e+09;-4.29204e+06;-1;0;0;0;-1;0;787701158;796443257;42146550
1322;8.45383e-15;-267;1711;21534;15937.9;1;558;-2.14748e+09;-4.28201e+06;-1;0;0;0;-1;0;788042973;796813854;42236094
1323;8.45383e-15;-268;1711;21534;15937.9;1;558;-2.14748e+09;-4.27202e+06;0;0;0;0;0;0;788384002;797183686;42325572
1324;8.45383e-15;-268;1711;21534;15937.9;1;558;-2.14748e+09;-4.26206e+06;-1;0;0;0;-1;0;788724249;797552754;42414984
1325;8.45383e-15;-269;1711;21534;15937.9;1;558;-2.14748e+09;-4.25213e+06;0;0;0;0;0;0;789063715;797921061;42504330
1326;8.45383e-15;-269;1711;21534;15937.9;1;558;-2.14748e+09;-4.24224e+06;-1;0;0;0;-1;0;789402403;798288609;42593610
1327;8.45383e-15;-270;1711;21534;15937.9;1;558;-2.14748e+09;-4.23237e+06;0;0;0;0;0;0;789740314;798655400;42682823
1328;8.45383e-15;-270;1711;21534;15937.9;1;558;-2.14748e+09;-4.22253e+06;-1;0;0;0;-1;0;790077452;799021435;42771969
1329;8.45383e-15;-271;1711;21534;15937.9;1;558;-2.14748e+09;-4.21272e+06;0;0;0;0;0;0;790413818;799386717;42861047
1330;8.45383e-15;-272;1711;21534;15937.9;1;558;-2.14748e+09;-4.20295e+06;0;0;0;0;0;0;790749415;799751248;42950058
1331;8.45383e-15;-272;1711;21534;15937.9;1;558;-2.14748e+09;-4.1932e+06;-1;0;0;0;-1;0;791084244;800115029;43039001
1332;8.45383e-15;-272;1711;21534;15937.9;1;558;-2.14748e+09;-4.18349e+06;-1;0;0;0;-1;0;791418307;800478064;43127877
1333;8.45383e-15;-273;1711;21534;15937.9;1;558;-2.14748e+09;-4.1738e+06;0;0;0;0;0;0;791751608;800840353;43216684
1334;8.45383e-15;-274;1711;21534;15937.9;1;558;-2.14748e+09;-4.16415e+06;0;0;0;0;0;0;792084148;801201898;43305422
1335;8.45383e-15;-274;1711;21534;15937.9;1;558;-2.14748e+09;-4.15452e+06;-1;0;0;0;-1;0;792415928;801562702;43394092
1336;8.45383e-15;-275;1711;21534;15937.9;1;558;-2.14748e+09;-4.14493e+06;0;0;0;0;0;0;792746952;801922767;43482693
1337;8.45383e-15;-276;1711;21534;15937.9;1;558;-2.14748e+09;-4.13536e+06;0;0;0;0;0;0;793077222;802282094;43571225
1338;8.45383e-15;-276;1711;21534;15937.9;1;558;-2.14748e+09;-4.12582e+06;-1;0;0;0;-1;0;793406739;802640686;43659687
1339;8.45383e-15;-276;1711;21534;15937.9;1;558;-2.14748e+09;-4.11631e+06;-1;0;0;0;-1;0;793735505;802998544;43748080
1340;8.45383e-15;-277;1711;21534;15937.9;1;558;-2.14748e+09;-4.10683e+06;0;0;0;0;0;0;794063524;803355670;43836403
1341;8.45383e-15;-277;1711;21534;15937.9;1;558;-2.14748e+09;-4.09738e+06;-1;0;0;0;-1;0;794390795;803712066;43924656
1342;8.45383e-15;-277;1711;21534;15937.9;1;558;-2.14748e+09;-4.08796e+06;-1;0;0;0;-1;0;794717323;804067735;44012838
1343;8.45383e-15;-278;1711;21534;15937.9;1;558;-2.14748e+09;-4.07857e+06;0;0;0;0;0;0;795043109;804422677;44100950
1344;8.45383e-15;-278;1711;21534;15937.9;1;558;-2.14748e+09;-4.0692e+06;-1;0;0;0;-1;0;795368154;804776895;44188991
1345;8.45383e-15;-279;1711;21534;15937.9;1;558;-2.14748e+09;-4.05987e+06;0;0;0;0;0;0;795692462;805130391;44276961
1346;8.45383e-15;-280;1711;21534;15937.9;1;558;-2.14748e+09;-4.05056e+06;0;0;0;0;0;0;796016033;805483167;44364860
1347;8.45383e-15;-281;1711;21534;15937.9;1;558;-2.14748e+09;-4.04128e+06;0;0;0;0;0;0;796338871;805835224;44452688
1348;8.45383e-15;-281;1711;21534;15937.9;1;558;-2.14748e+09;-4.03203e+06;-1;0;0;0;-1;0;796660977;806186564;44540444
1349;8.45383e-15;-281;1711;21534;15937.9;1;558;-2.14748e+09;-4.02281e+06;-1;0;0;0;-1;0;796982353;806537190;44628128
1350;8.45383e-15;-281;1711;21534;15937.9;1;558;-2.14748e+09;-4.01361e+06;-1;0;0;0;-1;0;797303001;806887102;44715740
1351;8.45383e-15;-282;1711;21534;15937.9;1;558;-2.14748e+09;-4.00444e+06;0;0;0;0;0;0;797622923;807236304;44803279
1352;8.45383e-15;-283;1711;21534;15937.9;1;558;-2.14748e+09;-3.9953e+06;0;0;0;0;0;0;797942121;807584796;44890746
1353;8.45383e-15;-284;1711;21534;15937.9;1;558;-2.14748e+09;-3.98619e+06;0;0;0;0;0;0;798260598;807932580;44978141
1354;8.45383e-15;-285;1711;21534;15937.9;1;558;-2.14748e+09;-3.9771e+06;0;0;0;0;0;0;798578354;808279659;45065463
1355;8.45383e-15;-286;1711;21534;15937.9;1;558;-2.14748e+09;-3.96805e+06;0;0;0;0;0;0;798895393;808626034;45152711
1356;8.45383e-15;-286;1711;21534;15937.9;1;558;-2.14748e+09;-3.95902e+06;-1;0;0;0;-1;0;799211715;808971707;45239887
1357;8.45383e-15;-286;1711;21534;15937.9;1;558;-2.14748e+09;-3.95001e+06;-1;0;0;0;-1;0;799527324;809316680;45326988
1358;8.45383e-15;-287;1711;21534;15937.9;1;558;-2.14748e+09;-3.94103e+06;0;0;0;0;0;0;799842221;809660954;45414017
1359;8.45383e-15;-288;1711;21534;15937.9;1;558;-2.14748e+09;-3.93208e+06;0;0;0;0;0;0;800156407;810004532;45500971
1360;8.45383e-15;-289;1711;21534;15937.9;1;558;-2.14748e+09;-3.92316e+06;0;0;0;0;0;0;800469886;810347415;45587851
1361;8.45383e-15;-290;1711;21534;15937.9;1;558;-2.14748e+09;-3.91426e+06;0;0;0;0;0;0;800782658;810689604;45674657
1362;8.45383e-15;-290;1711;21534;15937.9;1;558;-2.14748e+09;-3.90539e+06;-1;0;0;0;-1;0;801094726;811031102;45761388
1363;8.45383e-15;-291;1711;21534;15937.9;1;558;-2.14748e+09;-3.89655e+06;0;0;0;0;0;0;801406092;811371911;45848045
1364;8.45383e-15;-291;1711;21534;15937.9;1;558;-2.14748e+09;-3.88773e+06;-1;0;0;0;-1;0;801716757;811712031;45934627
1365;8.45383e-15;-291;1711;21534;15937.9;1;558;-2.14748e+09;-3.87894e+06;-1;0;0;0;-1;0;802026724;812051466;46021134
1366;8.45383e-15;-291;1711;21534;15937.9;1;558;-2.14748e+09;-3.87017e+06;-1;0;0;0;-1;0;802335994;812390216;46107566
1367;8.45383e-15;-291;1711;21534;15937.9;1;558;-2.14748e+09;-3.86143e+06;-1;0;0;0;-1;0;802644569;812728283;46193923
1368;8.45383e-15;-291;1711;21534;15937.9;1;558;-2.14748e+09;-3.85271e+06;-1;0;0;0;-1;0;802952452;813065670;46280203
1369;8.45383e-15;-291;1711;21534;15937.9;1;558;-2.14748e+09;-3.84402e+06;-1;0;0;0;-1;0;803259644;813402377;46366409
1370;8.45383e-15;-291;1711;21534;15937.9;1;558;-2.14748e+09;-3.83536e+06;-1;0;0;0;-1;0;803566146;813738407;46452538
1371;8.45383e-15;-291;1711;21534;15937.9;1;558;-2.14748e+09;-3.82672e+06;-1;0;0;0;-1;0;803871961;814073761;46538591
1372;8.45383e-15;-291;1711;21534;15937.9;1;558;-2.14748e+09;-3.81811e+06;-1;0;0;0;-1;0;804177091;814408441;46624568
1373;8.45383e-15;-292;1711;21534;15937.9;1;558;-2.14748e+09;-3.80952e+06;0;0;0;0;0;0;804481538;814742448;46710468
1374;8.45383e-15;-293;1711;21534;15937.9;1;558;-2.14748e+09;-3.80096e+06;0;0;0;0;0;0;804785302;815075785;46796292
1375;8.45383e-15;-294;1711;21534;15937.9;1;558;-2.14748e+09;-3.79242e+06;0;0;0;0;0;0;805088387;815408452;46882039
1376;8.45383e-15;-295;1711;21534;15937.9;1;558;-2.14748e+09;-3.7839e+06;0;0;0;0;0;0;805390794;815740452;46967709
1377;8.45383e-15;-296;1711;21534;15937.9;1;558;-2.14748e+09;-3.77542e+06;0;0;0;0;0;0;805692525;816071787;47053302
1378;8.45383e-15;-297;1711;21534;15937.9;1;558;-2.14748e+09;-3.76695e+06;0;0;0;0;0;0;805993581;816402457;47138818
1379;8.45383e-15;-297;1711;21534;15937.9;1;558;-2.14748e+09;-3.75851e+06;-1;0;0;0;-1;0;806293965;816732465;47224256
1380;8.45383e-15;-298;1711;21534;15937.9;1;558;-2.14748e+09;-3.7501e+06;0;0;0;0;0;0;806593678;817061813;47309617
1381;8.45383e-15;-299;1711;21534;15937.9;1;558;-2.14748e+09;-3.74171e+06;0;0;0;0;0;0;806892723;817390501;47394900
1382;8.45383e-15;-300;1711;21534;15937.9;1;558;-2.14748e+09;-3.73334e+06;0;0;0;0;0;0;807191100;817718532;47480104
1383;8.45383e-15;-300;1711;21534;15937.9;1;558;-2.14748e+09;-3.725e+06;-1;0;0;0;-1;0;807488812;818045907;47565231
1384;8.45383e-15;-301;1711;21534;15937.9;1;558;-2.14748e+09;-3.71668e+06;0;0;0;0;0;0;807785860;818372627;47650280
1385;8.45383e-15;-301;1711;21534;15937.9;1;558;-2.14748e+09;-3.70839e+06;-1;0;0;0;-1;0;808082247;818698695;47735250
1386;8.45383e-15;-301;1711;21534;15937.9;1;558;-2.14748e+09;-3.70012e+06;-1;0;0;0;-1;0;808377973;819024113;47820142
1387;8.45383e-15;-302;1711;21534;15937.9;1;558;-2.14748e+09;-3.69187e+06;0;0;0;0;0;0;808673042;819348880;47904955
1388;8.45383e-15;-302;1711;21534;15937.9;1;558;-2.14748e+09;-3.68365e+06;-1;0;0;0;-1;0;808967453;819673000;47989689
1389;8.45383e-15;-302;1711;21534;15937.9;1;558;-2.14748e+09;-3.67545e+06;-1;0;0;0;-1;0;809261211;819996474;48074344
1390;8.45383e-15;-303;1711;21534;15937.9;1;558;-2.14748e+09;-3.66728e+06;0;0;0;0;0;0;809554315;820319303;48158920
1391;8.45383e-15;-303;1711;21534;15937.9;1;558;-2.14748e+09;-3.65912e+06;-1;0;0;0;-1;0;809846768;820641490;48243417
1392;8.45383e-15;-304;1711;21534;15937.9;1;558;-2.14748e+09;-3.651e+06;0;0;0;0;0;0;810138571;820963034;48327834
1393;8.45383e-15;-305;1711;21534;15937.9;1;558;-2.14748e+09;-3.64289e+06;0;0;0;0;0;0;810429727;821283940;48412172
1394;8.45383e-15;-306;1711;21534;15937.9;1;558;-2.14748e+09;-3.63481e+06;0;0;0;0;0;0;810720236;821604206;48496430
1395;8.45383e-15;-307;1711;21534;15937.9;1;558;-2.14748e+09;-3.62675e+06;0;0;0;0;0;0;811010102;821923836;48580608
1396;8.45383e-15;-307;1711;21534;15937.9;1;558;-2.14748e+09;-3.61871e+06;-1;0;0;0;-1;0;811299324;822242831;48664706
1397;8.45383e-15;-307;1711;21534;15937.9;1;558;-2.14748e+09;-3.6107e+06;-1;0;0;0;-1;0;811587906;822561193;48748724
1398;8.45383e-15;-308;1711;21534;15937.9;1;558;-2.14748e+09;-3.60271e+06;0;0;0;0;0;0;811875849;822878922;48832662
1399;8.45383e-15;-308;1711;21534;15937.9;1;558;-2.14748e+09;-3.59474e+06;-1;0;0;0;-1;0;812163154;823196021;48916519
1400;8.45383e-15;-309;1711;21534;15937.9;1;558;-2.14748e+09;-3.58679e+06;0;0;0;0;0;0;812449823;823512491;49000296
1401;8.45383e-15;-309;1711;21534;15937.9;1;558;-2.14748e+09;-3.57887e+06;-1;0;0;0;-1;0;812735858;823828333;49083992
1402;8.45383e-15;-310;1711;21534;15937.9;1;558;-2.14748e+09;-3.57097e+06;0;0;0;0;0;0;813021260;824143549;49167607
1403;8.45383e-15;-310;1711;21534;15937.9;1;558;-2.14748e+09;-3.56309e+06;-1;0;0;0;-1;0;813306032;824458142;49251142
1404;8.45383e-15;-310;1711;21534;15937.9;1;558;-2.14748e+09;-3.55523e+06;-1;0;0;0;-1;0;813590175;824772111;49334595
1405;8.45383e-15;-310;1711;21534;15937.9;1;558;-2.14748e+09;-3.5474e+06;-1;0;0;0;-1;0;813873690;825085459;49417967
1406;8.45383e-15;-311;1711;21534;15937.9;1;558;-2.14748e+09;-3.53959e+06;0;0;0;0;0;0;814156579;825398187;49501258
1407;8.45383e-15;-312;1711;21534;15937.9;1;558;-2.14748e+09;-3.5318e+06;0;0;0;0;0;0;814438844;825710296;49584467
1408;8.45383e-15;-313;1711;21534;15937.9;1;558;-2.14748e+09;-3.52403e+06;0;0;0;0;0;0;814720486;826021789;49667595
1409;8.45383e-15;-314;1711;21534;15937.9;1;558;-2.14748e+09;-3.51628e+06;0;0;0;0;0;0;815001508;826332666;49750641
1410;8.45383e-15;-315;1711;21534;15937.9;1;558;-2.14748e+09;-3.50856e+06;0;0;0;0;0;0;815281910;826642930;49833606
1411;8.45383e-15;-316;1711;21534;15937.9;1;558;-2.14748e+09;-3.50085e+06;0;0;0;0;0;0;815561695;826952581;49916488
1412;8.45383e-15;-317;1711;21534;15937.9;1;558;-2.14748e+09;-3.49317e+06;0;0;0;0;0;0;815840863;827261621;49999288
1413;8.45383e-15;-317;1711;21534;15937.9;1;558;-2.14748e+09;-3.48551e+06;-1;0;0;0;-1;0;816119418;827570051;50082007
1414;8.45383e-15;-318;1711;21534;15937.9;1;558;-2.14748e+09;-3.47787e+06;0;0;0;0;0;0;816397359;827877874;50164643
1415;8.45383e-15;-319;1711;21534;15937.9;1;558;-2.14748e+09;-3.47025e+06;0;0;0;0;0;0;816674689;828185090;50247196
1416;8.45383e-15;-320;1711;21534;15937.9;1;558;-2.14748e+09;-3.46265e+06;0;0;0;0;0;0;816951409;828491701;50329667
1417;8.45383e-15;-321;1711;21534;15937.9;1;558;-2.14748e+09;-3.45508e+06;0;0;0;0;0;0;817227522;828797708;50412056
1418;8.45383e-15;-322;1711;21534;15937.9;1;558;-2.14748e+09;-3.44752e+06;0;0;0;0;0;0;817503028;829103113;50494362
1419;8.45383e-15;-323;1711;21534;15937.9;1;558;-2.14748e+09;-3.43999e+06;0;0;0;0;0;0;817777929;829407917;50576585
1420;8.45383e-15;-324;1711;21534;15937.9;1;558;-2.14748e+09;-3.43248e+06;0;0;0;0;0;0;818052227;829712122;50658725
1421;8.45383e-15;-324;1711;21534;15937.9;1;558;-2.14748e+09;-3.42498e+06;-1;0;0;0;-1;0;818325923;830015729;50740782
1422;8.45383e-15;-325;1711;21534;15937.9;1;558;-2.14748e+09;-3.41751e+06;0;0;0;0;0;0;818599019;830318739;50822755
1423;8.45383e-15;-326;1711;21534;15937.9;1;558;-2.14748e+09;-3.41006e+06;0;0;0;0;0;0;818871517;830621154;50904646
1424;8.45383e-15;-326;1711;21534;15937.9;1;558;-2.14748e+09;-3.40263e+06;-1;0;0;0;-1;0;819143417;830922976;50986453
1425;8.45383e-15;-327;1711;21534;15937.9;1;558;-2.14748e+09;-3.39522e+06;0;0;0;0;0;0;819414722;831224205;51068177
1426;8.45383e-15;-328;1711;21534;15937.9;1;558;-2.14748e+09;-3.38783e+06;0;0;0;0;0;0;819685433;831524844;51149817
1427;8.45383e-15;-328;1711;21534;15937.9;1;558;-2.14748e+09;-3.38046e+06;-1;0;0;0;-1;0;819955552;831824893;51231374
1428;8.45383e-15;-328;1711;21534;15937.9;1;558;-2.14748e+09;-3.37311e+06;-1;0;0;0;-1;0;820225079;832124354;51312847
1429;8.45383e-15;-329;1711;21534;15937.9;1;558;-2.14748e+09;-3.36578e+06;0;0;0;0;0;0;820494018;832423228;51394236
1430;8.45383e-15;-330;1711;21534;15937.9;1;558;-2.14748e+09;-3.35847e+06;0;0;0;0;0;0;820762368;832721517;51475541
1431;8.45383e-15;-331;1711;21534;15937.9;1;558;-2.14748e+09;-3.35118e+06;0;0;0;0;0;0;821030133;833019222;51556762
1432;8.45383e-15;-332;1711;21534;15937.9;1;558;-2.14748e+09;-3.34391e+06;0;0;0;0;0;0;821297312;833316345;51637899
1433;8.45383e-15;-332;1711;21534;15937.9;1;558;-2.14748e+09;-3.33666e+06;-1;0;0;0;-1;0;821563909;833612886;51718952
1434;8.45383e-15;-332;1711;21534;15937.9;1;558;-2.14748e+09;-3.32943e+06;-1;0;0;0;-1;0;821829923;833908847;51799920
1435;8.45383e-15;-333;1711;21534;15937.9;1;558;-2.14748e+09;-3.32222e+06;0;0;0;0;0;0;822095357;834204231;51880804
1436;8.45383e-15;-334;1711;21534;15937.9;1;558;-2.14748e+09;-3.31503e+06;0;0;0;0;0;0;822360213;834499037;51961604
1437;8.45383e-15;-335;1711;21534;15937.9;1;558;-2.14748e+09;-3.30786e+06;0;0;0;0;0;0;822624491;834793267;52042319
1438;8.45383e-15;-336;1711;21534;15937.9;1;558;-2.14748e+09;-3.3007e+06;0;0;0;0;0;0;822888193;835086923;52122949
1439;8.45383e-15;-337;1711;21534;15937.9;1;558;-2.14748e+09;-3.29357e+06;0;0;0;0;0;0;823151322;835380006;52203495
1440;8.45383e-15;-337;1711;21534;15937.9;1;558;-2.14748e+09;-3.28646e+06;-1;0;0;0;-1;0;823413877;835672517;52283955
1441;8.45383e-15;-338;1711;21534;15937.9;1;558;-2.14748e+09;-3.27936e+06;0;0;0;0;0;0;823675861;835964458;52364331
1442;8.45383e-15;-339;1711;21534;15937.9;1;558;-2.14748e+09;-3.27229e+06;0;0;0;0;0;0;823937275;836255830;52444622
1443;8.45383e-15;-340;1711;21534;15937.9;1;558;-2.14748e+09;-3.26523e+06;0;0;0;0;0;0;824198120;836546634;52524828
1444;8.45383e-15;-341;1711;21534;15937.9;1;558;-2.14748e+09;-3.2582e+06;0;0;0;0;0;0;824458399;836836871;52604949
1445;8.45383e-15;-341;1711;21534;15937.9;1;558;-2.14748e+09;-3.25118e+06;-1;0;0;0;-1;0;824718112;837126544;52684984
1446;8.45383e-15;-342;1711;21534;15937.9;1;558;-2.14748e+09;-3.24418e+06;0;0;0;0;0;0;824977261;837415653;52764934
1447;8.45383e-15;-342;1711;21534;15937.9;1;558;-2.14748e+09;-3.2372e+06;-1;0;0;0;-1;0;825235847;837704199;52844799
1448;8.45383e-15;-343;1711;21534;15937.9;1;558;-2.14748e+09;-3.23024e+06;0;0;0;0;0;0;825493872;837992184;52924578
1449;8.45383e-15;-343;1711;21534;15937.9;1;558;-2.14748e+09;-3.22329e+06;-1;0;0;0;-1;0;825751337;838279610;53004272
1450;8.45383e-15;-344;1711;21534;15937.9;1;558;-2.14748e+09;-3.21637e+06;0;0;0;0;0;0;826008244;838566477;53083880
1451;8.45383e-15;-345;1711;21534;15937.9;1;558;-2.14748e+09;-3.20946e+06;0;0;0;0;0;0;826264594;838852786;53163402
1452;8.45383e-15;-345;1711;21534;15937.9;1;558;-2.14748e+09;-3.20257e+06;-1;0;0;0;-1;0;826520388;839138540;53242839
1453;8.45383e-15;-345;1711;21534;15937.9;1;558;-2.14748e+09;-3.1957e+06;-1;0;0;0;-1;0;826775629;839423739;53322190
1454;8.45383e-15;-346;1711;21534;15937.9;1;558;-2.14748e+09;-3.18885e+06;0;0;0;0;0;0;827030316;839708385;53401455
1455;8.45383e-15;-346;1711;21534;15937.9;1;558;-2.14748e+09;-3.18202e+06;-1;0;0;0;-1;0;827284453;839992478;53480634
1456;8.45383e-15;-346;1711;21534;15937.9;1;558;-2.14748e+09;-3.1752e+06;-1;0;0;0;-1;0;827538039;840276020;53559726
1457;8.45383e-15;-347;1711;21534;15937.9;1;558;-2.14748e+09;-3.16841e+06;0;0;0;0;0;0;827791077;840559013;53638733
1458;8.45383e-15;-347;1711;21534;15937.9;1;558;-2.14748e+09;-3.16163e+06;-1;0;0;0;-1;0;828043568;840841458;53717654
1459;8.45383e-15;-348;1711;21534;15937.9;1;558;-2.14748e+09;-3.15487e+06;0;0;0;0;0;0;828295513;841123356;53796489
1460;8.45383e-15;-348;1711;21534;15937.9;1;558;-2.14748e+09;-3.14812e+06;-1;0;0;0;-1;0;828546914;841404707;53875237
1461;8.45383e-15;-348;1711;21534;15937.9;1;558;-2.14748e+09;-3.1414e+06;-1;0;0;0;-1;0;828797772;841685515;53953899
1462;8.45383e-15;-348;1711;21534;15937.9;1;558;-2.14748e+09;-3.13469e+06;-1;0;0;0;-1;0;829048088;841965778;54032474
1463;8.45383e-15;-348;1711;21534;15937.9;1;558;-2.14748e+09;-3.128e+06;-1;0;0;0;-1;0;829297864;842245500;54110963
1464;8.45383e-15;-349;1711;21534;15937.9;1;558;-2.14748e+09;-3.12133e+06;0;0;0;0;0;0;829547101;842524681;54189366
1465;8.45383e-15;-349;1711;21534;15937.9;1;558;-2.14748e+09;-3.11468e+06;-1;0;0;0;-1;0;829795801;842803322;54267681
1466;8.45383e-15;-350;1711;21534;15937.9;1;558;-2.14748e+09;-3.10804e+06;0;0;0;0;0;0;830043965;843081425;54345911
1467;8.45383e-15;-351;1711;21534;15937.9;1;558;-2.14748e+09;-3.10142e+06;0;0;0;0;0;0;830291593;843358991;54424053
1468;8.45383e-15;-351;1711;21534;15937.9;1;558;-2.14748e+09;-3.09482e+06;-1;0;0;0;-1;0;830538689;843636021;54502109
1469;8.45383e-15;-351;1711;21534;15937.9;1;558;-2.14748e+09;-3.08823e+06;-1;0;0;0;-1;0;830785252;843912516;54580078
1470;8.45383e-15;-351;1711;21534;15937.9;1;558;-2.14748e+09;-3.08166e+06;-1;0;0;0;-1;0;831031284;844188478;54657960
1471;8.45383e-15;-351;1711;21534;15937.9;1;558;-2.14748e+09;-3.07511e+06;-1;0;0;0;-1;0;831276788;844463907;54735755
1472;8.45383e-15;-351;1711;21534;15937.9;1;558;-2.14748e+09;-3.06858e+06;-1;0;0;0;-1;0;831521763;844738805;54813463
1473;8.45383e-15;-352;1711;21534;15937.9;1;558;-2.14748e+09;-3.06206e+06;0;0;0;0;0;0;831766211;845013174;54891085
1474;8.45383e-15;-353;1711;21534;15937.9;1;558;-2.14748e+09;-3.05556e+06;0;0;0;0;0;0;832010133;845287013;54968619
1475;8.45383e-15;-354;1711;21534;15937.9;1;558;-2.14748e+09;-3.04908e+06;0;0;0;0;0;0;832253532;845560326;55046066
1476;8.45383e-15;-354;1711;21534;15937.9;1;558;-2.14748e+09;-3.04262e+06;-1;0;0;0;-1;0;832496408;845833112;55123426
1477;8.45383e-15;-354;1711;21534;15937.9;1;558;-2.14748e+09;-3.03617e+06;-1;0;0;0;-1;0;832738762;846105372;55200698
1478;8.45383e-15;-355;1711;21534;15937.9;1;558;-2.14748e+09;-3.02974e+06;0;0;0;0;0;0;832980596;846377109;55277884
1479;8.45383e-15;-355;1711;21534;15937.9;1;558;-2.14748e+09;-3.02332e+06;-1;0;0;0;-1;0;833221911;846648324;55354982
1480;8.45383e-15;-356;1711;21534;15937.9;1;558;-2.14748e+09;-3.01692e+06;0;0;0;0;0;0;833462709;846919016;55431993
1481;8.45383e-15;-356;1711;21534;15937.9;1;558;-2.14748e+09;-3.01054e+06;-1;0;0;0;-1;0;833702990;847189188;55508916
1482;8.45383e-15;-356;1711;21534;15937.9;1;558;-2.14748e+09;-3.00417e+06;-1;0;0;0;-1;0;833942756;847458841;55585752
1483;8.45383e-15;-357;1711;21534;15937.9;1;558;-2.14748e+09;-2.99782e+06;0;0;0;0;0;0;834182009;847727976;55662501
1484;8.45383e-15;-357;1711;21534;15937.9;1;558;-2.14748e+09;-2.99149e+06;-1;0;0;0;-1;0;834420749;847996595;55739161
1485;8.45383e-15;-357;1711;21534;15937.9;1;558;-2.14748e+09;-2.98518e+06;-1;0;0;0;-1;0;834658978;848264697;55815735
1486;8.45383e-15;-358;1711;21534;15937.9;1;558;-2.14748e+09;-2.97888e+06;0;0;0;0;0;0;834896696;848532285;55892221
1487;8.45383e-15;-358;1711;21534;15937.9;1;558;-2.14748e+09;-2.97259e+06;-1;0;0;0;-1;0;835133907;848799359;55968619
1488;8.45383e-15;-359;1711;21534;15937.9;1;558;-2.14748e+09;-2.96632e+06;0;0;0;0;0;0;835370610;849065921;56044929
1489;8.45383e-15;-360;1711;21534;15937.9;1;558;-2.14748e+09;-2.96007e+06;0;0;0;0;0;0;835606806;849331972;56121152
1490;8.45383e-15;-360;1711;21534;15937.9;1;558;-2.14748e+09;-2.95384e+06;-1;0;0;0;-1;0;835842498;849597513;56197287
1491;8.45383e-15;-361;1711;21534;15937.9;1;558;-2.14748e+09;-2.94762e+06;0;0;0;0;0;0;836077686;849862545;56273335
1492;8.45383e-15;-361;1711;21534;15937.9;1;558;-2.14748e+09;-2.94141e+06;-1;0;0;0;-1;0;836312372;850127070;56349294
1493;8.45383e-15;-361;1711;21534;15937.9;1;558;-2.14748e+09;-2.93523e+06;-1;0;0;0;-1;0;836546557;850391088;56425166
1494;8.45383e-15;-361;1711;21534;15937.9;1;558;-2.14748e+09;-2.92905e+06;-1;0;0;0;-1;0;836780242;850654600;56500950
1495;8.45383e-15;-361;1711;21534;15937.9;1;558;-2.14748e+09;-2.9229e+06;-1;0;0;0;-1;0;837013428;850917608;56576646
1496;8.45383e-15;-361;1711;21534;15937.9;1;558;-2.14748e+09;-2.91676e+06;-1;0;0;0;-1;0;837246117;851180113;56652254
1497;8.45383e-15;-362;1711;21534;15937.9;1;558;-2.14748e+09;-2.91063e+06;0;0;0;0;0;0;837478310;851442116;56727774
1498;8.45383e-15;-363;1711;21534;15937.9;1;558;-2.14748e+09;-2.90452e+06;0;0;0;0;0;0;837710007;851703617;56803206
1499;8.45383e-15;-364;1711;21534;15937.9;1;558;-2.14748e+09;-2.89843e+06;0;0;0;0;0;0;837941211;851964619;56878550
1500;8.45383e-15;-365;1711;21534;15937.9;1;558;-2.14748e+09;-2.89235e+06;0;0;0;0;0;0;838171923;852225122;56953806
1501;8.45383e-15;-365;1711;21534;15937.9;1;558;-2.14748e+09;-2.88629e+06;-1;0;0;0;-1;0;838402143;852485128;57028973
1502;8.45383e-15;-365;1711;21534;15937.9;1;558;-2.14748e+09;-2.88024e+06;-1;0;0;0;-1;0;838631873;852744637;57104053
1503;8.45383e-15;-365;1711;21534;15937.9;1;558;-2.14748e+09;-2.87421e+06;-1;0;0;0;-1;0;838861114;853003650;57179045
1504;8.45383e-15;-365;1711;21534;15937.9;1;558;-2.14748e+09;-2.86819e+06;-1;0;0;0;-1;0;839089868;853262169;57253948
1505;8.45383e-15;-365;1711;21534;15937.9;1;558;-2.14748e+09;-2.86219e+06;-1;0;0;0;-1;0;839318135;853520195;57328764
1506;8.45383e-15;-365;1711;21534;15937.9;1;558;-2.14748e+09;-2.8562e+06;-1;0;0;0;-1;0;839545916;853777729;57403491
1507;8.45383e-15;-365;1711;21534;15937.9;1;558;-2.14748e+09;-2.85023e+06;-1;0;0;0;-1;0;839773214;854034771;57478130
1508;8.45383e-15;-365;1711;21534;15937.9;1;558;-2.14748e+09;-2.84427e+06;-1;0;0;0;-1;0;840000028;854291323;57552681
1509;8.45383e-15;-365;1711;21534;15937.9;1;558;-2.14748e+09;-2.83833e+06;-1;0;0;0;-1;0;840226361;854547387;57627143
1510;8.45383e-15;-365;1711;21534;15937.9;1;558;-2.14748e+09;-2.8324e+06;-1;0;0;0;-1;0;840452214;854802963;57701517
1511;8.45383e-15;-365;1711;21534;15937.9;1;558;-2.14748e+09;-2.82649e+06;-1;0;0;0;-1;0;840677587;855058051;57775803
1512;8.45383e-15;-366;1711;21534;15937.9;1;558;-2.14748e+09;-2.8206e+06;0;0;0;0;0;0;840902482;855312654;57850000
1513;8.45383e-15;-366;1711;21534;15937.9;1;558;-2.14748e+09;-2.81471e+06;-1;0;0;0;-1;0;841126900;855566773;57924110
1514;8.45383e-15;-367;1711;21534;15937.9;1;558;-2.14748e+09;-2.80885e+06;0;0;0;0;0;0;841350842;855820407;57998131
1515;8.45383e-15;-368;1711;21534;15937.9;1;558;-2.14748e+09;-2.803e+06;0;0;0;0;0;0;841574309;856073560;58072063
1516;8.45383e-15;-369;1711;21534;15937.9;1;558;-2.14748e+09;-2.79716e+06;0;0;0;0;0;0;841797303;856326230;58145907
1517;8.45383e-15;-370;1711;21534;15937.9;1;558;-2.14748e+09;-2.79134e+06;0;0;0;0;0;0;842019824;856578420;58219663
1518;8.45383e-15;-370;1711;21534;15937.9;1;558;-2.14748e+09;-2.78553e+06;-1;0;0;0;-1;0;842241874;856830131;58293330
1519;8.45383e-15;-370;1711;21534;15937.9;1;558;-2.14748e+09;-2.77973e+06;-1;0;0;0;-1;0;842463454;857081363;58366909
1520;8.45383e-15;-371;1711;21534;15937.9;1;558;-2.14748e+09;-2.77395e+06;0;0;0;0;0;0;842684565;857332119;58440400
1521;8.45383e-15;-371;1711;21534;15937.9;1;558;-2.14748e+09;-2.76819e+06;-1;0;0;0;-1;0;842905209;857582397;58513802
1522;8.45383e-15;-371;1711;21534;15937.9;1;558;-2.14748e+09;-2.76244e+06;-1;0;0;0;-1;0;843125385;857832201;58587115
1523;8.45383e-15;-372;1711;21534;15937.9;1;558;-2.14748e+09;-2.7567e+06;0;0;0;0;0;0;843345096;858081530;58660340
1524;8.45383e-15;-372;1711;21534;15937.9;1;558;-2.14748e+09;-2.75098e+06;-1;0;0;0;-1;0;843564343;858330386;58733477
1525;8.45383e-15;-373;1711;21534;15937.9;1;558;-2.14748e+09;-2.74527e+06;0;0;0;0;0;0;843783127;858578770;58806525
1526;8.45383e-15;-373;1711;21534;15937.9;1;558;-2.14748e+09;-2.73958e+06;-1;0;0;0;-1;0;844001448;858826683;58879485
1527;8.45383e-15;-373;1711;21534;15937.9;1;558;-2.14748e+09;-2.7339e+06;-1;0;0;0;-1;0;844219309;859074126;58952356
1528;8.45383e-15;-374;1711;21534;15937.9;1;558;-2.14748e+09;-2.72823e+06;0;0;0;0;0;0;844436709;859321100;59025138
1529;8.45383e-15;-375;1711;21534;15937.9;1;558;-2.14748e+09;-2.72258e+06;0;0;0;0;0;0;844653651;859567605;59097833
1530;8.45383e-15;-376;1711;21534;15937.9;1;558;-2.14748e+09;-2.71694e+06;0;0;0;0;0;0;844870135;859813644;59170438
1531;8.45383e-15;-377;1711;21534;15937.9;1;558;-2.14748e+09;-2.71132e+06;0;0;0;0;0;0;845086162;860059216;59242955
1532;8.45383e-15;-377;1711;21534;15937.9;1;558;-2.14748e+09;-2.70571e+06;-1;0;0;0;-1;0;845301734;860304324;59315384
1533;8.45383e-15;-377;1711;21534;15937.9;1;558;-2.14748e+09;-2.70011e+06;-1;0;0;0;-1;0;845516852;860548967;59387724
1534;8.45383e-15;-377;1711;21534;15937.9;1;558;-2.14748e+09;-2.69453e+06;-1;0;0;0;-1;0;845731517;860793147;59459975
1535;8.45383e-15;-377;1711;21534;15937.9;1;558;-2.14748e+09;-2.68896e+06;-1;0;0;0;-1;0;845945729;861036865;59532138
1536;8.45383e-15;-378;1711;21534;15937.9;1;558;-2.14748e+09;-2.68341e+06;0;0;0;0;0;0;846159490;861280123;59604213
1537;8.45383e-15;-379;1711;21534;15937.9;1;558;-2.14748e+09;-2.67786e+06;0;0;0;0;0;0;846372801;861522920;59676199
1538;8.45383e-15;-380;1711;21534;15937.9;1;558;-2.14748e+09;-2.67234e+06;0;0;0;0;0;0;846585664;861765258;59748096
1539;8.45383e-15;-380;1711;21534;15937.9;1;558;-2.14748e+09;-2.66682e+06;-1;0;0;0;-1;0;846798078;862007138;59819905
1540;8.45383e-15;-381;1711;21534;15937.9;1;558;-2.14748e+09;-2.66132e+06;0;0;0;0;0;0;847010046;862248560;59891625
1541;8.45383e-15;-382;1711;21534;15937.9;1;558;-2.14748e+09;-2.65584e+06;0;0;0;0;0;0;847221568;862489527;59963257
1542;8.45383e-15;-382;1711;21534;15937.9;1;558;-2.14748e+09;-2.65036e+06;-1;0;0;0;-1;0;847432646;862730039;60034800
1543;8.45383e-15;-382;1711;21534;15937.9;1;558;-2.14748e+09;-2.6449e+06;-1;0;0;0;-1;0;847643280;862970096;60106255
1544;8.45383e-15;-383;1711;21534;15937.9;1;558;-2.14748e+09;-2.63945e+06;0;0;0;0;0;0;847853471;863209700;60177621
1545;8.45383e-15;-383;1711;21534;15937.9;1;558;-2.14748e+09;-2.63402e+06;-1;0;0;0;-1;0;848063221;863448852;60248899
1546;8.45383e-15;-384;1711;21534;15937.9;1;558;-2.14748e+09;-2.6286e+06;0;0;0;0;0;0;848272531;863687553;60320088
1547;8.45383e-15;-384;1711;21534;15937.9;1;558;-2.14748e+09;-2.62319e+06;-1;0;0;0;-1;0;848481402;863925803;60391188
1548;8.45383e-15;-385;1711;21534;15937.9;1;558;-2.14748e+09;-2.6178e+06;0;0;0;0;0;0;848689834;864163604;60462201
1549;8.45383e-15;-386;1711;21534;15937.9;1;558;-2.14748e+09;-2.61242e+06;0;0;0;0;0;0;848897829;864400957;60533124
1550;8.45383e-15;-386;1711;21534;15937.9;1;558;-2.14748e+09;-2.60705e+06;-1;0;0;0;-1;0;849105388;864637862;60603959
1551;8.45383e-15;-386;1711;21534;15937.9;1;558;-2.14748e+09;-2.6017e+06;-1;0;0;0;-1;0;849312512;864874320;60674706
1552;8.45383e-15;-386;1711;21534;15937.9;1;558;-2.14748e+09;-2.59636e+06;-1;0;0;0;-1;0;849519202;865110334;60745364
1553;8.45383e-15;-386;1711;21534;15937.9;1;558;-2.14748e+09;-2.59103e+06;-1;0;0;0;-1;0;849725459;865345902;60815934
1554;8.45383e-15;-386;1711;21534;15937.9;1;558;-2.14748e+09;-2.58571e+06;-1;0;0;0;-1;0;849931284;865581027;60886415
1555;8.45383e-15;-387;1711;21534;15937.9;1;558;-2.14748e+09;-2.58041e+06;0;0;0;0;0;0;850136678;865815709;60956808
1556;8.45383e-15;-387;1711;21534;15937.9;1;558;-2.14748e+09;-2.57512e+06;-1;0;0;0;-1;0;850341642;866049950;61027112
1557;8.45383e-15;-387;1711;21534;15937.9;1;558;-2.14748e+09;-2.56984e+06;-1;0;0;0;-1;0;850546177;866283749;61097328
1558;8.45383e-15;-387;1711;21534;15937.9;1;558;-2.14748e+09;-2.56458e+06;-1;0;0;0;-1;0;850750285;866517109;61167456
1559;8.45383e-15;-387;1711;21534;15937.9;1;558;-2.14748e+09;-2.55932e+06;-1;0;0;0;-1;0;850953965;866750030;61237495
1560;8.45383e-15;-387;1711;21534;15937.9;1;558;-2.14748e+09;-2.55408e+06;-1;0;0;0;-1;0;851157220;866982513;61307446
1561;8.45383e-15;-388;1711;21534;15937.9;1;558;-2.14748e+09;-2.54886e+06;0;0;0;0;0;0;851360050;867214558;61377308
1562;8.45383e-15;-388;1711;21534;15937.9;1;558;-2.14748e+09;-2.54364e+06;-1;0;0;0;-1;0;851562456;867446168;61447082
1563;8.45383e-15;-388;1711;21534;15937.9;1;558;-2.14748e+09;-2.53844e+06;-1;0;0;0;-1;0;851764439;867677342;61516768
1564;8.45383e-15;-389;1711;21534;15937.9;1;558;-2.14748e+09;-2.53325e+06;0;0;0;0;0;0;851966001;867908082;61586365
1565;8.45383e-15;-389;1711;21534;15937.9;1;558;-2.14748e+09;-2.52808e+06;-1;0;0;0;-1;0;852167142;868138388;61655875
1566;8.45383e-15;-389;1711;21534;15937.9;1;558;-2.14748e+09;-2.52291e+06;-1;0;0;0;-1;0;852367863;868368262;61725295
1567;8.45383e-15;-389;1711;21534;15937.9;1;558;-2.14748e+09;-2.51776e+06;-1;0;0;0;-1;0;852568165;868597705;61794628
1568;8.45383e-15;-389;1711;21534;15937.9;1;558;-2.14748e+09;-2.51262e+06;-1;0;0;0;-1;0;852768049;868826716;61863872
1569;8.45383e-15;-390;1711;21534;15937.9;1;558;-2.14748e+09;-2.50749e+06;0;0;0;0;0;0;852967517;869055298;61933028
1570;8.45383e-15;-390;1711;21534;15937.9;1;558;-2.14748e+09;-2.50238e+06;-1;0;0;0;-1;0;853166569;869283451;62002096
1571;8.45383e-15;-390;1711;21534;15937.9;1;558;-2.14748e+09;-2.49728e+06;-1;0;0;0;-1;0;853365206;869511176;62071075
1572;8.45383e-15;-391;1711;21534;15937.9;1;558;-2.14748e+09;-2.49219e+06;0;0;0;0;0;0;853563429;869738474;62139967
1573;8.45383e-15;-392;1711;21534;15937.9;1;558;-2.14748e+09;-2.48711e+06;0;0;0;0;0;0;853761239;869965346;62208770
1574;8.45383e-15;-392;1711;21534;15937.9;1;558;-2.14748e+09;-2.48204e+06;-1;0;0;0;-1;0;853958637;870191792;62277485
1575;8.45383e-15;-393;1711;21534;15937.9;1;558;-2.14748e+09;-2.47699e+06;0;0;0;0;0;0;854155624;870417814;62346112
1576;8.45383e-15;-394;1711;21534;15937.9;1;558;-2.14748e+09;-2.47195e+06;0;0;0;0;0;0;854352202;870643413;62414651
1577;8.45383e-15;-395;1711;21534;15937.9;1;558;-2.14748e+09;-2.46692e+06;0;0;0;0;0;0;854548370;870868589;62483102
1578;8.45383e-15;-396;1711;21534;15937.9;1;558;-2.14748e+09;-2.4619e+06;0;0;0;0;0;0;854744131;871093343;62551465
1579;8.45383e-15;-397;1711;21534;15937.9;1;558;-2.14748e+09;-2.45689e+06;0;0;0;0;0;0;854939484;871317676;62619739
1580;8.45383e-15;-397;1711;21534;15937.9;1;558;-2.14748e+09;-2.4519e+06;-1;0;0;0;-1;0;855134431;871541589;62687926
1581;8.45383e-15;-397;1711;21534;15937.9;1;558;-2.14748e+09;-2.44692e+06;-1;0;0;0;-1;0;855328973;871765084;62756025
1582;8.45383e-15;-398;1711;21534;15937.9;1;558;-2.14748e+09;-2.44194e+06;0;0;0;0;0;0;855523111;871988159;62824035
1583;8.45383e-15;-398;1711;21534;15937.9;1;558;-2.14748e+09;-2.43699e+06;-1;0;0;0;-1;0;855716846;872210818;62891958
1584;8.45383e-15;-398;1711;21534;15937.9;1;558;-2.14748e+09;-2.43204e+06;-1;0;0;0;-1;0;855910178;872433060;62959793
1585;8.45383e-15;-398;1711;21534;15937.9;1;558;-2.14748e+09;-2.4271e+06;-1;0;0;0;-1;0;856103109;872654887;63027540
1586;8.45383e-15;-399;1711;21534;15937.9;1;558;-2.14748e+09;-2.42218e+06;0;0;0;0;0;0;856295640;872876298;63095199
1587;8.45383e-15;-399;1711;21534;15937.9;1;558;-2.14748e+09;-2.41727e+06;-1;0;0;0;-1;0;856487771;873097296;63162771
1588;8.45383e-15;-399;1711;21534;15937.9;1;558;-2.14748e+09;-2.41237e+06;-1;0;0;0;-1;0;856679504;873317881;63230254
1589;8.45383e-15;-399;1711;21534;15937.9;1;558;-2.14748e+09;-2.40748e+06;-1;0;0;0;-1;0;856870839;873538053;63297650
1590;8.45383e-15;-400;1711;21534;15937.9;1;558;-2.14748e+09;-2.4026e+06;0;0;0;0;0;0;857061777;873757814;63364958
1591;8.45383e-15;-401;1711;21534;15937.9;1;558;-2.14748e+09;-2.39774e+06;0;0;0;0;0;0;857252320;873977165;63432178
1592;8.45383e-15;-402;1711;21534;15937.9;1;558;-2.14748e+09;-2.39288e+06;0;0;0;0;0;0;857442468;874196106;63499311
1593;8.45383e-15;-402;1711;21534;15937.9;1;558;-2.14748e+09;-2.38804e+06;-1;0;0;0;-1;0;857632222;874414638;63566356
1594;8.45383e-15;-402;1711;21534;15937.9;1;558;-2.14748e+09;-2.38321e+06;-1;0;0;0;-1;0;857821582;874632763;63633313
1595;8.45383e-15;-403;1711;21534;15937.9;1;558;-2.14748e+09;-2.37839e+06;0;0;0;0;0;0;858010551;874850480;63700183
1596;8.45383e-15;-404;1711;21534;15937.9;1;558;-2.14748e+09;-2.37358e+06;0;0;0;0;0;0;858199129;875067791;63766965
1597;8.45383e-15;-405;1711;21534;15937.9;1;558;-2.14748e+09;-2.36878e+06;0;0;0;0;0;0;858387317;875284696;63833659
1598;8.45383e-15;-406;1711;21534;15937.9;1;558;-2.14748e+09;-2.36399e+06;0;0;0;0;0;0;858575115;875501197;63900266
1599;8.45383e-15;-407;1711;21534;15937.9;1;558;-2.14748e+09;-2.35922e+06;0;0;0;0;0;0;858762525;875717295;63966786
1600;8.45383e-15;-407;1711;21534;15937.9;1;558;-2.14748e+09;-2.35445e+06;-1;0;0;0;-1;0;858949548;875932989;64033218
1601;8.45383e-15;-408;1711;21534;15937.9;1;558;-2.14748e+09;-2.3497e+06;0;0;0;0;0;0;859136184;876148281;64099563
1602;8.45383e-15;-408;1711;21534;15937.9;1;558;-2.14748e+09;-2.34496e+06;-1;0;0;0;-1;0;859322434;876363172;64165820
1603;8.45383e-15;-408;1711;21534;15937.9;1;558;-2.14748e+09;-2.34023e+06;-1;0;0;0;-1;0;859508299;876577663;64231990
1604;8.45383e-15;-408;1711;21534;15937.9;1;558;-2.14748e+09;-2.33551e+06;-1;0;0;0;-1;0;859693781;876791754;64298073
1605;8.45383e-15;-408;1711;21534;15937.9;1;558;-2.14748e+09;-2.3308e+06;-1;0;0;0;-1;0;859878879;877005446;64364069
1606;8.45383e-15;-409;1711;21534;15937.9;1;558;-2.14748e+09;-2.3261e+06;0;0;0;0;0;0;860063596;877218741;64429977
1607;8.45383e-15;-409;1711;21534;15937.9;1;558;-2.14748e+09;-2.32141e+06;-1;0;0;0;-1;0;860247931;877431638;64495798
1608;8.45383e-15;-409;1711;21534;15937.9;1;558;-2.14748e+09;-2.31674e+06;-1;0;0;0;-1;0;860431886;877644139;64561532
1609;8.45383e-15;-409;1711;21534;15937.9;1;558;-2.14748e+09;-2.31207e+06;-1;0;0;0;-1;0;860615461;877856244;64627179
1610;8.45383e-15;-409;1711;21534;15937.9;1;558;-2.14748e+09;-2.30742e+06;-1;0;0;0;-1;0;860798658;878067955;64692738
1611;8.45383e-15;-409;1711;21534;15937.9;1;558;-2.14748e+09;-2.30277e+06;-1;0;0;0;-1;0;860981477;878279271;64758211
1612;8.45383e-15;-409;1711;21534;15937.9;1;558;-2.14748e+09;-2.29814e+06;-1;0;0;0;-1;0;861163920;878490195;64823597
1613;8.45383e-15;-409;1711;21534;15937.9;1;558;-2.14748e+09;-2.29352e+06;-1;0;0;0;-1;0;861345986;878700726;64888895
1614;8.45383e-15;-409;1711;21534;15937.9;1;558;-2.14748e+09;-2.28891e+06;-1;0;0;0;-1;0;861527678;878910866;64954107
1615;8.45383e-15;-409;1711;21534;15937.9;1;558;-2.14748e+09;-2.28431e+06;-1;0;0;0;-1;0;861708995;879120615;65019232
1616;8.45383e-15;-409;1711;21534;15937.9;1;558;-2.14748e+09;-2.27972e+06;-1;0;0;0;-1;0;861889939;879329974;65084270
1617;8.45383e-15;-410;1711;21534;15937.9;1;558;-2.14748e+09;-2.27514e+06;0;0;0;0;0;0;862070510;879538945;65149221
1618;8.45383e-15;-411;1711;21534;15937.9;1;558;-2.14748e+09;-2.27057e+06;0;0;0;0;0;0;862250710;879747527;65214086
1619;8.45383e-15;-412;1711;21534;15937.9;1;558;-2.14748e+09;-2.26601e+06;0;0;0;0;0;0;862430539;879955721;65278863
1620;8.45383e-15;-413;1711;21534;15937.9;1;558;-2.14748e+09;-2.26146e+06;0;0;0;0;0;0;862609998;880163529;65343554
1621;8.45383e-15;-413;1711;21534;15937.9;1;558;-2.14748e+09;-2.25692e+06;-1;0;0;0;-1;0;862789088;880370950;65408159
1622;8.45383e-15;-414;1711;21534;15937.9;1;558;-2.14748e+09;-2.2524e+06;0;0;0;0;0;0;862967810;880577987;65472676
1623;8.45383e-15;-414;1711;21534;15937.9;1;558;-2.14748e+09;-2.24788e+06;-1;0;0;0;-1;0;863146165;880784639;65537107
1624;8.45383e-15;-414;1711;21534;15937.9;1;558;-2.14748e+09;-2.24337e+06;-1;0;0;0;-1;0;863324153;880990908;65601452
1625;8.45383e-15;-415;1711;21534;15937.9;1;558;-2.14748e+09;-2.23888e+06;0;0;0;0;0;0;863501775;881196794;65665710
1626;8.45383e-15;-415;1711;21534;15937.9;1;558;-2.14748e+09;-2.23439e+06;-1;0;0;0;-1;0;863679033;881402298;65729882
1627;8.45383e-15;-415;1711;21534;15937.9;1;558;-2.14748e+09;-2.22992e+06;-1;0;0;0;-1;0;863855927;881607420;65793967
1628;8.45383e-15;-415;1711;21534;15937.9;1;558;-2.14748e+09;-2.22545e+06;-1;0;0;0;-1;0;864032457;881812163;65857966
1629;8.45383e-15;-415;1711;21534;15937.9;1;558;-2.14748e+09;-2.221e+06;-1;0;0;0;-1;0;864208625;882016525;65921879
1630;8.45383e-15;-416;1711;21534;15937.9;1;558;-2.14748e+09;-2.21655e+06;0;0;0;0;0;0;864384432;882220509;65985705
1631;8.45383e-15;-417;1711;21534;15937.9;1;558;-2.14748e+09;-2.21212e+06;0;0;0;0;0;0;864559878;882424114;66049445
1632;8.45383e-15;-418;1711;21534;15937.9;1;558;-2.14748e+09;-2.2077e+06;0;0;0;0;0;0;864734965;882627342;66113099
1633;8.45383e-15;-418;1711;21534;15937.9;1;558;-2.14748e+09;-2.20328e+06;-1;0;0;0;-1;0;864909692;882830193;66176667
1634;8.45383e-15;-419;1711;21534;15937.9;1;558;-2.14748e+09;-2.19888e+06;0;0;0;0;0;0;865084062;883032669;66240149
1635;8.45383e-15;-419;1711;21534;15937.9;1;558;-2.14748e+09;-2.19448e+06;-1;0;0;0;-1;0;865258073;883234769;66303545
1636;8.45383e-15;-419;1711;21534;15937.9;1;558;-2.14748e+09;-2.1901e+06;-1;0;0;0;-1;0;865431729;883436495;66366855
1637;8.45383e-15;-420;1711;21534;15937.9;1;558;-2.14748e+09;-2.18572e+06;0;0;0;0;0;0;865605029;883637848;66430079
1638;8.45383e-15;-420;1711;21534;15937.9;1;558;-2.14748e+09;-2.18136e+06;-1;0;0;0;-1;0;865777973;883838827;66493217
1639;8.45383e-15;-420;1711;21534;15937.9;1;558;-2.14748e+09;-2.17701e+06;-1;0;0;0;-1;0;865950564;884039435;66556269
1640;8.45383e-15;-420;1711;21534;15937.9;1;558;-2.14748e+09;-2.17266e+06;-1;0;0;0;-1;0;866122802;884239671;66619235
1641;8.45383e-15;-421;1711;21534;15937.9;1;558;-2.14748e+09;-2.16833e+06;0;0;0;0;0;0;866294687;884439537;66682116
1642;8.45383e-15;-421;1711;21534;15937.9;1;558;-2.14748e+09;-2.164e+06;-1;0;0;0;-1;0;866466220;884639033;66744911
1643;8.45383e-15;-422;1711;21534;15937.9;1;558;-2.14748e+09;-2.15969e+06;0;0;0;0;0;0;866637403;884838159;66807620
1644;8.45383e-15;-422;1711;21534;15937.9;1;558;-2.14748e+09;-2.15538e+06;-1;0;0;0;-1;0;866808235;885036918;66870243
1645;8.45383e-15;-422;1711;21534;15937.9;1;558;-2.14748e+09;-2.15109e+06;-1;0;0;0;-1;0;866978719;885235308;66932781
1646;8.45383e-15;-423;1711;21534;15937.9;1;558;-2.14748e+09;-2.1468e+06;0;0;0;0;0;0;867148854;885433332;66995234
1647;8.45383e-15;-424;1711;21534;15937.9;1;558;-2.14748e+09;-2.14253e+06;0;0;0;0;0;0;867318641;885630990;67057601
1648;8.45383e-15;-425;1711;21534;15937.9;1;558;-2.14748e+09;-2.13826e+06;0;0;0;0;0;0;867488081;885828282;67119883
1649;8.45383e-15;-425;1711;21534;15937.9;1;558;-2.14748e+09;-2.13401e+06;-1;0;0;0;-1;0;867657176;886025210;67182079
1650;8.45383e-15;-426;1711;21534;15937.9;1;558;-2.14748e+09;-2.12976e+06;0;0;0;0;0;0;867825925;886221773;67244191
1651;8.45383e-15;-426;1711;21534;15937.9;1;558;-2.14748e+09;-2.12552e+06;-1;0;0;0;-1;0;867994329;886417974;67306216
1652;8.45383e-15;-426;1711;21534;15937.9;1;558;-2.14748e+09;-2.1213e+06;-1;0;0;0;-1;0;868162390;886613812;67368157
1653;8.45383e-15;-426;1711;21534;15937.9;1;558;-2.14748e+09;-2.11708e+06;-1;0;0;0;-1;0;868330108;886809288;67430013
1654;8.45383e-15;-426;1711;21534;15937.9;1;558;-2.14748e+09;-2.11287e+06;-1;0;0;0;-1;0;868497484;887004403;67491783
1655;8.45383e-15;-427;1711;21534;15937.9;1;558;-2.14748e+09;-2.10867e+06;0;0;0;0;0;0;868664518;887199158;67553468
1656;8.45383e-15;-428;1711;21534;15937.9;1;558;-2.14748e+09;-2.10448e+06;0;0;0;0;0;0;868831212;887393553;67615069
1657;8.45383e-15;-428;1711;21534;15937.9;1;558;-2.14748e+09;-2.1003e+06;-1;0;0;0;-1;0;868997566;887587590;67676584
1658;8.45383e-15;-429;1711;21534;15937.9;1;558;-2.14748e+09;-2.09613e+06;0;0;0;0;0;0;869163581;887781268;67738015
1659;8.45383e-15;-430;1711;21534;15937.9;1;558;-2.14748e+09;-2.09197e+06;0;0;0;0;0;0;869329258;887974589;67799361
1660;8.45383e-15;-430;1711;21534;15937.9;1;558;-2.14748e+09;-2.08782e+06;-1;0;0;0;-1;0;869494597;888167553;67860622
1661;8.45383e-15;-431;1711;21534;15937.9;1;558;-2.14748e+09;-2.08367e+06;0;0;0;0;0;0;869659599;888360161;67921798
1662;8.45383e-15;-431;1711;21534;15937.9;1;558;-2.14748e+09;-2.07954e+06;-1;0;0;0;-1;0;869824266;888552414;67982890
1663;8.45383e-15;-432;1711;21534;15937.9;1;558;-2.14748e+09;-2.07542e+06;0;0;0;0;0;0;869988597;888744312;68043897
1664;8.45383e-15;-433;1711;21534;15937.9;1;558;-2.14748e+09;-2.0713e+06;0;0;0;0;0;0;870152594;888935857;68104820
1665;8.45383e-15;-434;1711;21534;15937.9;1;558;-2.14748e+09;-2.0672e+06;0;0;0;0;0;0;870316257;889127048;68165658
1666;8.45383e-15;-435;1711;21534;15937.9;1;558;-2.14748e+09;-2.0631e+06;0;0;0;0;0;0;870479587;889317886;68226412
1667;8.45383e-15;-436;1711;21534;15937.9;1;558;-2.14748e+09;-2.05901e+06;0;0;0;0;0;0;870642585;889508373;68287081
1668;8.45383e-15;-436;1711;21534;15937.9;1;558;-2.14748e+09;-2.05493e+06;-1;0;0;0;-1;0;870805252;889698509;68347666
1669;8.45383e-15;-437;1711;21534;15937.9;1;558;-2.14748e+09;-2.05086e+06;0;0;0;0;0;0;870967588;889888295;68408166
1670;8.45383e-15;-438;1711;21534;15937.9;1;558;-2.14748e+09;-2.0468e+06;0;0;0;0;0;0;871129594;890077730;68468583
1671;8.45383e-15;-439;1711;21534;15937.9;1;558;-2.14748e+09;-2.04275e+06;0;0;0;0;0;0;871291270;890266817;68528915
1672;8.45383e-15;-439;1711;21534;15937.9;1;558;-2.14748e+09;-2.03871e+06;-1;0;0;0;-1;0;871452619;890455556;68589164
1673;8.45383e-15;-439;1711;21534;15937.9;1;558;-2.14748e+09;-2.03468e+06;-1;0;0;0;-1;0;871613639;890643946;68649328
1674;8.45383e-15;-440;1711;21534;15937.9;1;558;-2.14748e+09;-2.03066e+06;0;0;0;0;0;0;871774333;890831990;68709408
1675;8.45383e-15;-440;1711;21534;15937.9;1;558;-2.14748e+09;-2.02664e+06;-1;0;0;0;-1;0;871934700;891019688;68769404
1676;8.45383e-15;-440;1711;21534;15937.9;1;558;-2.14748e+09;-2.02263e+06;-1;0;0;0;-1;0;872094742;891207040;68829317
1677;8.45383e-15;-440;1711;21534;15937.9;1;558;-2.14748e+09;-2.01864e+06;-1;0;0;0;-1;0;872254459;891394048;68889146
1678;8.45383e-15;-441;1711;21534;15937.9;1;558;-2.14748e+09;-2.01465e+06;0;0;0;0;0;0;872413852;891580711;68948891
1679;8.45383e-15;-441;1711;21534;15937.9;1;558;-2.14748e+09;-2.01067e+06;-1;0;0;0;-1;0;872572921;891767030;69008552
1680;8.45383e-15;-442;1711;21534;15937.9;1;558;-2.14748e+09;-2.0067e+06;0;0;0;0;0;0;872731668;891953007;69068130
1681;8.45383e-15;-443;1711;21534;15937.9;1;558;-2.14748e+09;-2.00274e+06;0;0;0;0;0;0;872890094;892138642;69127624
1682;8.45383e-15;-444;1711;21534;15937.9;1;558;-2.14748e+09;-1.99878e+06;0;0;0;0;0;0;873048198;892323935;69187034
1683;8.45383e-15;-444;1711;21534;15937.9;1;558;-2.14748e+09;-1.99484e+06;-1;0;0;0;-1;0;873205981;892508887;69246361
1684;8.45383e-15;-445;1711;21534;15937.9;1;558;-2.14748e+09;-1.9909e+06;0;0;0;0;0;0;873363445;892693500;69305605
1685;8.45383e-15;-446;1711;21534;15937.9;1;558;-2.14748e+09;-1.98698e+06;0;0;0;0;0;0;873520590;892877772;69364766
1686;8.45383e-15;-446;1711;21534;15937.9;1;558;-2.14748e+09;-1.98306e+06;-1;0;0;0;-1;0;873677417;893061707;69423843
1687;8.45383e-15;-447;1711;21534;15937.9;1;558;-2.14748e+09;-1.97915e+06;0;0;0;0;0;0;873833926;893245302;69482837
1688;8.45383e-15;-447;1711;21534;15937.9;1;558;-2.14748e+09;-1.97525e+06;-1;0;0;0;-1;0;873990118;893428561;69541748
1689;8.45383e-15;-448;1711;21534;15937.9;1;558;-2.14748e+09;-1.97136e+06;0;0;0;0;0;0;874145995;893611483;69600576
1690;8.45383e-15;-449;1711;21534;15937.9;1;558;-2.14748e+09;-1.96747e+06;0;0;0;0;0;0;874301555;893794068;69659321
1691;8.45383e-15;-449;1711;21534;15937.9;1;558;-2.14748e+09;-1.9636e+06;-1;0;0;0;-1;0;874456801;893976319;69717983
1692;8.45383e-15;-450;1711;21534;15937.9;1;558;-2.14748e+09;-1.95973e+06;0;0;0;0;0;0;874611733;894158234;69776562
1693;8.45383e-15;-450;1711;21534;15937.9;1;558;-2.14748e+09;-1.95588e+06;-1;0;0;0;-1;0;874766352;894339815;69835058
1694;8.45383e-15;-451;1711;21534;15937.9;1;558;-2.14748e+09;-1.95203e+06;0;0;0;0;0;0;874920658;894521063;69893471
1695;8.45383e-15;-451;1711;21534;15937.9;1;558;-2.14748e+09;-1.94818e+06;-1;0;0;0;-1;0;875074652;894701978;69951802
1696;8.45383e-15;-451;1711;21534;15937.9;1;558;-2.14748e+09;-1.94435e+06;-1;0;0;0;-1;0;875228335;894882561;70010050
1697;8.45383e-15;-452;1711;21534;15937.9;1;558;-2.14748e+09;-1.94053e+06;0;0;0;0;0;0;875381708;895062812;70068216
1698;8.45383e-15;-452;1711;21534;15937.9;1;558;-2.14748e+09;-1.93671e+06;-1;0;0;0;-1;0;875534770;895242732;70126299
1699;8.45383e-15;-452;1711;21534;15937.9;1;558;-2.14748e+09;-1.9329e+06;-1;0;0;0;-1;0;875687524;895422322;70184300
1700;8.45383e-15;-452;1711;21534;15937.9;1;558;-2.14748e+09;-1.92911e+06;-1;0;0;0;-1;0;875839969;895601583;70242218
1701;8.45383e-15;-452;1711;21534;15937.9;1;558;-2.14748e+09;-1.92532e+06;-1;0;0;0;-1;0;875992106;895780514;70300054
1702;8.45383e-15;-452;1711;21534;15937.9;1;558;-2.14748e+09;-1.92153e+06;-1;0;0;0;-1;0;876143936;895959118;70357808
1703;8.45383e-15;-453;1711;21534;15937.9;1;558;-2.14748e+09;-1.91776e+06;0;0;0;0;0;0;876295460;896137394;70415479
1704;8.45383e-15;-453;1711;21534;15937.9;1;558;-2.14748e+09;-1.91399e+06;-1;0;0;0;-1;0;876446678;896315342;70473069
1705;8.45383e-15;-454;1711;21534;15937.9;1;558;-2.14748e+09;-1.91024e+06;0;0;0;0;0;0;876597591;896492965;70530576
1706;8.45383e-15;-454;1711;21534;15937.9;1;558;-2.14748e+09;-1.90649e+06;-1;0;0;0;-1;0;876748200;896670261;70588001
1707;8.45383e-15;-455;1711;21534;15937.9;1;558;-2.14748e+09;-1.90275e+06;0;0;0;0;0;0;876898505;896847233;70645345
1708;8.45383e-15;-456;1711;21534;15937.9;1;558;-2.14748e+09;-1.89901e+06;0;0;0;0;0;0;877048507;897023880;70702607
1709;8.45383e-15;-457;1711;21534;15937.9;1;558;-2.14748e+09;-1.89529e+06;0;0;0;0;0;0;877198207;897200203;70759787
1710;8.45383e-15;-458;1711;21534;15937.9;1;558;-2.14748e+09;-1.89157e+06;0;0;0;0;0;0;877347605;897376203;70816885
1711;8.45383e-15;-459;1711;21534;15937.9;1;558;-2.14748e+09;-1.88786e+06;0;0;0;0;0;0;877496702;897551881;70873901
1712;8.45383e-15;-459;1711;21534;15937.9;1;558;-2.14748e+09;-1.88416e+06;-1;0;0;0;-1;0;877645499;897727237;70930836
1713;8.45383e-15;-459;1711;21534;15937.9;1;558;-2.14748e+09;-1.88047e+06;-1;0;0;0;-1;0;877793996;897902271;70987690
1714;8.45383e-15;-459;1711;21534;15937.9;1;558;-2.14748e+09;-1.87679e+06;-1;0;0;0;-1;0;877942194;898076985;71044462
1715;8.45383e-15;-460;1711;21534;15937.9;1;558;-2.14748e+09;-1.87311e+06;0;0;0;0;0;0;878090094;898251379;71101152
1716;8.45383e-15;-460;1711;21534;15937.9;1;558;-2.14748e+09;-1.86944e+06;-1;0;0;0;-1;0;878237696;898425453;71157761
1717;8.45383e-15;-461;1711;21534;15937.9;1;558;-2.14748e+09;-1.86578e+06;0;0;0;0;0;0;878385001;898599208;71214289
1718;8.45383e-15;-462;1711;21534;15937.9;1;558;-2.14748e+09;-1.86213e+06;0;0;0;0;0;0;878532010;898772645;71270736
1719;8.45383e-15;-462;1711;21534;15937.9;1;558;-2.14748e+09;-1.85848e+06;-1;0;0;0;-1;0;878678723;898945765;71327102
1720;8.45383e-15;-463;1711;21534;15937.9;1;558;-2.14748e+09;-1.85485e+06;0;0;0;0;0;0;878825141;899118568;71383387
1721;8.45383e-15;-464;1711;21534;15937.9;1;558;-2.14748e+09;-1.85122e+06;0;0;0;0;0;0;878971265;899291054;71439591
1722;8.45383e-15;-464;1711;21534;15937.9;1;558;-2.14748e+09;-1.8476e+06;-1;0;0;0;-1;0;879117095;899463225;71495713
1723;8.45383e-15;-465;1711;21534;15937.9;1;558;-2.14748e+09;-1.84398e+06;0;0;0;0;0;0;879262632;899635081;71551755
1724;8.45383e-15;-466;1711;21534;15937.9;1;558;-2.14748e+09;-1.84038e+06;0;0;0;0;0;0;879407876;899806622;71607717
1725;8.45383e-15;-467;1711;21534;15937.9;1;558;-2.14748e+09;-1.83678e+06;0;0;0;0;0;0;879552829;899977849;71663597
1726;8.45383e-15;-467;1711;21534;15937.9;1;558;-2.14748e+09;-1.83319e+06;-1;0;0;0;-1;0;879697490;900148763;71719397
1727;8.45383e-15;-468;1711;21534;15937.9;1;558;-2.14748e+09;-1.82961e+06;0;0;0;0;0;0;879841861;900319364;71775117
1728;8.45383e-15;-469;1711;21534;15937.9;1;558;-2.14748e+09;-1.82604e+06;0;0;0;0;0;0;879985943;900489653;71830755
1729;8.45383e-15;-470;1711;21534;15937.9;1;558;-2.14748e+09;-1.82247e+06;0;0;0;0;0;0;880129735;900659631;71886314
1730;8.45383e-15;-470;1711;21534;15937.9;1;558;-2.14748e+09;-1.81891e+06;-1;0;0;0;-1;0;880273238;900829298;71941792
1731;8.45383e-15;-471;1711;21534;15937.9;1;558;-2.14748e+09;-1.81536e+06;0;0;0;0;0;0;880416454;900998655;71997190
1732;8.45383e-15;-472;1711;21534;15937.9;1;558;-2.14748e+09;-1.81182e+06;0;0;0;0;0;0;880559382;901167702;72052508
1733;8.45383e-15;-473;1711;21534;15937.9;1;558;-2.14748e+09;-1.80828e+06;0;0;0;0;0;0;880702023;901336440;72107745
1734;8.45383e-15;-473;1711;21534;15937.9;1;558;-2.14748e+09;-1.80476e+06;-1;0;0;0;-1;0;880844379;901504870;72162902
1735;8.45383e-15;-473;1711;21534;15937.9;1;558;-2.14748e+09;-1.80123e+06;-1;0;0;0;-1;0;880986449;901672992;72217980
1736;8.45383e-15;-474;1711;21534;15937.9;1;558;-2.14748e+09;-1.79772e+06;0;0;0;0;0;0;881128234;901840806;72272977
1737;8.45383e-15;-475;1711;21534;15937.9;1;558;-2.14748e+09;-1.79422e+06;0;0;0;0;0;0;881269735;902008314;72327895
1738;8.45383e-15;-476;1711;21534;15937.9;1;558;-2.14748e+09;-1.79072e+06;0;0;0;0;0;0;881410953;902175516;72382733
1739;8.45383e-15;-477;1711;21534;15937.9;1;558;-2.14748e+09;-1.78723e+06;0;0;0;0;0;0;881551887;902342412;72437491
1740;8.45383e-15;-478;1711;21534;15937.9;1;558;-2.14748e+09;-1.78375e+06;0;0;0;0;0;0;881692540;902509004;72492170
1741;8.45383e-15;-479;1711;21534;15937.9;1;558;-2.14748e+09;-1.78027e+06;0;0;0;0;0;0;881832910;902675291;72546769
1742;8.45383e-15;-479;1711;21534;15937.9;1;558;-2.14748e+09;-1.7768e+06;-1;0;0;0;-1;0;881973000;902841274;72601288
1743;8.45383e-15;-479;1711;21534;15937.9;1;558;-2.14748e+09;-1.77334e+06;-1;0;0;0;-1;0;882112809;903006954;72655728
1744;8.45383e-15;-479;1711;21534;15937.9;1;558;-2.14748e+09;-1.76989e+06;-1;0;0;0;-1;0;882252339;903172332;72710089
1745;8.45383e-15;-479;1711;21534;15937.9;1;558;-2.14748e+09;-1.76644e+06;-1;0;0;0;-1;0;882391589;903337408;72764370
1746;8.45383e-15;-479;1711;21534;15937.9;1;558;-2.14748e+09;-1.76301e+06;-1;0;0;0;-1;0;882530560;903502182;72818573
1747;8.45383e-15;-479;1711;21534;15937.9;1;558;-2.14748e+09;-1.75958e+06;-1;0;0;0;-1;0;882669254;903666656;72872696
1748;8.45383e-15;-480;1711;21534;15937.9;1;558;-2.14748e+09;-1.75615e+06;0;0;0;0;0;0;882807670;903830829;72926740
1749;8.45383e-15;-480;1711;21534;15937.9;1;558;-2.14748e+09;-1.75274e+06;-1;0;0;0;-1;0;882945809;903994703;72980705
1750;8.45383e-15;-481;1711;21534;15937.9;1;558;-2.14748e+09;-1.74933e+06;0;0;0;0;0;0;883083673;904158278;73034591
1751;8.45383e-15;-481;1711;21534;15937.9;1;558;-2.14748e+09;-1.74593e+06;-1;0;0;0;-1;0;883221260;904321554;73088398
1752;8.45383e-15;-481;1711;21534;15937.9;1;558;-2.14748e+09;-1.74253e+06;-1;0;0;0;-1;0;883358573;904484532;73142127
1753;8.45383e-15;-482;1711;21534;15937.9;1;558;-2.14748e+09;-1.73914e+06;0;0;0;0;0;0;883495611;904647213;73195777
1754;8.45383e-15;-483;1711;21534;15937.9;1;558;-2.14748e+09;-1.73576e+06;0;0;0;0;0;0;883632376;904809597;73249348
1755;8.45383e-15;-483;1711;21534;15937.9;1;558;-2.14748e+09;-1.73239e+06;-1;0;0;0;-1;0;883768867;904971685;73302841
1756;8.45383e-15;-484;1711;21534;15937.9;1;558;-2.14748e+09;-1.72903e+06;0;0;0;0;0;0;883905086;905133478;73356255
1757;8.45383e-15;-484;1711;21534;15937.9;1;558;-2.14748e+09;-1.72567e+06;-1;0;0;0;-1;0;884041033;905294975;73409591
1758;8.45383e-15;-484;1711;21534;15937.9;1;558;-2.14748e+09;-1.72232e+06;-1;0;0;0;-1;0;884176709;905456178;73462848
1759;8.45383e-15;-485;1711;21534;15937.9;1;558;-2.14748e+09;-1.71898e+06;0;0;0;0;0;0;884312113;905617087;73516028
1760;8.45383e-15;-486;1711;21534;15937.9;1;558;-2.14748e+09;-1.71564e+06;0;0;0;0;0;0;884447248;905777702;73569129
1761;8.45383e-15;-486;1711;21534;15937.9;1;558;-2.14748e+09;-1.71231e+06;-1;0;0;0;-1;0;884582113;905938025;73622152
1762;8.45383e-15;-486;1711;21534;15937.9;1;558;-2.14748e+09;-1.70899e+06;-1;0;0;0;-1;0;884716709;906098055;73675097
1763;8.45383e-15;-487;1711;21534;15937.9;1;558;-2.14748e+09;-1.70567e+06;0;0;0;0;0;0;884851036;906257794;73727964
1764;8.45383e-15;-488;1711;21534;15937.9;1;558;-2.14748e+09;-1.70236e+06;0;0;0;0;0;0;884985096;906417242;73780753
1765;8.45383e-15;-489;1711;21534;15937.9;1;558;-2.14748e+09;-1.69906e+06;0;0;0;0;0;0;885118888;906576399;73833464
1766;8.45383e-15;-490;1711;21534;15937.9;1;558;-2.14748e+09;-1.69577e+06;0;0;0;0;0;0;885252414;906735266;73886098
1767;8.45383e-15;-491;1711;21534;15937.9;1;558;-2.14748e+09;-1.69248e+06;0;0;0;0;0;0;885385674;906893843;73938654
1768;8.45383e-15;-491;1711;21534;15937.9;1;558;-2.14748e+09;-1.6892e+06;-1;0;0;0;-1;0;885518668;907052132;73991132
1769;8.45383e-15;-492;1711;21534;15937.9;1;558;-2.14748e+09;-1.68592e+06;0;0;0;0;0;0;885651397;907210132;74043533
1770;8.45383e-15;-492;1711;21534;15937.9;1;558;-2.14748e+09;-1.68266e+06;-1;0;0;0;-1;0;885783862;907367845;74095856
1771;8.45383e-15;-492;1711;21534;15937.9;1;558;-2.14748e+09;-1.6794e+06;-1;0;0;0;-1;0;885916063;907525270;74148102
1772;8.45383e-15;-492;1711;21534;15937.9;1;558;-2.14748e+09;-1.67615e+06;-1;0;0;0;-1;0;886048000;907682408;74200271
1773;8.45383e-15;-492;1711;21534;15937.9;1;558;-2.14748e+09;-1.6729e+06;-1;0;0;0;-1;0;886179675;907839261;74252363
1774;8.45383e-15;-492;1711;21534;15937.9;1;558;-2.14748e+09;-1.66966e+06;-1;0;0;0;-1;0;886311088;907995827;74304377
1775;8.45383e-15;-492;1711;21534;15937.9;1;558;-2.14748e+09;-1.66643e+06;-1;0;0;0;-1;0;886442240;908152109;74356315
1776;8.45383e-15;-493;1711;21534;15937.9;1;558;-2.14748e+09;-1.6632e+06;0;0;0;0;0;0;886573131;908308106;74408175
1777;8.45383e-15;-494;1711;21534;15937.9;1;558;-2.14748e+09;-1.65999e+06;0;0;0;0;0;0;886703761;908463819;74459959
1778;8.45383e-15;-495;1711;21534;15937.9;1;558;-2.14748e+09;-1.65677e+06;0;0;0;0;0;0;886834131;908619249;74511666
1779;8.45383e-15;-495;1711;21534;15937.9;1;558;-2.14748e+09;-1.65357e+06;-1;0;0;0;-1;0;886964242;908774396;74563296
1780;8.45383e-15;-495;1711;21534;15937.9;1;558;-2.14748e+09;-1.65037e+06;-1;0;0;0;-1;0;887094095;908929260;74614849
1781;8.45383e-15;-496;1711;21534;15937.9;1;558;-2.14748e+09;-1.64718e+06;0;0;0;0;0;0;887223689;909083843;74666326
1782;8.45383e-15;-497;1711;21534;15937.9;1;558;-2.14748e+09;-1.644e+06;0;0;0;0;0;0;887353026;909238144;74717727
1783;8.45383e-15;-497;1711;21534;15937.9;1;558;-2.14748e+09;-1.64082e+06;-1;0;0;0;-1;0;887482105;909392165;74769050
1784;8.45383e-15;-498;1711;21534;15937.9;1;558;-2.14748e+09;-1.63765e+06;0;0;0;0;0;0;887610928;909545905;74820298
1785;8.45383e-15;-498;1711;21534;15937.9;1;558;-2.14748e+09;-1.63448e+06;-1;0;0;0;-1;0;887739496;909699366;74871469
1786;8.45383e-15;-499;1711;21534;15937.9;1;558;-2.14748e+09;-1.63132e+06;0;0;0;0;0;0;887867808;909852547;74922564
1787;8.45383e-15;-499;1711;21534;15937.9;1;558;-2.14748e+09;-1.62817e+06;-1;0;0;0;-1;0;887995865;910005450;74973583
1788;8.45383e-15;-499;1711;21534;15937.9;1;558;-2.14748e+09;-1.62503e+06;-1;0;0;0;-1;0;888123668;910158075;75024526
1789;8.45383e-15;-500;1711;21534;15937.9;1;558;-2.14748e+09;-1.62189e+06;0;0;0;0;0;0;888251217;910310422;75075393
1790;8.45383e-15;-500;1711;21534;15937.9;1;558;-2.14748e+09;-1.61876e+06;-1;0;0;0;-1;0;888378513;910462493;75126184
1791;8.45383e-15;-501;1711;21534;15937.9;1;558;-2.14748e+09;-1.61563e+06;0;0;0;0;0;0;888505557;910614286;75176899
1792;8.45383e-15;-502;1711;21534;15937.9;1;558;-2.14748e+09;-1.61252e+06;0;0;0;0;0;0;888632348;910765804;75227539
1793;8.45383e-15;-503;1711;21534;15937.9;1;558;-2.14748e+09;-1.6094e+06;0;0;0;0;0;0;888758888;910917046;75278102
1794;8.45383e-15;-503;1711;21534;15937.9;1;558;-2.14748e+09;-1.6063e+06;-1;0;0;0;-1;0;888885177;911068013;75328591
1795;8.45383e-15;-503;1711;21534;15937.9;1;558;-2.14748e+09;-1.6032e+06;-1;0;0;0;-1;0;889011215;911218706;75379003
1796;8.45383e-15;-504;1711;21534;15937.9;1;558;-2.14748e+09;-1.60011e+06;0;0;0;0;0;0;889137004;911369125;75429341
1797;8.45383e-15;-504;1711;21534;15937.9;1;558;-2.14748e+09;-1.59702e+06;-1;0;0;0;-1;0;889262543;911519271;75479603
1798;8.45383e-15;-504;1711;21534;15937.9;1;558;-2.14748e+09;-1.59394e+06;-1;0;0;0;-1;0;889387833;911669144;75529789
1799;8.45383e-15;-505;1711;21534;15937.9;1;558;-2.14748e+09;-1.59087e+06;0;0;0;0;0;0;889512875;911818744;75579901
1800;8.45383e-15;-505;1711;21534;15937.9;1;558;-2.14748e+09;-1.5878e+06;-1;0;0;0;-1;0;889637670;911968073;75629937
1801;8.45383e-15;-506;1711;21534;15937.9;1;558;-2.14748e+09;-1.58474e+06;0;0;0;0;0;0;889762217;912117130;75679899
1802;8.45383e-15;-507;1711;21534;15937.9;1;558;-2.14748e+09;-1.58169e+06;0;0;0;0;0;0;889886517;912265916;75729785
1803;8.45383e-15;-508;1711;21534;15937.9;1;558;-2.14748e+09;-1.57864e+06;0;0;0;0;0;0;890010572;912414433;75779597
1804;8.45383e-15;-509;1711;21534;15937.9;1;558;-2.14748e+09;-1.5756e+06;0;0;0;0;0;0;890134380;912562679;75829333
1805;8.45383e-15;-509;1711;21534;15937.9;1;558;-2.14748e+09;-1.57257e+06;-1;0;0;0;-1;0;890257944;912710656;75878996
1806;8.45383e-15;-509;1711;21534;15937.9;1;558;-2.14748e+09;-1.56954e+06;-1;0;0;0;-1;0;890381263;912858364;75928583
1807;8.45383e-15;-509;1711;21534;15937.9;1;558;-2.14748e+09;-1.56652e+06;-1;0;0;0;-1;0;890504338;913005805;75978096
1808;8.45383e-15;-510;1711;21534;15937.9;1;558;-2.14748e+09;-1.5635e+06;0;0;0;0;0;0;890627169;913152977;76027534
1809;8.45383e-15;-510;1711;21534;15937.9;1;558;-2.14748e+09;-1.56049e+06;-1;0;0;0;-1;0;890749757;913299882;76076898
1810;8.45383e-15;-511;1711;21534;15937.9;1;558;-2.14748e+09;-1.55749e+06;0;0;0;0;0;0;890872103;913446520;76126188
1811;8.45383e-15;-512;1711;21534;15937.9;1;558;-2.14748e+09;-1.55449e+06;0;0;0;0;0;0;890994207;913592893;76175403
1812;8.45383e-15;-512;1711;21534;15937.9;1;558;-2.14748e+09;-1.5515e+06;-1;0;0;0;-1;0;891116070;913738999;76224544
1813;8.45383e-15;-513;1711;21534;15937.9;1;558;-2.14748e+09;-1.54852e+06;0;0;0;0;0;0;891237691;913884840;76273611
1814;8.45383e-15;-513;1711;21534;15937.9;1;558;-2.14748e+09;-1.54554e+06;-1;0;0;0;-1;0;891359072;914030417;76322605
1815;8.45383e-15;-514;1711;21534;15937.9;1;558;-2.14748e+09;-1.54257e+06;0;0;0;0;0;0;891480214;914175729;76371524
1816;8.45383e-15;-515;1711;21534;15937.9;1;558;-2.14748e+09;-1.5396e+06;0;0;0;0;0;0;891601116;914320777;76420369
1817;8.45383e-15;-515;1711;21534;15937.9;1;558;-2.14748e+09;-1.53664e+06;-1;0;0;0;-1;0;891721779;914465563;76469141
1818;8.45383e-15;-515;1711;21534;15937.9;1;558;-2.14748e+09;-1.53369e+06;-1;0;0;0;-1;0;891842203;914610085;76517839
1819;8.45383e-15;-516;1711;21534;15937.9;1;558;-2.14748e+09;-1.53074e+06;0;0;0;0;0;0;891962390;914754346;76566463
1820;8.45383e-15;-516;1711;21534;15937.9;1;558;-2.14748e+09;-1.5278e+06;-1;0;0;0;-1;0;892082340;914898344;76615014
1821;8.45383e-15;-517;1711;21534;15937.9;1;558;-2.14748e+09;-1.52487e+06;0;0;0;0;0;0;892202052;915042082;76663491
1822;8.45383e-15;-518;1711;21534;15937.9;1;558;-2.14748e+09;-1.52194e+06;0;0;0;0;0;0;892321529;915185558;76711895
1823;8.45383e-15;-519;1711;21534;15937.9;1;558;-2.14748e+09;-1.51902e+06;0;0;0;0;0;0;892440769;915328774;76760226
1824;8.45383e-15;-520;1711;21534;15937.9;1;558;-2.14748e+09;-1.5161e+06;0;0;0;0;0;0;892559774;915471731;76808483
1825;8.45383e-15;-521;1711;21534;15937.9;1;558;-2.14748e+09;-1.51319e+06;0;0;0;0;0;0;892678544;915614428;76856668
1826;8.45383e-15;-521;1711;21534;15937.9;1;558;-2.14748e+09;-1.51028e+06;-1;0;0;0;-1;0;892797080;915756867;76904779
1827;8.45383e-15;-521;1711;21534;15937.9;1;558;-2.14748e+09;-1.50738e+06;-1;0;0;0;-1;0;892915383;915899047;76952817
1828;8.45383e-15;-521;1711;21534;15937.9;1;558;-2.14748e+09;-1.50449e+06;-1;0;0;0;-1;0;893033451;916040969;77000783
1829;8.45383e-15;-522;1711;21534;15937.9;1;558;-2.14748e+09;-1.5016e+06;0;0;0;0;0;0;893151287;916182634;77048675
1830;8.45383e-15;-523;1711;21534;15937.9;1;558;-2.14748e+09;-1.49872e+06;0;0;0;0;0;0;893268891;916324042;77096495
1831;8.45383e-15;-524;1711;21534;15937.9;1;558;-2.14748e+09;-1.49585e+06;0;0;0;0;0;0;893386263;916465194;77144243
1832;8.45383e-15;-524;1711;21534;15937.9;1;558;-2.14748e+09;-1.49298e+06;-1;0;0;0;-1;0;893503404;916606090;77191917
1833;8.45383e-15;-525;1711;21534;15937.9;1;558;-2.14748e+09;-1.49012e+06;0;0;0;0;0;0;893620313;916746730;77239520
1834;8.45383e-15;-525;1711;21534;15937.9;1;558;-2.14748e+09;-1.48726e+06;-1;0;0;0;-1;0;893736993;916887115;77287049
1835;8.45383e-15;-526;1711;21534;15937.9;1;558;-2.14748e+09;-1.48441e+06;0;0;0;0;0;0;893853442;917027246;77334507
1836;8.45383e-15;-526;1711;21534;15937.9;1;558;-2.14748e+09;-1.48156e+06;-1;0;0;0;-1;0;893969662;917167123;77381892
1837;8.45383e-15;-527;1711;21534;15937.9;1;558;-2.14748e+09;-1.47872e+06;0;0;0;0;0;0;894085653;917306747;77429205
1838;8.45383e-15;-527;1711;21534;15937.9;1;558;-2.14748e+09;-1.47589e+06;-1;0;0;0;-1;0;894201416;917446117;77476446
1839;8.45383e-15;-527;1711;21534;15937.9;1;558;-2.14748e+09;-1.47306e+06;-1;0;0;0;-1;0;894316951;917585235;77523615
1840;8.45383e-15;-527;1711;21534;15937.9;1;558;-2.14748e+09;-1.47024e+06;-1;0;0;0;-1;0;894432259;917724101;77570712
1841;8.45383e-15;-528;1711;21534;15937.9;1;558;-2.14748e+09;-1.46742e+06;0;0;0;0;0;0;894547339;917862715;77617738
1842;8.45383e-15;-528;1711;21534;15937.9;1;558;-2.14748e+09;-1.46462e+06;-1;0;0;0;-1;0;894662193;918001078;77664691
1843;8.45383e-15;-529;1711;21534;15937.9;1;558;-2.14748e+09;-1.46181e+06;0;0;0;0;0;0;894776821;918139190;77711573
1844;8.45383e-15;-529;1711;21534;15937.9;1;558;-2.14748e+09;-1.45901e+06;-1;0;0;0;-1;0;894891224;918277053;77758383
1845;8.45383e-15;-529;1711;21534;15937.9;1;558;-2.14748e+09;-1.45622e+06;-1;0;0;0;-1;0;895005402;918414665;77805122
1846;8.45383e-15;-530;1711;21534;15937.9;1;558;-2.14748e+09;-1.45343e+06;0;0;0;0;0;0;895119355;918552028;77851789
1847;8.45383e-15;-531;1711;21534;15937.9;1;558;-2.14748e+09;-1.45065e+06;0;0;0;0;0;0;895233084;918689143;77898385
1848;8.45383e-15;-532;1711;21534;15937.9;1;558;-2.14748e+09;-1.44788e+06;0;0;0;0;0;0;895346589;918826009;77944910
1849;8.45383e-15;-533;1711;21534;15937.9;1;558;-2.14748e+09;-1.4451e+06;0;0;0;0;0;0;895459871;918962627;77991363
1850;8.45383e-15;-533;1711;21534;15937.9;1;558;-2.14748e+09;-1.44234e+06;-1;0;0;0;-1;0;895572931;919098998;78037746
1851;8.45383e-15;-533;1711;21534;15937.9;1;558;-2.14748e+09;-1.43958e+06;-1;0;0;0;-1;0;895685768;919235121;78084057
1852;8.45383e-15;-533;1711;21534;15937.9;1;558;-2.14748e+09;-1.43683e+06;-1;0;0;0;-1;0;895798384;919370999;78130297
1853;8.45383e-15;-533;1711;21534;15937.9;1;558;-2.14748e+09;-1.43408e+06;-1;0;0;0;-1;0;895910778;919506630;78176467
1854;8.45383e-15;-534;1711;21534;15937.9;1;558;-2.14748e+09;-1.43134e+06;0;0;0;0;0;0;896022952;919642016;78222566
1855;8.45383e-15;-535;1711;21534;15937.9;1;558;-2.14748e+09;-1.4286e+06;0;0;0;0;0;0;896134905;919777157;78268594
1856;8.45383e-15;-535;1711;21534;15937.9;1;558;-2.14748e+09;-1.42587e+06;-1;0;0;0;-1;0;896246639;919912053;78314551
1857;8.45383e-15;-535;1711;21534;15937.9;1;558;-2.14748e+09;-1.42315e+06;-1;0;0;0;-1;0;896358153;920046704;78360438
1858;8.45383e-15;-535;1711;21534;15937.9;1;558;-2.14748e+09;-1.42043e+06;-1;0;0;0;-1;0;896469448;920181113;78406254
1859;8.45383e-15;-535;1711;21534;15937.9;1;558;-2.14748e+09;-1.41771e+06;-1;0;0;0;-1;0;896580525;920315277;78452000
1860;8.45383e-15;-535;1711;21534;15937.9;1;558;-2.14748e+09;-1.41501e+06;-1;0;0;0;-1;0;896691384;920449199;78497676
1861;8.45383e-15;-536;1711;21534;15937.9;1;558;-2.14748e+09;-1.4123e+06;0;0;0;0;0;0;896802025;920582879;78543282
1862;8.45383e-15;-536;1711;21534;15937.9;1;558;-2.14748e+09;-1.40961e+06;-1;0;0;0;-1;0;896912449;920716317;78588817
1863;8.45383e-15;-536;1711;21534;15937.9;1;558;-2.14748e+09;-1.40691e+06;-1;0;0;0;-1;0;897022657;920849513;78634282
1864;8.45383e-15;-537;1711;21534;15937.9;1;558;-2.14748e+09;-1.40423e+06;0;0;0;0;0;0;897132648;920982468;78679678
1865;8.45383e-15;-538;1711;21534;15937.9;1;558;-2.14748e+09;-1.40155e+06;0;0;0;0;0;0;897242424;921115183;78725003
1866;8.45383e-15;-538;1711;21534;15937.9;1;558;-2.14748e+09;-1.39887e+06;-1;0;0;0;-1;0;897351984;921247658;78770259
1867;8.45383e-15;-539;1711;21534;15937.9;1;558;-2.14748e+09;-1.3962e+06;0;0;0;0;0;0;897461330;921379892;78815445
1868;8.45383e-15;-540;1711;21534;15937.9;1;558;-2.14748e+09;-1.39354e+06;0;0;0;0;0;0;897570461;921511888;78860561
1869;8.45383e-15;-540;1711;21534;15937.9;1;558;-2.14748e+09;-1.39088e+06;-1;0;0;0;-1;0;897679379;921643645;78905608
1870;8.45383e-15;-540;1711;21534;15937.9;1;558;-2.14748e+09;-1.38823e+06;-1;0;0;0;-1;0;897788083;921775163;78950585
1871;8.45383e-15;-541;1711;21534;15937.9;1;558;-2.14748e+09;-1.38558e+06;0;0;0;0;0;0;897896574;921906444;78995493
1872;8.45383e-15;-541;1711;21534;15937.9;1;558;-2.14748e+09;-1.38294e+06;-1;0;0;0;-1;0;898004853;922037487;79040331
1873;8.45383e-15;-542;1711;21534;15937.9;1;558;-2.14748e+09;-1.3803e+06;0;0;0;0;0;0;898112919;922168293;79085101
1874;8.45383e-15;-543;1711;21534;15937.9;1;558;-2.14748e+09;-1.37767e+06;0;0;0;0;0;0;898220774;922298863;79129801
1875;8.45383e-15;-544;1711;21534;15937.9;1;558;-2.14748e+09;-1.37504e+06;0;0;0;0;0;0;898328418;922429197;79174432
1876;8.45383e-15;-544;1711;21534;15937.9;1;558;-2.14748e+09;-1.37242e+06;-1;0;0;0;-1;0;898435850;922559294;79218994
1877;8.45383e-15;-545;1711;21534;15937.9;1;558;-2.14748e+09;-1.3698e+06;0;0;0;0;0;0;898543073;922689157;79263487
1878;8.45383e-15;-546;1711;21534;15937.9;1;558;-2.14748e+09;-1.36719e+06;0;0;0;0;0;0;898650086;922818785;79307911
1879;8.45383e-15;-547;1711;21534;15937.9;1;558;-2.14748e+09;-1.36459e+06;0;0;0;0;0;0;898756889;922948178;79352267
1880;8.45383e-15;-547;1711;21534;15937.9;1;558;-2.14748e+09;-1.36199e+06;-1;0;0;0;-1;0;898863483;923077338;79396554
1881;8.45383e-15;-547;1711;21534;15937.9;1;558;-2.14748e+09;-1.35939e+06;-1;0;0;0;-1;0;898969869;923206264;79440772
1882;8.45383e-15;-547;1711;21534;15937.9;1;558;-2.14748e+09;-1.3568e+06;-1;0;0;0;-1;0;899076047;923334956;79484922
1883;8.45383e-15;-548;1711;21534;15937.9;1;558;-2.14748e+09;-1.35422e+06;0;0;0;0;0;0;899182017;923463417;79529004
1884;8.45383e-15;-549;1711;21534;15937.9;1;558;-2.14748e+09;-1.35164e+06;0;0;0;0;0;0;899287779;923591645;79573017
1885;8.45383e-15;-550;1711;21534;15937.9;1;558;-2.14748e+09;-1.34907e+06;0;0;0;0;0;0;899393335;923719641;79616962
1886;8.45383e-15;-550;1711;21534;15937.9;1;558;-2.14748e+09;-1.3465e+06;-1;0;0;0;-1;0;899498685;923847406;79660838
1887;8.45383e-15;-550;1711;21534;15937.9;1;558;-2.14748e+09;-1.34393e+06;-1;0;0;0;-1;0;899603828;923974940;79704647
1888;8.45383e-15;-550;1711;21534;15937.9;1;558;-2.14748e+09;-1.34138e+06;-1;0;0;0;-1;0;899708766;924102243;79748388
1889;8.45383e-15;-551;1711;21534;15937.9;1;558;-2.14748e+09;-1.33882e+06;0;0;0;0;0;0;899813499;924229317;79792060
1890;8.45383e-15;-552;1711;21534;15937.9;1;558;-2.14748e+09;-1.33628e+06;0;0;0;0;0;0;899918028;924356160;79835665
1891;8.45383e-15;-553;1711;21534;15937.9;1;558;-2.14748e+09;-1.33373e+06;0;0;0;0;0;0;900022352;924482775;79879202
1892;8.45383e-15;-553;1711;21534;15937.9;1;558;-2.14748e+09;-1.3312e+06;-1;0;0;0;-1;0;900126472;924609161;79922672
1893;8.45383e-15;-554;1711;21534;15937.9;1;558;-2.14748e+09;-1.32866e+06;0;0;0;0;0;0;900230389;924735318;79966073
1894;8.45383e-15;-554;1711;21534;15937.9;1;558;-2.14748e+09;-1.32614e+06;-1;0;0;0;-1;0;900334104;924861248;80009408
1895;8.45383e-15;-555;1711;21534;15937.9;1;558;-2.14748e+09;-1.32361e+06;0;0;0;0;0;0;900437615;924986950;80052674
1896;8.45383e-15;-556;1711;21534;15937.9;1;558;-2.14748e+09;-1.3211e+06;0;0;0;0;0;0;900540925;925112425;80095874
1897;8.45383e-15;-557;1711;21534;15937.9;1;558;-2.14748e+09;-1.31858e+06;0;0;0;0;0;0;900644032;925237673;80139006
1898;8.45383e-15;-557;1711;21534;15937.9;1;558;-2.14748e+09;-1.31608e+06;-1;0;0;0;-1;0;900746939;925362695;80182071
1899;8.45383e-15;-557;1711;21534;15937.9;1;558;-2.14748e+09;-1.31358e+06;-1;0;0;0;-1;0;900849645;925487491;80225069
1900;8.45383e-15;-558;1711;21534;15937.9;1;558;-2.14748e+09;-1.31108e+06;0;0;0;0;0;0;900952150;925612062;80268000
1901;8.45383e-15;-558;1711;21534;15937.9;1;558;-2.14748e+09;-1.30859e+06;-1;0;0;0;-1;0;901054456;925736408;80310864
1902;8.45383e-15;-559;1711;21534;15937.9;1;558;-2.14748e+09;-1.3061e+06;0;0;0;0;0;0;901156561;925860529;80353661
1903;8.45383e-15;-560;1711;21534;15937.9;1;558;-2.14748e+09;-1.30362e+06;0;0;0;0;0;0;901258468;925984426;80396391
1904;8.45383e-15;-560;1711;21534;15937.9;1;558;-2.14748e+09;-1.30114e+06;-1;0;0;0;-1;0;901360176;926108099;80439055
1905;8.45383e-15;-560;1711;21534;15937.9;1;558;-2.14748e+09;-1.29867e+06;-1;0;0;0;-1;0;901461685;926231549;80481652
1906;8.45383e-15;-560;1711;21534;15937.9;1;558;-2.14748e+09;-1.2962e+06;-1;0;0;0;-1;0;901562997;926354776;80524183
1907;8.45383e-15;-560;1711;21534;15937.9;1;558;-2.14748e+09;-1.29374e+06;-1;0;0;0;-1;0;901664111;926477781;80566647
1908;8.45383e-15;-560;1711;21534;15937.9;1;558;-2.14748e+09;-1.29129e+06;-1;0;0;0;-1;0;901765028;926600563;80609044
1909;8.45383e-15;-560;1711;21534;15937.9;1;558;-2.14748e+09;-1.28884e+06;-1;0;0;0;-1;0;901865749;926723124;80651376
1910;8.45383e-15;-560;1711;21534;15937.9;1;558;-2.14748e+09;-1.28639e+06;-1;0;0;0;-1;0;901966273;926845463;80693641
1911;8.45383e-15;-561;1711;21534;15937.9;1;558;-2.14748e+09;-1.28395e+06;0;0;0;0;0;0;902066601;926967582;80735840
1912;8.45383e-15;-562;1711;21534;15937.9;1;558;-2.14748e+09;-1.28151e+06;0;0;0;0;0;0;902166734;927089480;80777973
1913;8.45383e-15;-563;1711;21534;15937.9;1;558;-2.14748e+09;-1.27908e+06;0;0;0;0;0;0;902266672;927211158;80820040
1914;8.45383e-15;-564;1711;21534;15937.9;1;558;-2.14748e+09;-1.27665e+06;0;0;0;0;0;0;902366415;927332616;80862041
1915;8.45383e-15;-564;1711;21534;15937.9;1;558;-2.14748e+09;-1.27423e+06;-1;0;0;0;-1;0;902465964;927453855;80903976
1916;8.45383e-15;-565;1711;21534;15937.9;1;558;-2.14748e+09;-1.27181e+06;0;0;0;0;0;0;902565319;927574876;80945846
1917;8.45383e-15;-565;1711;21534;15937.9;1;558;-2.14748e+09;-1.2694e+06;-1;0;0;0;-1;0;902664481;927695677;80987650
1918;8.45383e-15;-566;1711;21534;15937.9;1;558;-2.14748e+09;-1.26699e+06;0;0;0;0;0;0;902763450;927816261;81029389
1919;8.45383e-15;-566;1711;21534;15937.9;1;558;-2.14748e+09;-1.26459e+06;-1;0;0;0;-1;0;902862226;927936627;81071062
1920;8.45383e-15;-566;1711;21534;15937.9;1;558;-2.14748e+09;-1.26219e+06;-1;0;0;0;-1;0;902960810;928056776;81112669
1921;8.45383e-15;-567;1711;21534;15937.9;1;558;-2.14748e+09;-1.2598e+06;0;0;0;0;0;0;903059202;928176709;81154212
1922;8.45383e-15;-568;1711;21534;15937.9;1;558;-2.14748e+09;-1.25741e+06;0;0;0;0;0;0;903157402;928296424;81195689
1923;8.45383e-15;-569;1711;21534;15937.9;1;558;-2.14748e+09;-1.25502e+06;0;0;0;0;0;0;903255412;928415924;81237101
1924;8.45383e-15;-569;1711;21534;15937.9;1;558;-2.14748e+09;-1.25265e+06;-1;0;0;0;-1;0;903353231;928535208;81278448
1925;8.45383e-15;-569;1711;21534;15937.9;1;558;-2.14748e+09;-1.25027e+06;-1;0;0;0;-1;0;903450860;928654277;81319730
1926;8.45383e-15;-570;1711;21534;15937.9;1;558;-2.14748e+09;-1.2479e+06;0;0;0;0;0;0;903548299;928773131;81360947
1927;8.45383e-15;-570;1711;21534;15937.9;1;558;-2.14748e+09;-1.24554e+06;-1;0;0;0;-1;0;903645548;928891770;81402099
1928;8.45383e-15;-570;1711;21534;15937.9;1;558;-2.14748e+09;-1.24318e+06;-1;0;0;0;-1;0;903742609;929010196;81443187
1929;8.45383e-15;-571;1711;21534;15937.9;1;558;-2.14748e+09;-1.24082e+06;0;0;0;0;0;0;903839481;929128408;81484209
1930;8.45383e-15;-572;1711;21534;15937.9;1;558;-2.14748e+09;-1.23847e+06;0;0;0;0;0;0;903936164;929246406;81525168
1931;8.45383e-15;-572;1711;21534;15937.9;1;558;-2.14748e+09;-1.23613e+06;-1;0;0;0;-1;0;904032660;929364192;81566062
1932;8.45383e-15;-573;1711;21534;15937.9;1;558;-2.14748e+09;-1.23378e+06;0;0;0;0;0;0;904128968;929481765;81606891
1933;8.45383e-15;-573;1711;21534;15937.9;1;558;-2.14748e+09;-1.23145e+06;-1;0;0;0;-1;0;904225089;929599126;81647656
1934;8.45383e-15;-573;1711;21534;15937.9;1;558;-2.14748e+09;-1.22912e+06;-1;0;0;0;-1;0;904321023;929716276;81688357
1935;8.45383e-15;-574;1711;21534;15937.9;1;558;-2.14748e+09;-1.22679e+06;0;0;0;0;0;0;904416771;929833214;81728994
1936;8.45383e-15;-574;1711;21534;15937.9;1;558;-2.14748e+09;-1.22447e+06;-1;0;0;0;-1;0;904512333;929949941;81769566
1937;8.45383e-15;-574;1711;21534;15937.9;1;558;-2.14748e+09;-1.22215e+06;-1;0;0;0;-1;0;904607710;930066458;81810075
1938;8.45383e-15;-574;1711;21534;15937.9;1;558;-2.14748e+09;-1.21984e+06;-1;0;0;0;-1;0;904702901;930182764;81850519
1939;8.45383e-15;-575;1711;21534;15937.9;1;558;-2.14748e+09;-1.21753e+06;0;0;0;0;0;0;904797908;930298861;81890900
1940;8.45383e-15;-575;1711;21534;15937.9;1;558;-2.14748e+09;-1.21522e+06;-1;0;0;0;-1;0;904892730;930414749;81931217
1941;8.45383e-15;-576;1711;21534;15937.9;1;558;-2.14748e+09;-1.21293e+06;0;0;0;0;0;0;904987368;930530427;81971471
1942;8.45383e-15;-576;1711;21534;15937.9;1;558;-2.14748e+09;-1.21063e+06;-1;0;0;0;-1;0;905081823;930645897;82011661
1943;8.45383e-15;-576;1711;21534;15937.9;1;558;-2.14748e+09;-1.20834e+06;-1;0;0;0;-1;0;905176094;930761159;82051787
1944;8.45383e-15;-576;1711;21534;15937.9;1;558;-2.14748e+09;-1.20606e+06;-1;0;0;0;-1;0;905270183;930876213;82091850
1945;8.45383e-15;-577;1711;21534;15937.9;1;558;-2.14748e+09;-1.20377e+06;0;0;0;0;0;0;905364088;930991059;82131850
1946;8.45383e-15;-577;1711;21534;15937.9;1;558;-2.14748e+09;-1.2015e+06;-1;0;0;0;-1;0;905457812;931105698;82171786
1947;8.45383e-15;-578;1711;21534;15937.9;1;558;-2.14748e+09;-1.19923e+06;0;0;0;0;0;0;905551354;931220131;82211659
1948;8.45383e-15;-578;1711;21534;15937.9;1;558;-2.14748e+09;-1.19696e+06;-1;0;0;0;-1;0;905644715;931334357;82251469
1949;8.45383e-15;-579;1711;21534;15937.9;1;558;-2.14748e+09;-1.1947e+06;0;0;0;0;0;0;905737895;931448378;82291216
1950;8.45383e-15;-580;1711;21534;15937.9;1;558;-2.14748e+09;-1.19244e+06;0;0;0;0;0;0;905830894;931562193;82330900
1951;8.45383e-15;-580;1711;21534;15937.9;1;558;-2.14748e+09;-1.19018e+06;-1;0;0;0;-1;0;905923712;931675802;82370522
1952;8.45383e-15;-580;1711;21534;15937.9;1;558;-2.14748e+09;-1.18793e+06;-1;0;0;0;-1;0;906016351;931789207;82410080
1953;8.45383e-15;-581;1711;21534;15937.9;1;558;-2.14748e+09;-1.18569e+06;0;0;0;0;0;0;906108810;931902408;82449576
1954;8.45383e-15;-581;1711;21534;15937.9;1;558;-2.14748e+09;-1.18345e+06;-1;0;0;0;-1;0;906201091;932015404;82489009
1955;8.45383e-15;-581;1711;21534;15937.9;1;558;-2.14748e+09;-1.18121e+06;-1;0;0;0;-1;0;906293192;932128197;82528380
1956;8.45383e-15;-582;1711;21534;15937.9;1;558;-2.14748e+09;-1.17898e+06;0;0;0;0;0;0;906385115;932240786;82567688
1957;8.45383e-15;-582;1711;21534;15937.9;1;558;-2.14748e+09;-1.17675e+06;-1;0;0;0;-1;0;906476860;932353173;82606934
1958;8.45383e-15;-583;1711;21534;15937.9;1;558;-2.14748e+09;-1.17453e+06;0;0;0;0;0;0;906568428;932465357;82646117
1959;8.45383e-15;-584;1711;21534;15937.9;1;558;-2.14748e+09;-1.17231e+06;0;0;0;0;0;0;906659818;932577338;82685239
1960;8.45383e-15;-585;1711;21534;15937.9;1;558;-2.14748e+09;-1.1701e+06;0;0;0;0;0;0;906751031;932689118;82724298
1961;8.45383e-15;-585;1711;21534;15937.9;1;558;-2.14748e+09;-1.16789e+06;-1;0;0;0;-1;0;906842067;932800697;82763295
1962;8.45383e-15;-586;1711;21534;15937.9;1;558;-2.14748e+09;-1.16568e+06;0;0;0;0;0;0;906932927;932912074;82802230
1963;8.45383e-15;-587;1711;21534;15937.9;1;558;-2.14748e+09;-1.16348e+06;0;0;0;0;0;0;907023612;933023251;82841104
1964;8.45383e-15;-587;1711;21534;15937.9;1;558;-2.14748e+09;-1.16129e+06;-1;0;0;0;-1;0;907114121;933134227;82879915
1965;8.45383e-15;-588;1711;21534;15937.9;1;558;-2.14748e+09;-1.1591e+06;0;0;0;0;0;0;907204455;933245004;82918665
1966;8.45383e-15;-589;1711;21534;15937.9;1;558;-2.14748e+09;-1.15691e+06;0;0;0;0;0;0;907294614;933355581;82957353
1967;8.45383e-15;-590;1711;21534;15937.9;1;558;-2.14748e+09;-1.15472e+06;0;0;0;0;0;0;907384598;933465958;82995980
1968;8.45383e-15;-590;1711;21534;15937.9;1;558;-2.14748e+09;-1.15255e+06;-1;0;0;0;-1;0;907474409;933576137;83034545
1969;8.45383e-15;-591;1711;21534;15937.9;1;558;-2.14748e+09;-1.15037e+06;0;0;0;0;0;0;907564046;933686117;83073048
1970;8.45383e-15;-592;1711;21534;15937.9;1;558;-2.14748e+09;-1.1482e+06;0;0;0;0;0;0;907653509;933795899;83111491
1971;8.45383e-15;-593;1711;21534;15937.9;1;558;-2.14748e+09;-1.14604e+06;0;0;0;0;0;0;907742800;933905484;83149872
1972;8.45383e-15;-593;1711;21534;15937.9;1;558;-2.14748e+09;-1.14387e+06;-1;0;0;0;-1;0;907831918;934014871;83188192
1973;8.45383e-15;-594;1711;21534;15937.9;1;558;-2.14748e+09;-1.14172e+06;0;0;0;0;0;0;907920863;934124060;83226451
1974;8.45383e-15;-594;1711;21534;15937.9;1;558;-2.14748e+09;-1.13956e+06;-1;0;0;0;-1;0;908009637;934233054;83264649
1975;8.45383e-15;-595;1711;21534;15937.9;1;558;-2.14748e+09;-1.13741e+06;0;0;0;0;0;0;908098239;934341850;83302786
1976;8.45383e-15;-596;1711;21534;15937.9;1;558;-2.14748e+09;-1.13527e+06;0;0;0;0;0;0;908186670;934450451;83340862
1977;8.45383e-15;-596;1711;21534;15937.9;1;558;-2.14748e+09;-1.13313e+06;-1;0;0;0;-1;0;908274930;934558856;83378878
1978;8.45383e-15;-597;1711;21534;15937.9;1;558;-2.14748e+09;-1.13099e+06;0;0;0;0;0;0;908363020;934667066;83416833
1979;8.45383e-15;-597;1711;21534;15937.9;1;558;-2.14748e+09;-1.12886e+06;-1;0;0;0;-1;0;908450939;934775081;83454727
1980;8.45383e-15;-597;1711;21534;15937.9;1;558;-2.14748e+09;-1.12673e+06;-1;0;0;0;-1;0;908538689;934882902;83492561
1981;8.45383e-15;-597;1711;21534;15937.9;1;558;-2.14748e+09;-1.12461e+06;-1;0;0;0;-1;0;908626269;934990528;83530334
1982;8.45383e-15;-598;1711;21534;15937.9;1;558;-2.14748e+09;-1.12249e+06;0;0;0;0;0;0;908713680;935097960;83568047
1983;8.45383e-15;-599;1711;21534;15937.9;1;558;-2.14748e+09;-1.12037e+06;0;0;0;0;0;0;908800922;935205199;83605699
1984;8.45383e-15;-600;1711;21534;15937.9;1;558;-2.14748e+09;-1.11826e+06;0;0;0;0;0;0;908887996;935312245;83643292
1985;8.45383e-15;-601;1711;21534;15937.9;1;558;-2.14748e+09;-1.11616e+06;0;0;0;0;0;0;908974902;935419098;83680824
1986;8.45383e-15;-601;1711;21534;15937.9;1;558;-2.14748e+09;-1.11405e+06;-1;0;0;0;-1;0;909061640;935525759;83718297
1987;8.45383e-15;-601;1711;21534;15937.9;1;558;-2.14748e+09;-1.11196e+06;-1;0;0;0;-1;0;909148211;935632227;83755709
1988;8.45383e-15;-602;1711;21534;15937.9;1;558;-2.14748e+09;-1.10986e+06;0;0;0;0;0;0;909234614;935738504;83793061
1989;8.45383e-15;-602;1711;21534;15937.9;1;558;-2.14748e+09;-1.10777e+06;-1;0;0;0;-1;0;909320851;935844590;83830354
1990;8.45383e-15;-602;1711;21534;15937.9;1;558;-2.14748e+09;-1.10568e+06;-1;0;0;0;-1;0;909406922;935950484;83867587
1991;8.45383e-15;-602;1711;21534;15937.9;1;558;-2.14748e+09;-1.1036e+06;-1;0;0;0;-1;0;909492826;936056188;83904761
1992;8.45383e-15;-603;1711;21534;15937.9;1;558;-2.14748e+09;-1.10152e+06;0;0;0;0;0;0;909578565;936161701;83941874
1993;8.45383e-15;-604;1711;21534;15937.9;1;558;-2.14748e+09;-1.09945e+06;0;0;0;0;0;0;909664138;936267025;83978929
1994;8.45383e-15;-604;1711;21534;15937.9;1;558;-2.14748e+09;-1.09738e+06;-1;0;0;0;-1;0;909749546;936372159;84015924
1995;8.45383e-15;-604;1711;21534;15937.9;1;558;-2.14748e+09;-1.09532e+06;-1;0;0;0;-1;0;909834790;936477103;84052859
1996;8.45383e-15;-605;1711;21534;15937.9;1;558;-2.14748e+09;-1.09325e+06;0;0;0;0;0;0;909919870;936581859;84089736
1997;8.45383e-15;-606;1711;21534;15937.9;1;558;-2.14748e+09;-1.0912e+06;0;0;0;0;0;0;910004785;936686426;84126553
1998;8.45383e-15;-607;1711;21534;15937.9;1;558;-2.14748e+09;-1.08914e+06;0;0;0;0;0;0;910089537;936790805;84163311
1999;8.45383e-15;-608;1711;21534;15937.9;1;558;-2.14748e+09;-1.08709e+06;0;0;0;0;0;0;910174125;936894995;84200011
