step;volume;A_0;B_0;C;L;p;Compl;Aext;Bext;A_ingresso;A_uscita;B_ingresso;B_uscita;A_netto;B_netto;Avicino;Amedio;Alontano
0;4.18816e-15;389;354;99;10000;1;1;1062;1100;506;129;538;133;377;405;982;2;0
1;4.18816e-15;391;360;97;10001;1;3;1022;1076;503;126;515;146;377;369;944;2;0
2;4.18879e-15;464;477;94;10002;1;6;1165;1250;535;228;529;233;307;296;913;6;0
3;4.18942e-15;552;549;97;10002;1;5;1192;1320;631;284;653;250;347;403;883;8;0
4;4.18942e-15;528;655;94;10002;1;9;1252;1388;564;303;651;308;261;343;856;9;0
5;4.18942e-15;600;671;95;10002;1;10;1188;1352;605;281;700;316;324;384;841;8;0
6;4.18942e-15;632;661;93;10002;1;13;1326;1514;570;315;678;328;255;350;808;8;0
7;4.18942e-15;635;703;89;10003;1;18;1265;1474;624;334;767;328;290;439;795;8;0
8;4.19005e-15;634;710;86;10003;1;22;1384;1631;622;303;745;353;319;392;765;7;0
9;4.19005e-15;681;761;86;10003;1;23;1430;1686;692;318;811;364;374;447;744;7;0
10;4.19005e-15;684;813;94;10003;1;20;1452;1739;694;316;817;394;378;423;723;7;0
11;4.19005e-15;699;821;91;10005;1;23;1477;1789;742;321;828;402;421;426;704;6;0
12;4.19131e-15;730;865;93;10005;1;24;1478;1838;794;353;896;450;441;446;685;6;0
13;4.19131e-15;773;888;91;10005;1;26;1500;1884;708;336;931;444;372;487;664;6;0
14;4.19131e-15;722;929;94;10005;1;26;1542;1929;736;396;937;414;340;523;649;6;0
15;4.19131e-15;737;942;98;10005;1;26;1540;1972;781;401;959;477;380;482;632;6;0
16;4.19131e-15;758;993;98;10005;1;28;1578;2014;801;418;1008;497;383;511;616;6;0
17;4.19131e-15;738;977;106;10006;1;25;1595;2054;777;360;1063;490;417;573;602;6;0
18;4.19195e-15;787;953;106;10007;1;28;1612;2092;796;374;1001;499;422;502;586;6;0
19;4.19258e-15;764;958;108;10007;1;30;1611;2129;778;411;1033;553;367;480;570;6;0
20;4.19258e-15;776;1078;105;10007;1;35;1623;2165;784;366;1090;469;418;621;556;6;0
21;4.19258e-15;821;1120;102;10007;1;39;1638;2199;788;379;1069;514;409;555;542;6;0
22;4.19258e-15;798;1071;115;10007;1;35;1572;2132;811;424;1087;564;387;523;536;6;0
23;4.19258e-15;814;1064;127;10008;1;31;1665;2264;830;377;1047;517;453;530;514;6;0
24;4.19321e-15;885;1108;126;10010;1;34;1694;2294;840;374;1151;522;466;629;503;6;0
25;4.19447e-15;809;1140;130;10011;1;34;1701;2324;883;458;1186;567;425;619;492;6;0
26;4.1951e-15;838;1098;132;10013;1;37;1609;2252;852;408;1173;584;444;589;487;6;0
27;4.19637e-15;806;1083;131;10014;1;44;1618;2280;838;410;1125;557;428;568;474;6;0
28;4.197e-15;800;1131;137;10015;1;44;1631;2306;828;436;1136;539;392;597;463;7;0
29;4.19763e-15;785;1129;139;10016;1;45;1723;2432;855;411;1138;552;444;586;448;7;0
30;4.19826e-15;829;1168;139;10016;1;48;1726;2456;815;354;1258;598;461;660;439;7;0
31;4.19826e-15;878;1236;143;10017;1;49;1732;2480;898;406;1216;581;492;635;431;7;0
32;4.1989e-15;862;1213;154;10018;1;48;1758;2503;871;404;1277;621;467;656;421;8;0
33;4.19953e-15;847;1267;157;10019;1;51;1742;2525;886;424;1271;653;462;618;411;8;0
34;4.20016e-15;887;1270;169;10019;1;46;1746;2547;881;429;1243;685;452;558;403;8;0
35;4.20016e-15;846;1277;173;10019;1;52;1751;2567;854;420;1254;618;434;636;395;9;0
36;4.20016e-15;868;1306;183;10020;1;54;1774;2587;929;395;1256;627;534;629;389;9;0
37;4.20079e-15;895;1267;189;10023;1;57;1760;2607;877;431;1341;626;446;715;381;10;0
38;4.20269e-15;868;1283;206;10025;1;49;1787;2626;904;456;1304;633;448;671;373;10;0
39;4.20395e-15;857;1274;209;10027;1;54;1769;2644;872;464;1300;671;408;629;367;11;0
40;4.20522e-15;853;1328;222;10027;1;52;1771;2661;901;433;1334;625;468;709;360;11;0
41;4.20522e-15;891;1292;220;10027;1;61;1797;2678;880;430;1295;690;450;605;353;12;0
42;4.20522e-15;919;1351;228;10029;1;62;1802;2695;867;461;1363;617;406;746;347;12;0
43;4.20648e-15;869;1381;230;10031;1;68;1779;2711;937;442;1363;670;495;693;341;12;0
44;4.20775e-15;928;1374;234;10032;1;72;1803;2726;918;438;1367;656;480;711;335;13;0
45;4.20838e-15;955;1369;242;10035;1;74;1776;2741;904;435;1392;711;469;681;327;14;0
46;4.21028e-15;931;1364;246;10036;1;79;1781;2755;930;485;1381;680;445;701;321;14;0
47;4.21091e-15;892;1317;258;10036;1;81;1786;2769;933;440;1345;679;493;666;314;15;0
48;4.21091e-15;862;1419;268;10039;1;83;1813;2783;830;410;1378;666;420;712;309;15;0
49;4.21281e-15;808;1391;298;10040;1;75;1816;2796;900;468;1397;708;432;689;304;16;0
50;4.21344e-15;831;1349;316;10043;1;75;1821;2809;841;409;1420;684;432;736;301;17;0
51;4.21534e-15;821;1419;329;10044;1;76;1821;2821;892;412;1401;683;480;718;296;17;0
52;4.21597e-15;842;1417;352;10048;1;71;1825;2833;884;439;1418;690;445;728;291;18;0
53;4.2185e-15;874;1403;366;10051;1;72;1828;2845;857;438;1423;686;419;737;286;19;0
54;4.2204e-15;924;1450;372;10053;1;80;1829;2856;933;456;1430;720;477;710;282;19;0
55;4.22167e-15;912;1405;381;10056;1;88;1834;2868;885;441;1391;701;444;690;278;20;0
56;4.22357e-15;925;1404;402;10060;1;87;1832;2878;909;433;1415;705;476;710;274;20;0
57;4.2261e-15;937;1422;409;10061;1;95;1833;2889;903;456;1429;694;447;735;270;21;0
58;4.22673e-15;911;1435;413;10064;1;105;1836;2899;911;464;1384;749;447;635;265;21;0
59;4.22863e-15;901;1432;427;10070;1;107;1814;2909;855;448;1448;744;407;704;260;21;0
60;4.23244e-15;925;1439;444;10073;1;110;1838;2918;914;461;1451;706;453;745;256;21;0
61;4.23434e-15;896;1405;462;10076;1;112;1838;2928;907;449;1468;701;458;767;252;22;0
62;4.23624e-15;932;1441;473;10076;1;117;1836;2937;919;435;1462;721;484;741;249;22;0
63;4.23624e-15;912;1449;503;10078;1;111;1837;2945;954;462;1485;715;492;770;245;23;0
64;4.23751e-15;888;1443;501;10079;1;127;1835;2954;945;460;1509;702;485;807;243;24;0
65;4.23814e-15;866;1425;508;10081;1;134;1805;2962;971;429;1497;737;542;760;239;24;0
66;4.23941e-15;878;1459;534;10083;1;134;1830;2971;859;425;1489;666;434;823;235;25;0
67;4.24068e-15;899;1449;555;10084;1;140;1831;2979;903;464;1567;696;439;871;232;25;0
68;4.24131e-15;883;1463;581;10087;1;142;1805;2986;931;411;1544;733;520;811;229;26;0
69;4.24321e-15;906;1526;627;10092;1;133;1827;2994;920;428;1491;707;492;784;225;26;0
70;4.24638e-15;938;1387;635;10095;1;151;1826;3001;924;430;1485;763;494;722;222;26;0
71;4.24829e-15;861;1405;650;10098;1;161;1825;3008;938;461;1530;719;477;811;220;27;0
72;4.25019e-15;842;1434;674;10102;1;164;1830;3015;908;447;1507;689;461;818;217;28;0
73;4.25273e-15;866;1416;693;10104;1;174;1807;3022;919;449;1522;730;470;792;215;28;0
74;4.254e-15;856;1499;731;10112;1;173;1808;3029;913;423;1540;710;490;830;214;29;0
75;4.25908e-15;832;1493;752;10112;1;181;1811;3035;877;453;1548;742;424;806;212;30;0
76;4.25908e-15;859;1462;798;10114;1;180;1810;3042;953;441;1509;770;512;739;207;30;0
77;4.26035e-15;861;1569;805;10118;1;199;1808;3048;908;407;1528;767;501;761;205;31;0
78;4.26289e-15;846;1486;825;10120;1;215;1807;3054;922;441;1557;751;481;806;203;31;0
79;4.26416e-15;836;1484;843;10123;1;227;1829;3060;934;426;1526;739;508;787;201;32;0
80;4.26606e-15;815;1475;874;10129;1;233;1805;3066;886;438;1551;721;448;830;199;33;0
81;4.26988e-15;865;1552;920;10135;1;227;1801;3071;895;425;1501;660;470;841;198;33;0
82;4.27369e-15;829;1505;947;10143;1;243;1805;3077;869;430;1487;757;439;730;195;33;0
83;4.27878e-15;840;1503;982;10148;1;244;1806;3082;878;421;1631;708;457;923;194;34;0
84;4.28196e-15;871;1491;1022;10151;1;249;1809;3088;871;415;1487;751;456;736;193;34;0
85;4.28387e-15;871;1501;1055;10157;1;260;1810;3093;891;414;1560;743;477;817;192;35;0
86;4.28768e-15;851;1480;1105;10161;1;262;1835;3098;878;424;1608;767;454;841;189;35;0
87;4.29023e-15;833;1502;1155;10165;1;268;1831;3103;943;432;1583;720;511;863;187;36;0
88;4.29278e-15;801;1486;1202;10169;1;273;1832;3108;887;436;1477;750;451;727;186;37;0
89;4.29532e-15;831;1477;1236;10175;1;283;1809;3112;973;428;1591;756;545;835;184;38;0
90;4.29914e-15;835;1526;1285;10184;1;290;1831;3117;903;408;1516;733;495;783;183;38;0
91;4.30488e-15;839;1541;1295;10193;1;321;1836;3122;860;429;1603;752;431;851;182;40;0
92;4.31062e-15;854;1501;1363;10204;1;318;1811;3126;919;466;1584;758;453;826;181;40;0
93;4.31763e-15;823;1483;1408;10208;1;332;1808;3130;880;422;1642;761;458;881;180;40;0
94;4.32018e-15;844;1497;1445;10215;1;347;1832;3135;889;419;1555;791;470;764;179;40;0
95;4.32465e-15;835;1502;1508;10227;1;350;1826;3139;975;416;1586;715;559;871;177;41;0
96;4.33231e-15;844;1482;1542;10233;1;375;1799;3143;926;409;1557;743;517;814;175;41;0
97;4.33614e-15;850;1527;1590;10247;1;384;1797;3147;908;453;1595;774;455;821;175;42;0
98;4.34509e-15;851;1512;1655;10256;1;390;1795;3151;857;390;1603;776;467;827;173;43;0
99;4.35084e-15;814;1469;1722;10260;1;396;1798;3155;852;414;1678;740;438;938;172;44;0
100;4.3534e-15;809;1526;1761;10268;1;410;1798;3159;856;434;1502;716;422;786;171;44;0
101;4.35852e-15;832;1574;1821;10281;1;415;1823;3162;873;422;1581;716;451;865;169;44;0
102;4.36684e-15;857;1529;1872;10300;1;438;1819;3166;926;417;1578;781;509;797;167;45;0
103;4.37901e-15;842;1475;1944;10309;1;446;1820;3170;899;433;1649;821;466;828;165;46;0
104;4.38478e-15;844;1565;1985;10323;1;478;1792;3173;904;419;1606;768;485;838;164;46;0
105;4.39376e-15;801;1519;2025;10332;1;512;1792;3177;908;437;1606;777;471;829;163;47;0
106;4.39954e-15;830;1529;2105;10347;1;523;1716;3080;864;391;1579;742;473;837;164;47;0
107;4.40917e-15;752;1535;2193;10356;1;529;1789;3184;884;419;1507;741;465;766;160;48;0
108;4.41496e-15;762;1495;2277;10370;1;533;1784;3187;942;387;1516;730;555;786;159;49;0
109;4.42396e-15;791;1500;2347;10383;1;543;1708;3090;865;383;1553;745;482;808;160;49;0
110;4.43232e-15;785;1554;2400;10392;1;573;1808;3193;828;386;1514;756;442;758;157;49;0
111;4.43811e-15;805;1470;2510;10410;1;574;1782;3196;906;401;1588;758;505;830;157;50;0
112;4.44971e-15;788;1464;2571;10418;1;607;1777;3199;853;345;1584;778;508;806;155;51;0
113;4.45486e-15;818;1475;2653;10441;1;622;1780;3203;830;394;1625;742;436;883;154;52;0
114;4.4697e-15;812;1460;2757;10451;1;630;1780;3206;913;386;1614;741;527;873;153;52;0
115;4.47615e-15;765;1430;2814;10466;1;666;1782;3208;836;404;1668;752;432;916;152;52;0
116;4.48584e-15;775;1475;2932;10480;1;673;1805;3211;877;357;1611;757;520;854;151;53;0
117;4.49489e-15;797;1508;3020;10502;1;693;1778;3214;922;382;1522;720;540;802;150;53;0
118;4.50912e-15;715;1570;3123;10527;1;707;1802;3217;882;379;1566;759;503;807;149;54;0
119;4.52531e-15;776;1469;3196;10539;1;733;1798;3220;868;365;1559;790;503;769;148;55;0
120;4.53309e-15;830;1493;3267;10558;1;764;1774;3222;900;357;1564;776;543;788;148;56;0
121;4.54542e-15;762;1473;3358;10578;1;802;1699;3125;876;411;1633;746;465;887;149;56;0
122;4.5584e-15;700;1432;3451;10608;1;828;1777;3228;812;362;1524;680;450;844;146;57;0
123;4.5779e-15;679;1435;3568;10625;1;844;1800;3230;872;361;1536;714;511;822;145;57;0
124;4.58897e-15;734;1504;3693;10648;1;848;1791;3233;947;348;1659;692;599;967;144;57;0
125;4.60395e-15;698;1581;3819;10664;1;856;1792;3235;882;363;1614;717;519;897;143;58;0
126;4.61438e-15;739;1490;3971;10692;1;854;1786;3238;888;337;1594;787;551;807;144;58;0
127;4.63266e-15;702;1446;4102;10712;1;870;1783;3240;897;405;1591;726;492;865;143;58;0
128;4.64573e-15;725;1520;4200;10735;1;899;1780;3243;852;368;1603;707;484;896;143;59;0
129;4.66077e-15;706;1484;4350;10768;1;903;1783;3245;856;387;1641;734;469;907;141;60;0
130;4.68239e-15;721;1473;4498;10795;1;910;1754;3248;916;381;1632;705;535;927;140;60;0
131;4.70009e-15;708;1487;4656;10819;1;909;1776;3250;904;350;1585;714;554;871;140;60;0
132;4.71585e-15;684;1461;4791;10839;1;928;1674;3152;869;362;1598;772;507;826;141;60;0
133;4.729e-15;659;1422;4861;10862;1;977;1772;3254;848;337;1549;767;511;782;138;60;0
134;4.74414e-15;690;1423;5005;10887;1;991;1771;3257;913;347;1585;713;566;872;139;61;0
135;4.7606e-15;725;1501;5133;10907;1;1016;1767;3259;854;341;1608;750;513;858;139;61;0
136;4.77379e-15;737;1510;5265;10932;1;1058;1770;3261;840;385;1621;754;455;867;138;62;0
137;4.7903e-15;674;1513;5416;10961;1;1077;1735;3263;901;341;1603;715;560;888;138;63;0
138;4.80946e-15;648;1494;5599;10992;1;1084;1734;3265;850;333;1696;714;517;982;137;63;0
139;4.82998e-15;654;1449;5811;11010;1;1071;1728;3267;877;331;1675;762;546;913;136;63;0
140;4.84191e-15;668;1464;5927;11036;1;1117;1753;3269;836;325;1721;765;511;956;136;63;0
141;4.85915e-15;707;1484;6068;11062;1;1144;1723;3271;887;340;1576;769;547;807;135;63;0
142;4.87642e-15;654;1465;6197;11095;1;1196;1716;3273;961;354;1644;720;607;924;134;64;0
143;4.89836e-15;664;1429;6386;11121;1;1194;1743;3275;815;328;1689;701;487;988;134;64;0
144;4.91567e-15;654;1449;6495;11157;1;1239;1716;3277;870;341;1568;722;529;846;134;64;0
145;4.93968e-15;638;1474;6594;11187;1;1308;1708;3279;852;289;1678;723;563;955;134;65;0
146;4.95971e-15;663;1449;6750;11229;1;1346;1629;3181;887;300;1602;755;587;847;135;65;0
147;4.9878e-15;619;1496;6967;11259;1;1345;1706;3283;838;340;1557;678;498;879;133;66;0
148;5.0079e-15;589;1447;7111;11298;1;1386;1702;3285;883;301;1605;741;582;864;133;66;0
149;5.03407e-15;617;1420;7247;11330;1;1441;1726;3287;843;294;1643;731;549;912;132;66;0
150;5.05557e-15;641;1447;7418;11361;1;1478;1697;3289;864;325;1676;735;539;941;132;68;0
151;5.07644e-15;604;1491;7581;11407;1;1525;1727;3291;761;328;1681;696;433;985;132;68;0
152;5.10745e-15;604;1475;7790;11453;1;1535;1726;3292;829;293;1608;743;536;865;130;68;0
153;5.13852e-15;593;1508;7979;11502;1;1572;1725;3294;843;294;1621;757;549;864;129;69;0
154;5.17169e-15;615;1521;8167;11533;1;1605;1723;3296;842;314;1582;700;528;882;129;69;0
155;5.19271e-15;605;1526;8386;11566;1;1619;1695;3298;891;350;1642;767;541;875;129;70;0
156;5.21512e-15;602;1471;8603;11622;1;1631;1721;3299;818;307;1688;760;511;928;130;70;0
157;5.25322e-15;636;1431;8831;11659;1;1637;1715;3301;886;300;1729;703;586;1026;129;71;0
158;5.27845e-15;647;1431;8987;11699;1;1697;1688;3303;866;299;1681;744;567;937;129;72;0
159;5.30576e-15;595;1413;9151;11736;1;1763;1686;3304;846;307;1636;693;539;943;129;72;0
160;5.33107e-15;572;1458;9394;11787;1;1763;1685;3306;830;299;1668;710;531;958;128;73;0
161;5.36602e-15;561;1396;9615;11839;1;1784;1708;3308;864;291;1673;782;573;891;129;73;0
162;5.40174e-15;530;1401;9810;11892;1;1820;1703;3309;840;293;1683;643;547;1040;129;74;0
163;5.43822e-15;565;1410;9964;11948;1;1888;1697;3311;898;262;1654;716;636;938;129;73;0
164;5.47686e-15;545;1373;10143;11996;1;1942;1669;3312;795;299;1712;710;496;1002;129;73;0
165;5.51005e-15;546;1448;10391;12044;1;1950;1666;3314;866;304;1587;715;562;872;128;74;0
166;5.54331e-15;525;1497;10633;12096;1;1942;1661;3315;843;286;1609;734;557;875;129;74;0
167;5.57942e-15;552;1451;10927;12147;1;1928;1686;3317;836;282;1579;726;554;853;128;74;0
168;5.61491e-15;574;1386;11147;12208;1;1951;1656;3318;801;286;1607;707;515;900;128;75;0
169;5.65745e-15;605;1377;11410;12258;1;1945;1656;3320;809;306;1657;709;503;948;128;75;0
170;5.69241e-15;556;1415;11562;12295;1;2021;1682;3321;824;290;1745;676;534;1069;127;75;0
171;5.71832e-15;516;1388;11781;12341;1;2051;1646;3323;834;286;1733;715;548;1018;127;76;0
172;5.75059e-15;533;1382;12000;12396;1;2072;1671;3324;831;251;1602;699;580;903;126;76;0
173;5.78925e-15;603;1472;12196;12438;1;2104;1644;3326;816;288;1634;673;528;961;127;76;0
174;5.81883e-15;556;1411;12395;12491;1;2156;1642;3327;812;286;1729;716;526;1013;126;76;0
175;5.85623e-15;526;1339;12625;12544;1;2185;1669;3329;823;275;1704;720;548;984;126;76;0
176;5.89372e-15;550;1378;12922;12595;1;2164;1642;3330;830;293;1702;679;537;1023;126;77;0
177;5.92986e-15;545;1403;13068;12660;1;2239;1638;3331;842;260;1648;702;582;946;125;77;0
178;5.97603e-15;515;1468;13299;12698;1;2269;1664;3333;804;263;1633;677;541;956;125;77;0
179;6.00308e-15;538;1382;13536;12755;1;2300;1630;3334;860;240;1654;725;620;929;126;78;0
180;6.04373e-15;520;1371;13798;12815;1;2318;1661;3336;752;277;1663;699;475;964;126;79;0
181;6.08662e-15;544;1500;14062;12874;1;2339;1657;3337;852;273;1651;670;579;981;126;79;0
182;6.12889e-15;502;1430;14307;12933;1;2372;1625;3338;808;278;1670;712;530;958;126;80;0
183;6.17126e-15;504;1377;14555;13001;1;2401;1621;3340;833;259;1635;732;574;903;126;81;0
184;6.22021e-15;492;1378;14774;13057;1;2446;1617;3341;781;209;1659;690;572;969;127;79;0
185;6.26063e-15;515;1444;14976;13110;1;2493;1613;3342;802;261;1622;684;541;938;126;79;0
186;6.29895e-15;500;1350;15247;13172;1;2510;1609;3343;815;252;1630;722;563;908;125;79;0
187;6.34389e-15;501;1429;15493;13233;1;2530;1607;3345;766;234;1673;617;532;1056;125;79;0
188;6.38821e-15;521;1406;15739;13299;1;2563;1634;3346;821;252;1696;716;569;980;125;79;0
189;6.43627e-15;524;1398;15968;13362;1;2609;1608;3347;784;251;1671;728;533;943;124;79;0
190;6.48226e-15;491;1355;16230;13428;1;2642;1637;3349;768;259;1633;716;509;917;124;79;0
191;6.53056e-15;472;1389;16497;13496;1;2658;1606;3350;825;246;1635;676;579;959;124;80;0
192;6.58045e-15;494;1404;16708;13564;1;2710;1634;3351;817;273;1702;708;544;994;124;80;0
193;6.63046e-15;524;1340;16932;13625;1;2764;1627;3352;842;233;1726;685;609;1041;124;80;0
194;6.67544e-15;524;1389;17130;13686;1;2832;1626;3353;856;256;1667;690;600;977;124;80;0
195;6.72051e-15;506;1463;17355;13750;1;2884;1624;3355;808;221;1697;644;587;1053;125;81;0
196;6.76792e-15;501;1407;17620;13815;1;2903;1623;3356;839;246;1704;749;593;955;124;81;0
197;6.81617e-15;509;1370;17830;13874;1;2973;1593;3357;798;247;1711;719;551;992;123;81;0
198;6.86007e-15;473;1361;18087;13937;1;3014;1597;3358;769;260;1688;697;509;991;123;82;0
199;6.90705e-15;500;1328;18421;14014;1;2997;1599;3359;777;232;1756;680;545;1076;123;82;0
200;6.96462e-15;465;1330;18758;14082;1;2990;1596;3360;816;230;1632;636;586;996;124;82;0
201;7.01559e-15;479;1379;19122;14152;1;2961;1592;3362;817;230;1741;661;587;1080;122;83;0
202;7.06819e-15;472;1338;19393;14218;1;2989;1594;3363;772;243;1690;720;529;970;123;83;0
203;7.11791e-15;489;1405;19710;14286;1;2993;1595;3364;795;226;1699;658;569;1041;123;83;0
204;7.16925e-15;442;1358;19958;14359;1;3039;1620;3365;842;241;1653;725;601;928;122;84;0
205;7.22451e-15;450;1355;20191;14426;1;3083;1615;3366;800;222;1728;706;578;1022;122;83;0
206;7.27535e-15;487;1391;20378;14505;1;3165;1585;3367;794;232;1683;704;562;979;122;85;0
207;7.33545e-15;473;1380;20648;14574;1;3193;1613;3368;795;239;1694;682;556;1012;122;83;0
208;7.38807e-15;426;1401;20924;14650;1;3207;1613;3369;814;253;1619;706;561;913;122;82;0
209;7.44618e-15;453;1385;21228;14712;1;3218;1585;3370;798;243;1725;676;555;1049;122;82;0
210;7.4937e-15;454;1378;21439;14780;1;3279;1586;3371;756;236;1669;693;520;976;122;82;0
211;7.54593e-15;445;1353;21671;14846;1;3337;1514;3273;778;231;1601;731;547;870;123;82;0
212;7.59675e-15;459;1287;22006;14909;1;3318;1515;3274;767;216;1594;675;551;919;123;83;0
213;7.64536e-15;478;1321;22292;14974;1;3322;1619;3375;732;240;1583;652;492;931;121;83;0
214;7.69562e-15;482;1320;22502;15044;1;3388;1594;3376;819;249;1746;716;570;1030;121;83;0
215;7.74987e-15;482;1362;22832;15107;1;3385;1623;3377;764;238;1626;685;526;941;121;84;0
216;7.7988e-15;443;1342;23088;15174;1;3430;1619;3378;854;248;1708;688;606;1020;120;83;0
217;7.85096e-15;428;1400;23313;15259;1;3478;1586;3379;838;213;1650;696;625;954;120;84;0
218;7.91729e-15;437;1350;23573;15340;1;3511;1614;3380;776;216;1722;698;560;1024;120;84;0
219;7.98068e-15;465;1326;23854;15402;1;3544;1613;3381;778;219;1692;687;559;1005;120;84;0
220;8.02931e-15;428;1385;24160;15492;1;3557;1612;3382;832;239;1657;632;593;1025;121;84;0
221;8.10008e-15;459;1352;24384;15571;1;3604;1584;3383;818;242;1692;750;576;942;121;85;0
222;8.16237e-15;448;1389;24641;15647;1;3640;1584;3384;790;251;1701;686;539;1015;120;86;0
223;8.22245e-15;435;1430;24868;15706;1;3711;1610;3385;815;226;1659;741;589;918;120;87;0
224;8.26919e-15;422;1309;25173;15794;1;3714;1583;3386;801;228;1661;697;573;964;121;88;0
225;8.33906e-15;408;1331;25516;15864;1;3708;1610;3387;794;241;1795;671;553;1124;121;88;0
226;8.39479e-15;432;1378;25816;15927;1;3733;1606;3388;815;206;1651;691;609;960;121;89;0
227;8.44505e-15;466;1347;26044;16011;1;3782;1606;3389;783;226;1699;704;557;995;121;89;0
228;8.51222e-15;494;1399;26276;16103;1;3845;1582;3390;803;246;1650;690;557;960;121;89;0
229;8.58598e-15;470;1357;26593;16177;1;3856;1609;3390;810;245;1698;715;565;983;121;89;0
230;8.64547e-15;476;1343;26817;16252;1;3922;1579;3391;780;233;1703;732;547;971;121;89;0
231;8.70591e-15;418;1364;27055;16337;1;3989;1606;3392;817;243;1683;660;574;1023;121;90;0
232;8.77457e-15;461;1354;27395;16427;1;3981;1603;3393;814;227;1737;654;587;1083;121;90;0
233;8.84747e-15;452;1323;27667;16513;1;4021;1601;3394;811;234;1691;692;577;999;121;89;0
234;8.91731e-15;455;1364;27908;16591;1;4077;1571;3395;837;260;1746;694;577;1052;121;89;0
235;8.98082e-15;443;1405;28191;16674;1;4107;1571;3396;787;232;1684;645;555;1039;121;89;0
236;9.04856e-15;453;1374;28471;16741;1;4141;1600;3397;766;234;1756;718;532;1038;120;89;0
237;9.10337e-15;448;1408;28732;16810;1;4195;1570;3398;773;252;1678;687;521;991;120;89;0
238;9.15993e-15;438;1379;29000;16884;1;4230;1567;3399;794;250;1784;712;544;1072;120;89;0
239;9.22072e-15;446;1314;29309;16975;1;4255;1595;3400;752;208;1769;674;544;1095;121;89;0
240;9.29566e-15;463;1260;29547;17062;1;4310;1594;3400;804;211;1671;656;593;1015;121;89;0
241;9.3675e-15;421;1365;29713;17153;1;4412;1596;3401;771;220;1660;665;551;995;121;90;0
242;9.44283e-15;434;1318;30096;17217;1;4378;1567;3402;767;209;1697;690;558;1007;120;91;0
243;9.49593e-15;424;1385;30394;17286;1;4389;1563;3403;826;237;1695;689;589;1006;120;91;0
244;9.5533e-15;418;1392;30676;17369;1;4423;1563;3404;795;215;1679;724;580;955;120;91;0
245;9.62245e-15;436;1361;30964;17443;1;4445;1560;3405;744;215;1625;682;529;943;119;92;0
246;9.68425e-15;453;1323;31259;17527;1;4473;1557;3406;793;203;1770;660;590;1110;119;92;0
247;9.75456e-15;462;1421;31545;17612;1;4501;1554;3407;774;223;1741;680;551;1061;119;93;0
248;9.82588e-15;449;1365;31834;17713;1;4544;1582;3407;795;222;1715;750;573;965;119;92;0
249;9.91085e-15;505;1306;32078;17786;1;4605;1585;3408;737;212;1760;684;525;1076;118;93;0
250;9.97241e-15;428;1336;32348;17864;1;4662;1558;3409;756;260;1753;646;496;1107;118;93;0
251;1.00383e-14;393;1376;32663;17953;1;4672;1587;3410;759;215;1707;686;544;1021;117;93;0
252;1.01137e-14;465;1389;32959;18040;1;4681;1587;3411;789;215;1679;697;574;982;116;93;0
253;1.01876e-14;465;1464;33279;18122;1;4703;1560;3411;791;236;1657;682;555;975;116;92;0
254;1.02574e-14;451;1384;33553;18202;1;4755;1588;3412;773;228;1762;728;545;1034;115;92;0
255;1.03257e-14;457;1424;33877;18288;1;4765;1587;3413;795;205;1685;694;590;991;115;92;0
256;1.03992e-14;448;1407;34209;18366;1;4777;1559;3414;796;215;1731;672;581;1059;115;91;0
257;1.04661e-14;438;1363;34429;18457;1;4862;1562;3415;750;233;1719;704;517;1015;115;92;0
258;1.05442e-14;416;1371;34677;18541;1;4924;1588;3415;829;221;1664;662;608;1002;116;93;0
259;1.06166e-14;392;1414;35006;18628;1;4928;1587;3416;772;221;1803;681;551;1122;116;92;0
260;1.06917e-14;440;1406;35370;18710;1;4914;1586;3417;797;206;1712;729;591;983;116;93;0
261;1.07626e-14;421;1466;35641;18803;1;4968;1587;3418;807;220;1748;691;587;1057;116;93;0
262;1.08432e-14;472;1415;35968;18874;1;4981;1558;3419;774;211;1624;726;563;898;116;92;0
263;1.09049e-14;448;1386;36308;18962;1;4978;1586;3419;786;225;1740;700;561;1040;116;94;0
264;1.09816e-14;469;1437;36577;19042;1;5024;1587;3420;768;220;1726;685;548;1041;116;94;0
265;1.10514e-14;424;1422;36948;19146;1;5019;1584;3421;825;235;1748;696;590;1052;116;94;0
266;1.11424e-14;434;1432;37173;19219;1;5085;1555;3422;798;213;1715;696;585;1019;116;94;0
267;1.12064e-14;429;1477;37465;19307;1;5108;1552;3422;828;237;1737;698;591;1039;115;96;0
268;1.12838e-14;439;1429;37788;19384;1;5120;1579;3423;799;206;1671;702;593;969;115;94;0
269;1.13516e-14;450;1374;38064;19475;1;5158;1549;3424;820;223;1697;714;597;983;115;95;0
270;1.14319e-14;427;1341;38306;19567;1;5235;1578;3425;762;206;1703;684;556;1019;115;95;0
271;1.15133e-14;443;1352;38526;19645;1;5297;1578;3425;768;209;1636;652;559;984;115;94;1
272;1.15825e-14;452;1424;38823;19729;1;5336;1551;3426;754;219;1665;691;535;974;116;95;1
273;1.16571e-14;452;1400;39055;19814;1;5408;1552;3427;821;226;1771;693;595;1078;116;94;1
274;1.17328e-14;428;1389;39343;19895;1;5460;1554;3428;761;208;1735;674;553;1061;115;94;1
275;1.18051e-14;453;1364;39641;20004;1;5494;1581;3428;769;200;1758;664;569;1094;116;93;1
276;4.18942e-15;372;940;14758;10106;1;5241;1559;3429;760;147;1728;390;613;1338;115;93;1
277;4.25527e-15;418;1059;15560;10194;1;5015;1527;3430;781;199;1773;499;582;1274;115;94;1
278;4.31125e-15;371;1104;16432;10283;1;4769;1500;3431;779;203;1758;540;576;1218;115;94;1
279;4.36812e-15;403;1155;17254;10377;1;4535;1503;3431;712;170;1681;564;542;1117;115;95;1
280;4.42846e-15;368;1137;18008;10476;1;4359;1436;3432;739;193;1749;583;546;1166;116;94;1
281;4.4923e-15;329;1163;18730;10595;1;4192;1359;3433;703;175;1692;576;528;1116;116;94;1
282;4.56945e-15;319;1202;19488;10700;1;3978;1322;3433;642;158;1674;604;484;1070;115;95;1
283;4.63788e-15;312;1213;20143;10806;1;3814;1291;3434;645;147;1715;609;498;1106;116;95;1
284;4.70732e-15;335;1220;20794;10926;1;3661;1259;3435;654;150;1764;574;504;1190;117;96;1
285;4.78633e-15;301;1288;21312;11027;1;3574;1307;3435;573;176;1688;600;397;1088;118;96;1
286;4.85318e-15;289;1233;21895;11151;1;3465;1215;3436;610;161;1754;639;449;1115;118;97;1
287;4.93567e-15;284;1202;22474;11261;1;3341;1237;3437;632;159;1713;642;473;1071;118;97;1
288;5.00924e-15;271;1318;22976;11366;1;3246;1235;3438;640;156;1667;653;484;1014;118;97;1
289;5.0798e-15;278;1331;23421;11489;1;3206;1214;3438;636;154;1647;615;482;1032;118;97;1
290;5.16288e-15;286;1344;23893;11603;1;3130;1197;3439;605;134;1692;659;471;1033;117;97;1
291;5.24028e-15;260;1360;24378;11723;1;3048;1160;3440;597;138;1699;683;459;1016;118;97;1
292;5.32218e-15;275;1372;24775;11843;1;3017;1146;3440;607;148;1748;627;459;1121;118;97;1
293;5.40449e-15;250;1391;25223;11959;1;2944;1154;3441;624;149;1705;634;475;1071;118;97;1
294;5.48446e-15;256;1321;25674;12074;1;2873;1143;3442;567;124;1680;682;443;998;118;97;1
295;5.56413e-15;277;1366;26051;12187;1;2845;1091;3442;586;134;1753;645;452;1108;118;97;1
296;5.64279e-15;248;1369;26438;12297;1;2796;1107;3443;530;131;1708;667;399;1041;117;97;1
297;5.71972e-15;252;1349;26801;12424;1;2762;1079;3444;536;122;1755;690;414;1065;117;97;1
298;5.80896e-15;261;1377;27194;12556;1;2712;1097;3444;553;140;1669;667;413;1002;118;97;1
299;5.90221e-15;270;1351;27527;12675;1;2709;1066;3445;575;104;1720;706;471;1014;117;97;1
300;5.9867e-15;266;1356;27890;12796;1;2671;1062;3445;547;147;1829;682;400;1147;117;97;1
301;6.07303e-15;271;1410;28243;12907;1;2638;1096;3446;542;140;1744;675;402;1069;117;97;1
302;6.15258e-15;238;1354;28578;13028;1;2628;1089;3447;525;112;1730;711;413;1019;116;97;1
303;6.23969e-15;241;1472;28922;13169;1;2589;1089;3447;543;151;1664;703;392;961;117;97;1
304;6.34171e-15;254;1474;29202;13267;1;2593;1051;3448;534;136;1734;746;398;988;117;97;1
305;6.41295e-15;230;1441;29512;13399;1;2589;1052;3449;493;125;1683;728;368;955;116;96;1
306;6.50932e-15;210;1436;29792;13508;1;2585;1066;3449;537;114;1720;719;423;1001;116;97;1
307;6.58927e-15;237;1408;30013;13638;1;2627;1080;3450;533;112;1758;727;421;1031;115;96;1
308;6.68504e-15;240;1456;30284;13735;1;2619;1077;3451;530;142;1748;696;388;1052;115;97;1
309;6.7568e-15;229;1473;30573;13822;1;2606;1037;3451;517;148;1745;720;369;1025;115;95;1
310;6.82138e-15;251;1524;30824;13914;1;2631;1070;3452;543;100;1746;747;443;999;115;95;1
311;6.88989e-15;260;1573;31109;14032;1;2630;1025;3452;554;106;1633;751;448;882;115;96;1
312;6.9781e-15;257;1464;31405;14130;1;2626;1065;3453;493;142;1731;804;351;927;114;95;1
313;7.05165e-15;299;1473;31618;14249;1;2669;1007;3454;504;110;1633;740;394;893;113;95;1
314;7.1413e-15;252;1452;31843;14362;1;2708;1061;3454;556;137;1718;737;419;981;113;95;1
315;7.22678e-15;256;1468;32096;14483;1;2711;1057;3455;527;133;1666;736;394;930;113;94;1
316;7.31869e-15;245;1437;32406;14602;1;2700;999;3455;512;124;1678;729;388;949;113;94;1
317;7.40946e-15;250;1411;32648;14693;1;2714;997;3456;529;144;1738;787;385;951;114;95;1
318;7.47913e-15;220;1446;32918;14805;1;2713;1052;3457;517;115;1782;724;402;1058;114;95;1
319;7.56517e-15;227;1476;33221;14895;1;2689;994;3457;534;120;1737;721;414;1016;114;95;1
320;7.63455e-15;233;1503;33472;15003;1;2691;1009;3458;499;114;1683;743;385;940;114;96;1
321;7.71808e-15;251;1516;33739;15126;1;2681;992;3458;522;119;1736;762;403;974;114;95;1
322;7.81358e-15;216;1464;33992;15231;1;2686;994;3459;476;118;1686;738;358;948;113;96;1
323;7.89542e-15;220;1481;34247;15340;1;2685;991;3460;514;114;1814;754;400;1060;112;96;1
324;7.98068e-15;267;1506;34463;15455;1;2695;1048;3460;483;122;1763;748;361;1015;112;96;1
325;8.07096e-15;236;1551;34672;15550;1;2732;1005;3461;567;121;1693;755;446;938;111;96;1
326;8.1458e-15;258;1515;34906;15655;1;2735;1025;3461;515;121;1660;739;394;921;111;95;1
327;8.22878e-15;243;1494;35129;15751;1;2753;1045;3462;491;111;1645;766;380;879;112;96;1
328;8.3049e-15;254;1556;35350;15848;1;2785;1007;3462;524;124;1765;676;400;1089;111;95;1
329;8.38204e-15;226;1513;35563;15957;1;2815;1045;3463;517;134;1764;765;383;999;112;95;1
330;8.46902e-15;250;1512;35805;16060;1;2825;1023;3464;548;124;1724;736;424;988;112;96;1
331;8.55148e-15;245;1478;36104;16161;1;2801;1045;3464;527;126;1701;771;401;930;112;95;1
332;8.6326e-15;236;1489;36304;16260;1;2844;1007;3465;546;118;1673;751;428;922;112;95;1
333;8.71236e-15;237;1519;36534;16369;1;2862;1012;3465;467;122;1726;731;345;995;111;96;1
334;8.80047e-15;249;1513;36813;16470;1;2847;1031;3466;502;121;1766;736;381;1030;110;96;2
335;8.88237e-15;250;1458;36998;16586;1;2893;1049;3466;528;131;1738;764;397;974;110;95;2
336;8.97675e-15;252;1495;37157;16699;1;2949;1046;3467;547;118;1743;729;429;1014;110;95;2
337;9.069e-15;235;1504;37347;16789;1;2984;1010;3467;487;133;1681;724;354;957;109;95;2
338;9.14271e-15;274;1478;37546;16897;1;3002;1049;3468;498;119;1759;771;379;988;109;95;2
339;9.23142e-15;248;1505;37700;17007;1;3056;1011;3469;507;142;1768;750;365;1018;109;95;2
340;9.32206e-15;265;1512;37967;17115;1;3048;988;3469;524;128;1692;726;396;966;109;96;2
341;9.41135e-15;250;1501;38147;17209;1;3085;1006;3470;489;127;1744;719;362;1025;109;95;2
342;9.48929e-15;247;1415;38343;17297;1;3123;1006;3470;479;135;1731;756;344;975;109;94;2
343;9.56245e-15;253;1486;38586;17395;1;3122;986;3471;497;118;1790;727;379;1063;108;94;2
344;9.64415e-15;247;1511;38833;17495;1;3122;1041;3471;499;106;1700;740;393;960;108;94;2
345;9.72775e-15;250;1526;39004;17580;1;3169;1006;3472;529;132;1769;735;397;1034;108;94;2
346;9.79901e-15;257;1495;39240;17679;1;3169;991;3472;491;146;1756;770;345;986;108;94;2
347;9.88221e-15;250;1487;39459;17785;1;3184;1046;3473;509;126;1749;740;383;1009;108;94;2
348;9.97157e-15;273;1522;39691;17887;1;3190;985;3473;556;145;1747;706;411;1041;108;94;2
349;1.00578e-14;258;1433;39892;17992;1;3216;987;3474;468;141;1762;755;327;1007;109;94;2
350;1.01468e-14;250;1542;40100;18085;1;3234;988;3474;449;128;1757;754;321;1003;108;94;2
351;1.02259e-14;251;1492;40316;18170;1;3248;989;3475;498;110;1704;746;388;958;108;94;2
352;1.02984e-14;246;1465;40548;18265;1;3262;989;3475;469;123;1687;757;346;930;107;94;2
353;1.03795e-14;258;1466;40789;18365;1;3258;991;3476;461;112;1764;709;349;1055;107;94;2
354;1.04652e-14;269;1419;41003;18473;1;3273;988;3476;518;137;1738;738;381;1000;106;93;2
355;1.0558e-14;253;1473;41210;18550;1;3282;990;3477;524;125;1754;720;399;1034;106;93;2
356;1.06243e-14;263;1485;41456;18633;1;3275;992;3477;487;113;1700;770;374;930;105;93;2
357;1.0696e-14;233;1566;41606;18741;1;3324;1047;3478;481;113;1763;744;368;1019;105;94;2
358;1.07895e-14;274;1582;41812;18841;1;3350;1043;3479;502;119;1755;761;383;994;105;93;2
359;1.08763e-14;278;1516;42052;18933;1;3368;978;3479;542;114;1737;759;428;978;106;92;2
360;1.09563e-14;245;1541;42289;19043;1;3371;1013;3480;516;124;1742;790;392;952;105;92;2
361;1.10523e-14;237;1546;42539;19150;1;3358;1031;3480;506;136;1732;734;370;998;104;92;2
362;1.11459e-14;230;1487;42808;19239;1;3338;1027;3481;536;136;1772;764;400;1008;104;92;2
363;1.1224e-14;273;1496;42984;19347;1;3373;1029;3481;490;122;1737;748;368;989;103;92;2
364;1.1319e-14;299;1513;43185;19438;1;3397;977;3482;531;139;1778;746;392;1032;103;91;2
365;1.13992e-14;240;1508;43350;19542;1;3449;1015;3482;504;143;1770;757;361;1013;103;92;2
366;1.14912e-14;245;1567;43600;19628;1;3444;980;3482;520;143;1757;797;377;960;103;92;2
367;1.15674e-14;242;1620;43807;19725;1;3451;982;3483;491;119;1731;741;372;990;102;92;2
368;1.16535e-14;260;1612;43985;19801;1;3487;981;3483;504;117;1759;783;387;976;102;92;2
369;1.17212e-14;253;1583;44204;19887;1;3499;981;3484;513;127;1698;796;386;902;102;93;2
370;1.17979e-14;256;1517;44385;19985;1;3528;1039;3484;480;134;1738;804;346;934;102;93;2
371;1.18856e-14;269;1477;44558;20091;1;3569;1018;3485;479;142;1732;739;337;993;102;94;2
372;4.21724e-15;203;1071;16223;10139.5;1;3424;1016;3485;532;82;1805;397;450;1408;102;94;2
373;4.27687e-15;252;1148;16867;10235.5;1;3227;961;3486;483;131;1684;557;352;1127;102;94;2
374;4.33806e-15;253;1259;17491;10333.5;1;3038;963;3486;495;111;1733;627;384;1106;102;94;2
375;4.40082e-15;264;1333;18039;10420.5;1;2893;985;3487;515;119;1711;644;396;1067;101;95;2
376;4.4568e-15;250;1324;18662;10502.5;1;2708;940;3487;467;132;1775;644;335;1131;101;95;2
377;4.50977e-15;229;1253;19176;10598.5;1;2570;906;3488;435;136;1694;755;299;939;100;95;2
378;4.57205e-15;212;1322;19670;10692.5;1;2442;881;3488;477;119;1653;656;358;997;101;95;2
379;4.63331e-15;207;1314;20194;10810.5;1;2280;821;3489;428;121;1722;681;307;1041;101;95;2
380;4.7106e-15;185;1414;20633;10922.5;1;2171;886;3489;401;96;1759;676;305;1083;101;95;2
381;4.78435e-15;213;1425;21056;11019.5;1;2063;870;3490;426;102;1783;730;324;1053;101;94;2
382;4.84854e-15;222;1437;21387;11117.5;1;2024;789;3490;392;105;1730;737;287;993;101;94;2
383;4.91367e-15;163;1468;21711;11231.5;1;1976;808;3491;392;100;1714;714;292;1000;101;93;2
384;4.98981e-15;200;1416;22118;11358.5;1;1868;832;3491;380;83;1772;763;297;1009;101;93;2
385;5.07509e-15;197;1474;22490;11458.5;1;1794;840;3491;386;93;1725;701;293;1024;101;93;2
386;5.14258e-15;203;1508;22813;11570.5;1;1728;834;3492;398;95;1770;713;303;1057;101;93;3
387;5.21852e-15;188;1472;23066;11685.5;1;1722;802;3492;422;98;1712;723;324;989;102;93;3
388;5.29688e-15;206;1541;23276;11799.5;1;1729;809;3493;458;85;1709;767;373;942;102;93;3
389;5.37495e-15;159;1461;23581;11898.5;1;1678;819;3493;414;97;1692;801;317;891;102;93;3
390;5.44305e-15;215;1524;23841;12006.5;1;1643;754;3494;416;78;1744;745;338;999;102;92;3
391;5.51767e-15;194;1599;24051;12116.5;1;1641;744;3494;353;95;1727;717;258;1010;101;92;3
392;5.59402e-15;162;1557;24267;12214.5;1;1636;752;3495;378;75;1722;804;303;918;101;91;3
393;5.66234e-15;181;1622;24493;12318.5;1;1616;760;3495;364;81;1726;804;283;922;101;91;3
394;5.73515e-15;163;1576;24728;12418.5;1;1593;747;3496;348;96;1737;802;252;935;100;91;3
395;5.80544e-15;158;1642;24971;12536.5;1;1564;802;3496;355;91;1760;785;264;975;100;90;3
396;5.88876e-15;201;1574;25221;12659.5;1;1515;769;3496;392;93;1821;781;299;1040;99;90;3
397;5.97603e-15;195;1523;25404;12766.5;1;1522;737;3497;410;87;1820;780;323;1040;99;90;3
398;6.0523e-15;159;1529;25567;12877.5;1;1543;739;3497;381;109;1764;767;272;997;99;90;3
399;6.13176e-15;167;1475;25735;12983.5;1;1546;733;3498;366;79;1764;787;287;977;98;90;3
400;6.20796e-15;175;1481;25953;13084.5;1;1536;735;3498;382;95;1860;774;287;1086;98;90;3
401;6.28087e-15;180;1585;26141;13200.5;1;1532;774;3499;373;96;1773;748;277;1025;98;90;3
402;6.36495e-15;174;1599;26264;13316.5;1;1577;760;3499;394;87;1725;829;307;896;98;90;3
403;6.4494e-15;168;1601;26428;13416.5;1;1598;735;3499;386;84;1685;794;302;891;98;89;3
404;6.5225e-15;184;1533;26620;13539.5;1;1592;653;3500;373;86;1765;790;287;975;98;90;3
405;6.6128e-15;150;1436;26829;13643.5;1;1570;619;3500;350;79;1788;762;271;1026;98;90;3
406;6.68947e-15;142;1537;27006;13732.5;1;1555;607;3501;336;86;1779;758;250;1021;98;91;3
407;6.75531e-15;141;1533;27147;13843.5;1;1562;564;3501;317;73;1782;797;244;985;97;91;3
408;6.83774e-15;130;1569;27367;13946.5;1;1527;585;3502;255;71;1728;825;184;903;97;91;3
409;6.91452e-15;147;1580;27575;14040.5;1;1489;567;3502;290;74;1770;828;216;942;97;89;3
410;6.98485e-15;129;1551;27808;14140.5;1;1445;576;3502;275;73;1803;782;202;1021;96;89;3
411;7.05992e-15;129;1583;27954;14226.5;1;1435;539;3503;257;80;1761;774;177;987;95;90;3
412;7.1247e-15;136;1628;28152;14328.5;1;1397;567;3503;285;62;1783;803;223;980;95;89;3
413;7.20178e-15;150;1630;28321;14421.5;1;1382;569;3504;271;70;1757;826;201;931;94;89;3
414;7.27231e-15;156;1605;28495;14523.5;1;1367;485;3504;291;68;1736;803;223;933;94;88;3
415;7.34992e-15;123;1561;28667;14622.5;1;1340;447;3405;249;71;1736;790;178;946;95;89;3
416;7.42552e-15;119;1476;28855;14719.5;1;1299;512;3505;190;64;1720;801;126;919;94;89;3
417;7.49984e-15;132;1562;28993;14817.5;1;1284;522;3505;249;53;1766;775;196;991;94;89;3
418;7.57518e-15;144;1488;29131;14916.5;1;1281;565;3506;241;81;1705;797;160;908;94;88;3
419;7.65154e-15;127;1613;29247;15014.5;1;1290;535;3506;276;92;1796;765;184;1031;94;88;3
420;7.72738e-15;130;1621;29415;15113.5;1;1273;528;3507;302;70;1727;790;232;937;93;88;3
421;7.80425e-15;128;1611;29582;15209.5;1;1251;516;3507;257;66;1745;775;191;970;94;87;3
422;7.87903e-15;146;1604;29715;15296.5;1;1240;542;3507;259;74;1807;809;185;998;93;88;3
423;7.94701e-15;142;1613;29862;15389.5;1;1235;464;3508;273;74;1738;840;199;898;93;87;3
424;8.01989e-15;117;1549;30010;15464.5;1;1214;509;3508;218;64;1707;834;154;873;92;87;3
425;8.07883e-15;136;1567;30179;15556.5;1;1186;538;3509;257;63;1787;824;194;963;92;86;3
426;8.15132e-15;134;1678;30312;15645.5;1;1176;498;3509;295;71;1780;775;224;1005;91;86;3
427;8.22166e-15;140;1696;30418;15741.5;1;1178;545;3509;244;55;1766;878;189;888;91;86;3
428;8.29775e-15;142;1667;30547;15848.5;1;1180;535;3510;276;81;1729;881;195;848;91;86;3
429;8.38284e-15;154;1644;30668;15932.5;1;1180;511;3510;239;83;1771;814;156;957;90;85;3
430;8.44984e-15;138;1653;30755;16019.5;1;1198;527;3511;250;77;1827;848;173;979;90;85;3
431;8.51942e-15;124;1624;30878;16117.5;1;1196;528;3511;266;64;1760;826;202;934;91;85;3
432;8.59803e-15;123;1639;30939;16208.5;1;1228;545;3511;263;80;1704;795;183;909;91;85;3
433;8.67124e-15;122;1693;31066;16284.5;1;1219;463;3512;291;75;1787;780;216;1007;91;84;3
434;8.73254e-15;115;1638;31149;16374.5;1;1233;526;3512;222;58;1759;840;164;919;91;84;3
435;8.80533e-15;139;1588;31254;16454.5;1;1238;462;3513;273;76;1756;862;197;894;90;83;4
436;8.87019e-15;123;1592;31335;16556.5;1;1264;478;3513;231;68;1681;818;163;863;89;82;4
437;8.95312e-15;123;1600;31464;16633.5;1;1247;509;3513;232;57;1758;829;175;929;89;82;4
438;9.0159e-15;138;1662;31568;16723.5;1;1246;525;3514;260;71;1676;789;189;887;90;82;4
439;9.08946e-15;143;1637;31687;16811.5;1;1246;504;3514;263;78;1895;822;185;1073;89;83;4
440;9.16158e-15;150;1675;31808;16901.5;1;1241;510;3514;256;79;1743;789;177;954;90;83;4
441;9.23553e-15;134;1627;31917;16991.5;1;1242;455;3515;234;78;1813;849;156;964;90;83;4
442;9.30968e-15;129;1643;32049;17089.5;1;1230;538;3515;203;57;1794;812;146;982;90;83;4
443;9.39065e-15;151;1587;32198;17188.5;1;1212;524;3516;257;59;1712;772;198;940;90;83;4
444;9.47269e-15;143;1587;32276;17268.5;1;1240;459;3516;285;64;1805;840;221;965;89;83;4
445;9.53915e-15;139;1595;32369;17345.5;1;1250;541;3516;263;74;1759;801;189;958;89;84;4
446;9.60327e-15;148;1656;32504;17428.5;1;1237;520;3517;314;69;1777;811;245;966;89;83;4
447;9.67255e-15;140;1662;32578;17503.5;1;1262;525;3517;251;60;1781;871;191;910;88;83;4
448;9.73529e-15;144;1660;32674;17598.5;1;1283;537;3517;283;76;1850;838;207;1012;89;83;4
449;9.81496e-15;144;1664;32721;17683.5;1;1324;531;3518;266;77;1750;847;189;903;88;82;4
450;9.88642e-15;132;1563;32833;17765.5;1;1326;474;3518;275;88;1740;828;187;912;87;82;4
451;9.95553e-15;133;1665;32934;17840.5;1;1337;547;3519;238;59;1759;760;179;999;87;81;4
452;1.00189e-14;129;1663;33064;17924.5;1;1330;467;3519;293;74;1711;807;219;904;86;80;4
453;1.009e-14;130;1627;33191;18019.5;1;1314;550;3519;226;82;1814;811;144;1003;85;80;4
454;1.01706e-14;145;1607;33284;18091.5;1;1333;516;3520;285;83;1690;809;202;881;85;80;4
455;1.02319e-14;163;1647;33377;18159.5;1;1338;530;3520;242;71;1709;821;171;888;85;80;4
456;1.02898e-14;153;1715;33472;18246.5;1;1346;550;3520;262;72;1743;819;190;924;85;80;4
457;1.03641e-14;147;1539;33550;18320.5;1;1376;551;3521;293;69;1724;875;224;849;86;80;4
458;1.04275e-14;157;1674;33613;18395.5;1;1404;457;3421;285;64;1746;791;221;955;86;80;4
459;1.04918e-14;151;1621;33733;18461.5;1;1404;547;3521;219;75;1774;811;144;963;84;80;4
460;1.05485e-14;139;1656;33867;18523.5;1;1393;560;3522;286;64;1694;845;222;849;83;80;4
461;1.06019e-14;147;1680;33973;18591.5;1;1410;539;3522;287;61;1869;837;226;1032;83;80;4
462;1.06606e-14;154;1620;34090;18671.5;1;1410;499;3523;276;77;1763;876;199;887;83;80;4
463;1.07297e-14;143;1665;34167;18747.5;1;1428;517;3523;228;77;1765;825;151;940;83;80;4
464;1.07955e-14;154;1650;34270;18833.5;1;1437;567;3523;240;68;1756;847;172;909;82;80;4
465;1.08702e-14;176;1624;34313;18910.5;1;1479;492;3524;292;96;1767;873;196;894;82;80;4
466;1.09371e-14;116;1734;34398;18989.5;1;1500;506;3524;229;73;1693;819;156;874;82;80;4
467;1.1006e-14;113;1665;34535;19076.5;1;1479;503;3524;264;64;1806;891;200;915;81;79;4
468;1.1082e-14;120;1711;34663;19149.5;1;1469;528;3525;234;66;1788;821;168;967;81;78;4
469;1.11459e-14;129;1564;34746;19229.5;1;1484;506;3525;236;53;1737;902;183;835;82;78;4
470;1.12161e-14;138;1719;34885;19311.5;1;1462;541;3525;260;62;1733;734;198;999;82;78;4
471;1.12882e-14;148;1627;34992;19378.5;1;1462;508;3526;275;79;1738;792;196;946;82;78;4
472;1.13472e-14;128;1623;35066;19441.5;1;1481;505;3526;274;79;1781;853;195;928;81;78;4
473;1.14028e-14;137;1664;35194;19516.5;1;1472;501;3526;256;60;1767;797;196;970;81;78;4
474;1.1469e-14;142;1732;35318;19603.5;1;1464;513;3527;243;81;1744;858;162;886;82;78;4
475;1.15461e-14;148;1679;35437;19688.5;1;1457;468;3527;248;74;1762;888;174;874;81;78;4
476;1.16215e-14;129;1617;35555;19783.5;1;1451;529;3527;237;63;1700;829;174;871;81;78;4
477;1.17061e-14;140;1607;35672;19861.5;1;1447;504;3528;295;71;1714;857;224;857;81;78;4
478;1.17756e-14;159;1616;35747;19950.5;1;1470;532;3528;242;75;1822;818;167;1004;81;78;4
479;1.18551e-14;137;1686;35814;20026.5;1;1508;532;3528;293;69;1774;802;224;972;81;77;4
480;4.197e-15;116;1241;12929;10113.2;1;1415;514;3529;279;48;1726;498;231;1228;81;77;4
481;4.26035e-15;165;1367;13240;10194.2;1;1311;484;3529;252;48;1800;691;204;1109;81;77;4
482;4.31189e-15;131;1507;13561;10273.2;1;1208;445;3529;248;77;1779;745;171;1034;80;77;4
483;4.36236e-15;163;1585;13868;10335.2;1;1110;510;3530;261;63;1839;789;198;1050;80;77;4
484;4.40211e-15;150;1590;14151;10422.2;1;1026;512;3530;234;71;1743;807;163;936;80;77;5
485;4.45809e-15;139;1623;14409;10509.2;1;952;422;3530;244;76;1825;814;168;1011;79;76;5
486;4.5143e-15;133;1585;14605;10583.2;1;907;417;3531;220;57;1828;901;163;927;79;75;5
487;4.5623e-15;126;1583;14847;10653.2;1;836;419;3531;192;59;1771;809;133;962;79;75;5
488;4.60786e-15;118;1677;15050;10733.2;1;776;466;3531;223;61;1755;797;162;958;80;75;5
489;4.66012e-15;131;1654;15237;10817.2;1;727;414;3532;214;55;1760;826;159;934;79;74;5
490;4.7152e-15;118;1627;15401;10888.2;1;689;462;3532;225;65;1755;812;160;943;79;74;5
491;4.76192e-15;131;1625;15543;10969.2;1;671;416;3532;241;65;1750;820;176;930;79;74;5
492;4.81542e-15;103;1635;15680;11052.2;1;648;465;3533;185;72;1772;836;113;936;78;74;5
493;4.87044e-15;122;1675;15813;11141.2;1;632;403;3533;221;59;1747;820;162;927;78;73;5
494;4.92967e-15;112;1696;15896;11225.2;1;645;400;3533;189;46;1791;816;143;975;78;73;5
495;4.98579e-15;109;1655;16022;11305.2;1;625;445;3534;181;62;1837;832;119;1005;78;73;5
496;5.03944e-15;117;1660;16190;11388.2;1;586;398;3534;216;69;1712;837;147;875;78;73;5
497;5.0953e-15;94;1659;16300;11471.2;1;576;419;3534;194;54;1774;863;140;911;78;72;5
498;5.15137e-15;131;1678;16393;11551.2;1;570;437;3535;209;54;1774;870;155;904;77;72;5
499;5.20561e-15;136;1703;16487;11624.2;1;567;452;3535;232;46;1777;806;186;971;77;72;5
500;5.25527e-15;123;1717;16573;11712.2;1;577;447;3535;191;63;1799;855;128;944;77;72;5
501;5.31533e-15;128;1712;16655;11793.2;1;584;441;3536;231;69;1761;830;162;931;76;73;5
502;5.37083e-15;140;1667;16756;11868.2;1;583;403;3536;214;56;1795;841;158;954;76;72;5
503;5.42238e-15;106;1745;16795;11945.2;1;623;414;3536;169;60;1662;810;109;852;75;72;5
504;5.47548e-15;103;1652;16911;12023.2;1;616;456;3537;204;51;1707;846;153;861;75;72;5
505;5.52945e-15;127;1716;16997;12108.2;1;617;405;3537;223;50;1805;861;173;944;75;72;5
506;5.58846e-15;116;1746;17113;12170.2;1;606;472;3537;191;68;1763;882;123;881;74;73;5
507;5.63163e-15;121;1714;17211;12246.2;1;599;411;3537;251;47;1750;864;204;886;75;71;5
508;5.68471e-15;109;1674;17283;12316.2;1;608;468;3538;184;62;1776;888;122;888;75;72;5
509;5.73374e-15;147;1680;17377;12372.2;1;610;419;3538;230;50;1766;804;180;962;74;71;5
510;5.77307e-15;128;1638;17470;12427.2;1;613;374;3538;194;72;1759;856;122;903;74;71;5
511;5.81178e-15;115;1666;17582;12492.2;1;602;434;3539;182;61;1755;828;121;927;73;71;5
512;5.85765e-15;116;1641;17652;12570.2;1;618;414;3539;218;52;1771;877;166;894;72;71;5
513;5.91284e-15;122;1680;17741;12654.2;1;614;438;3539;208;77;1794;784;131;1010;72;71;5
514;5.97248e-15;111;1695;17787;12729.2;1;642;404;3540;210;78;1785;835;132;950;72;70;5
515;6.02589e-15;127;1743;17879;12805.2;1;644;370;3540;207;42;1776;818;165;958;72;71;5
516;6.08018e-15;121;1653;17967;12875.2;1;640;371;3540;186;57;1754;879;129;875;72;70;5
517;6.13032e-15;112;1668;18088;12951.2;1;611;379;3541;186;59;1800;808;127;992;73;71;5
518;6.18493e-15;114;1709;18170;13011.2;1;614;359;3541;198;57;1749;869;141;880;72;70;5
519;6.22815e-15;103;1783;18210;13079.2;1;639;376;3541;189;42;1710;808;147;902;71;70;5
520;6.27725e-15;102;1750;18291;13149.2;1;635;369;3541;189;60;1779;825;129;954;72;70;5
521;6.32793e-15;94;1789;18362;13228.2;1;646;361;3542;190;38;1764;868;152;896;71;69;5
522;6.3853e-15;108;1703;18469;13297.2;1;628;369;3542;176;47;1775;892;129;883;71;70;5
523;6.43554e-15;116;1629;18550;13366.2;1;623;375;3542;187;53;1786;855;134;931;70;69;5
524;6.48592e-15;104;1688;18615;13437.2;1;630;365;3543;162;66;1828;839;96;989;70;69;5
525;6.53789e-15;115;1697;18681;13509.2;1;635;323;3543;158;55;1686;853;103;833;70;68;5
526;6.59074e-15;108;1713;18773;13586.2;1;627;375;3543;165;50;1759;863;115;896;70;69;5
527;6.64741e-15;118;1692;18850;13662.2;1;629;375;3544;199;60;1818;819;139;999;69;68;5
528;6.70351e-15;127;1698;18917;13730.2;1;635;367;3544;191;56;1798;875;135;923;70;68;5
529;6.75383e-15;125;1715;18982;13792.2;1;643;364;3544;189;58;1686;821;131;865;70;67;5
530;6.79983e-15;96;1777;19077;13861.2;1;632;348;3544;197;63;1757;802;134;955;70;68;5
531;6.85114e-15;120;1691;19147;13920.2;1;626;352;3545;197;37;1785;883;160;902;70;68;5
532;6.89511e-15;116;1701;19213;14014.2;1;636;361;3545;163;66;1789;831;97;958;70;68;5
533;6.96537e-15;120;1704;19302;14090.2;1;624;251;3545;164;61;1829;794;103;1035;69;68;5
534;7.02235e-15;98;1688;19391;14156.2;1;614;334;3546;126;47;1763;888;79;875;69;69;5
535;7.07196e-15;93;1686;19475;14220.2;1;606;319;3546;172;43;1763;836;129;927;69;69;5
536;7.12017e-15;109;1718;19521;14293.2;1;620;342;3546;133;46;1736;844;87;892;69;68;5
537;7.1753e-15;101;1647;19580;14349.2;1;625;330;3546;166;57;1784;905;109;879;68;68;5
538;7.21769e-15;98;1677;19645;14414.2;1;626;323;3547;162;50;1836;827;112;1009;68;68;5
539;7.26699e-15;85;1657;19750;14470.2;1;604;329;3547;170;54;1778;889;116;889;68;67;6
540;7.30956e-15;102;1711;19812;14532.2;1;606;328;3547;169;36;1782;856;133;926;68;67;6
541;7.35679e-15;108;1716;19897;14586.2;1;591;334;3548;184;54;1723;869;130;854;68;66;6
542;7.398e-15;106;1740;19972;14660.2;1;588;329;3548;138;47;1893;841;91;1052;68;67;6
543;7.45461e-15;92;1680;20052;14722.2;1;574;286;3548;147;57;1814;887;90;927;68;67;6
544;7.50214e-15;86;1736;20145;14784.2;1;554;233;3548;138;45;1740;832;93;908;67;67;6
545;7.54978e-15;74;1788;20208;14860.2;1;545;253;3549;105;41;1866;849;64;1017;68;67;6
546;7.60831e-15;71;1778;20286;14924.2;1;531;307;3549;127;35;1799;888;92;911;68;67;6
547;7.65772e-15;92;1769;20351;14998.2;1;527;315;3549;164;39;1690;850;125;840;68;66;6
548;7.71498e-15;90;1733;20395;15074.2;1;537;301;3550;161;51;1723;897;110;826;67;66;6
549;7.77394e-15;88;1634;20476;15143.2;1;531;262;3550;158;45;1803;846;113;957;67;66;6
550;7.82759e-15;85;1750;20549;15212.2;1;520;294;3550;104;48;1725;876;56;849;67;66;6
551;7.88137e-15;86;1697;20599;15287.2;1;521;264;3550;158;56;1760;888;102;872;67;66;6
552;7.93997e-15;72;1674;20644;15360.2;1;526;318;3551;117;38;1739;882;79;857;67;66;6
553;7.99714e-15;80;1715;20703;15431.2;1;527;324;3551;167;37;1756;822;130;934;66;65;6
554;8.05288e-15;98;1717;20764;15497.2;1;527;289;3551;155;52;1777;866;103;911;66;65;6
555;8.1048e-15;93;1733;20817;15558.2;1;536;248;3551;142;40;1794;852;102;942;66;65;6
556;8.1529e-15;78;1754;20900;15618.2;1;520;252;3552;129;49;1710;881;80;829;66;65;6
557;8.2003e-15;69;1811;20944;15680.2;1;522;305;3552;146;48;1860;865;98;995;66;65;6
558;8.24937e-15;85;1745;20996;15748.2;1;522;300;3552;158;43;1768;922;115;846;66;65;6
559;8.30331e-15;94;1709;21068;15815.2;1;511;241;3553;138;41;1804;873;97;931;66;64;6
560;8.35656e-15;87;1713;21111;15882.2;1;515;265;3553;134;39;1778;864;95;914;65;64;6
561;8.40994e-15;92;1739;21131;15939.2;1;532;282;3553;134;45;1781;861;89;920;65;64;6
562;8.45543e-15;81;1762;21189;15999.2;1;530;315;3553;144;48;1759;892;96;867;65;64;6
563;8.50341e-15;110;1754;21222;16047.2;1;543;228;3554;171;38;1749;866;133;883;64;63;6
564;8.54186e-15;89;1700;21268;16101.2;1;548;1.07374e+08;-2.14748e+09;109;48;1788;873;61;915;64;63;6
565;8.58518e-15;89;1700;21268;16101.2;1;548;1.032e+08;-2.06399e+09;0;0;-1;0;0;-1;64;63;6
566;8.58518e-15;89;1699;21268;16101.2;1;548;3.09788e+08;-1.98428e+09;0;0;-1;0;0;-1;64;63;6
567;8.58518e-15;90;1698;21268;16101.2;1;548;2.97823e+08;-1.90817e+09;0;0;-1;0;0;-1;239;238;6
568;8.58518e-15;90;1697;21268;16101.2;1;548;4.96971e+08;-1.83548e+09;0;0;-1;0;0;-1;913;913;6
569;8.58518e-15;90;1697;21268;16101.2;1;548;5.85273e+08;-1.76604e+09;0;0;-1;0;0;-1;2534;2533;6
570;8.58518e-15;90;1696;21268;16101.2;1;548;5.62884e+08;-1.69969e+09;0;0;-1;0;0;-1;5648;5647;6
571;8.58518e-15;90;1696;21268;16101.2;1;548;7.52072e+08;-1.63627e+09;0;0;-1;0;0;-1;10888;10887;6
572;8.58518e-15;90;1696;21268;16101.2;1;548;8.30855e+08;-1.57565e+09;0;0;-1;0;0;-1;18951;18950;6
573;8.58518e-15;92;1696;21268;16101.2;1;548;9.06739e+08;-1.51768e+09;0;0;-1;0;0;-1;30582;30581;6
574;8.58518e-15;94;1696;21268;16101.2;1;548;9.79851e+08;-1.46224e+09;0;0;-1;0;0;-1;46565;46564;6
575;8.58518e-15;97;1695;21268;16101.2;1;548;1.05031e+09;-1.40921e+09;0;0;-1;0;0;-1;67707;67706;6
576;8.58518e-15;98;1695;21268;16101.2;1;548;1.11824e+09;-1.35846e+09;0;0;-1;0;0;-1;94830;94828;6
577;8.58518e-15;100;1693;21268;16101.2;1;548;1.07636e+09;-1.30989e+09;2;0;-1;0;2;-1;128760;128758;6
578;8.58518e-15;101;1691;21268;16101.2;1;548;1.2469e+09;-1.2634e+09;2;0;-1;0;2;-1;170321;170319;6
579;8.58518e-15;101;1691;21268;16101.2;1;548;1.30785e+09;-1.21888e+09;1;0;-1;0;1;-1;220327;220326;6
580;8.58518e-15;103;1689;21268;16101.2;1;548;1.25928e+09;-1.17625e+09;2;0;-1;0;2;-1;279577;279575;6
581;8.58518e-15;103;1689;21268;16101.2;1;548;1.31605e+09;-1.13541e+09;0;0;-1;0;0;-1;348848;348846;6
582;8.58518e-15;103;1689;21268;16101.2;1;548;1.37087e+09;-1.09627e+09;0;0;-1;0;0;-1;428893;428891;6
583;8.58518e-15;104;1688;21268;16101.2;1;548;1.53118e+09;-1.05877e+09;2;0;-1;0;2;-1;520437;520436;6
584;8.58518e-15;104;1688;21268;16101.2;1;548;1.47495e+09;-1.02281e+09;0;0;-1;0;0;-1;624174;624173;6
585;8.58518e-15;104;1687;21268;16101.2;1;548;1.52436e+09;-9.88342e+08;1;0;-1;0;1;-1;740763;740762;6
586;8.58518e-15;110;1680;21268;16101.2;1;548;1.6795e+09;-9.5528e+08;16;0;-1;0;16;-1;870830;870828;6
587;8.58518e-15;110;1680;21268;16101.2;1;548;1.61831e+09;-9.23566e+08;0;0;-1;0;0;-1;1014962;1014960;6
588;8.58518e-15;116;1677;21268;16101.2;1;548;1.66296e+09;-8.93136e+08;2;0;-1;0;2;-1;1173709;1173707;6
589;8.58518e-15;117;1677;21268;16101.2;1;548;1.70616e+09;-8.63933e+08;0;0;-1;0;0;-1;1347583;1347581;6
590;8.58518e-15;117;1677;21268;16101.2;1;548;1.74796e+09;-8.359e+08;0;0;-1;0;0;-1;1537058;1537056;6
591;8.58518e-15;117;1677;21268;16101.2;1;548;1.89578e+09;-8.08984e+08;0;0;-1;0;0;-1;1742568;1742566;6
592;8.58518e-15;118;1677;21268;16101.2;1;548;1.82756e+09;-7.83135e+08;1;0;-1;0;1;-1;1964509;1964508;6
593;8.58518e-15;121;1677;21268;16101.2;1;548;1.97285e+09;-7.58305e+08;3;0;-1;0;3;-1;2203240;2203238;6
594;8.58518e-15;130;1675;21268;16101.2;1;548;1.9022e+09;-7.34449e+08;6;0;-1;0;6;-1;2459079;2459077;6
595;8.58518e-15;131;1675;21268;16101.2;1;548;1.93778e+09;-7.11523e+08;3;0;-1;0;3;-1;2732311;2732309;6
596;8.58518e-15;139;1674;21268;16101.2;1;548;2.07963e+09;-6.89486e+08;7;0;-1;0;7;-1;3023183;3023181;7
597;8.58518e-15;147;1672;21268;16101.2;1;548;2.11304e+09;-6.68298e+08;5;0;-1;0;5;-1;3331907;3331905;7
598;8.58518e-15;148;1670;21268;16101.2;1;548;2.14544e+09;-6.47923e+08;2;0;-1;0;2;-1;3658661;3658659;7
599;8.58518e-15;148;1670;21268;16101.2;1;548;2.06948e+09;-6.28325e+08;1;0;-1;0;1;-1;4003589;4003587;7
600;8.58518e-15;149;1668;21268;16101.2;1;548;-2.14748e+09;-6.0947e+08;0;0;-1;0;0;-1;4366806;4366804;7
601;8.58518e-15;149;1667;21268;16101.2;1;548;-2.14748e+09;-5.91326e+08;-1;0;0;0;-1;0;4748392;4748390;7
602;8.58518e-15;148;1667;21268;16101.2;1;548;-2.14748e+09;-5.73862e+08;-1;0;0;0;-1;0;5148402;5148400;7
603;8.58518e-15;148;1667;21268;16101.2;1;548;-2.14748e+09;-5.57049e+08;-1;0;0;0;-1;0;5566860;5566858;8
604;8.58518e-15;148;1667;21268;16101.2;1;548;-2.14748e+09;-5.40859e+08;-1;0;0;0;-1;0;6003764;6003762;8
605;8.58518e-15;146;1667;21268;16101.2;1;548;-2.14748e+09;-5.25265e+08;0;0;-1;0;0;-1;6459086;6459085;8
606;8.58518e-15;146;1667;21268;16101.2;1;548;-2.14748e+09;-5.10244e+08;-1;0;0;0;-1;0;6932775;6932773;9
607;8.58518e-15;146;1667;21268;16101.2;1;548;-2.14748e+09;-4.95769e+08;-1;0;0;0;-1;0;7424755;7424753;9
608;8.58518e-15;145;1667;21268;16101.2;1;548;-2.14748e+09;-4.81819e+08;-1;0;0;0;-1;0;7934928;7934927;10
609;8.58518e-15;142;1667;21268;16101.2;1;548;-2.14748e+09;-4.68371e+08;0;0;-1;0;0;-1;8463179;8463177;11
610;8.58518e-15;142;1665;21268;16101.2;1;548;-2.14748e+09;-4.55404e+08;-1;0;0;0;-1;0;9009369;9009367;12
611;8.58518e-15;142;1665;21268;16101.2;1;548;-2.14748e+09;-4.429e+08;-1;0;0;0;-1;0;9573344;9573342;13
612;8.58518e-15;142;1664;21268;16101.2;1;548;-2.14748e+09;-4.30837e+08;-1;0;0;0;-1;0;10154931;10154930;14
613;8.58518e-15;141;1664;21268;16101.2;1;548;-2.14748e+09;-4.192e+08;-1;0;0;0;-1;0;10753944;10753942;16
614;8.58518e-15;138;1663;21268;16101.2;1;548;-2.14748e+09;-4.07969e+08;-1;0;0;0;-1;0;11370178;11370177;18
615;8.58518e-15;138;1663;21268;16101.2;1;548;-2.14748e+09;-3.97129e+08;0;0;-1;0;0;-1;12003419;12003418;20
616;8.58518e-15;137;1663;21268;16101.2;1;548;-2.14748e+09;-3.86664e+08;-1;0;0;0;-1;0;12653436;12653435;23
617;8.58518e-15;137;1663;21268;16101.2;1;548;-2.14748e+09;-3.76558e+08;-1;0;0;0;-1;0;13319990;13319989;26
618;8.58518e-15;137;1663;21268;16101.2;1;548;-2.14748e+09;-3.66798e+08;-1;0;0;0;-1;0;14002829;14002828;29
619;8.58518e-15;137;1663;21268;16101.2;1;548;-2.14748e+09;-3.57369e+08;-1;0;0;0;-1;0;14701692;14701692;33
620;8.58518e-15;136;1663;21268;16101.2;1;548;-2.14748e+09;-3.48258e+08;-1;0;0;0;-1;0;15416310;15416309;38
621;8.58518e-15;135;1663;21268;16101.2;1;548;-2.14748e+09;-3.39454e+08;-1;0;0;0;-1;0;16146404;16146404;43
622;8.58518e-15;133;1663;21268;16101.2;1;548;-2.14748e+09;-3.30943e+08;-1;0;0;0;-1;0;16891690;16891690;49
623;8.58518e-15;132;1662;21268;16101.2;1;548;-2.14748e+09;-3.22714e+08;-1;0;0;0;-1;0;17651876;17651876;56
624;8.58518e-15;132;1661;21268;16101.2;1;548;-2.14748e+09;-3.14757e+08;-1;0;0;0;-1;0;18426665;18426666;64
625;8.58518e-15;130;1661;21268;16101.2;1;548;-2.14748e+09;-3.07061e+08;-1;0;0;0;-1;0;19215756;19215757;72
626;8.58518e-15;129;1661;21268;16101.2;1;548;-2.14748e+09;-2.99615e+08;-1;0;0;0;-1;0;20018843;20018844;82
627;8.58518e-15;129;1661;21268;16101.2;1;548;-2.14748e+09;-2.92411e+08;-1;0;0;0;-1;0;20835615;20835617;93
628;8.58518e-15;129;1661;21268;16101.2;1;548;-2.14748e+09;-2.85438e+08;-1;0;0;0;-1;0;21665760;21665763;106
629;8.58518e-15;128;1661;21268;16101.2;1;548;-2.14748e+09;-2.78689e+08;-1;0;0;0;-1;0;22508964;22508967;120
630;8.58518e-15;128;1661;21268;16101.2;1;548;-2.14748e+09;-2.72154e+08;-1;0;0;0;-1;0;23364909;23364913;136
631;8.58518e-15;128;1661;21268;16101.2;1;548;-2.14748e+09;-2.65826e+08;-1;0;0;0;-1;0;24233278;24233283;153
632;8.58518e-15;126;1661;21268;16101.2;1;548;-2.14748e+09;-2.59696e+08;-1;0;0;0;-1;0;25113751;25113756;172
633;8.58518e-15;123;1661;21268;16101.2;1;548;-2.14748e+09;-2.53759e+08;-1;0;0;0;-1;0;26006008;26006015;194
634;8.58518e-15;122;1661;21268;16101.2;1;548;-2.14748e+09;-2.48005e+08;-1;0;0;0;-1;0;26909732;26909740;218
635;8.58518e-15;121;1660;21268;16101.2;1;548;-2.14748e+09;-2.42429e+08;-1;0;0;0;-1;0;27824602;27824611;244
636;8.58518e-15;121;1660;21268;16101.2;1;548;-2.14748e+09;-2.37024e+08;-1;0;0;0;-1;0;28750301;28750312;273
637;8.58518e-15;121;1660;21268;16101.2;1;548;-2.14748e+09;-2.31784e+08;-1;0;0;0;-1;0;29686513;29686525;305
638;8.58518e-15;121;1660;21268;16101.2;1;548;-2.14748e+09;-2.26703e+08;-1;0;0;0;-1;0;30632922;30632935;340
639;8.58518e-15;119;1660;21268;16101.2;1;548;-2.14748e+09;-2.21775e+08;-1;0;0;0;-1;0;31589215;31589230;379
640;8.58518e-15;118;1660;21268;16101.2;1;548;-2.14748e+09;-2.16994e+08;-1;0;0;0;-1;0;32555080;32555098;421
641;8.58518e-15;118;1660;21268;16101.2;1;548;-2.14748e+09;-2.12356e+08;-1;0;0;0;-1;0;33530210;33530230;467
642;8.58518e-15;117;1660;21268;16101.2;1;548;-2.14748e+09;-2.07855e+08;-1;0;0;0;-1;0;34514298;34514320;517
643;8.58518e-15;117;1660;21268;16101.2;1;548;-2.14748e+09;-2.03486e+08;-1;0;0;0;-1;0;35507041;35507065;572
644;8.58518e-15;116;1660;21268;16101.2;1;548;-2.14748e+09;-1.99245e+08;-1;0;0;0;-1;0;36508138;36508166;632
645;8.58518e-15;116;1660;21268;16101.2;1;548;-2.14748e+09;-1.95127e+08;-1;0;0;0;-1;0;37517293;37517324;697
646;8.58518e-15;115;1660;21268;16101.2;1;548;-2.14748e+09;-1.91128e+08;-1;0;0;0;-1;0;38534214;38534248;767
647;8.58518e-15;114;1660;21268;16101.2;1;548;-2.14748e+09;-1.87243e+08;-1;0;0;0;-1;0;39558609;39558647;843
648;8.58518e-15;112;1660;21268;16101.2;1;548;-2.14748e+09;-1.83469e+08;-1;0;0;0;-1;0;40590194;40590236;926
649;8.58518e-15;112;1660;21268;16101.2;1;548;-2.14748e+09;-1.79803e+08;-1;0;0;0;-1;0;41628686;41628732;1015
650;8.58518e-15;111;1660;21268;16101.2;1;548;-2.14748e+09;-1.76239e+08;-1;0;0;0;-1;0;42673808;42673858;1111
651;8.58518e-15;111;1660;21268;16101.2;1;548;-2.14748e+09;-1.72776e+08;-1;0;0;0;-1;0;43725285;43725340;1214
652;8.58518e-15;110;1660;21268;16101.2;1;548;-2.14748e+09;-1.69408e+08;-1;0;0;0;-1;0;44782848;44782909;1326
653;8.58518e-15;106;1660;21268;16101.2;1;548;-2.14748e+09;-1.66134e+08;-1;0;0;0;-1;0;45846232;45846298;1445
654;8.58518e-15;105;1660;21268;16101.2;1;548;-2.14748e+09;-1.6295e+08;-1;0;0;0;-1;0;46915175;46915248;1574
655;8.58518e-15;101;1660;21268;16101.2;1;548;-2.14748e+09;-1.59852e+08;-1;0;0;0;-1;0;47989423;47989502;1712
656;8.58518e-15;100;1660;21268;16101.2;1;548;-2.14748e+09;-1.56839e+08;-1;0;0;0;-1;0;49068721;49068807;1860
657;8.58518e-15;97;1660;21268;16101.2;1;548;-2.14748e+09;-1.53907e+08;-1;0;0;0;-1;0;50152824;50152917;2018
658;8.58518e-15;95;1660;21268;16101.2;1;548;-2.14748e+09;-1.51054e+08;-1;0;0;0;-1;0;51241487;51241589;2186
659;8.58518e-15;95;1660;21268;16101.2;1;548;-2.14748e+09;-1.48277e+08;-1;0;0;0;-1;0;52334473;52334584;2367
660;8.58518e-15;95;1660;21268;16101.2;1;548;-2.14748e+09;-1.45573e+08;-1;0;0;0;-1;0;53431548;53431668;2559
661;8.58518e-15;94;1659;21268;16101.2;1;548;-2.14748e+09;-1.42941e+08;-1;0;0;0;-1;0;54532483;54532613;2764
662;8.58518e-15;94;1659;21268;16101.2;1;548;-2.14748e+09;-1.40378e+08;-1;0;0;0;-1;0;55637054;55637194;2982
663;8.58518e-15;94;1659;21268;16101.2;1;548;-2.14748e+09;-1.37881e+08;-1;0;0;0;-1;0;56745040;56745192;3214
664;8.58518e-15;92;1659;21268;16101.2;1;548;-2.14748e+09;-1.35448e+08;-1;0;0;0;-1;0;57856226;57856390;3461
665;8.58518e-15;92;1659;21268;16101.2;1;548;-2.14748e+09;-1.33079e+08;-1;0;0;0;-1;0;58970402;58970579;3722
666;8.58518e-15;90;1659;21268;16101.2;1;548;-2.14748e+09;-1.30769e+08;-1;0;0;0;-1;0;60087362;60087552;4000
667;8.58518e-15;89;1659;21268;16101.2;1;548;-2.14748e+09;-1.28518e+08;-1;0;0;0;-1;0;61206903;61207107;4294
668;8.58518e-15;88;1659;21268;16101.2;1;548;-2.14748e+09;-1.26325e+08;-1;0;0;0;-1;0;62328829;62329048;4605
669;8.58518e-15;88;1659;21268;16101.2;1;548;-2.14748e+09;-1.24186e+08;-1;0;0;0;-1;0;63452947;63453183;4935
670;8.58518e-15;88;1659;21268;16101.2;1;548;-2.14748e+09;-1.221e+08;-1;0;0;0;-1;0;64579069;64579322;5283
671;8.58518e-15;87;1659;21268;16101.2;1;548;-2.14748e+09;-1.20066e+08;-1;0;0;0;-1;0;65707012;65707284;5651
672;8.58518e-15;86;1659;21268;16101.2;1;548;-2.14748e+09;-1.18082e+08;-1;0;0;0;-1;0;66836596;66836887;6039
673;8.58518e-15;86;1659;21268;16101.2;1;548;-2.14748e+09;-1.16147e+08;-1;0;0;0;-1;0;67967647;67967958;6448
674;8.58518e-15;86;1659;21268;16101.2;1;548;-2.14748e+09;-1.14258e+08;-1;0;0;0;-1;0;69099992;69100325;6879
675;8.58518e-15;86;1659;21268;16101.2;1;548;-2.14748e+09;-1.12415e+08;-1;0;0;0;-1;0;70233467;70233822;7333
676;8.58518e-15;86;1659;21268;16101.2;1;548;-2.14748e+09;-1.10617e+08;-1;0;0;0;-1;0;71367907;71368288;7811
677;8.58518e-15;85;1659;21268;16101.2;1;548;-2.14748e+09;-1.08861e+08;-1;0;0;0;-1;0;72503157;72503563;8313
678;8.58518e-15;85;1659;21268;16101.2;1;548;-2.14748e+09;-1.07148e+08;-1;0;0;0;-1;0;73639061;73639493;8841
679;8.58518e-15;84;1659;21268;16101.2;1;548;-2.14748e+09;-1.05474e+08;-1;0;0;0;-1;0;74775469;74775930;9395
680;8.58518e-15;82;1659;21268;16101.2;1;548;-2.14748e+09;-1.0384e+08;-1;0;0;0;-1;0;75912236;75912726;9976
681;8.58518e-15;81;1659;21268;16101.2;1;548;-2.14748e+09;-1.02244e+08;-1;0;0;0;-1;0;77049218;77049740;10585
682;8.58518e-15;81;1659;21268;16101.2;1;548;-2.14748e+09;-1.00684e+08;-1;0;0;0;-1;0;78186278;78186832;11224
683;8.58518e-15;77;1658;21268;16101.2;1;548;-2.14748e+09;-9.9161e+07;-1;0;0;0;-1;0;79323281;79323869;11893
684;8.58518e-15;77;1658;21268;16101.2;1;548;-2.14748e+09;-9.76725e+07;-1;0;0;0;-1;0;80460095;80460720;12593
685;8.58518e-15;77;1658;21268;16101.2;1;548;-2.14748e+09;-9.62178e+07;-1;0;0;0;-1;0;81596595;81597258;13325
686;8.58518e-15;75;1657;21268;16101.2;1;548;-2.14748e+09;-9.4796e+07;-1;0;0;0;-1;0;82732656;82733358;14091
687;8.58518e-15;75;1657;21268;16101.2;1;548;-2.14748e+09;-9.34062e+07;-1;0;0;0;-1;0;83868157;83868901;14890
688;8.58518e-15;75;1657;21268;16101.2;1;548;-2.14748e+09;-9.20473e+07;-1;0;0;0;-1;0;85002983;85003771;15725
689;8.58518e-15;74;1657;21268;16101.2;1;548;-2.14748e+09;-9.07186e+07;-1;0;0;0;-1;0;86137020;86137853;16596
690;8.58518e-15;74;1657;21268;16101.2;1;548;-2.14748e+09;-8.94192e+07;-1;0;0;0;-1;0;87270158;87271039;17505
691;8.58518e-15;72;1657;21268;16101.2;1;548;-2.14748e+09;-8.81483e+07;-1;0;0;0;-1;0;88402290;88403222;18452
692;8.58518e-15;66;1657;21268;16101.2;1;548;-2.14748e+09;-8.69051e+07;-1;0;0;0;-1;0;89533314;89534297;19438
693;8.58518e-15;66;1657;21268;16101.2;1;548;-2.14748e+09;-8.56888e+07;-1;0;0;0;-1;0;90663128;90664166;20466
694;8.58518e-15;66;1657;21268;16101.2;1;548;-2.14748e+09;-8.44987e+07;-1;0;0;0;-1;0;91791635;91792731;21535
695;8.58518e-15;66;1657;21268;16101.2;1;548;-2.14748e+09;-8.33341e+07;-1;0;0;0;-1;0;92918742;92919898;22647
696;8.58518e-15;66;1657;21268;16101.2;1;548;-2.14748e+09;-8.21942e+07;-1;0;0;0;-1;0;94044357;94045575;23804
697;8.58518e-15;65;1657;21268;16101.2;1;548;-2.14748e+09;-8.10785e+07;-1;0;0;0;-1;0;95168392;95169675;25005
698;8.58518e-15;65;1657;21268;16101.2;1;548;-2.14748e+09;-7.99862e+07;-1;0;0;0;-1;0;96290761;96292112;26253
699;8.58518e-15;64;1657;21268;16101.2;1;548;-2.14748e+09;-7.89167e+07;-1;0;0;0;-1;0;97411382;97412803;27549
700;8.58518e-15;63;1657;21268;16101.2;1;548;-2.14748e+09;-7.78694e+07;-1;0;0;0;-1;0;98530174;98531668;28894
701;8.58518e-15;63;1657;21268;16101.2;1;548;-2.14748e+09;-7.68437e+07;-1;0;0;0;-1;0;99647061;99648631;30288
702;8.58518e-15;63;1657;21268;16101.2;1;548;-2.14748e+09;-7.58391e+07;0;0;-1;0;0;-1;100761967;100763617;31734
703;8.58518e-15;62;1657;21268;16101.2;1;548;-2.14748e+09;-7.4855e+07;-1;0;0;0;-1;0;101874821;101876553;33233
704;8.58518e-15;62;1657;21268;16101.2;1;548;-2.14748e+09;-7.38908e+07;-1;0;0;0;-1;0;102985552;102987370;34785
705;8.58518e-15;61;1657;21268;16101.2;1;548;-2.14748e+09;-7.2946e+07;-1;0;0;0;-1;0;104094094;104096000;36392
706;8.58518e-15;56;1657;21268;16101.2;1;548;-2.14748e+09;-7.20202e+07;-1;0;0;0;-1;0;105200381;105202380;38055
707;8.58518e-15;54;1657;21268;16101.2;1;548;-2.14748e+09;-7.11128e+07;-1;0;0;0;-1;0;106304350;106306446;39776
708;8.58518e-15;53;1657;21268;16101.2;1;548;-2.14748e+09;-7.02234e+07;-1;0;0;0;-1;0;107405942;107408137;41555
709;8.58518e-15;52;1657;21268;16101.2;1;548;-2.14748e+09;-6.93515e+07;-1;0;0;0;-1;0;108505098;108507397;43394
710;8.58518e-15;49;1657;21268;16101.2;1;548;-2.14748e+09;-6.84966e+07;-1;0;0;0;-1;0;109601763;109604169;45295
711;8.58518e-15;48;1657;21268;16101.2;1;548;-2.14748e+09;-6.76584e+07;-1;0;0;0;-1;0;110695882;110698399;47258
712;8.58518e-15;48;1657;21268;16101.2;1;548;-2.14748e+09;-6.68363e+07;-1;0;0;0;-1;0;111787404;111790036;49285
713;8.58518e-15;47;1657;21268;16101.2;1;548;-2.14748e+09;-6.60301e+07;-1;0;0;0;-1;0;112876279;112879029;51377
714;8.58518e-15;47;1657;21268;16101.2;1;548;-2.14748e+09;-6.52393e+07;-1;0;0;0;-1;0;113962459;113965331;53535
715;8.58518e-15;44;1657;21268;16101.2;1;548;-2.14748e+09;-6.44635e+07;-1;0;0;0;-1;0;115045897;115048897;55762
716;8.58518e-15;44;1657;21268;16101.2;1;548;-2.14748e+09;-6.37023e+07;-1;0;0;0;-1;0;116126550;116129683;58057
717;8.58518e-15;44;1657;21268;16101.2;1;548;-2.14748e+09;-6.29555e+07;-1;0;0;0;-1;0;117204375;117207645;60422
718;8.58518e-15;44;1657;21268;16101.2;1;548;-2.14748e+09;-6.22226e+07;-1;0;0;0;-1;0;118279333;118282744;62859
719;8.58518e-15;42;1657;21268;16101.2;1;548;-2.14748e+09;-6.15032e+07;-1;0;0;0;-1;0;119351383;119354940;65369
720;8.58518e-15;41;1657;21268;16101.2;1;548;-2.14748e+09;-6.07972e+07;-1;0;0;0;-1;0;120420489;120424197;67953
721;8.58518e-15;41;1657;21268;16101.2;1;548;-2.14748e+09;-6.01041e+07;-1;0;0;0;-1;0;121486616;121490479;70612
722;8.58518e-15;40;1657;21268;16101.2;1;548;-2.14748e+09;-5.94236e+07;-1;0;0;0;-1;0;122549729;122553753;73348
723;8.58518e-15;39;1657;21268;16101.2;1;548;-2.14748e+09;-5.87555e+07;-1;0;0;0;-1;0;123609795;123613985;76163
724;8.58518e-15;38;1657;21268;16101.2;1;548;-2.14748e+09;-5.80994e+07;-1;0;0;0;-1;0;124666785;124671146;79057
725;8.58518e-15;34;1657;21268;16101.2;1;548;-2.14748e+09;-5.74551e+07;-1;0;0;0;-1;0;125720668;125725205;82031
726;8.58518e-15;34;1657;21268;16101.2;1;548;-2.14748e+09;-5.68223e+07;-1;0;0;0;-1;0;126771416;126776136;85088
727;8.58518e-15;34;1657;21268;16101.2;1;548;-2.14748e+09;-5.62006e+07;-1;0;0;0;-1;0;127819003;127823911;88228
728;8.58518e-15;34;1657;21268;16101.2;1;548;-2.14748e+09;-5.559e+07;-1;0;0;0;-1;0;128863404;128868505;91453
729;8.58518e-15;33;1657;21268;16101.2;1;548;-2.14748e+09;-5.499e+07;-1;0;0;0;-1;0;129904594;129909895;94763
730;8.58518e-15;33;1657;21268;16101.2;1;548;-2.14748e+09;-5.44004e+07;-1;0;0;0;-1;0;130942550;130948056;98161
731;8.58518e-15;33;1657;21268;16101.2;1;548;-2.14748e+09;-5.38211e+07;-1;0;0;0;-1;0;131977251;131982970;101648
732;8.58518e-15;33;1657;21268;16101.2;1;548;-2.14748e+09;-5.32517e+07;-1;0;0;0;-1;0;133008677;133014614;105224
733;8.58518e-15;32;1657;21268;16101.2;1;548;-2.14748e+09;-5.26921e+07;-1;0;0;0;-1;0;134036809;134042970;108892
734;8.58518e-15;31;1657;21268;16101.2;1;548;-2.14748e+09;-5.2142e+07;-1;0;0;0;-1;0;135061629;135068021;112652
735;8.58518e-15;30;1657;21268;16101.2;1;548;-2.14748e+09;-5.16013e+07;-1;0;0;0;-1;0;136083119;136089749;116505
736;8.58518e-15;29;1657;21268;16101.2;1;548;-2.14748e+09;-5.10696e+07;-1;0;0;0;-1;0;137101264;137108138;120454
737;8.58518e-15;28;1657;21268;16101.2;1;548;-2.14748e+09;-5.05468e+07;-1;0;0;0;-1;0;138116049;138123175;124499
738;8.58518e-15;27;1657;21268;16101.2;1;548;-2.14748e+09;-5.00327e+07;-1;0;0;0;-1;0;139127460;139134845;128642
739;8.58518e-15;27;1657;21268;16101.2;1;548;-2.14748e+09;-4.95272e+07;-1;0;0;0;-1;0;140135485;140143135;132884
740;8.58518e-15;25;1657;21268;16101.2;1;548;-2.14748e+09;-4.90299e+07;-1;0;0;0;-1;0;141140112;141148035;137225
741;8.58518e-15;23;1657;21268;16101.2;1;548;-2.14748e+09;-4.85408e+07;-1;0;0;0;-1;0;142141329;142149532;141668
742;8.58518e-15;23;1657;21268;16101.2;1;548;-2.14748e+09;-4.80597e+07;-1;0;0;0;-1;0;143139127;143147618;146214
743;8.58518e-15;23;1657;21268;16101.2;1;548;-2.14748e+09;-4.75863e+07;-1;0;0;0;-1;0;144133496;144142284;150864
744;8.58518e-15;17;1657;21268;16101.2;1;548;-2.14748e+09;-4.71205e+07;-1;0;0;0;-1;0;145124429;145133520;155618
745;8.58518e-15;14;1656;21268;16101.2;1;548;-2.14748e+09;-4.66622e+07;-1;0;0;0;-1;0;146111917;146121319;160479
746;8.58518e-15;13;1656;21268;16101.2;1;548;-2.14748e+09;-4.62112e+07;-1;0;0;0;-1;0;147095954;147105676;165448
747;8.58518e-15;11;1656;21268;16101.2;1;548;-2.14748e+09;-4.57674e+07;-1;0;0;0;-1;0;148076534;148086584;170525
748;8.58518e-15;9;1656;21268;16101.2;1;548;-2.14748e+09;-4.53305e+07;-1;0;0;0;-1;0;149053653;149064038;175712
749;8.58518e-15;9;1656;21268;16101.2;1;548;-2.14748e+09;-4.49004e+07;-1;0;0;0;-1;0;150027304;150038035;181010
750;8.58518e-15;8;1656;21268;16101.2;1;548;-2.14748e+09;-4.44771e+07;-1;0;0;0;-1;0;150997485;151008569;186421
751;8.58518e-15;8;1656;21268;16101.2;1;548;-2.14748e+09;-4.40603e+07;-1;0;0;0;-1;0;151964192;151975638;191945
752;8.58518e-15;7;1656;21268;16101.2;1;548;-2.14748e+09;-4.36499e+07;-1;0;0;0;-1;0;152927424;152939241;197584
753;8.58518e-15;6;1656;21268;16101.2;1;548;-2.14748e+09;-4.32458e+07;-1;0;0;0;-1;0;153887177;153899375;203339
754;8.58518e-15;4;1656;21268;16101.2;1;548;-2.14748e+09;-4.28479e+07;-1;0;0;0;-1;0;154843452;154856039;209211
755;8.58518e-15;3;1656;21268;16101.2;1;548;-2.14748e+09;-4.2456e+07;-1;0;0;0;-1;0;155796247;155809233;215201
756;8.58518e-15;3;1656;21268;16101.2;1;548;-2.14748e+09;-4.207e+07;-1;0;0;0;-1;0;156745562;156758957;221310
757;8.58518e-15;1;1656;21268;16101.2;1;548;-2.14748e+09;-4.16897e+07;-1;0;0;0;-1;0;157691398;157705212;227539
758;8.58518e-15;0;1656;21268;16101.2;1;548;-2.14748e+09;-4.13152e+07;-1;0;0;0;-1;0;158633756;158647998;233890
759;8.58518e-15;0;1656;21268;16101.2;1;548;-2.14748e+09;-4.09462e+07;-1;0;0;0;-1;0;159572638;159587318;240364
760;8.58518e-15;-1;1656;21268;16101.2;1;548;-2.14748e+09;-4.05826e+07;0;0;0;0;0;0;160508045;160523174;246961
761;8.58518e-15;-2;1656;21268;16101.2;1;548;-2.14748e+09;-4.02244e+07;0;0;0;0;0;0;161439981;161455567;253684
762;8.58518e-15;-2;1656;21268;16101.2;1;548;-2.14748e+09;-3.98714e+07;-1;0;0;0;-1;0;162368447;162384503;260532
763;8.58518e-15;-2;1656;21268;16101.2;1;548;-2.14748e+09;-3.95235e+07;-1;0;0;0;-1;0;163293449;163309984;267506
764;8.58518e-15;-2;1656;21268;16101.2;1;548;-2.14748e+09;-3.91807e+07;-1;0;0;0;-1;0;164214989;164232014;274609
765;8.58518e-15;-3;1656;21268;16101.2;1;548;-2.14748e+09;-3.88428e+07;0;0;0;0;0;0;165133072;165150598;281841
766;8.58518e-15;-3;1656;21268;16101.2;1;548;-2.14748e+09;-3.85097e+07;-1;0;0;0;-1;0;166047702;166065741;289202
767;8.58518e-15;-4;1656;21268;16101.2;1;548;-2.14748e+09;-3.81813e+07;0;0;0;0;0;0;166958886;166977448;296695
768;8.58518e-15;-4;1656;21268;16101.2;1;548;-2.14748e+09;-3.78576e+07;-1;0;0;0;-1;0;167866628;167885724;304320
769;8.58518e-15;-5;1656;21268;16101.2;1;548;-2.14748e+09;-3.75384e+07;0;0;0;0;0;0;168770934;168790577;312077
770;8.58518e-15;-6;1656;21268;16101.2;1;548;-2.14748e+09;-3.72237e+07;0;0;0;0;0;0;169671811;169692012;319969
771;8.58518e-15;-6;1656;21268;16101.2;1;548;-2.14748e+09;-3.69134e+07;-1;0;0;0;-1;0;170569266;170590035;327995
772;8.58518e-15;-6;1656;21268;16101.2;1;548;-2.14748e+09;-3.66073e+07;-1;0;0;0;-1;0;171463304;171484655;336157
773;8.58518e-15;-7;1656;21268;16101.2;1;548;-2.14748e+09;-3.63055e+07;0;0;0;0;0;0;172353933;172375878;344456
774;8.58518e-15;-8;1656;21268;16101.2;1;548;-2.14748e+09;-3.60078e+07;0;0;0;0;0;0;173241162;173263712;352892
775;8.58518e-15;-8;1656;21268;16101.2;1;548;-2.14748e+09;-3.57142e+07;-1;0;0;0;-1;0;174124997;174148165;361467
776;8.58518e-15;-9;1656;21268;16101.2;1;548;-2.14748e+09;-3.54246e+07;0;0;0;0;0;0;175005447;175029246;370182
777;8.58518e-15;-9;1656;21268;16101.2;1;548;-2.14748e+09;-3.51389e+07;-1;0;0;0;-1;0;175882520;175906962;379036
778;8.58518e-15;-10;1656;21268;16101.2;1;548;-2.14748e+09;-3.4857e+07;0;0;0;0;0;0;176756225;176781323;388032
779;8.58518e-15;-11;1656;21268;16101.2;1;548;-2.14748e+09;-3.45788e+07;0;0;0;0;0;0;177626570;177652338;397170
780;8.58518e-15;-12;1656;21268;16101.2;1;548;-2.14748e+09;-3.43044e+07;0;0;0;0;0;0;178493566;178520015;406451
781;8.58518e-15;-12;1656;21268;16101.2;1;548;-2.14748e+09;-3.40336e+07;-1;0;0;0;-1;0;179357220;179384365;415876
782;8.58518e-15;-13;1656;21268;16101.2;1;548;-2.14748e+09;-3.37664e+07;0;0;0;0;0;0;180217543;180245398;425445
783;8.58518e-15;-13;1656;21268;16101.2;1;548;-2.14748e+09;-3.35026e+07;-1;0;0;0;-1;0;181074545;181103122;435159
784;8.58518e-15;-14;1656;21268;16101.2;1;548;-2.14748e+09;-3.32423e+07;0;0;0;0;0;0;181928235;181957549;445019
785;8.58518e-15;-14;1656;21268;16101.2;1;548;-2.14748e+09;-3.29854e+07;-1;0;0;0;-1;0;182778623;182808688;455026
786;8.58518e-15;-14;1656;21268;16101.2;1;548;-2.14748e+09;-3.27317e+07;-1;0;0;0;-1;0;183625721;183656550;465181
787;8.58518e-15;-14;1656;21268;16101.2;1;548;-2.14748e+09;-3.24814e+07;-1;0;0;0;-1;0;184469538;184501146;475484
788;8.58518e-15;-15;1656;21268;16101.2;1;548;-2.14748e+09;-3.22342e+07;0;0;0;0;0;0;185310085;185342486;485936
789;8.58518e-15;-16;1656;21268;16101.2;1;548;-2.14748e+09;-3.19902e+07;0;0;0;0;0;0;186147373;186180582;496537
790;8.58518e-15;-17;1656;21268;16101.2;1;548;-2.14748e+09;-3.17492e+07;0;0;0;0;0;0;186981414;187015445;507289
791;8.58518e-15;-18;1656;21268;16101.2;1;548;-2.14748e+09;-3.15113e+07;0;0;0;0;0;0;187812217;187847086;518192
792;8.58518e-15;-19;1656;21268;16101.2;1;548;-2.14748e+09;-3.12764e+07;0;0;0;0;0;0;188639795;188675517;529247
793;8.58518e-15;-19;1656;21268;16101.2;1;548;-2.14748e+09;-3.10444e+07;-1;0;0;0;-1;0;189464159;189500748;540455
794;8.58518e-15;-19;1656;21268;16101.2;1;548;-2.14748e+09;-3.08153e+07;-1;0;0;0;-1;0;190285320;190322793;551815
795;8.58518e-15;-19;1656;21268;16101.2;1;548;-2.14748e+09;-3.0589e+07;-1;0;0;0;-1;0;191103291;191141662;563329
796;8.58518e-15;-19;1656;21268;16101.2;1;548;-2.14748e+09;-3.03654e+07;-1;0;0;0;-1;0;191918082;191957367;574997
797;8.58518e-15;-20;1656;21268;16101.2;1;548;-2.14748e+09;-3.01446e+07;0;0;0;0;0;0;192729706;192769921;586820
798;8.58518e-15;-21;1656;21268;16101.2;1;548;-2.14748e+09;-2.99265e+07;0;0;0;0;0;0;193538174;193579336;598799
799;8.58518e-15;-22;1656;21268;16101.2;1;548;-2.14748e+09;-2.97111e+07;0;0;0;0;0;0;194343500;194385624;610933
800;8.58518e-15;-23;1656;21268;16101.2;1;548;-2.14748e+09;-2.94982e+07;0;0;0;0;0;0;195145695;195188797;623224
801;8.58518e-15;-23;1656;21268;16101.2;1;548;-2.14748e+09;-2.92879e+07;-1;0;0;0;-1;0;195944770;195988868;635672
802;8.58518e-15;-23;1656;21268;16101.2;1;548;-2.14748e+09;-2.90801e+07;-1;0;0;0;-1;0;196740740;196785849;648278
803;8.58518e-15;-24;1656;21268;16101.2;1;548;-2.14748e+09;-2.88747e+07;0;0;0;0;0;0;197533615;197579753;661042
804;8.58518e-15;-25;1656;21268;16101.2;1;548;-2.14748e+09;-2.86718e+07;0;0;0;0;0;0;198323408;198370592;673964
805;8.58518e-15;-26;1656;21268;16101.2;1;548;-2.14748e+09;-2.84713e+07;0;0;0;0;0;0;199110133;199158379;687046
806;8.58518e-15;-26;1656;21268;16101.2;1;548;-2.14748e+09;-2.82731e+07;-1;0;0;0;-1;0;199893801;199943127;700287
807;8.58518e-15;-26;1656;21268;16101.2;1;548;-2.14748e+09;-2.80773e+07;-1;0;0;0;-1;0;200674426;200724848;713688
808;8.58518e-15;-27;1656;21268;16101.2;1;548;-2.14748e+09;-2.78837e+07;0;0;0;0;0;0;201452019;201503556;727249
809;8.58518e-15;-27;1656;21268;16101.2;1;548;-2.14748e+09;-2.76923e+07;0;0;-1;0;0;-1;202226593;202279263;740971
810;8.58518e-15;-27;1656;21268;16101.2;1;548;-2.14748e+09;-2.75032e+07;-1;0;0;0;-1;0;202998163;203051983;754854
811;8.58518e-15;-28;1656;21268;16101.2;1;548;-2.14748e+09;-2.73162e+07;0;0;0;0;0;0;203766739;203821727;768899
812;8.58518e-15;-29;1656;21268;16101.2;1;548;-2.14748e+09;-2.71313e+07;0;0;0;0;0;0;204532335;204588510;783106
813;8.58518e-15;-29;1656;21268;16101.2;1;548;-2.14748e+09;-2.69485e+07;-1;0;0;0;-1;0;205294965;205352345;797476
814;8.58518e-15;-30;1656;21268;16101.2;1;548;-2.14748e+09;-2.67678e+07;0;0;0;0;0;0;206054640;206113243;812008
815;8.58518e-15;-30;1656;21268;16101.2;1;548;-2.14748e+09;-2.65892e+07;-1;0;0;0;-1;0;206811374;206871219;826703
816;8.58518e-15;-30;1656;21268;16101.2;1;548;-2.14748e+09;-2.64125e+07;-1;0;0;0;-1;0;207565180;207626286;841561
817;8.58518e-15;-30;1656;21268;16101.2;1;548;-2.14748e+09;-2.62378e+07;-1;0;0;0;-1;0;208316071;208378456;856583
818;8.58518e-15;-30;1656;21268;16101.2;1;548;-2.14748e+09;-2.6065e+07;-1;0;0;0;-1;0;209064059;209127744;871769
819;8.58518e-15;-30;1656;21268;16101.2;1;548;-2.14748e+09;-2.58941e+07;-1;0;0;0;-1;0;209809158;209874161;887120
820;8.58518e-15;-30;1656;21268;16101.2;1;548;-2.14748e+09;-2.57251e+07;-1;0;0;0;-1;0;210551381;210617721;902634
821;8.58518e-15;-30;1656;21268;16101.2;1;548;-2.14748e+09;-2.5558e+07;-1;0;0;0;-1;0;211290741;211358438;918314
822;8.58518e-15;-30;1656;21268;16101.2;1;548;-2.14748e+09;-2.53927e+07;-1;0;0;0;-1;0;212027250;212096324;934158
823;8.58518e-15;-31;1656;21268;16101.2;1;548;-2.14748e+09;-2.52292e+07;0;0;0;0;0;0;212760922;212831393;950168
824;8.58518e-15;-31;1656;21268;16101.2;1;548;-2.14748e+09;-2.50674e+07;-1;0;0;0;-1;0;213491770;213563658;966343
825;8.58518e-15;-32;1656;21268;16101.2;1;548;-2.14748e+09;-2.49074e+07;0;0;0;0;0;0;214219807;214293132;982684
826;8.58518e-15;-33;1656;21268;16101.2;1;548;-2.14748e+09;-2.47491e+07;0;0;0;0;0;0;214945046;215019828;999191
827;8.58518e-15;-33;1656;21268;16101.2;1;548;-2.14748e+09;-2.45924e+07;-1;0;0;0;-1;0;215667500;215743759;1015864
828;8.58518e-15;-33;1656;21268;16101.2;1;548;-2.14748e+09;-2.44375e+07;-1;0;0;0;-1;0;216387181;216464939;1032703
829;8.58518e-15;-33;1656;21268;16101.2;1;548;-2.14748e+09;-2.42841e+07;-1;0;0;0;-1;0;217104103;217183380;1049708
830;8.58518e-15;-33;1656;21268;16101.2;1;548;-2.14748e+09;-2.41324e+07;-1;0;0;0;-1;0;217818279;217899096;1066879
831;8.58518e-15;-34;1656;21268;16101.2;1;548;-2.14748e+09;-2.39823e+07;0;0;0;0;0;0;218529722;218612100;1084217
832;8.58518e-15;-35;1656;21268;16101.2;1;548;-2.14748e+09;-2.38337e+07;0;0;0;0;0;0;219238444;219322404;1101722
833;8.58518e-15;-35;1656;21268;16101.2;1;548;-2.14748e+09;-2.36867e+07;-1;0;0;0;-1;0;219944459;220030023;1119394
834;8.58518e-15;-35;1656;21268;16101.2;1;548;-2.14748e+09;-2.35412e+07;-1;0;0;0;-1;0;220647779;220734968;1137232
835;8.58518e-15;-36;1656;21268;16101.2;1;548;-2.14748e+09;-2.33972e+07;0;0;0;0;0;0;221348418;221437254;1155238
836;8.58518e-15;-36;1656;21268;16101.2;1;548;-2.14748e+09;-2.32547e+07;-1;0;0;0;-1;0;222046388;222136892;1173410
837;8.58518e-15;-37;1656;21268;16101.2;1;548;-2.14748e+09;-2.31136e+07;0;0;0;0;0;0;222741701;222833896;1191750
838;8.58518e-15;-37;1656;21268;16101.2;1;548;-2.14748e+09;-2.29739e+07;-1;0;0;0;-1;0;223434371;223528279;1210256
839;8.58518e-15;-37;1656;21268;16101.2;1;548;-2.14748e+09;-2.28357e+07;-1;0;0;0;-1;0;224124411;224220053;1228930
840;8.58518e-15;-37;1656;21268;16101.2;1;548;-2.14748e+09;-2.26989e+07;-1;0;0;0;-1;0;224811832;224909232;1247771
841;8.58518e-15;-38;1656;21268;16101.2;1;548;-2.14748e+09;-2.25634e+07;0;0;0;0;0;0;225496649;225595828;1266779
842;8.58518e-15;-38;1656;21268;16101.2;1;548;-2.14748e+09;-2.24293e+07;-1;0;0;0;-1;0;226178873;226279854;1285954
843;8.58518e-15;-39;1656;21268;16101.2;1;548;-2.14748e+09;-2.22965e+07;0;0;0;0;0;0;226858517;226961324;1305296
844;8.58518e-15;-39;1656;21268;16101.2;1;548;-2.14748e+09;-2.21651e+07;-1;0;0;0;-1;0;227535593;227640248;1324805
845;8.58518e-15;-39;1656;21268;16101.2;1;548;-2.14748e+09;-2.20349e+07;-1;0;0;0;-1;0;228210115;228316641;1344482
846;8.58518e-15;-39;1656;21268;16101.2;1;548;-2.14748e+09;-2.1906e+07;-1;0;0;0;-1;0;228882094;228990515;1364325
847;8.58518e-15;-39;1656;21268;16101.2;1;548;-2.14748e+09;-2.17784e+07;-1;0;0;0;-1;0;229551544;229661882;1384335
848;8.58518e-15;-40;1656;21268;16101.2;1;548;-2.14748e+09;-2.16521e+07;0;0;0;0;0;0;230218475;230330755;1404512
849;8.58518e-15;-40;1656;21268;16101.2;1;548;-2.14748e+09;-2.15269e+07;-1;0;0;0;-1;0;230882902;230997147;1424856
850;8.58518e-15;-40;1656;21268;16101.2;1;548;-2.14748e+09;-2.1403e+07;-1;0;0;0;-1;0;231544836;231661069;1445366
851;8.58518e-15;-40;1656;21268;16101.2;1;548;-2.14748e+09;-2.12802e+07;-1;0;0;0;-1;0;232204289;232322535;1466043
852;8.58518e-15;-40;1656;21268;16101.2;1;548;-2.14748e+09;-2.11587e+07;-1;0;0;0;-1;0;232861274;232981557;1486886
853;8.58518e-15;-41;1656;21268;16101.2;1;548;-2.14748e+09;-2.10383e+07;0;0;0;0;0;0;233515803;233638146;1507896
854;8.58518e-15;-41;1656;21268;16101.2;1;548;-2.14748e+09;-2.0919e+07;-1;0;0;0;-1;0;234167888;234292317;1529072
855;8.58518e-15;-41;1656;21268;16101.2;1;548;-2.14748e+09;-2.08009e+07;-1;0;0;0;-1;0;234817541;234944079;1550414
856;8.58518e-15;-42;1656;21268;16101.2;1;548;-2.14748e+09;-2.06839e+07;0;0;0;0;0;0;235464775;235593447;1571921
857;8.58518e-15;-43;1656;21268;16101.2;1;548;-2.14748e+09;-2.05679e+07;0;0;0;0;0;0;236109600;236240431;1593595
858;8.58518e-15;-43;1656;21268;16101.2;1;548;-2.14748e+09;-2.04531e+07;-1;0;0;0;-1;0;236752030;236885044;1615433
859;8.58518e-15;-44;1656;21268;16101.2;1;548;-2.14748e+09;-2.03394e+07;0;0;0;0;0;0;237392075;237527299;1637437
860;8.58518e-15;-45;1656;21268;16101.2;1;548;-2.14748e+09;-2.02267e+07;0;0;0;0;0;0;238029749;238167206;1659607
861;8.58518e-15;-45;1656;21268;16101.2;1;548;-2.14748e+09;-2.0115e+07;-1;0;0;0;-1;0;238665062;238804778;1681941
862;8.58518e-15;-46;1656;21268;16101.2;1;548;-2.14748e+09;-2.00044e+07;0;0;0;0;0;0;239298027;239440027;1704440
863;8.58518e-15;-46;1656;21268;16101.2;1;548;-2.14748e+09;-1.98948e+07;-1;0;0;0;-1;0;239928655;240072965;1727103
864;8.58518e-15;-46;1656;21268;16101.2;1;548;-2.14748e+09;-1.97862e+07;-1;0;0;0;-1;0;240556958;240703603;1749930
865;8.58518e-15;-46;1656;21268;16101.2;1;548;-2.14748e+09;-1.96786e+07;-1;0;0;0;-1;0;241182947;241331953;1772922
866;8.58518e-15;-46;1656;21268;16101.2;1;548;-2.14748e+09;-1.95719e+07;-1;0;0;0;-1;0;241806634;241958027;1796077
867;8.58518e-15;-47;1656;21268;16101.2;1;548;-2.14748e+09;-1.94663e+07;0;0;0;0;0;0;242428031;242581837;1819396
868;8.58518e-15;-48;1656;21268;16101.2;1;548;-2.14748e+09;-1.93615e+07;0;0;0;0;0;0;243047148;243203394;1842878
869;8.58518e-15;-48;1656;21268;16101.2;1;548;-2.14748e+09;-1.92578e+07;-1;0;0;0;-1;0;243663998;243822709;1866523
870;8.58518e-15;-48;1656;21268;16101.2;1;548;-2.14748e+09;-1.91549e+07;-1;0;0;0;-1;0;244278591;244439794;1890330
871;8.58518e-15;-49;1656;21268;16101.2;1;548;-2.14748e+09;-1.9053e+07;0;0;0;0;0;0;244890940;245054660;1914300
872;8.58518e-15;-49;1656;21268;16101.2;1;548;-2.14748e+09;-1.89519e+07;-1;0;0;0;-1;0;245501054;245667319;1938432
873;8.58518e-15;-49;1656;21268;16101.2;1;548;-2.14748e+09;-1.88518e+07;-1;0;0;0;-1;0;246108946;246277782;1962725
874;8.58518e-15;-49;1656;21268;16101.2;1;548;-2.14748e+09;-1.87526e+07;-1;0;0;0;-1;0;246714626;246886061;1987180
875;8.58518e-15;-50;1656;21268;16101.2;1;548;-2.14748e+09;-1.86542e+07;0;0;0;0;0;0;247318106;247492166;2011796
876;8.58518e-15;-50;1656;21268;16101.2;1;548;-2.14748e+09;-1.85566e+07;-1;0;0;0;-1;0;247919396;248096108;2036573
877;8.58518e-15;-50;1656;21268;16101.2;1;548;-2.14748e+09;-1.846e+07;-1;0;0;0;-1;0;248518508;248697899;2061510
878;8.58518e-15;-50;1656;21268;16101.2;1;548;-2.14748e+09;-1.83641e+07;-1;0;0;0;-1;0;249115452;249297549;2086608
879;8.58518e-15;-51;1656;21268;16101.2;1;548;-2.14748e+09;-1.82691e+07;0;0;0;0;0;0;249710239;249895070;2111865
880;8.58518e-15;-51;1656;21268;16101.2;1;548;-2.14748e+09;-1.8175e+07;-1;0;0;0;-1;0;250302880;250490473;2137281
881;8.58518e-15;-52;1656;21268;16101.2;1;548;-2.14748e+09;-1.80816e+07;0;0;0;0;0;0;250893386;251083768;2162856
882;8.58518e-15;-53;1656;21268;16101.2;1;548;-2.14748e+09;-1.7989e+07;0;0;0;0;0;0;251481767;251674966;2188590
883;8.58518e-15;-53;1656;21268;16101.2;1;548;-2.14748e+09;-1.78972e+07;-1;0;0;0;-1;0;252068034;252264077;2214482
884;8.58518e-15;-53;1656;21268;16101.2;1;548;-2.14748e+09;-1.78062e+07;-1;0;0;0;-1;0;252652197;252851113;2240532
885;8.58518e-15;-54;1656;21268;16101.2;1;548;-2.14748e+09;-1.7716e+07;0;0;0;0;0;0;253234268;253436085;2266739
886;8.58518e-15;-55;1656;21268;16101.2;1;548;-2.14748e+09;-1.76265e+07;0;0;0;0;0;0;253814256;254019002;2293103
887;8.58518e-15;-55;1656;21268;16101.2;1;548;-2.14748e+09;-1.75378e+07;-1;0;0;0;-1;0;254392172;254599875;2319624
888;8.58518e-15;-56;1656;21268;16101.2;1;548;-2.14748e+09;-1.74498e+07;0;0;0;0;0;0;254968026;255178714;2346301
889;8.58518e-15;-57;1656;21268;16101.2;1;548;-2.14748e+09;-1.73625e+07;0;0;0;0;0;0;255541829;255755531;2373134
890;8.58518e-15;-57;1656;21268;16101.2;1;548;-2.14748e+09;-1.7276e+07;-1;0;0;0;-1;0;256113590;256330335;2400122
891;8.58518e-15;-58;1656;21268;16101.2;1;548;-2.14748e+09;-1.71902e+07;0;0;0;0;0;0;256683320;256903136;2427265
892;8.58518e-15;-59;1656;21268;16101.2;1;548;-2.14748e+09;-1.71051e+07;0;0;0;0;0;0;257251030;257473946;2454562
893;8.58518e-15;-60;1656;21268;16101.2;1;548;-2.14748e+09;-1.70207e+07;0;0;0;0;0;0;257816728;258042773;2482013
894;8.58518e-15;-60;1656;21268;16101.2;1;548;-2.14748e+09;-1.6937e+07;-1;0;0;0;-1;0;258380425;258609628;2509618
895;8.58518e-15;-60;1656;21268;16101.2;1;548;-2.14748e+09;-1.6854e+07;-1;0;0;0;-1;0;258942132;259174521;2537376
896;8.58518e-15;-61;1656;21268;16101.2;1;548;-2.14748e+09;-1.67716e+07;0;0;0;0;0;0;259501857;259737463;2565286
897;8.58518e-15;-62;1656;21268;16101.2;1;548;-2.14748e+09;-1.66899e+07;0;0;0;0;0;0;260059611;260298462;2593349
898;8.58518e-15;-62;1656;21268;16101.2;1;548;-2.14748e+09;-1.66089e+07;-1;0;0;0;-1;0;260615404;260857530;2621563
899;8.58518e-15;-62;1656;21268;16101.2;1;548;-2.14748e+09;-1.65285e+07;-1;0;0;0;-1;0;261169244;261414675;2649928
900;8.58518e-15;-63;1656;21268;16101.2;1;548;-2.14748e+09;-1.64488e+07;0;0;0;0;0;0;261721143;261969907;2678444
901;8.58518e-15;-64;1656;21268;16101.2;1;548;-2.14748e+09;-1.63697e+07;0;0;0;0;0;0;262271109;262523237;2707110
902;8.58518e-15;-65;1656;21268;16101.2;1;548;-2.14748e+09;-1.62913e+07;0;0;0;0;0;0;262819153;263074673;2735926
903;8.58518e-15;-65;1656;21268;16101.2;1;548;-2.14748e+09;-1.62134e+07;-1;0;0;0;-1;0;263365283;263624226;2764891
904;8.58518e-15;-65;1656;21268;16101.2;1;548;-2.14748e+09;-1.61362e+07;-1;0;0;0;-1;0;263909509;264171905;2794005
905;8.58518e-15;-65;1656;21268;16101.2;1;548;-2.14748e+09;-1.60596e+07;-1;0;0;0;-1;0;264451840;264717720;2823266
906;8.58518e-15;-65;1656;21268;16101.2;1;548;-2.14748e+09;-1.59836e+07;-1;0;0;0;-1;0;264992286;265261679;2852676
907;8.58518e-15;-65;1656;21268;16101.2;1;548;-2.14748e+09;-1.59082e+07;-1;0;0;0;-1;0;265530857;265803793;2882232
908;8.58518e-15;-66;1656;21268;16101.2;1;548;-2.14748e+09;-1.58334e+07;0;0;0;0;0;0;266067560;266344070;2911936
909;8.58518e-15;-67;1656;21268;16101.2;1;548;-2.14748e+09;-1.57592e+07;0;0;0;0;0;0;266602406;266882520;2941785
910;8.58518e-15;-68;1656;21268;16101.2;1;548;-2.14748e+09;-1.56855e+07;0;0;0;0;0;0;267135404;267419152;2971779
911;8.58518e-15;-68;1656;21268;16101.2;1;548;-2.14748e+09;-1.56124e+07;-1;0;0;0;-1;0;267666563;267953975;3001919
912;8.58518e-15;-69;1656;21268;16101.2;1;548;-2.14748e+09;-1.55399e+07;0;0;0;0;0;0;268195891;268486999;3032203
913;8.58518e-15;-70;1656;21268;16101.2;1;548;-2.14748e+09;-1.54679e+07;0;0;0;0;0;0;268723398;269018232;3062631
914;8.58518e-15;-71;1656;21268;16101.2;1;548;-2.14748e+09;-1.53965e+07;0;0;0;0;0;0;269249092;269547683;3093202
915;8.58518e-15;-71;1656;21268;16101.2;1;548;-2.14748e+09;-1.53256e+07;-1;0;0;0;-1;0;269772983;270075362;3123916
916;8.58518e-15;-72;1656;21268;16101.2;1;548;-2.14748e+09;-1.52553e+07;0;0;0;0;0;0;270295079;270601277;3154773
917;8.58518e-15;-73;1656;21268;16101.2;1;548;-2.14748e+09;-1.51855e+07;0;0;0;0;0;0;270815390;271125437;3185771
918;8.58518e-15;-74;1656;21268;16101.2;1;548;-2.14748e+09;-1.51162e+07;0;0;0;0;0;0;271333923;271647851;3216910
919;8.58518e-15;-75;1656;21268;16101.2;1;548;-2.14748e+09;-1.50475e+07;0;0;0;0;0;0;271850687;272168527;3248189
920;8.58518e-15;-76;1656;21268;16101.2;1;548;-2.14748e+09;-1.49792e+07;0;0;0;0;0;0;272365692;272687474;3279608
921;8.58518e-15;-77;1656;21268;16101.2;1;548;-2.14748e+09;-1.49115e+07;0;0;0;0;0;0;272878945;273204702;3311167
922;8.58518e-15;-77;1656;21268;16101.2;1;548;-2.14748e+09;-1.48443e+07;-1;0;0;0;-1;0;273390455;273720218;3342865
923;8.58518e-15;-77;1656;21268;16101.2;1;548;-2.14748e+09;-1.47776e+07;-1;0;0;0;-1;0;273900230;274234031;3374701
924;8.58518e-15;-78;1656;21268;16101.2;1;548;-2.14748e+09;-1.47113e+07;0;0;0;0;0;0;274408280;274746149;3406674
925;8.58518e-15;-79;1656;21268;16101.2;1;548;-2.14748e+09;-1.46456e+07;0;0;0;0;0;0;274914612;275256581;3438784
926;8.58518e-15;-79;1656;21268;16101.2;1;548;-2.14748e+09;-1.45803e+07;-1;0;0;0;-1;0;275419234;275765336;3471031
927;8.58518e-15;-80;1656;21268;16101.2;1;548;-2.14748e+09;-1.45156e+07;0;0;0;0;0;0;275922155;276272421;3503414
928;8.58518e-15;-81;1656;21268;16101.2;1;548;-2.14748e+09;-1.44513e+07;0;0;0;0;0;0;276423384;276777845;3535932
929;8.58518e-15;-82;1656;21268;16101.2;1;548;-2.14748e+09;-1.43874e+07;0;0;0;0;0;0;276922927;277281615;3568584
930;8.58518e-15;-83;1656;21268;16101.2;1;548;-2.14748e+09;-1.43241e+07;0;0;0;0;0;0;277420794;277783741;3601371
931;8.58518e-15;-84;1656;21268;16101.2;1;548;-2.14748e+09;-1.42612e+07;0;0;0;0;0;0;277916992;278284231;3634291
932;8.58518e-15;-85;1656;21268;16101.2;1;548;-2.14748e+09;-1.41987e+07;0;0;0;0;0;0;278411530;278783091;3667344
933;8.58518e-15;-85;1656;21268;16101.2;1;548;-2.14748e+09;-1.41367e+07;-1;0;0;0;-1;0;278904415;279280332;3700529
934;8.58518e-15;-85;1656;21268;16101.2;1;548;-2.14748e+09;-1.40752e+07;-1;0;0;0;-1;0;279395655;279775959;3733845
935;8.58518e-15;-86;1656;21268;16101.2;1;548;-2.14748e+09;-1.4014e+07;0;0;0;0;0;0;279885258;280269982;3767293
936;8.58518e-15;-87;1656;21268;16101.2;1;548;-2.14748e+09;-1.39534e+07;0;0;0;0;0;0;280373232;280762408;3800871
937;8.58518e-15;-87;1656;21268;16101.2;1;548;-2.14748e+09;-1.38931e+07;-1;0;0;0;-1;0;280859584;281253245;3834578
938;8.58518e-15;-88;1656;21268;16101.2;1;548;-2.14748e+09;-1.38333e+07;0;0;0;0;0;0;281344324;281742501;3868415
939;8.58518e-15;-89;1656;21268;16101.2;1;548;-2.14748e+09;-1.37739e+07;0;0;0;0;0;0;281827457;282230183;3902380
940;8.58518e-15;-89;1656;21268;16101.2;1;548;-2.14748e+09;-1.37149e+07;-1;0;0;0;-1;0;282308992;282716300;3936473
941;8.58518e-15;-90;1656;21268;16101.2;1;548;-2.14748e+09;-1.36564e+07;0;0;0;0;0;0;282788936;283200858;3970693
942;8.58518e-15;-91;1656;21268;16101.2;1;548;-2.14748e+09;-1.35982e+07;0;0;0;0;0;0;283267297;283683866;4005040
943;8.58518e-15;-91;1656;21268;16101.2;1;548;-2.14748e+09;-1.35405e+07;-1;0;0;0;-1;0;283744082;284165331;4039513
944;8.58518e-15;-91;1656;21268;16101.2;1;548;-2.14748e+09;-1.34831e+07;-1;0;0;0;-1;0;284219299;284645260;4074111
945;8.58518e-15;-91;1656;21268;16101.2;1;548;-2.14748e+09;-1.34262e+07;-1;0;0;0;-1;0;284692955;285123661;4108834
946;8.58518e-15;-91;1656;21268;16101.2;1;548;-2.14748e+09;-1.33696e+07;-1;0;0;0;-1;0;285165058;285600541;4143681
947;8.58518e-15;-92;1656;21268;16101.2;1;548;-2.14748e+09;-1.33134e+07;0;0;0;0;0;0;285635615;286075909;4178652
948;8.58518e-15;-93;1656;21268;16101.2;1;548;-2.14748e+09;-1.32577e+07;0;0;0;0;0;0;286104632;286549770;4213745
949;8.58518e-15;-94;1656;21268;16101.2;1;548;-2.14748e+09;-1.32023e+07;0;0;0;0;0;0;286572118;287022132;4248960
950;8.58518e-15;-94;1656;21268;16101.2;1;548;-2.14748e+09;-1.31473e+07;-1;0;0;0;-1;0;287038080;287493003;4284297
951;8.58518e-15;-95;1656;21268;16101.2;1;548;-2.14748e+09;-1.30926e+07;0;0;0;0;0;0;287502524;287962389;4319755
952;8.58518e-15;-96;1656;21268;16101.2;1;548;-2.14748e+09;-1.30384e+07;0;0;0;0;0;0;287965458;288430298;4355333
953;8.58518e-15;-97;1656;21268;16101.2;1;548;-2.14748e+09;-1.29845e+07;0;0;0;0;0;0;288426888;288896737;4391030
954;8.58518e-15;-98;1656;21268;16101.2;1;548;-2.14748e+09;-1.29309e+07;0;0;0;0;0;0;288886823;289361713;4426846
955;8.58518e-15;-99;1656;21268;16101.2;1;548;-2.14748e+09;-1.28777e+07;0;0;0;0;0;0;289345268;289825233;4462781
956;8.58518e-15;-99;1656;21268;16101.2;1;548;-2.14748e+09;-1.28249e+07;-1;0;0;0;-1;0;289802231;290287304;4498833
957;8.58518e-15;-100;1656;21268;16101.2;1;548;-2.14748e+09;-1.27725e+07;0;0;0;0;0;0;290257718;290747933;4535003
958;8.58518e-15;-101;1656;21268;16101.2;1;548;-2.14748e+09;-1.27203e+07;0;0;0;0;0;0;290711737;291207126;4571288
959;8.58518e-15;-101;1656;21268;16101.2;1;548;-2.14748e+09;-1.26686e+07;-1;0;0;0;-1;0;291164294;291664891;4607689
960;8.58518e-15;-101;1656;21268;16101.2;1;548;-2.14748e+09;-1.26172e+07;-1;0;0;0;-1;0;291615395;292121234;4644206
961;8.58518e-15;-102;1656;21268;16101.2;1;548;-2.14748e+09;-1.25661e+07;0;0;0;0;0;0;292065049;292576162;4680836
962;8.58518e-15;-103;1656;21268;16101.2;1;548;-2.14748e+09;-1.25153e+07;0;0;0;0;0;0;292513260;293029682;4717581
963;8.58518e-15;-103;1656;21268;16101.2;1;548;-2.14748e+09;-1.24649e+07;-1;0;0;0;-1;0;292960037;293481800;4754438
964;8.58518e-15;-103;1656;21268;16101.2;1;548;-2.14748e+09;-1.24148e+07;-1;0;0;0;-1;0;293405385;293932523;4791408
965;8.58518e-15;-103;1656;21268;16101.2;1;548;-2.14748e+09;-1.23651e+07;-1;0;0;0;-1;0;293849312;294381858;4828489
966;8.58518e-15;-104;1656;21268;16101.2;1;548;-2.14748e+09;-1.23157e+07;0;0;0;0;0;0;294291823;294829811;4865682
967;8.58518e-15;-105;1656;21268;16101.2;1;548;-2.14748e+09;-1.22665e+07;0;0;0;0;0;0;294732925;295276388;4902985
968;8.58518e-15;-106;1656;21268;16101.2;1;548;-2.14748e+09;-1.22178e+07;0;0;0;0;0;0;295172624;295721597;4940398
969;8.58518e-15;-106;1656;21268;16101.2;1;548;-2.14748e+09;-1.21693e+07;-1;0;0;0;-1;0;295610927;296165443;4977920
970;8.58518e-15;-107;1656;21268;16101.2;1;548;-2.14748e+09;-1.21211e+07;0;0;0;0;0;0;296047841;296607934;5015550
971;8.58518e-15;-108;1656;21268;16101.2;1;548;-2.14748e+09;-1.20733e+07;0;0;0;0;0;0;296483371;297049074;5053288
972;8.58518e-15;-109;1656;21268;16101.2;1;548;-2.14748e+09;-1.20257e+07;0;0;0;0;0;0;296917524;297488871;5091134
973;8.58518e-15;-110;1656;21268;16101.2;1;548;-2.14748e+09;-1.19785e+07;0;0;0;0;0;0;297350307;297927331;5129086
974;8.58518e-15;-110;1656;21268;16101.2;1;548;-2.14748e+09;-1.19316e+07;-1;0;0;0;-1;0;297781724;298364459;5167143
975;8.58518e-15;-110;1656;21268;16101.2;1;548;-2.14748e+09;-1.18849e+07;-1;0;0;0;-1;0;298211783;298800263;5205306
976;8.58518e-15;-111;1656;21268;16101.2;1;548;-2.14748e+09;-1.18386e+07;0;0;0;0;0;0;298640490;299234749;5243574
977;8.58518e-15;-111;1656;21268;16101.2;1;548;-2.14748e+09;-1.17925e+07;-1;0;0;0;-1;0;299067850;299667922;5281945
978;8.58518e-15;-111;1656;21268;16101.2;1;548;-2.14748e+09;-1.17468e+07;-1;0;0;0;-1;0;299493870;300099788;5320419
979;8.58518e-15;-111;1656;21268;16101.2;1;548;-2.14748e+09;-1.17013e+07;-1;0;0;0;-1;0;299918556;300530354;5358996
980;8.58518e-15;-112;1656;21268;16101.2;1;548;-2.14748e+09;-1.16561e+07;0;0;0;0;0;0;300341913;300959626;5397675
981;8.58518e-15;-112;1656;21268;16101.2;1;548;-2.14748e+09;-1.16112e+07;-1;0;0;0;-1;0;300763949;301387609;5436455
982;8.58518e-15;-112;1656;21268;16101.2;1;548;-2.14748e+09;-1.15666e+07;-1;0;0;0;-1;0;301184668;301814310;5475336
983;8.58518e-15;-112;1656;21268;16101.2;1;548;-2.14748e+09;-1.15223e+07;-1;0;0;0;-1;0;301604076;302239734;5514317
984;8.58518e-15;-112;1656;21268;16101.2;1;548;-2.14748e+09;-1.14782e+07;-1;0;0;0;-1;0;302022180;302663887;5553396
985;8.58518e-15;-113;1656;21268;16101.2;1;548;-2.14748e+09;-1.14344e+07;0;0;0;0;0;0;302438984;303086775;5592575
986;8.58518e-15;-113;1656;21268;16101.2;1;548;-2.14748e+09;-1.13909e+07;-1;0;0;0;-1;0;302854496;303508405;5631851
987;8.58518e-15;-114;1656;21268;16101.2;1;548;-2.14748e+09;-1.13476e+07;0;0;0;0;0;0;303268721;303928780;5671225
988;8.58518e-15;-114;1656;21268;16101.2;1;548;-2.14748e+09;-1.13046e+07;-1;0;0;0;-1;0;303681663;304347908;5710695
989;8.58518e-15;-114;1656;21268;16101.2;1;548;-2.14748e+09;-1.12619e+07;-1;0;0;0;-1;0;304093330;304765794;5750262
990;8.58518e-15;-115;1656;21268;16101.2;1;548;-2.14748e+09;-1.12194e+07;0;0;0;0;0;0;304503727;305182444;5789923
991;8.58518e-15;-115;1656;21268;16101.2;1;548;-2.14748e+09;-1.11772e+07;-1;0;0;0;-1;0;304912858;305597862;5829680
992;8.58518e-15;-116;1656;21268;16101.2;1;548;-2.14748e+09;-1.11352e+07;0;0;0;0;0;0;305320731;306012056;5869530
993;8.58518e-15;-117;1656;21268;16101.2;1;548;-2.14748e+09;-1.10935e+07;0;0;0;0;0;0;305727349;306425029;5909474
994;8.58518e-15;-118;1656;21268;16101.2;1;548;-2.14748e+09;-1.10521e+07;0;0;0;0;0;0;306132720;306836789;5949510
995;8.58518e-15;-118;1656;21268;16101.2;1;548;-2.14748e+09;-1.10109e+07;-1;0;0;0;-1;0;306536848;307247340;5989639
996;8.58518e-15;-118;1656;21268;16101.2;1;548;-2.14748e+09;-1.09699e+07;-1;0;0;0;-1;0;306939739;307656687;6029859
997;8.58518e-15;-118;1656;21268;16101.2;1;548;-2.14748e+09;-1.09292e+07;-1;0;0;0;-1;0;307341398;308064837;6070169
998;8.58518e-15;-119;1656;21268;16101.2;1;548;-2.14748e+09;-1.08888e+07;0;0;0;0;0;0;307741830;308471794;6110570
999;8.58518e-15;-120;1656;21268;16101.2;1;548;-2.14748e+09;-1.08486e+07;0;0;0;0;0;0;308141042;308877564;6151060
1000;8.58518e-15;-120;1656;21268;16101.2;1;548;-2.14748e+09;-1.08086e+07;-1;0;0;0;-1;0;308539037;309282152;6191639
1001;8.58518e-15;-120;1656;21268;16101.2;1;548;-2.14748e+09;-1.07688e+07;-1;0;0;0;-1;0;308935822;309685563;6232307
1002;8.58518e-15;-120;1656;21268;16101.2;1;548;-2.14748e+09;-1.07293e+07;-1;0;0;0;-1;0;309331402;310087803;6273061
1003;8.58518e-15;-121;1656;21268;16101.2;1;548;-2.14748e+09;-1.069e+07;0;0;0;0;0;0;309725781;310488877;6313903
1004;8.58518e-15;-122;1656;21268;16101.2;1;548;-2.14748e+09;-1.0651e+07;0;0;0;0;0;0;310118966;310888790;6354831
1005;8.58518e-15;-122;1656;21268;16101.2;1;548;-2.14748e+09;-1.06122e+07;-1;0;0;0;-1;0;310510961;311287548;6395845
1006;8.58518e-15;-123;1656;21268;16101.2;1;548;-2.14748e+09;-1.05736e+07;0;0;0;0;0;0;310901771;311685154;6436943
1007;8.58518e-15;-124;1656;21268;16101.2;1;548;-2.14748e+09;-1.05352e+07;0;0;0;0;0;0;311291402;312081615;6478126
1008;8.58518e-15;-124;1656;21268;16101.2;1;548;-2.14748e+09;-1.04971e+07;-1;0;0;0;-1;0;311679858;312476935;6519392
1009;8.58518e-15;-125;1656;21268;16101.2;1;548;-2.14748e+09;-1.04592e+07;0;0;0;0;0;0;312067145;312871120;6560742
1010;8.58518e-15;-126;1656;21268;16101.2;1;548;-2.14748e+09;-1.04215e+07;0;0;0;0;0;0;312453268;313264174;6602174
1011;8.58518e-15;-126;1656;21268;16101.2;1;548;-2.14748e+09;-1.0384e+07;-1;0;0;0;-1;0;312838231;313656102;6643688
1012;8.58518e-15;-127;1656;21268;16101.2;1;548;-2.14748e+09;-1.03467e+07;0;0;0;0;0;0;313222039;314046910;6685282
1013;8.58518e-15;-128;1656;21268;16101.2;1;548;-2.14748e+09;-1.03096e+07;0;0;0;0;0;0;313604698;314436602;6726958
1014;8.58518e-15;-128;1656;21268;16101.2;1;548;-2.14748e+09;-1.02728e+07;-1;0;0;0;-1;0;313986212;314825184;6768713
1015;8.58518e-15;-128;1656;21268;16101.2;1;548;-2.14748e+09;-1.02362e+07;-1;0;0;0;-1;0;314366586;315212659;6810547
1016;8.58518e-15;-128;1656;21268;16101.2;1;548;-2.14748e+09;-1.01998e+07;-1;0;0;0;-1;0;314745826;315599033;6852460
1017;8.58518e-15;-129;1656;21268;16101.2;1;548;-2.14748e+09;-1.01635e+07;0;0;0;0;0;0;315123935;315984310;6894451
1018;8.58518e-15;-129;1656;21268;16101.2;1;548;-2.14748e+09;-1.01275e+07;-1;0;0;0;-1;0;315500919;316368496;6936520
1019;8.58518e-15;-129;1656;21268;16101.2;1;548;-2.14748e+09;-1.00917e+07;-1;0;0;0;-1;0;315876782;316751595;6978665
1020;8.58518e-15;-130;1656;21268;16101.2;1;548;-2.14748e+09;-1.00561e+07;0;0;0;0;0;0;316251529;317133611;7020886
1021;8.58518e-15;-131;1656;21268;16101.2;1;548;-2.14748e+09;-1.00207e+07;0;0;0;0;0;0;316625164;317514550;7063183
1022;8.58518e-15;-131;1656;21268;16101.2;1;548;-2.14748e+09;-9.98552e+06;-1;0;0;0;-1;0;316997693;317894416;7105554
1023;8.58518e-15;-131;1656;21268;16101.2;1;548;-2.14748e+09;-9.95051e+06;-1;0;0;0;-1;0;317369120;318273214;7148000
1024;8.58518e-15;-132;1656;21268;16101.2;1;548;-2.14748e+09;-9.9157e+06;0;0;0;0;0;0;317739450;318650948;7190519
1025;8.58518e-15;-133;1656;21268;16101.2;1;548;-2.14748e+09;-9.88108e+06;0;0;0;0;0;0;318108687;319027623;7233112
1026;8.58518e-15;-133;1656;21268;16101.2;1;548;-2.14748e+09;-9.84666e+06;-1;0;0;0;-1;0;318476836;319403243;7275777
1027;8.58518e-15;-133;1656;21268;16101.2;1;548;-2.14748e+09;-9.81242e+06;-1;0;0;0;-1;0;318843901;319777813;7318513
1028;8.58518e-15;-133;1656;21268;16101.2;1;548;-2.14748e+09;-9.77838e+06;-1;0;0;0;-1;0;319209887;320151337;7361321
1029;8.58518e-15;-133;1656;21268;16101.2;1;548;-2.14748e+09;-9.74452e+06;-1;0;0;0;-1;0;319574798;320523820;7404199
1030;8.58518e-15;-134;1656;21268;16101.2;1;548;-2.14748e+09;-9.71085e+06;0;0;0;0;0;0;319938639;320895267;7447147
1031;8.58518e-15;-135;1656;21268;16101.2;1;548;-2.14748e+09;-9.67736e+06;0;0;0;0;0;0;320301414;321265681;7490164
1032;8.58518e-15;-135;1656;21268;16101.2;1;548;-2.14748e+09;-9.64406e+06;-1;0;0;0;-1;0;320663127;321635067;7533251
1033;8.58518e-15;-136;1656;21268;16101.2;1;548;-2.14748e+09;-9.61094e+06;0;0;0;0;0;0;321023784;322003429;7576405
1034;8.58518e-15;-137;1656;21268;16101.2;1;548;-2.14748e+09;-9.578e+06;0;0;0;0;0;0;321383388;322370772;7619627
1035;8.58518e-15;-138;1656;21268;16101.2;1;548;-2.14748e+09;-9.54524e+06;0;0;0;0;0;0;321741944;322737100;7662915
1036;8.58518e-15;-139;1656;21268;16101.2;1;548;-2.14748e+09;-9.51266e+06;0;0;0;0;0;0;322099455;323102417;7706270
1037;8.58518e-15;-139;1656;21268;16101.2;1;548;-2.14748e+09;-9.48025e+06;-1;0;0;0;-1;0;322455927;323466728;7749691
1038;8.58518e-15;-140;1656;21268;16101.2;1;548;-2.14748e+09;-9.44802e+06;0;0;0;0;0;0;322811363;323830036;7793176
1039;8.58518e-15;-140;1656;21268;16101.2;1;548;-2.14748e+09;-9.41596e+06;-1;0;0;0;-1;0;323165768;324192347;7836727
1040;8.58518e-15;-141;1656;21268;16101.2;1;548;-2.14748e+09;-9.38407e+06;0;0;0;0;0;0;323519146;324553663;7880341
1041;8.58518e-15;-142;1656;21268;16101.2;1;548;-2.14748e+09;-9.35236e+06;0;0;0;0;0;0;323871501;324913990;7924018
1042;8.58518e-15;-142;1656;21268;16101.2;1;548;-2.14748e+09;-9.32081e+06;-1;0;0;0;-1;0;324222837;325273331;7967758
1043;8.58518e-15;-142;1656;21268;16101.2;1;548;-2.14748e+09;-9.28943e+06;-1;0;0;0;-1;0;324573159;325631690;8011560
1044;8.58518e-15;-143;1656;21268;16101.2;1;548;-2.14748e+09;-9.25822e+06;0;0;0;0;0;0;324922470;325989072;8055424
1045;8.58518e-15;-144;1656;21268;16101.2;1;548;-2.14748e+09;-9.22718e+06;0;0;0;0;0;0;325270774;326345481;8099349
1046;8.58518e-15;-145;1656;21268;16101.2;1;548;-2.14748e+09;-9.1963e+06;0;0;0;0;0;0;325618077;326700920;8143334
1047;8.58518e-15;-145;1656;21268;16101.2;1;548;-2.14748e+09;-9.16558e+06;-1;0;0;0;-1;0;325964381;327055394;8187379
1048;8.58518e-15;-145;1656;21268;16101.2;1;548;-2.14748e+09;-9.13502e+06;-1;0;0;0;-1;0;326309691;327408906;8231483
1049;8.58518e-15;-145;1656;21268;16101.2;1;548;-2.14748e+09;-9.10463e+06;-1;0;0;0;-1;0;326654010;327761462;8275646
1050;8.58518e-15;-145;1656;21268;16101.2;1;548;-2.14748e+09;-9.07439e+06;-1;0;0;0;-1;0;326997343;328113063;8319866
1051;8.58518e-15;-146;1656;21268;16101.2;1;548;-2.14748e+09;-9.04431e+06;0;0;0;0;0;0;327339694;328463715;8364145
1052;8.58518e-15;-146;1656;21268;16101.2;1;548;-2.14748e+09;-9.01439e+06;-1;0;0;0;-1;0;327681067;328813421;8408480
1053;8.58518e-15;-147;1656;21268;16101.2;1;548;-2.14748e+09;-8.98462e+06;0;0;0;0;0;0;328021465;329162185;8452871
1054;8.58518e-15;-147;1656;21268;16101.2;1;548;-2.14748e+09;-8.95501e+06;-1;0;0;0;-1;0;328360892;329510012;8497318
1055;8.58518e-15;-148;1656;21268;16101.2;1;548;-2.14748e+09;-8.92556e+06;0;0;0;0;0;0;328699352;329856904;8541821
1056;8.58518e-15;-148;1656;21268;16101.2;1;548;-2.14748e+09;-8.89625e+06;-1;0;0;0;-1;0;329036850;330202866;8586378
1057;8.58518e-15;-149;1656;21268;16101.2;1;548;-2.14748e+09;-8.8671e+06;0;0;0;0;0;0;329373389;330547901;8630989
1058;8.58518e-15;-149;1656;21268;16101.2;1;548;-2.14748e+09;-8.83809e+06;-1;0;0;0;-1;0;329708972;330892014;8675653
1059;8.58518e-15;-149;1656;21268;16101.2;1;548;-2.14748e+09;-8.80924e+06;-1;0;0;0;-1;0;330043604;331235207;8720370
1060;8.58518e-15;-150;1656;21268;16101.2;1;548;-2.14748e+09;-8.78053e+06;0;0;0;0;0;0;330377288;331577485;8765140
1061;8.58518e-15;-151;1656;21268;16101.2;1;548;-2.14748e+09;-8.75197e+06;0;0;0;0;0;0;330710029;331918851;8809962
1062;8.58518e-15;-152;1656;21268;16101.2;1;548;-2.14748e+09;-8.72355e+06;0;0;0;0;0;0;331041828;332259309;8854835
1063;8.58518e-15;-153;1656;21268;16101.2;1;548;-2.14748e+09;-8.69528e+06;0;0;0;0;0;0;331372692;332598863;8899758
1064;8.58518e-15;-154;1656;21268;16101.2;1;548;-2.14748e+09;-8.66715e+06;0;0;0;0;0;0;331702622;332937516;8944732
1065;8.58518e-15;-154;1656;21268;16101.2;1;548;-2.14748e+09;-8.63917e+06;-1;0;0;0;-1;0;332031624;333275272;8989755
1066;8.58518e-15;-154;1656;21268;16101.2;1;548;-2.14748e+09;-8.61132e+06;-1;0;0;0;-1;0;332359699;333612135;9034827
1067;8.58518e-15;-154;1656;21268;16101.2;1;548;-2.14748e+09;-8.58362e+06;-1;0;0;0;-1;0;332686853;333948107;9079948
1068;8.58518e-15;-155;1656;21268;16101.2;1;548;-2.14748e+09;-8.55606e+06;0;0;0;0;0;0;333013088;334283193;9125117
1069;8.58518e-15;-156;1656;21268;16101.2;1;548;-2.14748e+09;-8.52863e+06;0;0;0;0;0;0;333338409;334617397;9170333
1070;8.58518e-15;-156;1656;21268;16101.2;1;548;-2.14748e+09;-8.50134e+06;-1;0;0;0;-1;0;333662818;334950720;9215596
1071;8.58518e-15;-157;1656;21268;16101.2;1;548;-2.14748e+09;-8.47419e+06;0;0;0;0;0;0;333986320;335283168;9260905
1072;8.58518e-15;-158;1656;21268;16101.2;1;548;-2.14748e+09;-8.44717e+06;0;0;0;0;0;0;334308917;335614744;9306260
1073;8.58518e-15;-159;1656;21268;16101.2;1;548;-2.14748e+09;-8.42028e+06;0;0;0;0;0;0;334630614;335945450;9351661
1074;8.58518e-15;-160;1656;21268;16101.2;1;548;-2.14748e+09;-8.39354e+06;0;0;0;0;0;0;334951413;336275291;9397106
1075;8.58518e-15;-161;1656;21268;16101.2;1;548;-2.14748e+09;-8.36692e+06;0;0;0;0;0;0;335271319;336604270;9442595
1076;8.58518e-15;-162;1656;21268;16101.2;1;548;-2.14748e+09;-8.34043e+06;0;0;0;0;0;0;335590335;336932390;9488128
1077;8.58518e-15;-162;1656;21268;16101.2;1;548;-2.14748e+09;-8.31407e+06;-1;0;0;0;-1;0;335908463;337259654;9533704
1078;8.58518e-15;-162;1656;21268;16101.2;1;548;-2.14748e+09;-8.28785e+06;-1;0;0;0;-1;0;336225709;337586067;9579323
1079;8.58518e-15;-163;1656;21268;16101.2;1;548;-2.14748e+09;-8.26175e+06;0;0;0;0;0;0;336542074;337911631;9624983
1080;8.58518e-15;-163;1656;21268;16101.2;1;548;-2.14748e+09;-8.23578e+06;-1;0;0;0;-1;0;336857563;338236349;9670686
1081;8.58518e-15;-163;1656;21268;16101.2;1;548;-2.14748e+09;-8.20994e+06;-1;0;0;0;-1;0;337172178;338560226;9716429
1082;8.58518e-15;-164;1656;21268;16101.2;1;548;-2.14748e+09;-8.18422e+06;0;0;0;0;0;0;337485923;338883263;9762213
1083;8.58518e-15;-164;1656;21268;16101.2;1;548;-2.14748e+09;-8.15862e+06;-1;0;0;0;-1;0;337798802;339205465;9808037
1084;8.58518e-15;-165;1656;21268;16101.2;1;548;-2.14748e+09;-8.13316e+06;0;0;0;0;0;0;338110817;339526835;9853900
1085;8.58518e-15;-166;1656;21268;16101.2;1;548;-2.14748e+09;-8.10781e+06;0;0;0;0;0;0;338421972;339847375;9899802
1086;8.58518e-15;-167;1656;21268;16101.2;1;548;-2.14748e+09;-8.08258e+06;0;0;0;0;0;0;338732271;340167090;9945743
1087;8.58518e-15;-168;1656;21268;16101.2;1;548;-2.14748e+09;-8.05748e+06;0;0;0;0;0;0;339041716;340485982;9991722
1088;8.58518e-15;-168;1656;21268;16101.2;1;548;-2.14748e+09;-8.0325e+06;-1;0;0;0;-1;0;339350310;340804054;10037738
1089;8.58518e-15;-168;1656;21268;16101.2;1;548;-2.14748e+09;-8.00764e+06;-1;0;0;0;-1;0;339658057;341121310;10083791
1090;8.58518e-15;-169;1656;21268;16101.2;1;548;-2.14748e+09;-7.9829e+06;0;0;0;0;0;0;339964961;341437753;10129881
1091;8.58518e-15;-169;1656;21268;16101.2;1;548;-2.14748e+09;-7.95827e+06;-1;0;0;0;-1;0;340271024;341753386;10176006
1092;8.58518e-15;-170;1656;21268;16101.2;1;548;-2.14748e+09;-7.93376e+06;0;0;0;0;0;0;340576249;342068211;10222167
1093;8.58518e-15;-170;1656;21268;16101.2;1;548;-2.14748e+09;-7.90937e+06;-1;0;0;0;-1;0;340880640;342382233;10268363
1094;8.58518e-15;-171;1656;21268;16101.2;1;548;-2.14748e+09;-7.8851e+06;0;0;0;0;0;0;341184199;342695454;10314594
1095;8.58518e-15;-172;1656;21268;16101.2;1;548;-2.14748e+09;-7.86094e+06;0;0;0;0;0;0;341486930;343007877;10360858
1096;8.58518e-15;-173;1656;21268;16101.2;1;548;-2.14748e+09;-7.83689e+06;0;0;0;0;0;0;341788837;343319505;10407156
1097;8.58518e-15;-173;1656;21268;16101.2;1;548;-2.14748e+09;-7.81296e+06;-1;0;0;0;-1;0;342089921;343630341;10453487
1098;8.58518e-15;-173;1656;21268;16101.2;1;548;-2.14748e+09;-7.78914e+06;-1;0;0;0;-1;0;342390186;343940389;10499850
1099;8.58518e-15;-174;1656;21268;16101.2;1;548;-2.14748e+09;-7.76543e+06;0;0;0;0;0;0;342689636;344249650;10546245
1100;8.58518e-15;-175;1656;21268;16101.2;1;548;-2.14748e+09;-7.74183e+06;0;0;0;0;0;0;342988272;344558129;10592672
1101;8.58518e-15;-176;1656;21268;16101.2;1;548;-2.14748e+09;-7.71834e+06;0;0;0;0;0;0;343286099;344865828;10639130
1102;8.58518e-15;-176;1656;21268;16101.2;1;548;-2.14748e+09;-7.69496e+06;-1;0;0;0;-1;0;343583119;345172750;10685619
1103;8.58518e-15;-177;1656;21268;16101.2;1;548;-2.14748e+09;-7.67169e+06;0;0;0;0;0;0;343879335;345478898;10732137
1104;8.58518e-15;-178;1656;21268;16101.2;1;548;-2.14748e+09;-7.64853e+06;0;0;0;0;0;0;344174750;345784275;10778685
1105;8.58518e-15;-179;1656;21268;16101.2;1;548;-2.14748e+09;-7.62547e+06;0;0;0;0;0;0;344469367;346088884;10825263
1106;8.58518e-15;-179;1656;21268;16101.2;1;548;-2.14748e+09;-7.60252e+06;-1;0;0;0;-1;0;344763189;346392727;10871869
1107;8.58518e-15;-179;1656;21268;16101.2;1;548;-2.14748e+09;-7.57968e+06;-1;0;0;0;-1;0;345056220;346695807;10918503
1108;8.58518e-15;-179;1656;21268;16101.2;1;548;-2.14748e+09;-7.55694e+06;-1;0;0;0;-1;0;345348461;346998128;10965165
1109;8.58518e-15;-179;1656;21268;16101.2;1;548;-2.14748e+09;-7.53431e+06;-1;0;0;0;-1;0;345639916;347299692;11011854
1110;8.58518e-15;-179;1656;21268;16101.2;1;548;-2.14748e+09;-7.51178e+06;-1;0;0;0;-1;0;345930587;347600502;11058571
1111;8.58518e-15;-179;1656;21268;16101.2;1;548;-2.14748e+09;-7.48936e+06;-1;0;0;0;-1;0;346220478;347900561;11105313
1112;8.58518e-15;-179;1656;21268;16101.2;1;548;-2.14748e+09;-7.46703e+06;-1;0;0;0;-1;0;346509591;348199871;11152081
1113;8.58518e-15;-180;1656;21268;16101.2;1;548;-2.14748e+09;-7.44481e+06;0;0;0;0;0;0;346797930;348498436;11198875
1114;8.58518e-15;-181;1656;21268;16101.2;1;548;-2.14748e+09;-7.42268e+06;0;0;0;0;0;0;347085496;348796257;11245694
1115;8.58518e-15;-182;1656;21268;16101.2;1;548;-2.14748e+09;-7.40066e+06;0;0;0;0;0;0;347372294;349093338;11292537
1116;8.58518e-15;-182;1656;21268;16101.2;1;548;-2.14748e+09;-7.37874e+06;-1;0;0;0;-1;0;347658325;349389682;11339405
1117;8.58518e-15;-182;1656;21268;16101.2;1;548;-2.14748e+09;-7.35692e+06;-1;0;0;0;-1;0;347943592;349685291;11386296
1118;8.58518e-15;-182;1656;21268;16101.2;1;548;-2.14748e+09;-7.33519e+06;-1;0;0;0;-1;0;348228099;349980168;11433210
1119;8.58518e-15;-182;1656;21268;16101.2;1;548;-2.14748e+09;-7.31357e+06;-1;0;0;0;-1;0;348511847;350274315;11480147
1120;8.58518e-15;-183;1656;21268;16101.2;1;548;-2.14748e+09;-7.29204e+06;0;0;0;0;0;0;348794840;350567736;11527107
1121;8.58518e-15;-184;1656;21268;16101.2;1;548;-2.14748e+09;-7.2706e+06;0;0;0;0;0;0;349077081;350860432;11574088
1122;8.58518e-15;-185;1656;21268;16101.2;1;548;-2.14748e+09;-7.24926e+06;0;0;0;0;0;0;349358571;351152407;11621091
1123;8.58518e-15;-185;1656;21268;16101.2;1;548;-2.14748e+09;-7.22802e+06;-1;0;0;0;-1;0;349639315;351443663;11668114
1124;8.58518e-15;-185;1656;21268;16101.2;1;548;-2.14748e+09;-7.20687e+06;-1;0;0;0;-1;0;349919313;351734202;11715158
1125;8.58518e-15;-186;1656;21268;16101.2;1;548;-2.14748e+09;-7.18582e+06;0;0;0;0;0;0;350198570;352024028;11762223
1126;8.58518e-15;-186;1656;21268;16101.2;1;548;-2.14748e+09;-7.16485e+06;-1;0;0;0;-1;0;350477088;352313143;11809307
1127;8.58518e-15;-186;1656;21268;16101.2;1;548;-2.14748e+09;-7.14398e+06;-1;0;0;0;-1;0;350754869;352601549;11856410
1128;8.58518e-15;-186;1656;21268;16101.2;1;548;-2.14748e+09;-7.12321e+06;-1;0;0;0;-1;0;351031916;352889249;11903532
1129;8.58518e-15;-186;1656;21268;16101.2;1;548;-2.14748e+09;-7.10252e+06;-1;0;0;0;-1;0;351308232;353176246;11950673
1130;8.58518e-15;-186;1656;21268;16101.2;1;548;-2.14748e+09;-7.08193e+06;-1;0;0;0;-1;0;351583819;353462542;11997831
1131;8.58518e-15;-187;1656;21268;16101.2;1;548;-2.14748e+09;-7.06142e+06;0;0;0;0;0;0;351858680;353748139;12045007
1132;8.58518e-15;-188;1656;21268;16101.2;1;548;-2.14748e+09;-7.04101e+06;0;0;0;0;0;0;352132818;354033040;12092200
1133;8.58518e-15;-189;1656;21268;16101.2;1;548;-2.14748e+09;-7.02068e+06;0;0;0;0;0;0;352406234;354317248;12139410
1134;8.58518e-15;-189;1656;21268;16101.2;1;548;-2.14748e+09;-7.00044e+06;-1;0;0;0;-1;0;352678932;354600765;12186637
1135;8.58518e-15;-189;1656;21268;16101.2;1;548;-2.14748e+09;-6.98029e+06;-1;0;0;0;-1;0;352950915;354883593;12233879
1136;8.58518e-15;-190;1656;21268;16101.2;1;548;-2.14748e+09;-6.96023e+06;0;0;0;0;0;0;353222183;355165736;12281136
1137;8.58518e-15;-190;1656;21268;16101.2;1;548;-2.14748e+09;-6.94026e+06;-1;0;0;0;-1;0;353492741;355447194;12328409
1138;8.58518e-15;-191;1656;21268;16101.2;1;548;-2.14748e+09;-6.92037e+06;0;0;0;0;0;0;353762591;355727971;12375697
1139;8.58518e-15;-192;1656;21268;16101.2;1;548;-2.14748e+09;-6.90056e+06;0;0;0;0;0;0;354031735;356008070;12422998
1140;8.58518e-15;-192;1656;21268;16101.2;1;548;-2.14748e+09;-6.88085e+06;-1;0;0;0;-1;0;354300175;356287492;12470314
1141;8.58518e-15;-192;1656;21268;16101.2;1;548;-2.14748e+09;-6.86121e+06;-1;0;0;0;-1;0;354567914;356566240;12517643
1142;8.58518e-15;-192;1656;21268;16101.2;1;548;-2.14748e+09;-6.84166e+06;-1;0;0;0;-1;0;354834955;356844316;12564985
1143;8.58518e-15;-192;1656;21268;16101.2;1;548;-2.14748e+09;-6.8222e+06;-1;0;0;0;-1;0;355101300;357121723;12612340
1144;8.58518e-15;-193;1656;21268;16101.2;1;548;-2.14748e+09;-6.80282e+06;0;0;0;0;0;0;355366951;357398463;12659707
1145;8.58518e-15;-193;1656;21268;16101.2;1;548;-2.14748e+09;-6.78352e+06;-1;0;0;0;-1;0;355631911;357674539;12707086
1146;8.58518e-15;-193;1656;21268;16101.2;1;548;-2.14748e+09;-6.7643e+06;-1;0;0;0;-1;0;355896183;357949952;12754476
1147;8.58518e-15;-194;1656;21268;16101.2;1;548;-2.14748e+09;-6.74516e+06;0;0;0;0;0;0;356159768;358224705;12801877
1148;8.58518e-15;-194;1656;21268;16101.2;1;548;-2.14748e+09;-6.72611e+06;-1;0;0;0;-1;0;356422668;358498800;12849290
1149;8.58518e-15;-195;1656;21268;16101.2;1;548;-2.14748e+09;-6.70713e+06;0;0;0;0;0;0;356684888;358772240;12896712
1150;8.58518e-15;-195;1656;21268;16101.2;1;548;-2.14748e+09;-6.68824e+06;-1;0;0;0;-1;0;356946428;359045027;12944145
1151;8.58518e-15;-195;1656;21268;16101.2;1;548;-2.14748e+09;-6.66942e+06;-1;0;0;0;-1;0;357207291;359317163;12991587
1152;8.58518e-15;-195;1656;21268;16101.2;1;548;-2.14748e+09;-6.65069e+06;-1;0;0;0;-1;0;357467479;359588650;13039038
1153;8.58518e-15;-196;1656;21268;16101.2;1;548;-2.14748e+09;-6.63203e+06;0;0;0;0;0;0;357726996;359859490;13086498
1154;8.58518e-15;-197;1656;21268;16101.2;1;548;-2.14748e+09;-6.61345e+06;0;0;0;0;0;0;357985842;360129687;13133966
1155;8.58518e-15;-198;1656;21268;16101.2;1;548;-2.14748e+09;-6.59495e+06;0;0;0;0;0;0;358244021;360399242;13181442
1156;8.58518e-15;-198;1656;21268;16101.2;1;548;-2.14748e+09;-6.57652e+06;-1;0;0;0;-1;0;358501534;360668156;13228927
1157;8.58518e-15;-199;1656;21268;16101.2;1;548;-2.14748e+09;-6.55818e+06;0;0;0;0;0;0;358758384;360936434;13276418
1158;8.58518e-15;-199;1656;21268;16101.2;1;548;-2.14748e+09;-6.5399e+06;-1;0;0;0;-1;0;359014574;361204076;13323916
1159;8.58518e-15;-200;1656;21268;16101.2;1;548;-2.14748e+09;-6.52171e+06;0;0;0;0;0;0;359270105;361471084;13371421
1160;8.58518e-15;-200;1656;21268;16101.2;1;548;-2.14748e+09;-6.50359e+06;-1;0;0;0;-1;0;359524979;361737462;13418932
1161;8.58518e-15;-200;1656;21268;16101.2;1;548;-2.14748e+09;-6.48554e+06;-1;0;0;0;-1;0;359779200;362003211;13466449
1162;8.58518e-15;-200;1656;21268;16101.2;1;548;-2.14748e+09;-6.46757e+06;-1;0;0;0;-1;0;360032769;362268333;13513972
1163;8.58518e-15;-200;1656;21268;16101.2;1;548;-2.14748e+09;-6.44967e+06;-1;0;0;0;-1;0;360285688;362532830;13561499
1164;8.58518e-15;-200;1656;21268;16101.2;1;548;-2.14748e+09;-6.43184e+06;-1;0;0;0;-1;0;360537959;362796705;13609031
1165;8.58518e-15;-200;1656;21268;16101.2;1;548;-2.14748e+09;-6.41409e+06;-1;0;0;0;-1;0;360789586;363059959;13656568
1166;8.58518e-15;-201;1656;21268;16101.2;1;548;-2.14748e+09;-6.39642e+06;0;0;0;0;0;0;361040569;363322595;13704109
1167;8.58518e-15;-201;1656;21268;16101.2;1;548;-2.14748e+09;-6.37881e+06;-1;0;0;0;-1;0;361290912;363584615;13751653
1168;8.58518e-15;-202;1656;21268;16101.2;1;548;-2.14748e+09;-6.36127e+06;0;0;0;0;0;0;361540616;363846021;13799201
1169;8.58518e-15;-202;1656;21268;16101.2;1;548;-2.14748e+09;-6.34381e+06;-1;0;0;0;-1;0;361789684;364106814;13846751
1170;8.58518e-15;-203;1656;21268;16101.2;1;548;-2.14748e+09;-6.32642e+06;0;0;0;0;0;0;362038117;364366998;13894305
1171;8.58518e-15;-204;1656;21268;16101.2;1;548;-2.14748e+09;-6.30909e+06;0;0;0;0;0;0;362285918;364626574;13941860
1172;8.58518e-15;-205;1656;21268;16101.2;1;548;-2.14748e+09;-6.29184e+06;0;0;0;0;0;0;362533088;364885543;13989418
1173;8.58518e-15;-205;1656;21268;16101.2;1;548;-2.14748e+09;-6.27466e+06;-1;0;0;0;-1;0;362779631;365143909;14036977
1174;8.58518e-15;-206;1656;21268;16101.2;1;548;-2.14748e+09;-6.25754e+06;0;0;0;0;0;0;363025548;365401673;14084537
1175;8.58518e-15;-207;1656;21268;16101.2;1;548;-2.14748e+09;-6.2405e+06;0;0;0;0;0;0;363270841;365658837;14132099
1176;8.58518e-15;-208;1656;21268;16101.2;1;548;-2.14748e+09;-6.22352e+06;0;0;0;0;0;0;363515512;365915403;14179661
1177;8.58518e-15;-208;1656;21268;16101.2;1;548;-2.14748e+09;-6.20661e+06;-1;0;0;0;-1;0;363759564;366171373;14227223
1178;8.58518e-15;-208;1656;21268;16101.2;1;548;-2.14748e+09;-6.18977e+06;-1;0;0;0;-1;0;364002998;366426749;14274785
1179;8.58518e-15;-209;1656;21268;16101.2;1;548;-2.14748e+09;-6.173e+06;0;0;0;0;0;0;364245816;366681533;14322347
1180;8.58518e-15;-209;1656;21268;16101.2;1;548;-2.14748e+09;-6.15629e+06;-1;0;0;0;-1;0;364488022;366935727;14369908
1181;8.58518e-15;-209;1656;21268;16101.2;1;548;-2.14748e+09;-6.13965e+06;-1;0;0;0;-1;0;364729615;367189333;14417467
1182;8.58518e-15;-209;1656;21268;16101.2;1;548;-2.14748e+09;-6.12307e+06;-1;0;0;0;-1;0;364970599;367442353;14465026
1183;8.58518e-15;-209;1656;21268;16101.2;1;548;-2.14748e+09;-6.10656e+06;-1;0;0;0;-1;0;365210976;367694789;14512583
1184;8.58518e-15;-210;1656;21268;16101.2;1;548;-2.14748e+09;-6.09012e+06;0;0;0;0;0;0;365450748;367946642;14560138
1185;8.58518e-15;-211;1656;21268;16101.2;1;548;-2.14748e+09;-6.07374e+06;0;0;0;0;0;0;365689916;368197915;14607690
1186;8.58518e-15;-212;1656;21268;16101.2;1;548;-2.14748e+09;-6.05743e+06;0;0;0;0;0;0;365928482;368448610;14655240
1187;8.58518e-15;-213;1656;21268;16101.2;1;548;-2.14748e+09;-6.04118e+06;0;0;0;0;0;0;366166450;368698728;14702786
1188;8.58518e-15;-214;1656;21268;16101.2;1;548;-2.14748e+09;-6.02499e+06;0;0;0;0;0;0;366403820;368948271;14750330
1189;8.58518e-15;-215;1656;21268;16101.2;1;548;-2.14748e+09;-6.00886e+06;0;0;0;0;0;0;366640594;369197241;14797870
1190;8.58518e-15;-216;1656;21268;16101.2;1;548;-2.14748e+09;-5.9928e+06;0;0;0;0;0;0;366876775;369445641;14845405
1191;8.58518e-15;-216;1656;21268;16101.2;1;548;-2.14748e+09;-5.97681e+06;-1;0;0;0;-1;0;367112364;369693471;14892937
1192;8.58518e-15;-216;1656;21268;16101.2;1;548;-2.14748e+09;-5.96087e+06;-1;0;0;0;-1;0;367347364;369940734;14940464
1193;8.58518e-15;-216;1656;21268;16101.2;1;548;-2.14748e+09;-5.945e+06;-1;0;0;0;-1;0;367581776;370187431;14987986
1194;8.58518e-15;-217;1656;21268;16101.2;1;548;-2.14748e+09;-5.92918e+06;0;0;0;0;0;0;367815602;370433565;15035503
1195;8.58518e-15;-217;1656;21268;16101.2;1;548;-2.14748e+09;-5.91343e+06;-1;0;0;0;-1;0;368048844;370679137;15083015
1196;8.58518e-15;-217;1656;21268;16101.2;1;548;-2.14748e+09;-5.89774e+06;-1;0;0;0;-1;0;368281505;370924149;15130520
1197;8.58518e-15;-217;1656;21268;16101.2;1;548;-2.14748e+09;-5.88211e+06;-1;0;0;0;-1;0;368513585;371168602;15178020
1198;8.58518e-15;-217;1656;21268;16101.2;1;548;-2.14748e+09;-5.86654e+06;-1;0;0;0;-1;0;368745087;371412500;15225513
1199;8.58518e-15;-218;1656;21268;16101.2;1;548;-2.14748e+09;-5.85103e+06;0;0;0;0;0;0;368976013;371655843;15273000
1200;8.58518e-15;-219;1656;21268;16101.2;1;548;-2.14748e+09;-5.83558e+06;0;0;0;0;0;0;369206364;371898632;15320479
1201;8.58518e-15;-220;1656;21268;16101.2;1;548;-2.14748e+09;-5.82019e+06;0;0;0;0;0;0;369436143;372140871;15367952
1202;8.58518e-15;-221;1656;21268;16101.2;1;548;-2.14748e+09;-5.80486e+06;0;0;0;0;0;0;369665351;372382561;15415416
1203;8.58518e-15;-222;1656;21268;16101.2;1;548;-2.14748e+09;-5.78958e+06;0;0;0;0;0;0;369893990;372623702;15462873
1204;8.58518e-15;-223;1656;21268;16101.2;1;548;-2.14748e+09;-5.77437e+06;0;0;0;0;0;0;370122062;372864299;15510322
1205;8.58518e-15;-224;1656;21268;16101.2;1;548;-2.14748e+09;-5.75921e+06;0;0;0;0;0;0;370349569;373104350;15557762
1206;8.58518e-15;-225;1656;21268;16101.2;1;548;-2.14748e+09;-5.74411e+06;0;0;0;0;0;0;370576513;373343860;15605194
1207;8.58518e-15;-225;1656;21268;16101.2;1;548;-2.14748e+09;-5.72907e+06;-1;0;0;0;-1;0;370802895;373582829;15652617
1208;8.58518e-15;-225;1656;21268;16101.2;1;548;-2.14748e+09;-5.71408e+06;-1;0;0;0;-1;0;371028717;373821259;15700030
1209;8.58518e-15;-226;1656;21268;16101.2;1;548;-2.14748e+09;-5.69915e+06;0;0;0;0;0;0;371253981;374059151;15747434
1210;8.58518e-15;-226;1656;21268;16101.2;1;548;-2.14748e+09;-5.68428e+06;-1;0;0;0;-1;0;371478689;374296508;15794828
1211;8.58518e-15;-226;1656;21268;16101.2;1;548;-2.14748e+09;-5.66946e+06;-1;0;0;0;-1;0;371702842;374533332;15842212
1212;8.58518e-15;-227;1656;21268;16101.2;1;548;-2.14748e+09;-5.6547e+06;0;0;0;0;0;0;371926443;374769623;15889585
1213;8.58518e-15;-227;1656;21268;16101.2;1;548;-2.14748e+09;-5.63999e+06;-1;0;0;0;-1;0;372149493;375005383;15936948
1214;8.58518e-15;-227;1656;21268;16101.2;1;548;-2.14748e+09;-5.62534e+06;-1;0;0;0;-1;0;372371994;375240615;15984300
1215;8.58518e-15;-227;1656;21268;16101.2;1;548;-2.14748e+09;-5.61075e+06;-1;0;0;0;-1;0;372593947;375475319;16031640
1216;8.58518e-15;-228;1656;21268;16101.2;1;548;-2.14748e+09;-5.5962e+06;0;0;0;0;0;0;372815355;375709498;16078969
1217;8.58518e-15;-229;1656;21268;16101.2;1;548;-2.14748e+09;-5.58171e+06;0;0;0;0;0;0;373036219;375943153;16126287
1218;8.58518e-15;-230;1656;21268;16101.2;1;548;-2.14748e+09;-5.56728e+06;0;0;0;0;0;0;373256540;376176285;16173592
1219;8.58518e-15;-230;1656;21268;16101.2;1;548;-2.14748e+09;-5.5529e+06;-1;0;0;0;-1;0;373476321;376408897;16220885
1220;8.58518e-15;-230;1656;21268;16101.2;1;548;-2.14748e+09;-5.53857e+06;-1;0;0;0;-1;0;373695564;376640990;16268166
1221;8.58518e-15;-231;1656;21268;16101.2;1;548;-2.14748e+09;-5.5243e+06;0;0;0;0;0;0;373914269;376872565;16315434
1222;8.58518e-15;-231;1656;21268;16101.2;1;548;-2.14748e+09;-5.51007e+06;-1;0;0;0;-1;0;374132439;377103625;16362688
1223;8.58518e-15;-231;1656;21268;16101.2;1;548;-2.14748e+09;-5.4959e+06;-1;0;0;0;-1;0;374350075;377334170;16409929
1224;8.58518e-15;-232;1656;21268;16101.2;1;548;-2.14748e+09;-5.48179e+06;0;0;0;0;0;0;374567180;377564203;16457157
1225;8.58518e-15;-233;1656;21268;16101.2;1;548;-2.14748e+09;-5.46772e+06;0;0;0;0;0;0;374783754;377793724;16504371
1226;8.58518e-15;-234;1656;21268;16101.2;1;548;-2.14748e+09;-5.45371e+06;0;0;0;0;0;0;374999799;378022736;16551571
1227;8.58518e-15;-234;1656;21268;16101.2;1;548;-2.14748e+09;-5.43974e+06;-1;0;0;0;-1;0;375215317;378251240;16598756
1228;8.58518e-15;-235;1656;21268;16101.2;1;548;-2.14748e+09;-5.42583e+06;0;0;0;0;0;0;375430310;378479237;16645927
1229;8.58518e-15;-236;1656;21268;16101.2;1;548;-2.14748e+09;-5.41197e+06;0;0;0;0;0;0;375644779;378706730;16693083
1230;8.58518e-15;-237;1656;21268;16101.2;1;548;-2.14748e+09;-5.39816e+06;0;0;0;0;0;0;375858727;378933719;16740224
1231;8.58518e-15;-237;1656;21268;16101.2;1;548;-2.14748e+09;-5.3844e+06;-1;0;0;0;-1;0;376072153;379160207;16787349
1232;8.58518e-15;-238;1656;21268;16101.2;1;548;-2.14748e+09;-5.37069e+06;0;0;0;0;0;0;376285061;379386194;16834459
1233;8.58518e-15;-238;1656;21268;16101.2;1;548;-2.14748e+09;-5.35702e+06;-1;0;0;0;-1;0;376497452;379611683;16881553
1234;8.58518e-15;-239;1656;21268;16101.2;1;548;-2.14748e+09;-5.34341e+06;0;0;0;0;0;0;376709327;379836674;16928631
1235;8.58518e-15;-240;1656;21268;16101.2;1;548;-2.14748e+09;-5.32985e+06;0;0;0;0;0;0;376920689;380061170;16975693
1236;8.58518e-15;-240;1656;21268;16101.2;1;548;-2.14748e+09;-5.31634e+06;-1;0;0;0;-1;0;377131537;380285171;17022738
1237;8.58518e-15;-241;1656;21268;16101.2;1;548;-2.14748e+09;-5.30287e+06;0;0;0;0;0;0;377341875;380508680;17069767
1238;8.58518e-15;-241;1656;21268;16101.2;1;548;-2.14748e+09;-5.28945e+06;-1;0;0;0;-1;0;377551704;380731697;17116778
1239;8.58518e-15;-242;1656;21268;16101.2;1;548;-2.14748e+09;-5.27608e+06;0;0;0;0;0;0;377761025;380954225;17163772
1240;8.58518e-15;-242;1656;21268;16101.2;1;548;-2.14748e+09;-5.26276e+06;-1;0;0;0;-1;0;377969841;381176264;17210748
1241;8.58518e-15;-243;1656;21268;16101.2;1;548;-2.14748e+09;-5.24949e+06;0;0;0;0;0;0;378178151;381397817;17257707
1242;8.58518e-15;-244;1656;21268;16101.2;1;548;-2.14748e+09;-5.23626e+06;0;0;0;0;0;0;378385959;381618884;17304648
1243;8.58518e-15;-245;1656;21268;16101.2;1;548;-2.14748e+09;-5.22308e+06;0;0;0;0;0;0;378593265;381839467;17351570
1244;8.58518e-15;-246;1656;21268;16101.2;1;548;-2.14748e+09;-5.20995e+06;0;0;0;0;0;0;378800072;382059568;17398474
1245;8.58518e-15;-246;1656;21268;16101.2;1;548;-2.14748e+09;-5.19686e+06;-1;0;0;0;-1;0;379006380;382279188;17445360
1246;8.58518e-15;-246;1656;21268;16101.2;1;548;-2.14748e+09;-5.18382e+06;-1;0;0;0;-1;0;379212191;382498328;17492226
1247;8.58518e-15;-246;1656;21268;16101.2;1;548;-2.14748e+09;-5.17083e+06;-1;0;0;0;-1;0;379417507;382716991;17539074
1248;8.58518e-15;-247;1656;21268;16101.2;1;548;-2.14748e+09;-5.15788e+06;0;0;0;0;0;0;379622330;382935176;17585902
1249;8.58518e-15;-247;1656;21268;16101.2;1;548;-2.14748e+09;-5.14498e+06;-1;0;0;0;-1;0;379826660;383152886;17632711
1250;8.58518e-15;-247;1656;21268;16101.2;1;548;-2.14748e+09;-5.13212e+06;-1;0;0;0;-1;0;380030499;383370122;17679500
1251;8.58518e-15;-248;1656;21268;16101.2;1;548;-2.14748e+09;-5.11931e+06;0;0;0;0;0;0;380233849;383586886;17726268
1252;8.58518e-15;-249;1656;21268;16101.2;1;548;-2.14748e+09;-5.10655e+06;0;0;0;0;0;0;380436712;383803179;17773017
1253;8.58518e-15;-250;1656;21268;16101.2;1;548;-2.14748e+09;-5.09382e+06;0;0;0;0;0;0;380639088;384019002;17819745
1254;8.58518e-15;-250;1656;21268;16101.2;1;548;-2.14748e+09;-5.08115e+06;-1;0;0;0;-1;0;380840979;384234356;17866453
1255;8.58518e-15;-251;1656;21268;16101.2;1;548;-2.14748e+09;-5.06851e+06;0;0;0;0;0;0;381042388;384449244;17913139
1256;8.58518e-15;-251;1656;21268;16101.2;1;548;-2.14748e+09;-5.05592e+06;-1;0;0;0;-1;0;381243314;384663666;17959805
1257;8.58518e-15;-252;1656;21268;16101.2;1;548;-2.14748e+09;-5.04338e+06;0;0;0;0;0;0;381443760;384877624;18006449
1258;8.58518e-15;-252;1656;21268;16101.2;1;548;-2.14748e+09;-5.03088e+06;-1;0;0;0;-1;0;381643727;385091119;18053072
1259;8.58518e-15;-253;1656;21268;16101.2;1;548;-2.14748e+09;-5.01842e+06;0;0;0;0;0;0;381843216;385304152;18099674
1260;8.58518e-15;-254;1656;21268;16101.2;1;548;-2.14748e+09;-5.006e+06;0;0;0;0;0;0;382042230;385516726;18146253
1261;8.58518e-15;-255;1656;21268;16101.2;1;548;-2.14748e+09;-4.99363e+06;0;0;0;0;0;0;382240769;385728840;18192810
1262;8.58518e-15;-256;1656;21268;16101.2;1;548;-2.14748e+09;-4.9813e+06;0;0;0;0;0;0;382438834;385940497;18239345
1263;8.58518e-15;-257;1656;21268;16101.2;1;548;-2.14748e+09;-4.96901e+06;0;0;0;0;0;0;382636428;386151698;18285857
1264;8.58518e-15;-257;1656;21268;16101.2;1;548;-2.14748e+09;-4.95677e+06;-1;0;0;0;-1;0;382833552;386362445;18332347
1265;8.58518e-15;-257;1656;21268;16101.2;1;548;-2.14748e+09;-4.94456e+06;-1;0;0;0;-1;0;383030207;386572737;18378814
1266;8.58518e-15;-257;1656;21268;16101.2;1;548;-2.14748e+09;-4.9324e+06;-1;0;0;0;-1;0;383226394;386782578;18425257
1267;8.58518e-15;-257;1656;21268;16101.2;1;548;-2.14748e+09;-4.92028e+06;-1;0;0;0;-1;0;383422116;386991967;18471678
1268;8.58518e-15;-258;1656;21268;16101.2;1;548;-2.14748e+09;-4.9082e+06;0;0;0;0;0;0;383617372;387200908;18518074
1269;8.58518e-15;-259;1656;21268;16101.2;1;548;-2.14748e+09;-4.89617e+06;0;0;0;0;0;0;383812166;387409399;18564448
1270;8.58518e-15;-260;1656;21268;16101.2;1;548;-2.14748e+09;-4.88417e+06;0;0;0;0;0;0;384006497;387617444;18610797
1271;8.58518e-15;-261;1656;21268;16101.2;1;548;-2.14748e+09;-4.87222e+06;0;0;0;0;0;0;384200368;387825043;18657122
1272;8.58518e-15;-262;1656;21268;16101.2;1;548;-2.14748e+09;-4.8603e+06;0;0;0;0;0;0;384393780;388032198;18703423
1273;8.58518e-15;-263;1656;21268;16101.2;1;548;-2.14748e+09;-4.84843e+06;0;0;0;0;0;0;384586734;388238910;18749699
1274;8.58518e-15;-263;1656;21268;16101.2;1;548;-2.14748e+09;-4.83659e+06;-1;0;0;0;-1;0;384779231;388445179;18795951
1275;8.58518e-15;-263;1656;21268;16101.2;1;548;-2.14748e+09;-4.8248e+06;-1;0;0;0;-1;0;384971273;388651008;18842178
1276;8.58518e-15;-263;1656;21268;16101.2;1;548;-2.14748e+09;-4.81304e+06;-1;0;0;0;-1;0;385162862;388856398;18888380
1277;8.58518e-15;-263;1656;21268;16101.2;1;548;-2.14748e+09;-4.80133e+06;-1;0;0;0;-1;0;385353998;389061350;18934557
1278;8.58518e-15;-264;1656;21268;16101.2;1;548;-2.14748e+09;-4.78965e+06;0;0;0;0;0;0;385544684;389265865;18980708
1279;8.58518e-15;-265;1656;21268;16101.2;1;548;-2.14748e+09;-4.77802e+06;0;0;0;0;0;0;385734919;389469944;19026834
1280;8.58518e-15;-265;1656;21268;16101.2;1;548;-2.14748e+09;-4.76642e+06;-1;0;0;0;-1;0;385924707;389673589;19072933
1281;8.58518e-15;-265;1656;21268;16101.2;1;548;-2.14748e+09;-4.75486e+06;-1;0;0;0;-1;0;386114047;389876800;19119007
1282;8.58518e-15;-265;1656;21268;16101.2;1;548;-2.14748e+09;-4.74334e+06;-1;0;0;0;-1;0;386302942;390079580;19165055
1283;8.58518e-15;-265;1656;21268;16101.2;1;548;-2.14748e+09;-4.73186e+06;-1;0;0;0;-1;0;386491392;390281929;19211077
1284;8.58518e-15;-266;1656;21268;16101.2;1;548;-2.14748e+09;-4.72042e+06;0;0;0;0;0;0;386679399;390483849;19257072
1285;8.58518e-15;-266;1656;21268;16101.2;1;548;-2.14748e+09;-4.70901e+06;-1;0;0;0;-1;0;386866964;390685340;19303041
1286;8.58518e-15;-267;1656;21268;16101.2;1;548;-2.14748e+09;-4.69764e+06;0;0;0;0;0;0;387054089;390886405;19348982
1287;8.58518e-15;-267;1656;21268;16101.2;1;548;-2.14748e+09;-4.68631e+06;-1;0;0;0;-1;0;387240775;391087043;19394897
1288;8.58518e-15;-268;1656;21268;16101.2;1;548;-2.14748e+09;-4.67502e+06;0;0;0;0;0;0;387427022;391287257;19440784
1289;8.58518e-15;-268;1656;21268;16101.2;1;548;-2.14748e+09;-4.66377e+06;-1;0;0;0;-1;0;387612833;391487047;19486644
1290;8.58518e-15;-269;1656;21268;16101.2;1;548;-2.14748e+09;-4.65255e+06;0;0;0;0;0;0;387798209;391686415;19532477
1291;8.58518e-15;-269;1656;21268;16101.2;1;548;-2.14748e+09;-4.64137e+06;-1;0;0;0;-1;0;387983151;391885362;19578282
1292;8.58518e-15;-269;1656;21268;16101.2;1;548;-2.14748e+09;-4.63022e+06;-1;0;0;0;-1;0;388167660;392083889;19624059
1293;8.58518e-15;-270;1656;21268;16101.2;1;548;-2.14748e+09;-4.61912e+06;0;0;0;0;0;0;388351737;392281997;19669808
1294;8.58518e-15;-271;1656;21268;16101.2;1;548;-2.14748e+09;-4.60805e+06;0;0;0;0;0;0;388535384;392479688;19715529
1295;8.58518e-15;-271;1656;21268;16101.2;1;548;-2.14748e+09;-4.59701e+06;-1;0;0;0;-1;0;388718602;392676962;19761222
1296;8.58518e-15;-272;1656;21268;16101.2;1;548;-2.14748e+09;-4.58601e+06;0;0;0;0;0;0;388901393;392873821;19806886
1297;8.58518e-15;-272;1656;21268;16101.2;1;548;-2.14748e+09;-4.57505e+06;-1;0;0;0;-1;0;389083757;393070266;19852521
1298;8.58518e-15;-273;1656;21268;16101.2;1;548;-2.14748e+09;-4.56412e+06;0;0;0;0;0;0;389265695;393266298;19898128
1299;8.58518e-15;-274;1656;21268;16101.2;1;548;-2.14748e+09;-4.55323e+06;0;0;0;0;0;0;389447210;393461918;19943706
1300;8.58518e-15;-275;1656;21268;16101.2;1;548;-2.14748e+09;-4.54238e+06;0;0;0;0;0;0;389628301;393657127;19989254
1301;8.58518e-15;-275;1656;21268;16101.2;1;548;-2.14748e+09;-4.53156e+06;-1;0;0;0;-1;0;389808971;393851927;20034774
1302;8.58518e-15;-276;1656;21268;16101.2;1;548;-2.14748e+09;-4.52077e+06;0;0;0;0;0;0;389989221;394046318;20080263
1303;8.58518e-15;-276;1656;21268;16101.2;1;548;-2.14748e+09;-4.51002e+06;-1;0;0;0;-1;0;390169052;394240303;20125724
1304;8.58518e-15;-277;1656;21268;16101.2;1;548;-2.14748e+09;-4.4993e+06;0;0;0;0;0;0;390348464;394433880;20171154
1305;8.58518e-15;-277;1656;21268;16101.2;1;548;-2.14748e+09;-4.48862e+06;-1;0;0;0;-1;0;390527460;394627053;20216554
1306;8.58518e-15;-278;1656;21268;16101.2;1;548;-2.14748e+09;-4.47798e+06;0;0;0;0;0;0;390706040;394819822;20261925
1307;8.58518e-15;-278;1656;21268;16101.2;1;548;-2.14748e+09;-4.46736e+06;-1;0;0;0;-1;0;390884206;395012188;20307265
1308;8.58518e-15;-278;1656;21268;16101.2;1;548;-2.14748e+09;-4.45678e+06;-1;0;0;0;-1;0;391061959;395204152;20352575
1309;8.58518e-15;-279;1656;21268;16101.2;1;548;-2.14748e+09;-4.44624e+06;0;0;0;0;0;0;391239300;395395716;20397855
1310;8.58518e-15;-280;1656;21268;16101.2;1;548;-2.14748e+09;-4.43573e+06;0;0;0;0;0;0;391416230;395586880;20443103
1311;8.58518e-15;-281;1656;21268;16101.2;1;548;-2.14748e+09;-4.42525e+06;0;0;0;0;0;0;391592750;395777646;20488321
1312;8.58518e-15;-281;1656;21268;16101.2;1;548;-2.14748e+09;-4.41481e+06;-1;0;0;0;-1;0;391768862;395968014;20533508
1313;8.58518e-15;-282;1656;21268;16101.2;1;548;-2.14748e+09;-4.4044e+06;0;0;0;0;0;0;391944567;396157985;20578664
1314;8.58518e-15;-282;1656;21268;16101.2;1;548;-2.14748e+09;-4.39402e+06;-1;0;0;0;-1;0;392119866;396347562;20623789
1315;8.58518e-15;-282;1656;21268;16101.2;1;548;-2.14748e+09;-4.38368e+06;-1;0;0;0;-1;0;392294759;396536744;20668882
1316;8.58518e-15;-282;1656;21268;16101.2;1;548;-2.14748e+09;-4.37336e+06;-1;0;0;0;-1;0;392469249;396725534;20713944
1317;8.58518e-15;-283;1656;21268;16101.2;1;548;-2.14748e+09;-4.36308e+06;0;0;0;0;0;0;392643337;396913931;20758974
1318;8.58518e-15;-284;1656;21268;16101.2;1;548;-2.14748e+09;-4.35284e+06;0;0;0;0;0;0;392817023;397101937;20803972
1319;8.58518e-15;-285;1656;21268;16101.2;1;548;-2.14748e+09;-4.34262e+06;0;0;0;0;0;0;392990308;397289553;20848939
1320;8.58518e-15;-286;1656;21268;16101.2;1;548;-2.14748e+09;-4.33244e+06;0;0;0;0;0;0;393163194;397476781;20893873
1321;8.58518e-15;-286;1656;21268;16101.2;1;548;-2.14748e+09;-4.32229e+06;-1;0;0;0;-1;0;393335683;397663620;20938775
1322;8.58518e-15;-287;1656;21268;16101.2;1;548;-2.14748e+09;-4.31218e+06;0;0;0;0;0;0;393507774;397850073;20983645
1323;8.58518e-15;-288;1656;21268;16101.2;1;548;-2.14748e+09;-4.30209e+06;0;0;0;0;0;0;393679469;398036140;21028482
1324;8.58518e-15;-288;1656;21268;16101.2;1;548;-2.14748e+09;-4.29204e+06;-1;0;0;0;-1;0;393850770;398221823;21073287
1325;8.58518e-15;-288;1656;21268;16101.2;1;548;-2.14748e+09;-4.28201e+06;-1;0;0;0;-1;0;394021677;398407121;21118059
1326;8.58518e-15;-288;1656;21268;16101.2;1;548;-2.14748e+09;-4.27202e+06;-1;0;0;0;-1;0;394192192;398592037;21162798
1327;8.58518e-15;-289;1656;21268;16101.2;1;548;-2.14748e+09;-4.26206e+06;0;0;0;0;0;0;394362315;398776571;21207504
1328;8.58518e-15;-289;1656;21268;16101.2;1;548;-2.14748e+09;-4.25213e+06;-1;0;0;0;-1;0;394532048;398960725;21252178
1329;8.58518e-15;-289;1656;21268;16101.2;1;548;-2.14748e+09;-4.24224e+06;-1;0;0;0;-1;0;394701392;399144499;21296817
1330;8.58518e-15;-289;1656;21268;16101.2;1;548;-2.14748e+09;-4.23237e+06;-1;0;0;0;-1;0;394870348;399327894;21341424
1331;8.58518e-15;-290;1656;21268;16101.2;1;548;-2.14748e+09;-4.22253e+06;0;0;0;0;0;0;395038917;399510912;21385997
1332;8.58518e-15;-291;1656;21268;16101.2;1;548;-2.14748e+09;-4.21272e+06;0;0;0;0;0;0;395207100;399693553;21430536
1333;8.58518e-15;-292;1656;21268;16101.2;1;548;-2.14748e+09;-4.20295e+06;0;0;0;0;0;0;395374899;399875819;21475041
1334;8.58518e-15;-293;1656;21268;16101.2;1;548;-2.14748e+09;-4.1932e+06;0;0;0;0;0;0;395542313;400057709;21519513
1335;8.58518e-15;-294;1656;21268;16101.2;1;548;-2.14748e+09;-4.18349e+06;0;0;0;0;0;0;395709345;400239227;21563951
1336;8.58518e-15;-294;1656;21268;16101.2;1;548;-2.14748e+09;-4.1738e+06;-1;0;0;0;-1;0;395875996;400420371;21608354
1337;8.58518e-15;-295;1656;21268;16101.2;1;548;-2.14748e+09;-4.16415e+06;0;0;0;0;0;0;396042265;400601144;21652724
1338;8.58518e-15;-296;1656;21268;16101.2;1;548;-2.14748e+09;-4.15452e+06;0;0;0;0;0;0;396208156;400781546;21697059
1339;8.58518e-15;-296;1656;21268;16101.2;1;548;-2.14748e+09;-4.14492e+06;-1;0;0;0;-1;0;396373668;400961579;21741359
1340;8.58518e-15;-296;1656;21268;16101.2;1;548;-2.14748e+09;-4.13536e+06;-1;0;0;0;-1;0;396538803;401141242;21785625
1341;8.58518e-15;-296;1656;21268;16101.2;1;548;-2.14748e+09;-4.12582e+06;-1;0;0;0;-1;0;396703561;401320538;21829856
1342;8.58518e-15;-296;1656;21268;16101.2;1;548;-2.14748e+09;-4.11631e+06;-1;0;0;0;-1;0;396867944;401499467;21874053
1343;8.58518e-15;-296;1656;21268;16101.2;1;548;-2.14748e+09;-4.10683e+06;-1;0;0;0;-1;0;397031954;401678030;21918214
1344;8.58518e-15;-296;1656;21268;16101.2;1;548;-2.14748e+09;-4.09738e+06;-1;0;0;0;-1;0;397195590;401856229;21962340
1345;8.58518e-15;-297;1656;21268;16101.2;1;548;-2.14748e+09;-4.08796e+06;0;0;0;0;0;0;397358853;402034063;22006432
1346;8.58518e-15;-298;1656;21268;16101.2;1;548;-2.14748e+09;-4.07857e+06;0;0;0;0;0;0;397521746;402211534;22050488
1347;8.58518e-15;-299;1656;21268;16101.2;1;548;-2.14748e+09;-4.0692e+06;0;0;0;0;0;0;397684269;402388643;22094508
1348;8.58518e-15;-299;1656;21268;16101.2;1;548;-2.14748e+09;-4.05987e+06;-1;0;0;0;-1;0;397846423;402565391;22138493
1349;8.58518e-15;-300;1656;21268;16101.2;1;548;-2.14748e+09;-4.05056e+06;0;0;0;0;0;0;398008209;402741779;22182443
1350;8.58518e-15;-301;1656;21268;16101.2;1;548;-2.14748e+09;-4.04128e+06;0;0;0;0;0;0;398169628;402917808;22226356
1351;8.58518e-15;-302;1656;21268;16101.2;1;548;-2.14748e+09;-4.03203e+06;0;0;0;0;0;0;398330681;403093478;22270234
1352;8.58518e-15;-302;1656;21268;16101.2;1;548;-2.14748e+09;-4.02281e+06;-1;0;0;0;-1;0;398491369;403268791;22314076
1353;8.58518e-15;-302;1656;21268;16101.2;1;548;-2.14748e+09;-4.01361e+06;-1;0;0;0;-1;0;398651693;403443747;22357882
1354;8.58518e-15;-302;1656;21268;16101.2;1;548;-2.14748e+09;-4.00444e+06;-1;0;0;0;-1;0;398811654;403618348;22401652
1355;8.58518e-15;-303;1656;21268;16101.2;1;548;-2.14748e+09;-3.9953e+06;0;0;0;0;0;0;398971253;403792594;22445386
1356;8.58518e-15;-303;1656;21268;16101.2;1;548;-2.14748e+09;-3.98619e+06;-1;0;0;0;-1;0;399130491;403966486;22489083
1357;8.58518e-15;-303;1656;21268;16101.2;1;548;-2.14748e+09;-3.9771e+06;-1;0;0;0;-1;0;399289370;404140026;22532744
1358;8.58518e-15;-304;1656;21268;16101.2;1;548;-2.14748e+09;-3.96805e+06;0;0;0;0;0;0;399447889;404313214;22576368
1359;8.58518e-15;-304;1656;21268;16101.2;1;548;-2.14748e+09;-3.95902e+06;-1;0;0;0;-1;0;399606050;404486050;22619956
1360;8.58518e-15;-305;1656;21268;16101.2;1;548;-2.14748e+09;-3.95001e+06;0;0;0;0;0;0;399763855;404658537;22663507
1361;8.58518e-15;-305;1656;21268;16101.2;1;548;-2.14748e+09;-3.94103e+06;-1;0;0;0;-1;0;399921303;404830674;22707021
1362;8.58518e-15;-306;1656;21268;16101.2;1;548;-2.14748e+09;-3.93208e+06;0;0;0;0;0;0;400078397;405002463;22750498
1363;8.58518e-15;-307;1656;21268;16101.2;1;548;-2.14748e+09;-3.92316e+06;0;0;0;0;0;0;400235136;405173904;22793938
1364;8.58518e-15;-308;1656;21268;16101.2;1;548;-2.14748e+09;-3.91426e+06;0;0;0;0;0;0;400391522;405344999;22837341
1365;8.58518e-15;-308;1656;21268;16101.2;1;548;-2.14748e+09;-3.90539e+06;-1;0;0;0;-1;0;400547556;405515748;22880707
1366;8.58518e-15;-308;1656;21268;16101.2;1;548;-2.14748e+09;-3.89655e+06;-1;0;0;0;-1;0;400703239;405686152;22924036
1367;8.58518e-15;-309;1656;21268;16101.2;1;548;-2.14748e+09;-3.88773e+06;0;0;0;0;0;0;400858572;405856213;22967327
1368;8.58518e-15;-310;1656;21268;16101.2;1;548;-2.14748e+09;-3.87893e+06;0;0;0;0;0;0;401013555;406025930;23010580
1369;8.58518e-15;-310;1656;21268;16101.2;1;548;-2.14748e+09;-3.87017e+06;-1;0;0;0;-1;0;401168190;406195305;23053796
1370;8.58518e-15;-311;1656;21268;16101.2;1;548;-2.14748e+09;-3.86143e+06;0;0;0;0;0;0;401322478;406364339;23096974
1371;8.58518e-15;-311;1656;21268;16101.2;1;548;-2.14748e+09;-3.85271e+06;-1;0;0;0;-1;0;401476419;406533032;23140115
1372;8.58518e-15;-312;1656;21268;16101.2;1;548;-2.14748e+09;-3.84402e+06;0;0;0;0;0;0;401630015;406701386;23183217
1373;8.58518e-15;-312;1656;21268;16101.2;1;548;-2.14748e+09;-3.83536e+06;-1;0;0;0;-1;0;401783267;406869401;23226282
1374;8.58518e-15;-312;1656;21268;16101.2;1;548;-2.14748e+09;-3.82672e+06;-1;0;0;0;-1;0;401936174;407037078;23269309
1375;8.58518e-15;-313;1656;21268;16101.2;1;548;-2.14748e+09;-3.81811e+06;0;0;0;0;0;0;402088739;407204418;23312297
1376;8.58518e-15;-314;1656;21268;16101.2;1;548;-2.14748e+09;-3.80952e+06;0;0;0;0;0;0;402240963;407371421;23355247
1377;8.58518e-15;-314;1656;21268;16101.2;1;548;-2.14748e+09;-3.80096e+06;-1;0;0;0;-1;0;402392845;407538090;23398159
1378;8.58518e-15;-315;1656;21268;16101.2;1;548;-2.14748e+09;-3.79242e+06;0;0;0;0;0;0;402544388;407704424;23441033
1379;8.58518e-15;-316;1656;21268;16101.2;1;548;-2.14748e+09;-3.7839e+06;0;0;0;0;0;0;402695591;407870424;23483868
1380;8.58518e-15;-316;1656;21268;16101.2;1;548;-2.14748e+09;-3.77542e+06;-1;0;0;0;-1;0;402846457;408036091;23526664
1381;8.58518e-15;-316;1656;21268;16101.2;1;548;-2.14748e+09;-3.76695e+06;-1;0;0;0;-1;0;402996985;408201426;23569422
1382;8.58518e-15;-316;1656;21268;16101.2;1;548;-2.14748e+09;-3.75851e+06;-1;0;0;0;-1;0;403147177;408366431;23612141
1383;8.58518e-15;-316;1656;21268;16101.2;1;548;-2.14748e+09;-3.7501e+06;-1;0;0;0;-1;0;403297034;408531104;23654822
1384;8.58518e-15;-317;1656;21268;16101.2;1;548;-2.14748e+09;-3.74171e+06;0;0;0;0;0;0;403446556;408695448;23697463
1385;8.58518e-15;-318;1656;21268;16101.2;1;548;-2.14748e+09;-3.73334e+06;0;0;0;0;0;0;403595745;408859464;23740065
1386;8.58518e-15;-318;1656;21268;16101.2;1;548;-2.14748e+09;-3.725e+06;-1;0;0;0;-1;0;403744601;409023151;23782629
1387;8.58518e-15;-319;1656;21268;16101.2;1;548;-2.14748e+09;-3.71668e+06;0;0;0;0;0;0;403893125;409186512;23825153
1388;8.58518e-15;-319;1656;21268;16101.2;1;548;-2.14748e+09;-3.70839e+06;-1;0;0;0;-1;0;404041318;409349546;23867638
1389;8.58518e-15;-319;1656;21268;16101.2;1;548;-2.14748e+09;-3.70012e+06;-1;0;0;0;-1;0;404189181;409512255;23910084
1390;8.58518e-15;-319;1656;21268;16101.2;1;548;-2.14748e+09;-3.69187e+06;-1;0;0;0;-1;0;404336716;409674639;23952491
1391;8.58518e-15;-320;1656;21268;16101.2;1;548;-2.14748e+09;-3.68365e+06;0;0;0;0;0;0;404483922;409836699;23994858
1392;8.58518e-15;-321;1656;21268;16101.2;1;548;-2.14748e+09;-3.67545e+06;0;0;0;0;0;0;404630800;409998436;24037185
1393;8.58518e-15;-321;1656;21268;16101.2;1;548;-2.14748e+09;-3.66728e+06;-1;0;0;0;-1;0;404777352;410159850;24079473
1394;8.58518e-15;-322;1656;21268;16101.2;1;548;-2.14748e+09;-3.65912e+06;0;0;0;0;0;0;404923579;410320944;24121722
1395;8.58518e-15;-323;1656;21268;16101.2;1;548;-2.14748e+09;-3.651e+06;0;0;0;0;0;0;405069481;410481716;24163930
1396;8.58518e-15;-323;1656;21268;16101.2;1;548;-2.14748e+09;-3.64289e+06;-1;0;0;0;-1;0;405215059;410642169;24206099
1397;8.58518e-15;-323;1656;21268;16101.2;1;548;-2.14748e+09;-3.63481e+06;-1;0;0;0;-1;0;405360313;410802302;24248228
1398;8.58518e-15;-324;1656;21268;16101.2;1;548;-2.14748e+09;-3.62675e+06;0;0;0;0;0;0;405505246;410962117;24290317
1399;8.58518e-15;-324;1656;21268;16101.2;1;548;-2.14748e+09;-3.61871e+06;-1;0;0;0;-1;0;405649858;411121615;24332366
1400;8.58518e-15;-324;1656;21268;16101.2;1;548;-2.14748e+09;-3.6107e+06;-1;0;0;0;-1;0;405794149;411280795;24374376
1401;8.58518e-15;-324;1656;21268;16101.2;1;548;-2.14748e+09;-3.60271e+06;-1;0;0;0;-1;0;405938120;411439660;24416344
1402;8.58518e-15;-325;1656;21268;16101.2;1;548;-2.14748e+09;-3.59474e+06;0;0;0;0;0;0;406081772;411598210;24458273
1403;8.58518e-15;-325;1656;21268;16101.2;1;548;-2.14748e+09;-3.58679e+06;-1;0;0;0;-1;0;406225107;411756444;24500161
1404;8.58518e-15;-325;1656;21268;16101.2;1;548;-2.14748e+09;-3.57887e+06;-1;0;0;0;-1;0;406368125;411914366;24542010
1405;8.58518e-15;-326;1656;21268;16101.2;1;548;-2.14748e+09;-3.57097e+06;0;0;0;0;0;0;406510826;412071974;24583817
1406;8.58518e-15;-327;1656;21268;16101.2;1;548;-2.14748e+09;-3.56309e+06;0;0;0;0;0;0;406653212;412229270;24625584
1407;8.58518e-15;-327;1656;21268;16101.2;1;548;-2.14748e+09;-3.55523e+06;-1;0;0;0;-1;0;406795283;412386255;24667311
1408;8.58518e-15;-327;1656;21268;16101.2;1;548;-2.14748e+09;-3.5474e+06;-1;0;0;0;-1;0;406937041;412542929;24708997
1409;8.58518e-15;-328;1656;21268;16101.2;1;548;-2.14748e+09;-3.53959e+06;0;0;0;0;0;0;407078485;412699293;24750643
1410;8.58518e-15;-329;1656;21268;16101.2;1;548;-2.14748e+09;-3.5318e+06;0;0;0;0;0;0;407219618;412855348;24792247
1411;8.58518e-15;-329;1656;21268;16101.2;1;548;-2.14748e+09;-3.52403e+06;-1;0;0;0;-1;0;407360439;413011094;24833811
1412;8.58518e-15;-329;1656;21268;16101.2;1;548;-2.14748e+09;-3.51628e+06;-1;0;0;0;-1;0;407500950;413166533;24875334
1413;8.58518e-15;-330;1656;21268;16101.2;1;548;-2.14748e+09;-3.50856e+06;0;0;0;0;0;0;407641151;413321665;24916816
1414;8.58518e-15;-330;1656;21268;16101.2;1;548;-2.14748e+09;-3.50085e+06;-1;0;0;0;-1;0;407781044;413476490;24958258
1415;8.58518e-15;-331;1656;21268;16101.2;1;548;-2.14748e+09;-3.49317e+06;0;0;0;0;0;0;407920628;413631010;24999658
1416;8.58518e-15;-332;1656;21268;16101.2;1;548;-2.14748e+09;-3.48551e+06;0;0;0;0;0;0;408059905;413785226;25041017
1417;8.58518e-15;-332;1656;21268;16101.2;1;548;-2.14748e+09;-3.47787e+06;-1;0;0;0;-1;0;408198876;413939137;25082335
1418;8.58518e-15;-333;1656;21268;16101.2;1;548;-2.14748e+09;-3.47025e+06;0;0;0;0;0;0;408337541;414092745;25123612
1419;8.58518e-15;-333;1656;21268;16101.2;1;548;-2.14748e+09;-3.46265e+06;-1;0;0;0;-1;0;408475901;414246050;25164847
1420;8.58518e-15;-334;1656;21268;16101.2;1;548;-2.14748e+09;-3.45508e+06;0;0;0;0;0;0;408613957;414399054;25206042
1421;8.58518e-15;-334;1656;21268;16101.2;1;548;-2.14748e+09;-3.44752e+06;-1;0;0;0;-1;0;408751711;414551757;25247195
1422;8.58518e-15;-335;1656;21268;16101.2;1;548;-2.14748e+09;-3.43999e+06;0;0;0;0;0;0;408889161;414704159;25288306
1423;8.58518e-15;-335;1656;21268;16101.2;1;548;-2.14748e+09;-3.43248e+06;-1;0;0;0;-1;0;409026310;414856261;25329376
1424;8.58518e-15;-335;1656;21268;16101.2;1;548;-2.14748e+09;-3.42498e+06;-1;0;0;0;-1;0;409163158;415008065;25370405
1425;8.58518e-15;-335;1656;21268;16101.2;1;548;-2.14748e+09;-3.41751e+06;-1;0;0;0;-1;0;409299706;415159570;25411392
1426;8.58518e-15;-336;1656;21268;16101.2;1;548;-2.14748e+09;-3.41006e+06;0;0;0;0;0;0;409435955;415310778;25452337
1427;8.58518e-15;-337;1656;21268;16101.2;1;548;-2.14748e+09;-3.40263e+06;0;0;0;0;0;0;409571905;415461689;25493241
1428;8.58518e-15;-337;1656;21268;16101.2;1;548;-2.14748e+09;-3.39522e+06;-1;0;0;0;-1;0;409707558;415612303;25534103
1429;8.58518e-15;-338;1656;21268;16101.2;1;548;-2.14748e+09;-3.38783e+06;0;0;0;0;0;0;409842913;415762623;25574923
1430;8.58518e-15;-339;1656;21268;16101.2;1;548;-2.14748e+09;-3.38046e+06;0;0;0;0;0;0;409977973;415912647;25615701
1431;8.58518e-15;-339;1656;21268;16101.2;1;548;-2.14748e+09;-3.37311e+06;-1;0;0;0;-1;0;410112737;416062378;25656437
1432;8.58518e-15;-340;1656;21268;16101.2;1;548;-2.14748e+09;-3.36578e+06;0;0;0;0;0;0;410247206;416211815;25697132
1433;8.58518e-15;-341;1656;21268;16101.2;1;548;-2.14748e+09;-3.35847e+06;0;0;0;0;0;0;410381381;416360960;25737785
1434;8.58518e-15;-342;1656;21268;16101.2;1;548;-2.14748e+09;-3.35118e+06;0;0;0;0;0;0;410515263;416509812;25778395
1435;8.58518e-15;-342;1656;21268;16101.2;1;548;-2.14748e+09;-3.34391e+06;-1;0;0;0;-1;0;410648853;416658373;25818964
1436;8.58518e-15;-342;1656;21268;16101.2;1;548;-2.14748e+09;-3.33666e+06;-1;0;0;0;-1;0;410782151;416806644;25859490
1437;8.58518e-15;-343;1656;21268;16101.2;1;548;-2.14748e+09;-3.32943e+06;0;0;0;0;0;0;410915159;416954625;25899974
1438;8.58518e-15;-343;1656;21268;16101.2;1;548;-2.14748e+09;-3.32222e+06;-1;0;0;0;-1;0;411047876;417102317;25940416
1439;8.58518e-15;-344;1656;21268;16101.2;1;548;-2.14748e+09;-3.31503e+06;0;0;0;0;0;0;411180304;417249720;25980816
1440;8.58518e-15;-345;1656;21268;16101.2;1;548;-2.14748e+09;-3.30786e+06;0;0;0;0;0;0;411312443;417396835;26021174
1441;8.58518e-15;-345;1656;21268;16101.2;1;548;-2.14748e+09;-3.3007e+06;-1;0;0;0;-1;0;411444294;417543663;26061489
1442;8.58518e-15;-345;1656;21268;16101.2;1;548;-2.14748e+09;-3.29357e+06;-1;0;0;0;-1;0;411575858;417690204;26101762
1443;8.58518e-15;-346;1656;21268;16101.2;1;548;-2.14748e+09;-3.28646e+06;0;0;0;0;0;0;411707136;417836460;26141992
1444;8.58518e-15;-347;1656;21268;16101.2;1;548;-2.14748e+09;-3.27936e+06;0;0;0;0;0;0;411838128;417982431;26182180
1445;8.58518e-15;-347;1656;21268;16101.2;1;548;-2.14748e+09;-3.27229e+06;-1;0;0;0;-1;0;411968835;418128116;26222325
1446;8.58518e-15;-348;1656;21268;16101.2;1;548;-2.14748e+09;-3.26523e+06;0;0;0;0;0;0;412099258;418273519;26262428
1447;8.58518e-15;-348;1656;21268;16101.2;1;548;-2.14748e+09;-3.2582e+06;-1;0;0;0;-1;0;412229397;418418638;26302488
1448;8.58518e-15;-348;1656;21268;16101.2;1;548;-2.14748e+09;-3.25118e+06;-1;0;0;0;-1;0;412359254;418563474;26342506
1449;8.58518e-15;-349;1656;21268;16101.2;1;548;-2.14748e+09;-3.24418e+06;0;0;0;0;0;0;412488828;418708028;26382481
1450;8.58518e-15;-349;1656;21268;16101.2;1;548;-2.14748e+09;-3.2372e+06;-1;0;0;0;-1;0;412618121;418852302;26422414
1451;8.58518e-15;-349;1656;21268;16101.2;1;548;-2.14748e+09;-3.23024e+06;-1;0;0;0;-1;0;412747134;418996294;26462303
1452;8.58518e-15;-350;1656;21268;16101.2;1;548;-2.14748e+09;-3.22329e+06;0;0;0;0;0;0;412875867;419140007;26502150
1453;8.58518e-15;-351;1656;21268;16101.2;1;548;-2.14748e+09;-3.21637e+06;0;0;0;0;0;0;413004320;419283441;26541954
1454;8.58518e-15;-351;1656;21268;16101.2;1;548;-2.14748e+09;-3.20946e+06;-1;0;0;0;-1;0;413132495;419426595;26581715
1455;8.58518e-15;-352;1656;21268;16101.2;1;548;-2.14748e+09;-3.20257e+06;0;0;0;0;0;0;413260392;419569472;26621434
1456;8.58518e-15;-353;1656;21268;16101.2;1;548;-2.14748e+09;-3.1957e+06;0;0;0;0;0;0;413388013;419712072;26661109
1457;8.58518e-15;-353;1656;21268;16101.2;1;548;-2.14748e+09;-3.18885e+06;-1;0;0;0;-1;0;413515357;419854395;26700742
1458;8.58518e-15;-354;1656;21268;16101.2;1;548;-2.14748e+09;-3.18202e+06;0;0;0;0;0;0;413642425;419996442;26740331
1459;8.58518e-15;-355;1656;21268;16101.2;1;548;-2.14748e+09;-3.1752e+06;0;0;0;0;0;0;413769218;420138213;26779878
1460;8.58518e-15;-355;1656;21268;16101.2;1;548;-2.14748e+09;-3.16841e+06;-1;0;0;0;-1;0;413895737;420279709;26819381
1461;8.58518e-15;-356;1656;21268;16101.2;1;548;-2.14748e+09;-3.16163e+06;0;0;0;0;0;0;414021983;420420932;26858841
1462;8.58518e-15;-357;1656;21268;16101.2;1;548;-2.14748e+09;-3.15487e+06;0;0;0;0;0;0;414147955;420561880;26898259
1463;8.58518e-15;-358;1656;21268;16101.2;1;548;-2.14748e+09;-3.14812e+06;0;0;0;0;0;0;414273656;420702556;26937633
1464;8.58518e-15;-359;1656;21268;16101.2;1;548;-2.14748e+09;-3.1414e+06;0;0;0;0;0;0;414399085;420842960;26976964
1465;8.58518e-15;-360;1656;21268;16101.2;1;548;-2.14748e+09;-3.13469e+06;0;0;0;0;0;0;414524243;420983092;27016252
1466;8.58518e-15;-360;1656;21268;16101.2;1;548;-2.14748e+09;-3.128e+06;-1;0;0;0;-1;0;414649131;421122953;27055496
1467;8.58518e-15;-360;1656;21268;16101.2;1;548;-2.14748e+09;-3.12133e+06;-1;0;0;0;-1;0;414773750;421262544;27094697
1468;8.58518e-15;-361;1656;21268;16101.2;1;548;-2.14748e+09;-3.11468e+06;0;0;0;0;0;0;414898099;421401864;27133855
1469;8.58518e-15;-362;1656;21268;16101.2;1;548;-2.14748e+09;-3.10804e+06;0;0;0;0;0;0;415022181;421540916;27172970
1470;8.58518e-15;-363;1656;21268;16101.2;1;548;-2.14748e+09;-3.10142e+06;0;0;0;0;0;0;415145996;421679699;27212041
1471;8.58518e-15;-364;1656;21268;16101.2;1;548;-2.14748e+09;-3.09482e+06;0;0;0;0;0;0;415269543;421818214;27251069
1472;8.58518e-15;-364;1656;21268;16101.2;1;548;-2.14748e+09;-3.08823e+06;-1;0;0;0;-1;0;415392825;421956461;27290054
1473;8.58518e-15;-365;1656;21268;16101.2;1;548;-2.14748e+09;-3.08166e+06;0;0;0;0;0;0;415515841;422094442;27328995
1474;8.58518e-15;-366;1656;21268;16101.2;1;548;-2.14748e+09;-3.07511e+06;0;0;0;0;0;0;415638593;422232157;27367892
1475;8.58518e-15;-366;1656;21268;16101.2;1;548;-2.14748e+09;-3.06858e+06;-1;0;0;0;-1;0;415761080;422369606;27406746
1476;8.58518e-15;-366;1656;21268;16101.2;1;548;-2.14748e+09;-3.06206e+06;-1;0;0;0;-1;0;415883305;422506790;27445557
1477;8.58518e-15;-366;1656;21268;16101.2;1;548;-2.14748e+09;-3.05556e+06;-1;0;0;0;-1;0;416005266;422643710;27484324
1478;8.58518e-15;-367;1656;21268;16101.2;1;548;-2.14748e+09;-3.04908e+06;0;0;0;0;0;0;416126965;422780366;27523048
1479;8.58518e-15;-367;1656;21268;16101.2;1;548;-2.14748e+09;-3.04262e+06;-1;0;0;0;-1;0;416248403;422916759;27561728
1480;8.58518e-15;-368;1656;21268;16101.2;1;548;-2.14748e+09;-3.03617e+06;0;0;0;0;0;0;416369581;423052890;27600364
1481;8.58518e-15;-369;1656;21268;16101.2;1;548;-2.14748e+09;-3.02974e+06;0;0;0;0;0;0;416490498;423188758;27638957
1482;8.58518e-15;-369;1656;21268;16101.2;1;548;-2.14748e+09;-3.02332e+06;-1;0;0;0;-1;0;416611155;423324366;27677506
1483;8.58518e-15;-369;1656;21268;16101.2;1;548;-2.14748e+09;-3.01692e+06;-1;0;0;0;-1;0;416731554;423459712;27716011
1484;8.58518e-15;-369;1656;21268;16101.2;1;548;-2.14748e+09;-3.01054e+06;-1;0;0;0;-1;0;416851695;423594798;27754473
1485;8.58518e-15;-369;1656;21268;16101.2;1;548;-2.14748e+09;-3.00417e+06;-1;0;0;0;-1;0;416971578;423729625;27792891
1486;8.58518e-15;-370;1656;21268;16101.2;1;548;-2.14748e+09;-2.99782e+06;0;0;0;0;0;0;417091204;423864192;27831265
1487;8.58518e-15;-370;1656;21268;16101.2;1;548;-2.14748e+09;-2.99149e+06;-1;0;0;0;-1;0;417210574;423998501;27869596
1488;8.58518e-15;-370;1656;21268;16101.2;1;548;-2.14748e+09;-2.98518e+06;-1;0;0;0;-1;0;417329689;424132552;27907882
1489;8.58518e-15;-371;1656;21268;16101.2;1;548;-2.14748e+09;-2.97888e+06;0;0;0;0;0;0;417448548;424266346;27946125
1490;8.58518e-15;-371;1656;21268;16101.2;1;548;-2.14748e+09;-2.97259e+06;-1;0;0;0;-1;0;417567153;424399884;27984324
1491;8.58518e-15;-372;1656;21268;16101.2;1;548;-2.14748e+09;-2.96632e+06;0;0;0;0;0;0;417685505;424533165;28022480
1492;8.58518e-15;-372;1656;21268;16101.2;1;548;-2.14748e+09;-2.96007e+06;-1;0;0;0;-1;0;417803603;424666190;28060591
1493;8.58518e-15;-372;1656;21268;16101.2;1;548;-2.14748e+09;-2.95384e+06;-1;0;0;0;-1;0;417921449;424798961;28098659
1494;8.58518e-15;-372;1656;21268;16101.2;1;548;-2.14748e+09;-2.94762e+06;-1;0;0;0;-1;0;418039043;424931477;28136682
1495;8.58518e-15;-373;1656;21268;16101.2;1;548;-2.14748e+09;-2.94141e+06;0;0;0;0;0;0;418156386;425063739;28174662
1496;8.58518e-15;-373;1656;21268;16101.2;1;548;-2.14748e+09;-2.93522e+06;-1;0;0;0;-1;0;418273479;425195748;28212598
1497;8.58518e-15;-373;1656;21268;16101.2;1;548;-2.14748e+09;-2.92905e+06;-1;0;0;0;-1;0;418390321;425327505;28250490
1498;8.58518e-15;-373;1656;21268;16101.2;1;548;-2.14748e+09;-2.9229e+06;-1;0;0;0;-1;0;418506914;425459009;28288338
1499;8.58518e-15;-373;1656;21268;16101.2;1;548;-2.14748e+09;-2.91676e+06;-1;0;0;0;-1;0;418623259;425590261;28326142
1500;8.58518e-15;-374;1656;21268;16101.2;1;548;-2.14748e+09;-2.91063e+06;0;0;0;0;0;0;418739355;425721262;28363902
1501;8.58518e-15;-375;1656;21268;16101.2;1;548;-2.14748e+09;-2.90452e+06;0;0;0;0;0;0;418855204;425852013;28401618
1502;8.58518e-15;-376;1656;21268;16101.2;1;548;-2.14748e+09;-2.89843e+06;0;0;0;0;0;0;418970806;425982514;28439290
1503;8.58518e-15;-376;1656;21268;16101.2;1;548;-2.14748e+09;-2.89235e+06;-1;0;0;0;-1;0;419086162;426112766;28476918
1504;8.58518e-15;-377;1656;21268;16101.2;1;548;-2.14748e+09;-2.88629e+06;0;0;0;0;0;0;419201272;426242769;28514502
1505;8.58518e-15;-377;1656;21268;16101.2;1;548;-2.14748e+09;-2.88024e+06;-1;0;0;0;-1;0;419316137;426372523;28552042
1506;8.58518e-15;-378;1656;21268;16101.2;1;548;-2.14748e+09;-2.87421e+06;0;0;0;0;0;0;419430758;426502030;28589538
1507;8.58518e-15;-378;1656;21268;16101.2;1;548;-2.14748e+09;-2.86819e+06;-1;0;0;0;-1;0;419545134;426631290;28626989
1508;8.58518e-15;-378;1656;21268;16101.2;1;548;-2.14748e+09;-2.86219e+06;-1;0;0;0;-1;0;419659268;426760303;28664397
1509;8.58518e-15;-378;1656;21268;16101.2;1;548;-2.14748e+09;-2.8562e+06;-1;0;0;0;-1;0;419773159;426889069;28701761
1510;8.58518e-15;-379;1656;21268;16101.2;1;548;-2.14748e+09;-2.85023e+06;0;0;0;0;0;0;419886808;427017591;28739080
1511;8.58518e-15;-380;1656;21268;16101.2;1;548;-2.14748e+09;-2.84427e+06;0;0;0;0;0;0;420000215;427145867;28776355
1512;8.58518e-15;-381;1656;21268;16101.2;1;548;-2.14748e+09;-2.83833e+06;0;0;0;0;0;0;420113382;427273899;28813587
1513;8.58518e-15;-382;1656;21268;16101.2;1;548;-2.14748e+09;-2.8324e+06;0;0;0;0;0;0;420226308;427401687;28850774
1514;8.58518e-15;-382;1656;21268;16101.2;1;548;-2.14748e+09;-2.82649e+06;-1;0;0;0;-1;0;420338994;427529231;28887917
1515;8.58518e-15;-383;1656;21268;16101.2;1;548;-2.14748e+09;-2.8206e+06;0;0;0;0;0;0;420451442;427656533;28925015
1516;8.58518e-15;-383;1656;21268;16101.2;1;548;-2.14748e+09;-2.81472e+06;-1;0;0;0;-1;0;420563651;427783592;28962070
1517;8.58518e-15;-384;1656;21268;16101.2;1;548;-2.14748e+09;-2.80885e+06;0;0;0;0;0;0;420675622;427910409;28999081
1518;8.58518e-15;-384;1656;21268;16101.2;1;548;-2.14748e+09;-2.803e+06;-1;0;0;0;-1;0;420787355;428036985;29036047
1519;8.58518e-15;-385;1656;21268;16101.2;1;548;-2.14748e+09;-2.79716e+06;0;0;0;0;0;0;420898852;428163321;29072969
1520;8.58518e-15;-385;1656;21268;16101.2;1;548;-2.14748e+09;-2.79134e+06;-1;0;0;0;-1;0;421010113;428289416;29109847
1521;8.58518e-15;-385;1656;21268;16101.2;1;548;-2.14748e+09;-2.78553e+06;-1;0;0;0;-1;0;421121138;428415271;29146680
1522;8.58518e-15;-385;1656;21268;16101.2;1;548;-2.14748e+09;-2.77973e+06;-1;0;0;0;-1;0;421231928;428540887;29183470
1523;8.58518e-15;-386;1656;21268;16101.2;1;548;-2.14748e+09;-2.77395e+06;0;0;0;0;0;0;421342484;428666265;29220215
1524;8.58518e-15;-386;1656;21268;16101.2;1;548;-2.14748e+09;-2.76819e+06;-1;0;0;0;-1;0;421452805;428791404;29256916
1525;8.58518e-15;-387;1656;21268;16101.2;1;548;-2.14748e+09;-2.76244e+06;0;0;0;0;0;0;421562894;428916306;29293573
1526;8.58518e-15;-387;1656;21268;16101.2;1;548;-2.14748e+09;-2.7567e+06;-1;0;0;0;-1;0;421672750;429040971;29330186
1527;8.58518e-15;-388;1656;21268;16101.2;1;548;-2.14748e+09;-2.75098e+06;0;0;0;0;0;0;421782373;429165399;29366754
1528;8.58518e-15;-388;1656;21268;16101.2;1;548;-2.14748e+09;-2.74527e+06;-1;0;0;0;-1;0;421891765;429289591;29403278
1529;8.58518e-15;-389;1656;21268;16101.2;1;548;-2.14748e+09;-2.73958e+06;0;0;0;0;0;0;422000926;429413548;29439758
1530;8.58518e-15;-390;1656;21268;16101.2;1;548;-2.14748e+09;-2.7339e+06;0;0;0;0;0;0;422109856;429537269;29476193
1531;8.58518e-15;-391;1656;21268;16101.2;1;548;-2.14748e+09;-2.72823e+06;0;0;0;0;0;0;422218556;429660756;29512585
1532;8.58518e-15;-392;1656;21268;16101.2;1;548;-2.14748e+09;-2.72258e+06;0;0;0;0;0;0;422327027;429784009;29548932
1533;8.58518e-15;-393;1656;21268;16101.2;1;548;-2.14748e+09;-2.71694e+06;0;0;0;0;0;0;422435269;429907028;29585235
1534;8.58518e-15;-394;1656;21268;16101.2;1;548;-2.14748e+09;-2.71132e+06;0;0;0;0;0;0;422543283;430029814;29621493
1535;8.58518e-15;-394;1656;21268;16101.2;1;548;-2.14748e+09;-2.70571e+06;-1;0;0;0;-1;0;422651069;430152368;29657707
1536;8.58518e-15;-395;1656;21268;16101.2;1;548;-2.14748e+09;-2.70011e+06;0;0;0;0;0;0;422758628;430274690;29693877
1537;8.58518e-15;-395;1656;21268;16101.2;1;548;-2.14748e+09;-2.69453e+06;-1;0;0;0;-1;0;422865960;430396780;29730003
1538;8.58518e-15;-396;1656;21268;16101.2;1;548;-2.14748e+09;-2.68896e+06;0;0;0;0;0;0;422973066;430518639;29766085
1539;8.58518e-15;-397;1656;21268;16101.2;1;548;-2.14748e+09;-2.68341e+06;0;0;0;0;0;0;423079947;430640268;29802122
1540;8.58518e-15;-397;1656;21268;16101.2;1;548;-2.14748e+09;-2.67786e+06;-1;0;0;0;-1;0;423186602;430761666;29838115
1541;8.58518e-15;-397;1656;21268;16101.2;1;548;-2.14748e+09;-2.67234e+06;-1;0;0;0;-1;0;423293034;430882835;29874064
1542;8.58518e-15;-398;1656;21268;16101.2;1;548;-2.14748e+09;-2.66682e+06;0;0;0;0;0;0;423399241;431003776;29909968
1543;8.58518e-15;-398;1656;21268;16101.2;1;548;-2.14748e+09;-2.66132e+06;-1;0;0;0;-1;0;423505225;431124487;29945828
1544;8.58518e-15;-399;1656;21268;16101.2;1;548;-2.14748e+09;-2.65584e+06;0;0;0;0;0;0;423610986;431244970;29981644
1545;8.58518e-15;-399;1656;21268;16101.2;1;548;-2.14748e+09;-2.65036e+06;-1;0;0;0;-1;0;423716525;431365226;30017416
1546;8.58518e-15;-400;1656;21268;16101.2;1;548;-2.14748e+09;-2.6449e+06;0;0;0;0;0;0;423821842;431485255;30053143
1547;8.58518e-15;-401;1656;21268;16101.2;1;548;-2.14748e+09;-2.63946e+06;0;0;0;0;0;0;423926938;431605057;30088826
1548;8.58518e-15;-401;1656;21268;16101.2;1;548;-2.14748e+09;-2.63402e+06;-1;0;0;0;-1;0;424031813;431724633;30124465
1549;8.58518e-15;-401;1656;21268;16101.2;1;548;-2.14748e+09;-2.6286e+06;-1;0;0;0;-1;0;424136468;431843983;30160060
1550;8.58518e-15;-401;1656;21268;16101.2;1;548;-2.14748e+09;-2.62319e+06;-1;0;0;0;-1;0;424240903;431963109;30195610
1551;8.58518e-15;-402;1656;21268;16101.2;1;548;-2.14748e+09;-2.6178e+06;0;0;0;0;0;0;424345119;432082009;30231116
1552;8.58518e-15;-402;1656;21268;16101.2;1;548;-2.14748e+09;-2.61242e+06;-1;0;0;0;-1;0;424449117;432200685;30266578
1553;8.58518e-15;-402;1656;21268;16101.2;1;548;-2.14748e+09;-2.60705e+06;-1;0;0;0;-1;0;424552897;432319138;30301995
1554;8.58518e-15;-403;1656;21268;16101.2;1;548;-2.14748e+09;-2.6017e+06;0;0;0;0;0;0;424656459;432437367;30337369
1555;8.58518e-15;-404;1656;21268;16101.2;1;548;-2.14748e+09;-2.59636e+06;0;0;0;0;0;0;424759804;432555374;30372698
1556;8.58518e-15;-405;1656;21268;16101.2;1;548;-2.14748e+09;-2.59103e+06;0;0;0;0;0;0;424862932;432673158;30407983
1557;8.58518e-15;-406;1656;21268;16101.2;1;548;-2.14748e+09;-2.58571e+06;0;0;0;0;0;0;424965845;432790721;30443223
1558;8.58518e-15;-406;1656;21268;16101.2;1;548;-2.14748e+09;-2.58041e+06;-1;0;0;0;-1;0;425068542;432908062;30478420
1559;8.58518e-15;-406;1656;21268;16101.2;1;548;-2.14748e+09;-2.57512e+06;-1;0;0;0;-1;0;425171024;433025182;30513572
1560;8.58518e-15;-406;1656;21268;16101.2;1;548;-2.14748e+09;-2.56984e+06;-1;0;0;0;-1;0;425273291;433142082;30548680
1561;8.58518e-15;-407;1656;21268;16101.2;1;548;-2.14748e+09;-2.56458e+06;0;0;0;0;0;0;425375345;433258762;30583744
1562;8.58518e-15;-408;1656;21268;16101.2;1;548;-2.14748e+09;-2.55932e+06;0;0;0;0;0;0;425477185;433375222;30618763
1563;8.58518e-15;-408;1656;21268;16101.2;1;548;-2.14748e+09;-2.55408e+06;-1;0;0;0;-1;0;425578813;433491464;30653739
1564;8.58518e-15;-409;1656;21268;16101.2;1;548;-2.14748e+09;-2.54886e+06;0;0;0;0;0;0;425680228;433607487;30688670
1565;8.58518e-15;-409;1656;21268;16101.2;1;548;-2.14748e+09;-2.54364e+06;-1;0;0;0;-1;0;425781431;433723292;30723557
1566;8.58518e-15;-409;1656;21268;16101.2;1;548;-2.14748e+09;-2.53844e+06;-1;0;0;0;-1;0;425882423;433838879;30758400
1567;8.58518e-15;-409;1656;21268;16101.2;1;548;-2.14748e+09;-2.53325e+06;-1;0;0;0;-1;0;425983204;433954249;30793199
1568;8.58518e-15;-410;1656;21268;16101.2;1;548;-2.14748e+09;-2.52808e+06;0;0;0;0;0;0;426083774;434069402;30827953
1569;8.58518e-15;-410;1656;21268;16101.2;1;548;-2.14748e+09;-2.52291e+06;-1;0;0;0;-1;0;426184134;434184339;30862664
1570;8.58518e-15;-410;1656;21268;16101.2;1;548;-2.14748e+09;-2.51776e+06;-1;0;0;0;-1;0;426284286;434299060;30897330
1571;8.58518e-15;-411;1656;21268;16101.2;1;548;-2.14748e+09;-2.51262e+06;0;0;0;0;0;0;426384228;434413566;30931952
1572;8.58518e-15;-412;1656;21268;16101.2;1;548;-2.14748e+09;-2.5075e+06;0;0;0;0;0;0;426483962;434527857;30966530
1573;8.58518e-15;-413;1656;21268;16101.2;1;548;-2.14748e+09;-2.50238e+06;0;0;0;0;0;0;426583488;434641934;31001064
1574;8.58518e-15;-414;1656;21268;16101.2;1;548;-2.14748e+09;-2.49728e+06;0;0;0;0;0;0;426682806;434755796;31035554
1575;8.58518e-15;-414;1656;21268;16101.2;1;548;-2.14748e+09;-2.49219e+06;-1;0;0;0;-1;0;426781918;434869445;31070000
1576;8.58518e-15;-414;1656;21268;16101.2;1;548;-2.14748e+09;-2.48711e+06;-1;0;0;0;-1;0;426880823;434982881;31104401
1577;8.58518e-15;-414;1656;21268;16101.2;1;548;-2.14748e+09;-2.48204e+06;-1;0;0;0;-1;0;426979522;435096104;31138759
1578;8.58518e-15;-414;1656;21268;16101.2;1;548;-2.14748e+09;-2.47699e+06;-1;0;0;0;-1;0;427078016;435209115;31173072
1579;8.58518e-15;-415;1656;21268;16101.2;1;548;-2.14748e+09;-2.47195e+06;0;0;0;0;0;0;427176305;435321915;31207342
1580;8.58518e-15;-415;1656;21268;16101.2;1;548;-2.14748e+09;-2.46692e+06;-1;0;0;0;-1;0;427274389;435434503;31241567
1581;8.58518e-15;-415;1656;21268;16101.2;1;548;-2.14748e+09;-2.4619e+06;-1;0;0;0;-1;0;427372269;435546880;31275748
1582;8.58518e-15;-416;1656;21268;16101.2;1;548;-2.14748e+09;-2.45689e+06;0;0;0;0;0;0;427469946;435659046;31309886
1583;8.58518e-15;-416;1656;21268;16101.2;1;548;-2.14748e+09;-2.4519e+06;-1;0;0;0;-1;0;427567419;435771003;31343979
1584;8.58518e-15;-417;1656;21268;16101.2;1;548;-2.14748e+09;-2.44692e+06;0;0;0;0;0;0;427664690;435882750;31378029
1585;8.58518e-15;-417;1656;21268;16101.2;1;548;-2.14748e+09;-2.44194e+06;-1;0;0;0;-1;0;427761759;435994288;31412034
1586;8.58518e-15;-418;1656;21268;16101.2;1;548;-2.14748e+09;-2.43699e+06;0;0;0;0;0;0;427858627;436105618;31445995
1587;8.58518e-15;-418;1656;21268;16101.2;1;548;-2.14748e+09;-2.43204e+06;-1;0;0;0;-1;0;427955293;436216739;31479913
1588;8.58518e-15;-419;1656;21268;16101.2;1;548;-2.14748e+09;-2.4271e+06;0;0;0;0;0;0;428051759;436327652;31513786
1589;8.58518e-15;-420;1656;21268;16101.2;1;548;-2.14748e+09;-2.42218e+06;0;0;0;0;0;0;428148024;436438358;31547616
1590;8.58518e-15;-420;1656;21268;16101.2;1;548;-2.14748e+09;-2.41727e+06;-1;0;0;0;-1;0;428244090;436548857;31581402
1591;8.58518e-15;-420;1656;21268;16101.2;1;548;-2.14748e+09;-2.41237e+06;-1;0;0;0;-1;0;428339956;436659149;31615143
1592;8.58518e-15;-421;1656;21268;16101.2;1;548;-2.14748e+09;-2.40748e+06;0;0;0;0;0;0;428435623;436769235;31648841
1593;8.58518e-15;-422;1656;21268;16101.2;1;548;-2.14748e+09;-2.4026e+06;0;0;0;0;0;0;428531093;436879116;31682495
1594;8.58518e-15;-422;1656;21268;16101.2;1;548;-2.14748e+09;-2.39774e+06;-1;0;0;0;-1;0;428626364;436988791;31716105
1595;8.58518e-15;-423;1656;21268;16101.2;1;548;-2.14748e+09;-2.39288e+06;0;0;0;0;0;0;428721438;437098262;31749672
1596;8.58518e-15;-424;1656;21268;16101.2;1;548;-2.14748e+09;-2.38804e+06;0;0;0;0;0;0;428816315;437207528;31783194
1597;8.58518e-15;-425;1656;21268;16101.2;1;548;-2.14748e+09;-2.38321e+06;0;0;0;0;0;0;428910995;437316590;31816673
1598;8.58518e-15;-425;1656;21268;16101.2;1;548;-2.14748e+09;-2.37838e+06;-1;0;0;0;-1;0;429005480;437425449;31850108
1599;8.58518e-15;-425;1656;21268;16101.2;1;548;-2.14748e+09;-2.37358e+06;-1;0;0;0;-1;0;429099769;437534105;31883499
1600;8.58518e-15;-425;1656;21268;16101.2;1;548;-2.14748e+09;-2.36878e+06;-1;0;0;0;-1;0;429193863;437642557;31916846
1601;8.58518e-15;-426;1656;21268;16101.2;1;548;-2.14748e+09;-2.36399e+06;0;0;0;0;0;0;429287762;437750808;31950150
1602;8.58518e-15;-427;1656;21268;16101.2;1;548;-2.14748e+09;-2.35922e+06;0;0;0;0;0;0;429381467;437858857;31983409
1603;8.58518e-15;-428;1656;21268;16101.2;1;548;-2.14748e+09;-2.35445e+06;0;0;0;0;0;0;429474978;437966704;32016626
1604;8.58518e-15;-429;1656;21268;16101.2;1;548;-2.14748e+09;-2.3497e+06;0;0;0;0;0;0;429568296;438074350;32049798
1605;8.58518e-15;-430;1656;21268;16101.2;1;548;-2.14748e+09;-2.34496e+06;0;0;0;0;0;0;429661421;438181796;32082927
1606;8.58518e-15;-430;1656;21268;16101.2;1;548;-2.14748e+09;-2.34023e+06;-1;0;0;0;-1;0;429754354;438289041;32116012
1607;8.58518e-15;-431;1656;21268;16101.2;1;548;-2.14748e+09;-2.33551e+06;0;0;0;0;0;0;429847095;438396087;32149053
1608;8.58518e-15;-432;1656;21268;16101.2;1;548;-2.14748e+09;-2.3308e+06;0;0;0;0;0;0;429939644;438502933;32182051
1609;8.58518e-15;-433;1656;21268;16101.2;1;548;-2.14748e+09;-2.3261e+06;0;0;0;0;0;0;430032002;438609580;32215005
1610;8.58518e-15;-434;1656;21268;16101.2;1;548;-2.14748e+09;-2.32141e+06;0;0;0;0;0;0;430124170;438716028;32247916
1611;8.58518e-15;-435;1656;21268;16101.2;1;548;-2.14748e+09;-2.31674e+06;0;0;0;0;0;0;430216148;438822279;32280783
1612;8.58518e-15;-435;1656;21268;16101.2;1;548;-2.14748e+09;-2.31207e+06;-1;0;0;0;-1;0;430307935;438928332;32313606
1613;8.58518e-15;-435;1656;21268;16101.2;1;548;-2.14748e+09;-2.30742e+06;-1;0;0;0;-1;0;430399534;439034187;32346386
1614;8.58518e-15;-435;1656;21268;16101.2;1;548;-2.14748e+09;-2.30277e+06;-1;0;0;0;-1;0;430490943;439139845;32379122
1615;8.58518e-15;-435;1656;21268;16101.2;1;548;-2.14748e+09;-2.29814e+06;-1;0;0;0;-1;0;430582165;439245307;32411815
1616;8.58518e-15;-435;1656;21268;16101.2;1;548;-2.14748e+09;-2.29352e+06;-1;0;0;0;-1;0;430673198;439350573;32444464
1617;8.58518e-15;-436;1656;21268;16101.2;1;548;-2.14748e+09;-2.28891e+06;0;0;0;0;0;0;430764044;439455643;32477070
1618;8.58518e-15;-436;1656;21268;16101.2;1;548;-2.14748e+09;-2.28431e+06;-1;0;0;0;-1;0;430854702;439560517;32509633
1619;8.58518e-15;-437;1656;21268;16101.2;1;548;-2.14748e+09;-2.27972e+06;0;0;0;0;0;0;430945174;439665197;32542152
1620;8.58518e-15;-438;1656;21268;16101.2;1;548;-2.14748e+09;-2.27514e+06;0;0;0;0;0;0;431035460;439769682;32574627
1621;8.58518e-15;-439;1656;21268;16101.2;1;548;-2.14748e+09;-2.27057e+06;0;0;0;0;0;0;431125560;439873973;32607059
1622;8.58518e-15;-439;1656;21268;16101.2;1;548;-2.14748e+09;-2.26601e+06;-1;0;0;0;-1;0;431215475;439978071;32639448
1623;8.58518e-15;-439;1656;21268;16101.2;1;548;-2.14748e+09;-2.26146e+06;-1;0;0;0;-1;0;431305204;440081974;32671794
1624;8.58518e-15;-440;1656;21268;16101.2;1;548;-2.14748e+09;-2.25692e+06;0;0;0;0;0;0;431394749;440185685;32704096
1625;8.58518e-15;-441;1656;21268;16101.2;1;548;-2.14748e+09;-2.2524e+06;0;0;0;0;0;0;431484110;440289204;32736355
1626;8.58518e-15;-441;1656;21268;16101.2;1;548;-2.14748e+09;-2.24788e+06;-1;0;0;0;-1;0;431573288;440392530;32768570
1627;8.58518e-15;-441;1656;21268;16101.2;1;548;-2.14748e+09;-2.24337e+06;-1;0;0;0;-1;0;431662282;440495664;32800743
1628;8.58518e-15;-441;1656;21268;16101.2;1;548;-2.14748e+09;-2.23888e+06;-1;0;0;0;-1;0;431751093;440598607;32832872
1629;8.58518e-15;-442;1656;21268;16101.2;1;548;-2.14748e+09;-2.23439e+06;0;0;0;0;0;0;431839722;440701359;32864958
1630;8.58518e-15;-442;1656;21268;16101.2;1;548;-2.14748e+09;-2.22992e+06;-1;0;0;0;-1;0;431928169;440803921;32897000
1631;8.58518e-15;-443;1656;21268;16101.2;1;548;-2.14748e+09;-2.22545e+06;0;0;0;0;0;0;432016434;440906292;32929000
1632;8.58518e-15;-443;1656;21268;16101.2;1;548;-2.14748e+09;-2.221e+06;-1;0;0;0;-1;0;432104518;441008473;32960956
1633;8.58518e-15;-444;1656;21268;16101.2;1;548;-2.14748e+09;-2.21655e+06;0;0;0;0;0;0;432192422;441110465;32992869
1634;8.58518e-15;-444;1656;21268;16101.2;1;548;-2.14748e+09;-2.21212e+06;-1;0;0;0;-1;0;432280145;441212268;33024740
1635;8.58518e-15;-445;1656;21268;16101.2;1;548;-2.14748e+09;-2.2077e+06;0;0;0;0;0;0;432367688;441313882;33056567
1636;8.58518e-15;-446;1656;21268;16101.2;1;548;-2.14748e+09;-2.20328e+06;0;0;0;0;0;0;432455052;441415307;33088351
1637;8.58518e-15;-446;1656;21268;16101.2;1;548;-2.14748e+09;-2.19888e+06;-1;0;0;0;-1;0;432542236;441516545;33120091
1638;8.58518e-15;-447;1656;21268;16101.2;1;548;-2.14748e+09;-2.19448e+06;0;0;0;0;0;0;432629242;441617595;33151789
1639;8.58518e-15;-448;1656;21268;16101.2;1;548;-2.14748e+09;-2.1901e+06;0;0;0;0;0;0;432716070;441718458;33183444
1640;8.58518e-15;-448;1656;21268;16101.2;1;548;-2.14748e+09;-2.18572e+06;-1;0;0;0;-1;0;432802720;441819135;33215056
1641;8.58518e-15;-449;1656;21268;16101.2;1;548;-2.14748e+09;-2.18136e+06;0;0;0;0;0;0;432889192;441919625;33246625
1642;8.58518e-15;-450;1656;21268;16101.2;1;548;-2.14748e+09;-2.17701e+06;0;0;0;0;0;0;432975488;442019928;33278151
1643;8.58518e-15;-450;1656;21268;16101.2;1;548;-2.14748e+09;-2.17266e+06;-1;0;0;0;-1;0;433061607;442120047;33309634
1644;8.58518e-15;-451;1656;21268;16101.2;1;548;-2.14748e+09;-2.16833e+06;0;0;0;0;0;0;433147549;442219979;33341075
1645;8.58518e-15;-451;1656;21268;16101.2;1;548;-2.14748e+09;-2.164e+06;-1;0;0;0;-1;0;433233316;442319727;33372472
1646;8.58518e-15;-451;1656;21268;16101.2;1;548;-2.14748e+09;-2.15969e+06;-1;0;0;0;-1;0;433318907;442419291;33403827
1647;8.58518e-15;-452;1656;21268;16101.2;1;548;-2.14748e+09;-2.15538e+06;0;0;0;0;0;0;433404324;442518670;33435139
1648;8.58518e-15;-452;1656;21268;16101.2;1;548;-2.14748e+09;-2.15109e+06;-1;0;0;0;-1;0;433489565;442617865;33466408
1649;8.58518e-15;-452;1656;21268;16101.2;1;548;-2.14748e+09;-2.1468e+06;-1;0;0;0;-1;0;433574633;442716877;33497634
1650;8.58518e-15;-452;1656;21268;16101.2;1;548;-2.14748e+09;-2.14253e+06;-1;0;0;0;-1;0;433659527;442815706;33528818
1651;8.58518e-15;-452;1656;21268;16101.2;1;548;-2.14748e+09;-2.13826e+06;-1;0;0;0;-1;0;433744247;442914352;33559959
1652;8.58518e-15;-452;1656;21268;16101.2;1;548;-2.14748e+09;-2.13401e+06;-1;0;0;0;-1;0;433828794;443012816;33591057
1653;8.58518e-15;-453;1656;21268;16101.2;1;548;-2.14748e+09;-2.12976e+06;0;0;0;0;0;0;433913168;443111098;33622112
1654;8.58518e-15;-453;1656;21268;16101.2;1;548;-2.14748e+09;-2.12552e+06;-1;0;0;0;-1;0;433997371;443209198;33653125
1655;8.58518e-15;-453;1656;21268;16101.2;1;548;-2.14748e+09;-2.1213e+06;-1;0;0;0;-1;0;434081401;443307117;33684096
1656;8.58518e-15;-454;1656;21268;16101.2;1;548;-2.14748e+09;-2.11708e+06;0;0;0;0;0;0;434165260;443404855;33715023
1657;8.58518e-15;-454;1656;21268;16101.2;1;548;-2.14748e+09;-2.11287e+06;-1;0;0;0;-1;0;434248948;443502413;33745909
1658;8.58518e-15;-454;1656;21268;16101.2;1;548;-2.14748e+09;-2.10867e+06;-1;0;0;0;-1;0;434332466;443599791;33776751
1659;8.58518e-15;-454;1656;21268;16101.2;1;548;-2.14748e+09;-2.10448e+06;-1;0;0;0;-1;0;434415813;443696988;33807552
1660;8.58518e-15;-455;1656;21268;16101.2;1;548;-2.14748e+09;-2.1003e+06;0;0;0;0;0;0;434498990;443794007;33838309
1661;8.58518e-15;-456;1656;21268;16101.2;1;548;-2.14748e+09;-2.09613e+06;0;0;0;0;0;0;434581997;443890846;33869025
1662;8.58518e-15;-457;1656;21268;16101.2;1;548;-2.14748e+09;-2.09197e+06;0;0;0;0;0;0;434664835;443987506;33899698
1663;8.58518e-15;-458;1656;21268;16101.2;1;548;-2.14748e+09;-2.08782e+06;0;0;0;0;0;0;434747505;444083988;33930328
1664;8.58518e-15;-458;1656;21268;16101.2;1;548;-2.14748e+09;-2.08367e+06;-1;0;0;0;-1;0;434830006;444180292;33960916
1665;8.58518e-15;-459;1656;21268;16101.2;1;548;-2.14748e+09;-2.07954e+06;0;0;0;0;0;0;434912340;444276419;33991462
1666;8.58518e-15;-460;1656;21268;16101.2;1;548;-2.14748e+09;-2.07542e+06;0;0;0;0;0;0;434994505;444372368;34021966
1667;8.58518e-15;-461;1656;21268;16101.2;1;548;-2.14748e+09;-2.0713e+06;0;0;0;0;0;0;435076504;444468140;34052427
1668;8.58518e-15;-461;1656;21268;16101.2;1;548;-2.14748e+09;-2.0672e+06;-1;0;0;0;-1;0;435158335;444563736;34082846
1669;8.58518e-15;-462;1656;21268;16101.2;1;548;-2.14748e+09;-2.0631e+06;0;0;0;0;0;0;435240000;444659155;34113223
1670;8.58518e-15;-463;1656;21268;16101.2;1;548;-2.14748e+09;-2.05901e+06;0;0;0;0;0;0;435321499;444754399;34143558
1671;8.58518e-15;-464;1656;21268;16101.2;1;548;-2.14748e+09;-2.05493e+06;0;0;0;0;0;0;435402833;444849467;34173850
1672;8.58518e-15;-465;1656;21268;16101.2;1;548;-2.14748e+09;-2.05086e+06;0;0;0;0;0;0;435484001;444944359;34204101
1673;8.58518e-15;-465;1656;21268;16101.2;1;548;-2.14748e+09;-2.0468e+06;-1;0;0;0;-1;0;435565004;445039077;34234309
1674;8.58518e-15;-465;1656;21268;16101.2;1;548;-2.14748e+09;-2.04275e+06;-1;0;0;0;-1;0;435645842;445133621;34264475
1675;8.58518e-15;-466;1656;21268;16101.2;1;548;-2.14748e+09;-2.03871e+06;0;0;0;0;0;0;435726516;445227990;34294599
1676;8.58518e-15;-466;1656;21268;16101.2;1;548;-2.14748e+09;-2.03468e+06;-1;0;0;0;-1;0;435807027;445322185;34324681
1677;8.58518e-15;-466;1656;21268;16101.2;1;548;-2.14748e+09;-2.03066e+06;-1;0;0;0;-1;0;435887373;445416207;34354721
1678;8.58518e-15;-466;1656;21268;16101.2;1;548;-2.14748e+09;-2.02664e+06;-1;0;0;0;-1;0;435967557;445510056;34384720
1679;8.58518e-15;-467;1656;21268;16101.2;1;548;-2.14748e+09;-2.02263e+06;0;0;0;0;0;0;436047578;445603732;34414676
1680;8.58518e-15;-467;1656;21268;16101.2;1;548;-2.14748e+09;-2.01864e+06;-1;0;0;0;-1;0;436127436;445697236;34444590
1681;8.58518e-15;-468;1656;21268;16101.2;1;548;-2.14748e+09;-2.01465e+06;0;0;0;0;0;0;436207133;445790568;34474463
1682;8.58518e-15;-469;1656;21268;16101.2;1;548;-2.14748e+09;-2.01067e+06;0;0;0;0;0;0;436286668;445883728;34504293
1683;8.58518e-15;-469;1656;21268;16101.2;1;548;-2.14748e+09;-2.0067e+06;-1;0;0;0;-1;0;436366041;445976716;34534082
1684;8.58518e-15;-470;1656;21268;16101.2;1;548;-2.14748e+09;-2.00274e+06;0;0;0;0;0;0;436445254;446069533;34563829
1685;8.58518e-15;-470;1656;21268;16101.2;1;548;-2.14748e+09;-1.99878e+06;-1;0;0;0;-1;0;436524306;446162180;34593535
1686;8.58518e-15;-470;1656;21268;16101.2;1;548;-2.14748e+09;-1.99484e+06;-1;0;0;0;-1;0;436603198;446254656;34623198
1687;8.58518e-15;-470;1656;21268;16101.2;1;548;-2.14748e+09;-1.9909e+06;-1;0;0;0;-1;0;436681930;446346962;34652820
1688;8.58518e-15;-470;1656;21268;16101.2;1;548;-2.14748e+09;-1.98698e+06;-1;0;0;0;-1;0;436760502;446439099;34682400
1689;8.58518e-15;-471;1656;21268;16101.2;1;548;-2.14748e+09;-1.98306e+06;0;0;0;0;0;0;436838916;446531066;34711939
1690;8.58518e-15;-471;1656;21268;16101.2;1;548;-2.14748e+09;-1.97915e+06;-1;0;0;0;-1;0;436917170;446622864;34741436
1691;8.58518e-15;-472;1656;21268;16101.2;1;548;-2.14748e+09;-1.97525e+06;0;0;0;0;0;0;436995267;446714493;34770892
1692;8.58518e-15;-472;1656;21268;16101.2;1;548;-2.14748e+09;-1.97136e+06;-1;0;0;0;-1;0;437073205;446805954;34800305
1693;8.58518e-15;-473;1656;21268;16101.2;1;548;-2.14748e+09;-1.96747e+06;0;0;0;0;0;0;437150985;446897247;34829678
1694;8.58518e-15;-473;1656;21268;16101.2;1;548;-2.14748e+09;-1.9636e+06;-1;0;0;0;-1;0;437228608;446988372;34859009
1695;8.58518e-15;-474;1656;21268;16101.2;1;548;-2.14748e+09;-1.95973e+06;0;0;0;0;0;0;437306074;447079330;34888298
1696;8.58518e-15;-475;1656;21268;16101.2;1;548;-2.14748e+09;-1.95588e+06;0;0;0;0;0;0;437383383;447170120;34917547
1697;8.58518e-15;-475;1656;21268;16101.2;1;548;-2.14748e+09;-1.95203e+06;-1;0;0;0;-1;0;437460536;447260744;34946753
1698;8.58518e-15;-475;1656;21268;16101.2;1;548;-2.14748e+09;-1.94819e+06;-1;0;0;0;-1;0;437537534;447351202;34975919
1699;8.58518e-15;-475;1656;21268;16101.2;1;548;-2.14748e+09;-1.94435e+06;-1;0;0;0;-1;0;437614375;447441493;35005043
1700;8.58518e-15;-476;1656;21268;16101.2;1;548;-2.14748e+09;-1.94053e+06;0;0;0;0;0;0;437691061;447531619;35034126
1701;8.58518e-15;-477;1656;21268;16101.2;1;548;-2.14748e+09;-1.93671e+06;0;0;0;0;0;0;437767593;447621579;35063167
1702;8.58518e-15;-477;1656;21268;16101.2;1;548;-2.14748e+09;-1.9329e+06;-1;0;0;0;-1;0;437843969;447711374;35092167
1703;8.58518e-15;-477;1656;21268;16101.2;1;548;-2.14748e+09;-1.92911e+06;-1;0;0;0;-1;0;437920192;447801005;35121127
1704;8.58518e-15;-477;1656;21268;16101.2;1;548;-2.14748e+09;-1.92531e+06;-1;0;0;0;-1;0;437996261;447890470;35150045
1705;8.58518e-15;-478;1656;21268;16101.2;1;548;-2.14748e+09;-1.92153e+06;0;0;0;0;0;0;438072176;447979772;35178921
1706;8.58518e-15;-479;1656;21268;16101.2;1;548;-2.14748e+09;-1.91776e+06;0;0;0;0;0;0;438147938;448068910;35207757
1707;8.58518e-15;-480;1656;21268;16101.2;1;548;-2.14748e+09;-1.91399e+06;0;0;0;0;0;0;438223547;448157884;35236552
1708;8.58518e-15;-480;1656;21268;16101.2;1;548;-2.14748e+09;-1.91024e+06;-1;0;0;0;-1;0;438299003;448246696;35265306
1709;8.58518e-15;-480;1656;21268;16101.2;1;548;-2.14748e+09;-1.90649e+06;-1;0;0;0;-1;0;438374308;448335344;35294018
1710;8.58518e-15;-480;1656;21268;16101.2;1;548;-2.14748e+09;-1.90274e+06;-1;0;0;0;-1;0;438449460;448423830;35322690
1711;8.58518e-15;-481;1656;21268;16101.2;1;548;-2.14748e+09;-1.89901e+06;0;0;0;0;0;0;438524461;448512153;35351321
1712;8.58518e-15;-481;1656;21268;16101.2;1;548;-2.14748e+09;-1.89529e+06;-1;0;0;0;-1;0;438599311;448600315;35379911
1713;8.58518e-15;-481;1656;21268;16101.2;1;548;-2.14748e+09;-1.89157e+06;-1;0;0;0;-1;0;438674010;448688315;35408460
1714;8.58518e-15;-482;1656;21268;16101.2;1;548;-2.14748e+09;-1.88786e+06;0;0;0;0;0;0;438748559;448776154;35436968
1715;8.58518e-15;-483;1656;21268;16101.2;1;548;-2.14748e+09;-1.88416e+06;0;0;0;0;0;0;438822957;448863832;35465436
1716;8.58518e-15;-484;1656;21268;16101.2;1;548;-2.14748e+09;-1.88047e+06;0;0;0;0;0;0;438897206;448951349;35493863
1717;8.58518e-15;-484;1656;21268;16101.2;1;548;-2.14748e+09;-1.87678e+06;-1;0;0;0;-1;0;438971305;449038706;35522249
1718;8.58518e-15;-485;1656;21268;16101.2;1;548;-2.14748e+09;-1.87311e+06;0;0;0;0;0;0;439045255;449125903;35550594
1719;8.58518e-15;-485;1656;21268;16101.2;1;548;-2.14748e+09;-1.86944e+06;-1;0;0;0;-1;0;439119056;449212940;35578899
1720;8.58518e-15;-485;1656;21268;16101.2;1;548;-2.14748e+09;-1.86578e+06;-1;0;0;0;-1;0;439192709;449299818;35607163
1721;8.58518e-15;-485;1656;21268;16101.2;1;548;-2.14748e+09;-1.86213e+06;-1;0;0;0;-1;0;439266213;449386536;35635386
1722;8.58518e-15;-486;1656;21268;16101.2;1;548;-2.14748e+09;-1.85848e+06;0;0;0;0;0;0;439339570;449473096;35663569
1723;8.58518e-15;-486;1656;21268;16101.2;1;548;-2.14748e+09;-1.85485e+06;-1;0;0;0;-1;0;439412779;449559498;35691711
1724;8.58518e-15;-487;1656;21268;16101.2;1;548;-2.14748e+09;-1.85122e+06;0;0;0;0;0;0;439485841;449645741;35719813
1725;8.58518e-15;-488;1656;21268;16101.2;1;548;-2.14748e+09;-1.8476e+06;0;0;0;0;0;0;439558756;449731826;35747875
1726;8.58518e-15;-488;1656;21268;16101.2;1;548;-2.14748e+09;-1.84399e+06;-1;0;0;0;-1;0;439631524;449817754;35775896
1727;8.58518e-15;-488;1656;21268;16101.2;1;548;-2.14748e+09;-1.84038e+06;-1;0;0;0;-1;0;439704146;449903525;35803876
1728;8.58518e-15;-488;1656;21268;16101.2;1;548;-2.14748e+09;-1.83678e+06;-1;0;0;0;-1;0;439776623;449989138;35831817
1729;8.58518e-15;-489;1656;21268;16101.2;1;548;-2.14748e+09;-1.83319e+06;0;0;0;0;0;0;439848954;450074595;35859717
1730;8.58518e-15;-489;1656;21268;16101.2;1;548;-2.14748e+09;-1.82961e+06;-1;0;0;0;-1;0;439921139;450159896;35887576
1731;8.58518e-15;-490;1656;21268;16101.2;1;548;-2.14748e+09;-1.82604e+06;0;0;0;0;0;0;439993180;450245041;35915396
1732;8.58518e-15;-490;1656;21268;16101.2;1;548;-2.14748e+09;-1.82247e+06;-1;0;0;0;-1;0;440065076;450330030;35943175
1733;8.58518e-15;-490;1656;21268;16101.2;1;548;-2.14748e+09;-1.81891e+06;-1;0;0;0;-1;0;440136828;450414863;35970914
1734;8.58518e-15;-490;1656;21268;16101.2;1;548;-2.14748e+09;-1.81536e+06;-1;0;0;0;-1;0;440208435;450499542;35998613
1735;8.58518e-15;-490;1656;21268;16101.2;1;548;-2.14748e+09;-1.81182e+06;0;0;-1;0;0;-1;440279899;450584065;36026272
1736;8.58518e-15;-490;1656;21268;16101.2;1;548;-2.14748e+09;-1.80828e+06;-1;0;0;0;-1;0;440351220;450668434;36053891
1737;8.58518e-15;-491;1656;21268;16101.2;1;548;-2.14748e+09;-1.80476e+06;0;0;0;0;0;0;440422398;450752649;36081469
1738;8.58518e-15;-491;1656;21268;16101.2;1;548;-2.14748e+09;-1.80123e+06;-1;0;0;0;-1;0;440493433;450836710;36109008
1739;8.58518e-15;-491;1656;21268;16101.2;1;548;-2.14748e+09;-1.79772e+06;-1;0;0;0;-1;0;440564326;450920617;36136507
1740;8.58518e-15;-492;1656;21268;16101.2;1;548;-2.14748e+09;-1.79422e+06;0;0;0;0;0;0;440635076;451004371;36163966
1741;8.58518e-15;-493;1656;21268;16101.2;1;548;-2.14748e+09;-1.79072e+06;0;0;0;0;0;0;440705685;451087972;36191385
1742;8.58518e-15;-494;1656;21268;16101.2;1;548;-2.14748e+09;-1.78723e+06;0;0;0;0;0;0;440776152;451171421;36218764
1743;8.58518e-15;-494;1656;21268;16101.2;1;548;-2.14748e+09;-1.78375e+06;-1;0;0;0;-1;0;440846479;451254716;36246103
1744;8.58518e-15;-495;1656;21268;16101.2;1;548;-2.14748e+09;-1.78027e+06;0;0;0;0;0;0;440916664;451337860;36273402
1745;8.58518e-15;-495;1656;21268;16101.2;1;548;-2.14748e+09;-1.7768e+06;-1;0;0;0;-1;0;440986709;451420852;36300662
1746;8.58518e-15;-495;1656;21268;16101.2;1;548;-2.14748e+09;-1.77334e+06;-1;0;0;0;-1;0;441056613;451503692;36327882
1747;8.58518e-15;-495;1656;21268;16101.2;1;548;-2.14748e+09;-1.76989e+06;-1;0;0;0;-1;0;441126378;451586381;36355063
1748;8.58518e-15;-495;1656;21268;16101.2;1;548;-2.14748e+09;-1.76644e+06;-1;0;0;0;-1;0;441196003;451668919;36382203
1749;8.58518e-15;-495;1656;21268;16101.2;1;548;-2.14748e+09;-1.76301e+06;-1;0;0;0;-1;0;441265489;451751306;36409304
1750;8.58518e-15;-495;1656;21268;16101.2;1;548;-2.14748e+09;-1.75958e+06;-1;0;0;0;-1;0;441334836;451833543;36436366
1751;8.58518e-15;-496;1656;21268;16101.2;1;548;-2.14748e+09;-1.75615e+06;0;0;0;0;0;0;441404044;451915629;36463388
1752;8.58518e-15;-497;1656;21268;16101.2;1;548;-2.14748e+09;-1.75274e+06;0;0;0;0;0;0;441473114;451997566;36490371
1753;8.58518e-15;-497;1656;21268;16101.2;1;548;-2.14748e+09;-1.74933e+06;-1;0;0;0;-1;0;441542045;452079354;36517314
1754;8.58518e-15;-498;1656;21268;16101.2;1;548;-2.14748e+09;-1.74593e+06;0;0;0;0;0;0;441610839;452160992;36544217
1755;8.58518e-15;-499;1656;21268;16101.2;1;548;-2.14748e+09;-1.74253e+06;0;0;0;0;0;0;441679496;452242481;36571082
1756;8.58518e-15;-500;1656;21268;16101.2;1;548;-2.14748e+09;-1.73914e+06;0;0;0;0;0;0;441748015;452323821;36597907
1757;8.58518e-15;-501;1656;21268;16101.2;1;548;-2.14748e+09;-1.73576e+06;0;0;0;0;0;0;441816397;452405014;36624692
1758;8.58518e-15;-501;1656;21268;16101.2;1;548;-2.14748e+09;-1.73239e+06;-1;0;0;0;-1;0;441884643;452486058;36651439
1759;8.58518e-15;-502;1656;21268;16101.2;1;548;-2.14748e+09;-1.72903e+06;0;0;0;0;0;0;441952752;452566954;36678146
1760;8.58518e-15;-502;1656;21268;16101.2;1;548;-2.14748e+09;-1.72567e+06;-1;0;0;0;-1;0;442020726;452647702;36704814
1761;8.58518e-15;-503;1656;21268;16101.2;1;548;-2.14748e+09;-1.72232e+06;0;0;0;0;0;0;442088564;452728304;36731442
1762;8.58518e-15;-504;1656;21268;16101.2;1;548;-2.14748e+09;-1.71898e+06;0;0;0;0;0;0;442156266;452808758;36758032
1763;8.58518e-15;-505;1656;21268;16101.2;1;548;-2.14748e+09;-1.71564e+06;0;0;0;0;0;0;442223833;452889066;36784583
1764;8.58518e-15;-506;1656;21268;16101.2;1;548;-2.14748e+09;-1.71231e+06;0;0;0;0;0;0;442291266;452969227;36811094
1765;8.58518e-15;-506;1656;21268;16101.2;1;548;-2.14748e+09;-1.70899e+06;-1;0;0;0;-1;0;442358564;453049243;36837567
1766;8.58518e-15;-506;1656;21268;16101.2;1;548;-2.14748e+09;-1.70567e+06;-1;0;0;0;-1;0;442425728;453129112;36864000
1767;8.58518e-15;-506;1656;21268;16101.2;1;548;-2.14748e+09;-1.70236e+06;-1;0;0;0;-1;0;442492758;453208836;36890395
1768;8.58518e-15;-507;1656;21268;16101.2;1;548;-2.14748e+09;-1.69906e+06;0;0;0;0;0;0;442559654;453288414;36916750
1769;8.58518e-15;-507;1656;21268;16101.2;1;548;-2.14748e+09;-1.69577e+06;-1;0;0;0;-1;0;442626417;453367848;36943067
1770;8.58518e-15;-507;1656;21268;16101.2;1;548;-2.14748e+09;-1.69248e+06;-1;0;0;0;-1;0;442693046;453447137;36969345
1771;8.58518e-15;-507;1656;21268;16101.2;1;548;-2.14748e+09;-1.6892e+06;-1;0;0;0;-1;0;442759543;453526281;36995584
1772;8.58518e-15;-508;1656;21268;16101.2;1;548;-2.14748e+09;-1.68592e+06;0;0;0;0;0;0;442825908;453605281;37021785
1773;8.58518e-15;-509;1656;21268;16101.2;1;548;-2.14748e+09;-1.68266e+06;0;0;0;0;0;0;442892140;453684138;37047947
1774;8.58518e-15;-509;1656;21268;16101.2;1;548;-2.14748e+09;-1.6794e+06;-1;0;0;0;-1;0;442958241;453762850;37074070
1775;8.58518e-15;-509;1656;21268;16101.2;1;548;-2.14748e+09;-1.67615e+06;-1;0;0;0;-1;0;443024210;453841420;37100154
1776;8.58518e-15;-509;1656;21268;16101.2;1;548;-2.14748e+09;-1.6729e+06;-1;0;0;0;-1;0;443090047;453919846;37126200
1777;8.58518e-15;-510;1656;21268;16101.2;1;548;-2.14748e+09;-1.66966e+06;0;0;0;0;0;0;443155754;453998129;37152207
1778;8.58518e-15;-511;1656;21268;16101.2;1;548;-2.14748e+09;-1.66643e+06;0;0;0;0;0;0;443221330;454076270;37178176
1779;8.58518e-15;-511;1656;21268;16101.2;1;548;-2.14748e+09;-1.6632e+06;-1;0;0;0;-1;0;443286775;454154269;37204106
1780;8.58518e-15;-512;1656;21268;16101.2;1;548;-2.14748e+09;-1.65999e+06;0;0;0;0;0;0;443352090;454232125;37229998
1781;8.58518e-15;-512;1656;21268;16101.2;1;548;-2.14748e+09;-1.65677e+06;-1;0;0;0;-1;0;443417275;454309840;37255851
1782;8.58518e-15;-512;1656;21268;16101.2;1;548;-2.14748e+09;-1.65357e+06;-1;0;0;0;-1;0;443482331;454387414;37281666
1783;8.58518e-15;-513;1656;21268;16101.2;1;548;-2.14748e+09;-1.65037e+06;0;0;0;0;0;0;443547257;454464846;37307443
1784;8.58518e-15;-513;1656;21268;16101.2;1;548;-2.14748e+09;-1.64718e+06;-1;0;0;0;-1;0;443612054;454542137;37333182
1785;8.58518e-15;-513;1656;21268;16101.2;1;548;-2.14748e+09;-1.644e+06;-1;0;0;0;-1;0;443676723;454619288;37358882
1786;8.58518e-15;-513;1656;21268;16101.2;1;548;-2.14748e+09;-1.64082e+06;-1;0;0;0;-1;0;443741263;454696298;37384544
1787;8.58518e-15;-514;1656;21268;16101.2;1;548;-2.14748e+09;-1.63765e+06;0;0;0;0;0;0;443805674;454773168;37410167
1788;8.58518e-15;-514;1656;21268;16101.2;1;548;-2.14748e+09;-1.63448e+06;-1;0;0;0;-1;0;443869958;454849899;37435753
1789;8.58518e-15;-514;1656;21268;16101.2;1;548;-2.14748e+09;-1.63132e+06;-1;0;0;0;-1;0;443934114;454926490;37461301
1790;8.58518e-15;-514;1656;21268;16101.2;1;548;-2.14748e+09;-1.62817e+06;-1;0;0;0;-1;0;443998142;455002941;37486810
1791;8.58518e-15;-515;1656;21268;16101.2;1;548;-2.14748e+09;-1.62503e+06;0;0;0;0;0;0;444062044;455079253;37512282
1792;8.58518e-15;-516;1656;21268;16101.2;1;548;-2.14748e+09;-1.62189e+06;0;0;0;0;0;0;444125819;455155427;37537715
1793;8.58518e-15;-516;1656;21268;16101.2;1;548;-2.14748e+09;-1.61876e+06;-1;0;0;0;-1;0;444189467;455231462;37563111
1794;8.58518e-15;-516;1656;21268;16101.2;1;548;-2.14748e+09;-1.61563e+06;-1;0;0;0;-1;0;444252988;455307359;37588468
1795;8.58518e-15;-517;1656;21268;16101.2;1;548;-2.14748e+09;-1.61252e+06;0;0;0;0;0;0;444316384;455383118;37613788
1796;8.58518e-15;-518;1656;21268;16101.2;1;548;-2.14748e+09;-1.6094e+06;0;0;0;0;0;0;444379654;455458739;37639070
1797;8.58518e-15;-519;1656;21268;16101.2;1;548;-2.14748e+09;-1.6063e+06;0;0;0;0;0;0;444442799;455534223;37664314
1798;8.58518e-15;-519;1656;21268;16101.2;1;548;-2.14748e+09;-1.6032e+06;-1;0;0;0;-1;0;444505818;455609569;37689520
1799;8.58518e-15;-519;1656;21268;16101.2;1;548;-2.14748e+09;-1.60011e+06;-1;0;0;0;-1;0;444568712;455684779;37714689
1800;8.58518e-15;-519;1656;21268;16101.2;1;548;-2.14748e+09;-1.59702e+06;-1;0;0;0;-1;0;444631482;455759852;37739820
1801;8.58518e-15;-519;1656;21268;16101.2;1;548;-2.14748e+09;-1.59394e+06;-1;0;0;0;-1;0;444694127;455834788;37764913
1802;8.58518e-15;-519;1656;21268;16101.2;1;548;-2.14748e+09;-1.59087e+06;-1;0;0;0;-1;0;444756648;455909588;37789969
1803;8.58518e-15;-520;1656;21268;16101.2;1;548;-2.14748e+09;-1.5878e+06;0;0;0;0;0;0;444819045;455984253;37814987
1804;8.58518e-15;-520;1656;21268;16101.2;1;548;-2.14748e+09;-1.58474e+06;-1;0;0;0;-1;0;444881319;456058781;37839968
1805;8.58518e-15;-521;1656;21268;16101.2;1;548;-2.14748e+09;-1.58169e+06;0;0;0;0;0;0;444943469;456133175;37864911
1806;8.58518e-15;-521;1656;21268;16101.2;1;548;-2.14748e+09;-1.57864e+06;-1;0;0;0;-1;0;445005496;456207433;37889817
1807;8.58518e-15;-521;1656;21268;16101.2;1;548;-2.14748e+09;-1.5756e+06;-1;0;0;0;-1;0;445067400;456281556;37914685
1808;8.58518e-15;-522;1656;21268;16101.2;1;548;-2.14748e+09;-1.57257e+06;0;0;0;0;0;0;445129182;456355544;37939516
1809;8.58518e-15;-522;1656;21268;16101.2;1;548;-2.14748e+09;-1.56954e+06;-1;0;0;0;-1;0;445190842;456429399;37964310
1810;8.58518e-15;-523;1656;21268;16101.2;1;548;-2.14748e+09;-1.56652e+06;0;0;0;0;0;0;445252379;456503119;37989067
1811;8.58518e-15;-523;1656;21268;16101.2;1;548;-2.14748e+09;-1.5635e+06;-1;0;0;0;-1;0;445313795;456576705;38013786
1812;8.58518e-15;-523;1656;21268;16101.2;1;548;-2.14748e+09;-1.56049e+06;-1;0;0;0;-1;0;445375089;456650158;38038468
1813;8.58518e-15;-524;1656;21268;16101.2;1;548;-2.14748e+09;-1.55749e+06;0;0;0;0;0;0;445436262;456723477;38063113
1814;8.58518e-15;-525;1656;21268;16101.2;1;548;-2.14748e+09;-1.55449e+06;0;0;0;0;0;0;445497314;456796663;38087720
1815;8.58518e-15;-526;1656;21268;16101.2;1;548;-2.14748e+09;-1.5515e+06;0;0;0;0;0;0;445558245;456869716;38112291
1816;8.58518e-15;-526;1656;21268;16101.2;1;548;-2.14748e+09;-1.54852e+06;-1;0;0;0;-1;0;445619056;456942637;38136825
1817;8.58518e-15;-527;1656;21268;16101.2;1;548;-2.14748e+09;-1.54554e+06;0;0;0;0;0;0;445679747;457015425;38161321
1818;8.58518e-15;-527;1656;21268;16101.2;1;548;-2.14748e+09;-1.54257e+06;-1;0;0;0;-1;0;445740318;457088081;38185781
1819;8.58518e-15;-527;1656;21268;16101.2;1;548;-2.14748e+09;-1.5396e+06;-1;0;0;0;-1;0;445800768;457160605;38210203
1820;8.58518e-15;-527;1656;21268;16101.2;1;548;-2.14748e+09;-1.53664e+06;-1;0;0;0;-1;0;445861100;457232998;38234589
1821;8.58518e-15;-527;1656;21268;16101.2;1;548;-2.14748e+09;-1.53369e+06;-1;0;0;0;-1;0;445921312;457305259;38258938
1822;8.58518e-15;-528;1656;21268;16101.2;1;548;-2.14748e+09;-1.53074e+06;0;0;0;0;0;0;445981406;457377390;38283250
1823;8.58518e-15;-528;1656;21268;16101.2;1;548;-2.14748e+09;-1.5278e+06;-1;0;0;0;-1;0;446041381;457449389;38307526
1824;8.58518e-15;-529;1656;21268;16101.2;1;548;-2.14748e+09;-1.52487e+06;0;0;0;0;0;0;446101237;457521258;38331764
1825;8.58518e-15;-529;1656;21268;16101.2;1;548;-2.14748e+09;-1.52194e+06;-1;0;0;0;-1;0;446160975;457592996;38355966
1826;8.58518e-15;-529;1656;21268;16101.2;1;548;-2.14748e+09;-1.51902e+06;-1;0;0;0;-1;0;446220595;457664604;38380132
1827;8.58518e-15;-529;1656;21268;16101.2;1;548;-2.14748e+09;-1.5161e+06;-1;0;0;0;-1;0;446280098;457736082;38404261
1828;8.58518e-15;-530;1656;21268;16101.2;1;548;-2.14748e+09;-1.51319e+06;0;0;0;0;0;0;446339483;457807431;38428353
1829;8.58518e-15;-530;1656;21268;16101.2;1;548;-2.14748e+09;-1.51028e+06;-1;0;0;0;-1;0;446398751;457878650;38452408
1830;8.58518e-15;-530;1656;21268;16101.2;1;548;-2.14748e+09;-1.50738e+06;-1;0;0;0;-1;0;446457902;457949740;38476428
1831;8.58518e-15;-530;1656;21268;16101.2;1;548;-2.14748e+09;-1.50449e+06;-1;0;0;0;-1;0;446516937;458020702;38500410
1832;8.58518e-15;-530;1656;21268;16101.2;1;548;-2.14748e+09;-1.5016e+06;-1;0;0;0;-1;0;446575855;458091534;38524357
1833;8.58518e-15;-531;1656;21268;16101.2;1;548;-2.14748e+09;-1.49872e+06;0;0;0;0;0;0;446634657;458162238;38548267
1834;8.58518e-15;-532;1656;21268;16101.2;1;548;-2.14748e+09;-1.49585e+06;0;0;0;0;0;0;446693343;458232814;38572140
1835;8.58518e-15;-532;1656;21268;16101.2;1;548;-2.14748e+09;-1.49298e+06;-1;0;0;0;-1;0;446751913;458303262;38595978
1836;8.58518e-15;-532;1656;21268;16101.2;1;548;-2.14748e+09;-1.49012e+06;-1;0;0;0;-1;0;446810368;458373582;38619779
1837;8.58518e-15;-532;1656;21268;16101.2;1;548;-2.14748e+09;-1.48726e+06;-1;0;0;0;-1;0;446868708;458443775;38643544
1838;8.58518e-15;-532;1656;21268;16101.2;1;548;-2.14748e+09;-1.48441e+06;-1;0;0;0;-1;0;446926932;458513840;38667272
1839;8.58518e-15;-533;1656;21268;16101.2;1;548;-2.14748e+09;-1.48156e+06;0;0;0;0;0;0;446985042;458583779;38690965
1840;8.58518e-15;-534;1656;21268;16101.2;1;548;-2.14748e+09;-1.47872e+06;0;0;0;0;0;0;447043038;458653591;38714622
1841;8.58518e-15;-534;1656;21268;16101.2;1;548;-2.14748e+09;-1.47589e+06;-1;0;0;0;-1;0;447100919;458723276;38738242
1842;8.58518e-15;-535;1656;21268;16101.2;1;548;-2.14748e+09;-1.47306e+06;0;0;0;0;0;0;447158687;458792835;38761827
1843;8.58518e-15;-536;1656;21268;16101.2;1;548;-2.14748e+09;-1.47024e+06;0;0;0;0;0;0;447216341;458862268;38785375
1844;8.58518e-15;-537;1656;21268;16101.2;1;548;-2.14748e+09;-1.46742e+06;0;0;0;0;0;0;447273881;458931575;38808888
1845;8.58518e-15;-537;1656;21268;16101.2;1;548;-2.14748e+09;-1.46462e+06;-1;0;0;0;-1;0;447331308;459000756;38832365
1846;8.58518e-15;-537;1656;21268;16101.2;1;548;-2.14748e+09;-1.46181e+06;-1;0;0;0;-1;0;447388622;459069813;38855806
1847;8.58518e-15;-537;1656;21268;16101.2;1;548;-2.14748e+09;-1.45901e+06;-1;0;0;0;-1;0;447445823;459138744;38879211
1848;8.58518e-15;-537;1656;21268;16101.2;1;548;-2.14748e+09;-1.45622e+06;-1;0;0;0;-1;0;447502912;459207550;38902580
1849;8.58518e-15;-538;1656;21268;16101.2;1;548;-2.14748e+09;-1.45343e+06;0;0;0;0;0;0;447559889;459276232;38925914
1850;8.58518e-15;-538;1656;21268;16101.2;1;548;-2.14748e+09;-1.45065e+06;-1;0;0;0;-1;0;447616753;459344789;38949212
1851;8.58518e-15;-538;1656;21268;16101.2;1;548;-2.14748e+09;-1.44787e+06;-1;0;0;0;-1;0;447673506;459413222;38972474
1852;8.58518e-15;-539;1656;21268;16101.2;1;548;-2.14748e+09;-1.4451e+06;0;0;0;0;0;0;447730147;459481531;38995701
1853;8.58518e-15;-539;1656;21268;16101.2;1;548;-2.14748e+09;-1.44234e+06;-1;0;0;0;-1;0;447786677;459549716;39018892
1854;8.58518e-15;-539;1656;21268;16101.2;1;548;-2.14748e+09;-1.43958e+06;-1;0;0;0;-1;0;447843096;459617778;39042048
1855;8.58518e-15;-539;1656;21268;16101.2;1;548;-2.14748e+09;-1.43683e+06;-1;0;0;0;-1;0;447899404;459685717;39065168
1856;8.58518e-15;-539;1656;21268;16101.2;1;548;-2.14748e+09;-1.43408e+06;-1;0;0;0;-1;0;447955601;459753533;39088253
1857;8.58518e-15;-540;1656;21268;16101.2;1;548;-2.14748e+09;-1.43134e+06;0;0;0;0;0;0;448011688;459821226;39111302
1858;8.58518e-15;-540;1656;21268;16101.2;1;548;-2.14748e+09;-1.4286e+06;-1;0;0;0;-1;0;448067664;459888796;39134316
1859;8.58518e-15;-541;1656;21268;16101.2;1;548;-2.14748e+09;-1.42587e+06;0;0;0;0;0;0;448123531;459956244;39157295
1860;8.58518e-15;-541;1656;21268;16101.2;1;548;-2.14748e+09;-1.42315e+06;-1;0;0;0;-1;0;448179288;460023570;39180238
1861;8.58518e-15;-542;1656;21268;16101.2;1;548;-2.14748e+09;-1.42043e+06;0;0;0;0;0;0;448234936;460090774;39203146
1862;8.58518e-15;-542;1656;21268;16101.2;1;548;-2.14748e+09;-1.41771e+06;-1;0;0;0;-1;0;448290474;460157857;39226019
1863;8.58518e-15;-542;1656;21268;16101.2;1;548;-2.14748e+09;-1.41501e+06;-1;0;0;0;-1;0;448345904;460224818;39248857
1864;8.58518e-15;-542;1656;21268;16101.2;1;548;-2.14748e+09;-1.4123e+06;-1;0;0;0;-1;0;448401224;460291657;39271660
1865;8.58518e-15;-543;1656;21268;16101.2;1;548;-2.14748e+09;-1.40961e+06;0;0;0;0;0;0;448456437;460358376;39294428
1866;8.58518e-15;-544;1656;21268;16101.2;1;548;-2.14748e+09;-1.40691e+06;0;0;0;0;0;0;448511540;460424974;39317160
1867;8.58518e-15;-545;1656;21268;16101.2;1;548;-2.14748e+09;-1.40423e+06;0;0;0;0;0;0;448566536;460491452;39339858
1868;8.58518e-15;-546;1656;21268;16101.2;1;548;-2.14748e+09;-1.40155e+06;0;0;0;0;0;0;448621424;460557810;39362521
1869;8.58518e-15;-546;1656;21268;16101.2;1;548;-2.14748e+09;-1.39887e+06;-1;0;0;0;-1;0;448676204;460624047;39385149
1870;8.58518e-15;-547;1656;21268;16101.2;1;548;-2.14748e+09;-1.3962e+06;0;0;0;0;0;0;448730877;460690164;39407742
1871;8.58518e-15;-547;1656;21268;16101.2;1;548;-2.14748e+09;-1.39354e+06;-1;0;0;0;-1;0;448785443;460756162;39430300
1872;8.58518e-15;-548;1656;21268;16101.2;1;548;-2.14748e+09;-1.39088e+06;0;0;0;0;0;0;448839902;460822041;39452823
1873;8.58518e-15;-548;1656;21268;16101.2;1;548;-2.14748e+09;-1.38823e+06;-1;0;0;0;-1;0;448894254;460887800;39475312
1874;8.58518e-15;-549;1656;21268;16101.2;1;548;-2.14748e+09;-1.38558e+06;0;0;0;0;0;0;448948499;460953440;39497766
1875;8.58518e-15;-550;1656;21268;16101.2;1;548;-2.14748e+09;-1.38294e+06;0;0;0;0;0;0;449002638;461018962;39520185
1876;8.58518e-15;-551;1656;21268;16101.2;1;548;-2.14748e+09;-1.3803e+06;0;0;0;0;0;0;449056672;461084365;39542570
1877;8.58518e-15;-551;1656;21268;16101.2;1;548;-2.14748e+09;-1.37767e+06;-1;0;0;0;-1;0;449110599;461149650;39564920
1878;8.58518e-15;-551;1656;21268;16101.2;1;548;-2.14748e+09;-1.37504e+06;-1;0;0;0;-1;0;449164421;461214817;39587235
1879;8.58518e-15;-552;1656;21268;16101.2;1;548;-2.14748e+09;-1.37242e+06;0;0;0;0;0;0;449218137;461279866;39609516
1880;8.58518e-15;-552;1656;21268;16101.2;1;548;-2.14748e+09;-1.3698e+06;-1;0;0;0;-1;0;449271749;461344797;39631763
1881;8.58518e-15;-553;1656;21268;16101.2;1;548;-2.14748e+09;-1.36719e+06;0;0;0;0;0;0;449325255;461409611;39653975
1882;8.58518e-15;-554;1656;21268;16101.2;1;548;-2.14748e+09;-1.36459e+06;0;0;0;0;0;0;449378657;461474307;39676153
1883;8.58518e-15;-555;1656;21268;16101.2;1;548;-2.14748e+09;-1.36199e+06;0;0;0;0;0;0;449431954;461538887;39698296
1884;8.58518e-15;-555;1656;21268;16101.2;1;548;-2.14748e+09;-1.35939e+06;-1;0;0;0;-1;0;449485147;461603350;39720406
1885;8.58518e-15;-556;1656;21268;16101.2;1;548;-2.14748e+09;-1.3568e+06;0;0;0;0;0;0;449538236;461667697;39742481
1886;8.58518e-15;-557;1656;21268;16101.2;1;548;-2.14748e+09;-1.35422e+06;0;0;0;0;0;0;449591221;461731927;39764521
1887;8.58518e-15;-557;1656;21268;16101.2;1;548;-2.14748e+09;-1.35164e+06;-1;0;0;0;-1;0;449644102;461796041;39786528
1888;8.58518e-15;-557;1656;21268;16101.2;1;548;-2.14748e+09;-1.34907e+06;-1;0;0;0;-1;0;449696880;461860039;39808500
1889;8.58518e-15;-558;1656;21268;16101.2;1;548;-2.14748e+09;-1.3465e+06;0;0;0;0;0;0;449749555;461923921;39830439
1890;8.58518e-15;-559;1656;21268;16101.2;1;548;-2.14748e+09;-1.34393e+06;0;0;0;0;0;0;449802126;461987688;39852343
1891;8.58518e-15;-560;1656;21268;16101.2;1;548;-2.14748e+09;-1.34138e+06;0;0;0;0;0;0;449854596;462051340;39874213
1892;8.58518e-15;-560;1656;21268;16101.2;1;548;-2.14748e+09;-1.33882e+06;-1;0;0;0;-1;0;449906962;462114877;39896050
1893;8.58518e-15;-560;1656;21268;16101.2;1;548;-2.14748e+09;-1.33628e+06;-1;0;0;0;-1;0;449959226;462178299;39917852
1894;8.58518e-15;-560;1656;21268;16101.2;1;548;-2.14748e+09;-1.33373e+06;-1;0;0;0;-1;0;450011388;462241606;39939621
1895;8.58518e-15;-561;1656;21268;16101.2;1;548;-2.14748e+09;-1.3312e+06;0;0;0;0;0;0;450063449;462304799;39961355
1896;8.58518e-15;-562;1656;21268;16101.2;1;548;-2.14748e+09;-1.32866e+06;0;0;0;0;0;0;450115407;462367878;39983056
1897;8.58518e-15;-563;1656;21268;16101.2;1;548;-2.14748e+09;-1.32614e+06;0;0;0;0;0;0;450167264;462430843;40004723
1898;8.58518e-15;-564;1656;21268;16101.2;1;548;-2.14748e+09;-1.32361e+06;0;0;0;0;0;0;450219020;462493694;40026357
1899;8.58518e-15;-565;1656;21268;16101.2;1;548;-2.14748e+09;-1.3211e+06;0;0;0;0;0;0;450270675;462556431;40047957
1900;8.58518e-15;-565;1656;21268;16101.2;1;548;-2.14748e+09;-1.31858e+06;-1;0;0;0;-1;0;450322229;462619055;40069523
1901;8.58518e-15;-565;1656;21268;16101.2;1;548;-2.14748e+09;-1.31608e+06;-1;0;0;0;-1;0;450373682;462681566;40091055
1902;8.58518e-15;-566;1656;21268;16101.2;1;548;-2.14748e+09;-1.31358e+06;0;0;0;0;0;0;450425035;462743964;40112554
1903;8.58518e-15;-566;1656;21268;16101.2;1;548;-2.14748e+09;-1.31108e+06;-1;0;0;0;-1;0;450476288;462806250;40134020
1904;8.58518e-15;-567;1656;21268;16101.2;1;548;-2.14748e+09;-1.30859e+06;0;0;0;0;0;0;450527440;462868423;40155452
1905;8.58518e-15;-568;1656;21268;16101.2;1;548;-2.14748e+09;-1.3061e+06;0;0;0;0;0;0;450578493;462930483;40176850
1906;8.58518e-15;-569;1656;21268;16101.2;1;548;-2.14748e+09;-1.30362e+06;0;0;0;0;0;0;450629447;462992432;40198215
1907;8.58518e-15;-569;1656;21268;16101.2;1;548;-2.14748e+09;-1.30114e+06;-1;0;0;0;-1;0;450680300;463054269;40219547
1908;8.58518e-15;-570;1656;21268;16101.2;1;548;-2.14748e+09;-1.29867e+06;0;0;0;0;0;0;450731055;463115993;40240846
1909;8.58518e-15;-571;1656;21268;16101.2;1;548;-2.14748e+09;-1.2962e+06;0;0;0;0;0;0;450781711;463177607;40262111
1910;8.58518e-15;-572;1656;21268;16101.2;1;548;-2.14748e+09;-1.29374e+06;0;0;0;0;0;0;450832268;463239109;40283343
1911;8.58518e-15;-573;1656;21268;16101.2;1;548;-2.14748e+09;-1.29129e+06;0;0;0;0;0;0;450882727;463300501;40304542
1912;8.58518e-15;-574;1656;21268;16101.2;1;548;-2.14748e+09;-1.28884e+06;0;0;0;0;0;0;450933087;463361781;40325707
1913;8.58518e-15;-574;1656;21268;16101.2;1;548;-2.14748e+09;-1.28639e+06;-1;0;0;0;-1;0;450983349;463422951;40346840
1914;8.58518e-15;-575;1656;21268;16101.2;1;548;-2.14748e+09;-1.28395e+06;0;0;0;0;0;0;451033513;463484010;40367940
1915;8.58518e-15;-576;1656;21268;16101.2;1;548;-2.14748e+09;-1.28151e+06;0;0;0;0;0;0;451083580;463544959;40389006
1916;8.58518e-15;-577;1656;21268;16101.2;1;548;-2.14748e+09;-1.27908e+06;0;0;0;0;0;0;451133549;463605798;40410040
1917;8.58518e-15;-577;1656;21268;16101.2;1;548;-2.14748e+09;-1.27665e+06;-1;0;0;0;-1;0;451183420;463666527;40431040
1918;8.58518e-15;-577;1656;21268;16101.2;1;548;-2.14748e+09;-1.27423e+06;-1;0;0;0;-1;0;451233195;463727147;40452008
1919;8.58518e-15;-577;1656;21268;16101.2;1;548;-2.14748e+09;-1.27181e+06;-1;0;0;0;-1;0;451282873;463787657;40472943
1920;8.58518e-15;-577;1656;21268;16101.2;1;548;-2.14748e+09;-1.2694e+06;-1;0;0;0;-1;0;451332453;463848058;40493845
1921;8.58518e-15;-577;1656;21268;16101.2;1;548;-2.14748e+09;-1.26699e+06;-1;0;0;0;-1;0;451381938;463908350;40514714
1922;8.58518e-15;-578;1656;21268;16101.2;1;548;-2.14748e+09;-1.26459e+06;0;0;0;0;0;0;451431326;463968533;40535551
1923;8.58518e-15;-579;1656;21268;16101.2;1;548;-2.14748e+09;-1.26219e+06;0;0;0;0;0;0;451480618;464028608;40556354
1924;8.58518e-15;-579;1656;21268;16101.2;1;548;-2.14748e+09;-1.2598e+06;-1;0;0;0;-1;0;451529814;464088574;40577126
1925;8.58518e-15;-580;1656;21268;16101.2;1;548;-2.14748e+09;-1.25741e+06;0;0;0;0;0;0;451578914;464148432;40597864
1926;8.58518e-15;-581;1656;21268;16101.2;1;548;-2.14748e+09;-1.25502e+06;0;0;0;0;0;0;451627919;464208181;40618570
1927;8.58518e-15;-581;1656;21268;16101.2;1;548;-2.14748e+09;-1.25265e+06;-1;0;0;0;-1;0;451676829;464267823;40639244
1928;8.58518e-15;-581;1656;21268;16101.2;1;548;-2.14748e+09;-1.25027e+06;-1;0;0;0;-1;0;451725643;464327358;40659885
1929;8.58518e-15;-582;1656;21268;16101.2;1;548;-2.14748e+09;-1.2479e+06;0;0;0;0;0;0;451774362;464386785;40680493
1930;8.58518e-15;-582;1656;21268;16101.2;1;548;-2.14748e+09;-1.24554e+06;-1;0;0;0;-1;0;451822987;464446105;40701069
1931;8.58518e-15;-582;1656;21268;16101.2;1;548;-2.14748e+09;-1.24318e+06;-1;0;0;0;-1;0;451871517;464505317;40721613
1932;8.58518e-15;-582;1656;21268;16101.2;1;548;-2.14748e+09;-1.24082e+06;-1;0;0;0;-1;0;451919953;464564423;40742125
1933;8.58518e-15;-583;1656;21268;16101.2;1;548;-2.14748e+09;-1.23847e+06;0;0;0;0;0;0;451968295;464623423;40762604
1934;8.58518e-15;-583;1656;21268;16101.2;1;548;-2.14748e+09;-1.23613e+06;-1;0;0;0;-1;0;452016543;464682316;40783051
1935;8.58518e-15;-583;1656;21268;16101.2;1;548;-2.14748e+09;-1.23378e+06;-1;0;0;0;-1;0;452064697;464741102;40803465
1936;8.58518e-15;-583;1656;21268;16101.2;1;548;-2.14748e+09;-1.23145e+06;-1;0;0;0;-1;0;452112758;464799783;40823848
1937;8.58518e-15;-583;1656;21268;16101.2;1;548;-2.14748e+09;-1.22912e+06;-1;0;0;0;-1;0;452160725;464858358;40844198
1938;8.58518e-15;-584;1656;21268;16101.2;1;548;-2.14748e+09;-1.22679e+06;0;0;0;0;0;0;452208599;464916827;40864517
1939;8.58518e-15;-584;1656;21268;16101.2;1;548;-2.14748e+09;-1.22447e+06;-1;0;0;0;-1;0;452256380;464975190;40884803
1940;8.58518e-15;-585;1656;21268;16101.2;1;548;-2.14748e+09;-1.22215e+06;0;0;0;0;0;0;452304068;465033449;40905057
1941;8.58518e-15;-586;1656;21268;16101.2;1;548;-2.14748e+09;-1.21984e+06;0;0;0;0;0;0;452351664;465091602;40925280
1942;8.58518e-15;-586;1656;21268;16101.2;1;548;-2.14748e+09;-1.21753e+06;-1;0;0;0;-1;0;452399167;465149650;40945470
1943;8.58518e-15;-586;1656;21268;16101.2;1;548;-2.14748e+09;-1.21522e+06;-1;0;0;0;-1;0;452446578;465207594;40965629
1944;8.58518e-15;-587;1656;21268;16101.2;1;548;-2.14748e+09;-1.21293e+06;0;0;0;0;0;0;452493897;465265434;40985755
1945;8.58518e-15;-588;1656;21268;16101.2;1;548;-2.14748e+09;-1.21063e+06;0;0;0;0;0;0;452541125;465323168;41005850
1946;8.58518e-15;-588;1656;21268;16101.2;1;548;-2.14748e+09;-1.20834e+06;-1;0;0;0;-1;0;452588260;465380799;41025914
1947;8.58518e-15;-589;1656;21268;16101.2;1;548;-2.14748e+09;-1.20606e+06;0;0;0;0;0;0;452635305;465438326;41045945
1948;8.58518e-15;-589;1656;21268;16101.2;1;548;-2.14748e+09;-1.20377e+06;-1;0;0;0;-1;0;452682258;465495749;41065945
1949;8.58518e-15;-589;1656;21268;16101.2;1;548;-2.14748e+09;-1.2015e+06;-1;0;0;0;-1;0;452729119;465553069;41085913
1950;8.58518e-15;-590;1656;21268;16101.2;1;548;-2.14748e+09;-1.19923e+06;0;0;0;0;0;0;452775890;465610286;41105850
1951;8.58518e-15;-590;1656;21268;16101.2;1;548;-2.14748e+09;-1.19696e+06;-1;0;0;0;-1;0;452822571;465667399;41125755
1952;8.58518e-15;-590;1656;21268;16101.2;1;548;-2.14748e+09;-1.1947e+06;-1;0;0;0;-1;0;452869161;465724409;41145628
1953;8.58518e-15;-591;1656;21268;16101.2;1;548;-2.14748e+09;-1.19244e+06;0;0;0;0;0;0;452915660;465781316;41165470
1954;8.58518e-15;-591;1656;21268;16101.2;1;548;-2.14748e+09;-1.19018e+06;-1;0;0;0;-1;0;452962069;465838121;41185281
1955;8.58518e-15;-591;1656;21268;16101.2;1;548;-2.14748e+09;-1.18793e+06;-1;0;0;0;-1;0;453008389;465894824;41205060
1956;8.58518e-15;-591;1656;21268;16101.2;1;548;-2.14748e+09;-1.18569e+06;-1;0;0;0;-1;0;453054619;465951424;41224808
1957;8.58518e-15;-592;1656;21268;16101.2;1;548;-2.14748e+09;-1.18345e+06;0;0;0;0;0;0;453100759;466007922;41244525
1958;8.58518e-15;-593;1656;21268;16101.2;1;548;-2.14748e+09;-1.18121e+06;0;0;0;0;0;0;453146809;466064319;41264210
1959;8.58518e-15;-594;1656;21268;16101.2;1;548;-2.14748e+09;-1.17898e+06;0;0;0;0;0;0;453192771;466120613;41283864
1960;8.58518e-15;-594;1656;21268;16101.2;1;548;-2.14748e+09;-1.17675e+06;-1;0;0;0;-1;0;453238644;466176807;41303487
1961;8.58518e-15;-595;1656;21268;16101.2;1;548;-2.14748e+09;-1.17453e+06;0;0;0;0;0;0;453284427;466232899;41323079
1962;8.58518e-15;-595;1656;21268;16101.2;1;548;-2.14748e+09;-1.17231e+06;-1;0;0;0;-1;0;453330122;466288890;41342639
1963;8.58518e-15;-596;1656;21268;16101.2;1;548;-2.14748e+09;-1.1701e+06;0;0;0;0;0;0;453375729;466344779;41362169
1964;8.58518e-15;-596;1656;21268;16101.2;1;548;-2.14748e+09;-1.16789e+06;-1;0;0;0;-1;0;453421247;466400569;41381668
1965;8.58518e-15;-597;1656;21268;16101.2;1;548;-2.14748e+09;-1.16568e+06;0;0;0;0;0;0;453466677;466456258;41401135
1966;8.58518e-15;-597;1656;21268;16101.2;1;548;-2.14748e+09;-1.16348e+06;-1;0;0;0;-1;0;453512020;466511846;41420572
1967;8.58518e-15;-597;1656;21268;16101.2;1;548;-2.14748e+09;-1.16129e+06;-1;0;0;0;-1;0;453557274;466567334;41439978
1968;8.58518e-15;-598;1656;21268;16101.2;1;548;-2.14748e+09;-1.1591e+06;0;0;0;0;0;0;453602441;466622722;41459353
1969;8.58518e-15;-598;1656;21268;16101.2;1;548;-2.14748e+09;-1.15691e+06;-1;0;0;0;-1;0;453647521;466678011;41478697
1970;8.58518e-15;-599;1656;21268;16101.2;1;548;-2.14748e+09;-1.15472e+06;0;0;0;0;0;0;453692513;466733200;41498010
1971;8.58518e-15;-599;1656;21268;16101.2;1;548;-2.14748e+09;-1.15255e+06;-1;0;0;0;-1;0;453737418;466788289;41517292
1972;8.58518e-15;-599;1656;21268;16101.2;1;548;-2.14748e+09;-1.15037e+06;-1;0;0;0;-1;0;453782237;466843279;41536544
1973;8.58518e-15;-600;1656;21268;16101.2;1;548;-2.14748e+09;-1.1482e+06;0;0;0;0;0;0;453826968;466898170;41555766
1974;8.58518e-15;-601;1656;21268;16101.2;1;548;-2.14748e+09;-1.14604e+06;0;0;0;0;0;0;453871614;466952962;41574956
1975;8.58518e-15;-602;1656;21268;16101.2;1;548;-2.14748e+09;-1.14387e+06;0;0;0;0;0;0;453916173;467007656;41594116
1976;8.58518e-15;-602;1656;21268;16101.2;1;548;-2.14748e+09;-1.14172e+06;-1;0;0;0;-1;0;453960646;467062251;41613246
1977;8.58518e-15;-602;1656;21268;16101.2;1;548;-2.14748e+09;-1.13956e+06;-1;0;0;0;-1;0;454005033;467116747;41632345
1978;8.58518e-15;-603;1656;21268;16101.2;1;548;-2.14748e+09;-1.13741e+06;0;0;0;0;0;0;454049334;467171146;41651413
1979;8.58518e-15;-604;1656;21268;16101.2;1;548;-2.14748e+09;-1.13527e+06;0;0;0;0;0;0;454093549;467225446;41670451
1980;8.58518e-15;-605;1656;21268;16101.2;1;548;-2.14748e+09;-1.13313e+06;0;0;0;0;0;0;454137679;467279649;41689459
1981;8.58518e-15;-605;1656;21268;16101.2;1;548;-2.14748e+09;-1.13099e+06;-1;0;0;0;-1;0;454181724;467333754;41708436
1982;8.58518e-15;-605;1656;21268;16101.2;1;548;-2.14748e+09;-1.12886e+06;-1;0;0;0;-1;0;454225684;467387761;41727384
1983;8.58518e-15;-605;1656;21268;16101.2;1;548;-2.14748e+09;-1.12673e+06;-1;0;0;0;-1;0;454269559;467441672;41746300
1984;8.58518e-15;-605;1656;21268;16101.2;1;548;-2.14748e+09;-1.12461e+06;-1;0;0;0;-1;0;454313349;467495485;41765187
1985;8.58518e-15;-605;1656;21268;16101.2;1;548;-2.14748e+09;-1.12249e+06;-1;0;0;0;-1;0;454357054;467549201;41784044
1986;8.58518e-15;-606;1656;21268;16101.2;1;548;-2.14748e+09;-1.12037e+06;0;0;0;0;0;0;454400675;467602821;41802870
1987;8.58518e-15;-606;1656;21268;16101.2;1;548;-2.14748e+09;-1.11826e+06;-1;0;0;0;-1;0;454444212;467656343;41821666
1988;8.58518e-15;-607;1656;21268;16101.2;1;548;-2.14748e+09;-1.11616e+06;0;0;0;0;0;0;454487665;467709770;41840432
1989;8.58518e-15;-608;1656;21268;16101.2;1;548;-2.14748e+09;-1.11405e+06;0;0;0;0;0;0;454531034;467763100;41859169
1990;8.58518e-15;-609;1656;21268;16101.2;1;548;-2.14748e+09;-1.11196e+06;0;0;0;0;0;0;454574320;467816335;41877875
1991;8.58518e-15;-610;1656;21268;16101.2;1;548;-2.14748e+09;-1.10986e+06;0;0;0;0;0;0;454617521;467869473;41896551
1992;8.58518e-15;-610;1656;21268;16101.2;1;548;-2.14748e+09;-1.10777e+06;-1;0;0;0;-1;0;454660640;467922516;41915197
1993;8.58518e-15;-611;1656;21268;16101.2;1;548;-2.14748e+09;-1.10568e+06;0;0;0;0;0;0;454703675;467975463;41933814
1994;8.58518e-15;-612;1656;21268;16101.2;1;548;-2.14748e+09;-1.1036e+06;0;0;0;0;0;0;454746627;468028315;41952401
1995;8.58518e-15;-612;1656;21268;16101.2;1;548;-2.14748e+09;-1.10152e+06;-1;0;0;0;-1;0;454789497;468081072;41970957
1996;8.58518e-15;-612;1656;21268;16101.2;1;548;-2.14748e+09;-1.09945e+06;-1;0;0;0;-1;0;454832283;468133734;41989485
1997;8.58518e-15;-612;1656;21268;16101.2;1;548;-2.14748e+09;-1.09738e+06;-1;0;0;0;-1;0;454874988;468186301;42007982
1998;8.58518e-15;-613;1656;21268;16101.2;1;548;-2.14748e+09;-1.09532e+06;0;0;0;0;0;0;454917609;468238773;42026450
1999;8.58518e-15;-614;1656;21268;16101.2;1;548;-2.14748e+09;-1.09325e+06;0;0;0;0;0;0;454960149;468291151;42044888
