step;volume;A_0;B_0;C;L;p;Compl;Aext;Bext;A_ingresso;A_uscita;B_ingresso;B_uscita;A_netto;B_netto;Avicino;Amedio;Alontano
280;4.18816e-15;140;484;14269;10022;1;1;1488;3432;501;130;474;165;371;309;116;94;1
281;4.20269e-15;358;1225;14046;10114;1;239;1386;3433;743;127;1690;469;616;1221;116;94;1
282;4.26098e-15;385;1468;13879;10196;1;462;1346;3433;732;187;1732;649;545;1083;115;95;1
283;4.31317e-15;340;1543;13800;10266;1;647;1316;3434;638;206;1681;738;432;943;116;95;1
284;4.35788e-15;351;1574;13762;10351;1;811;1284;3435;639;169;1743;766;470;977;117;96;1
285;4.41239e-15;334;1587;13761;10426;1;947;1239;3435;642;188;1735;775;454;960;118;96;1
286;4.46067e-15;349;1538;13825;10519;1;1045;1237;3436;615;178;1767;786;437;981;118;97;1
287;4.52078e-15;342;1493;13938;10586;1;1125;1215;3437;629;188;1846;759;441;1087;118;97;1
288;4.56425e-15;352;1503;14086;10658;1;1176;1189;3438;629;172;1686;814;457;872;118;97;1
289;4.61112e-15;322;1541;14195;10751;1;1249;1195;3438;573;186;1753;776;387;977;118;97;1
290;4.6719e-15;335;1492;14371;10821;1;1293;1176;3439;603;182;1649;745;421;904;117;97;1
291;4.71783e-15;338;1498;14516;10897;1;1351;1115;3440;597;172;1689;715;425;974;118;97;1
292;4.7672e-15;312;1525;14664;10971;1;1405;1126;3440;557;162;1721;728;395;993;118;97;1
293;4.81674e-15;328;1514;14835;11043;1;1450;1092;3441;580;151;1668;748;429;920;118;97;1
294;4.86446e-15;315;1478;15085;11122;1;1450;1124;3442;536;160;1707;734;376;973;118;97;1
295;4.917e-15;307;1560;15305;11195;1;1452;1072;3442;533;160;1707;756;373;951;118;97;1
296;4.96572e-15;325;1548;15565;11286;1;1438;1067;3443;531;149;1728;752;382;976;117;97;1
297;5.02668e-15;294;1522;15769;11353;1;1453;1062;3444;505;163;1698;754;342;944;117;97;1
298;5.07172e-15;286;1501;15959;11430;1;1478;1078;3444;505;130;1718;786;375;932;118;97;1
299;5.12365e-15;318;1440;16147;11511;1;1500;1047;3445;536;148;1729;742;388;987;117;97;1
300;5.17847e-15;290;1449;16338;11586;1;1535;1042;3445;555;142;1695;785;413;910;117;97;1
301;5.2294e-15;272;1437;16605;11649;1;1518;1035;3446;523;134;1768;722;389;1046;117;97;1
302;5.27231e-15;281;1494;16836;11731;1;1511;1055;3447;498;144;1739;726;354;1013;116;97;1
303;5.32833e-15;323;1487;17037;11797;1;1524;1032;3447;494;147;1640;759;347;881;117;97;1
304;5.37357e-15;322;1506;17242;11878;1;1540;1032;3448;500;137;1700;722;363;978;117;97;1
305;5.42927e-15;288;1546;17404;11956;1;1567;1092;3449;473;159;1784;706;314;1078;116;96;1
306;5.48308e-15;296;1538;17606;12049;1;1593;1026;3449;543;148;1726;777;395;949;116;97;1
307;5.54748e-15;291;1493;17789;12118;1;1611;1042;3450;513;148;1640;769;365;871;115;96;1
308;5.59541e-15;279;1501;17995;12176;1;1622;1018;3451;535;140;1673;777;395;896;115;97;1
309;5.63582e-15;296;1457;18198;12244;1;1635;1017;3451;529;140;1645;779;389;866;115;95;1
310;5.68331e-15;288;1558;18370;12341;1;1670;1010;3452;490;151;1756;702;339;1054;115;95;1
311;5.75129e-15;284;1503;18605;12421;1;1658;1008;3452;498;155;1810;744;343;1066;115;96;1
312;5.80756e-15;295;1483;18838;12511;1;1646;1028;3453;490;155;1728;745;335;983;114;95;1
313;5.87108e-15;280;1509;19053;12600;1;1651;1027;3454;517;142;1721;789;375;932;113;95;1
314;5.93412e-15;275;1496;19249;12673;1;1660;1001;3454;493;148;1667;804;345;863;113;95;1
315;5.98599e-15;303;1525;19457;12750;1;1664;1037;3455;510;125;1714;722;385;992;113;94;1
316;6.04087e-15;275;1478;19664;12834;1;1671;1018;3455;503;143;1738;765;360;973;113;94;1
317;6.10094e-15;285;1482;19852;12916;1;1694;1016;3456;515;130;1800;731;385;1069;114;95;1
318;6.15976e-15;292;1442;20066;12980;1;1700;996;3457;469;142;1726;782;327;944;114;95;1
319;6.2058e-15;287;1484;20249;13063;1;1724;1036;3457;452;135;1739;723;317;1016;114;95;1
320;6.26568e-15;301;1537;20401;13141;1;1775;992;3458;495;150;1619;744;345;875;114;96;1
321;6.32213e-15;265;1508;20577;13232;1;1815;1030;3458;509;144;1713;780;365;933;114;95;1
322;6.38821e-15;296;1461;20775;13302;1;1816;1012;3459;530;143;1648;777;387;871;113;96;1
323;6.43919e-15;310;1519;20931;13390;1;1856;1031;3460;520;158;1727;761;362;966;112;96;1
324;6.50347e-15;238;1530;21048;13447;1;1925;1029;3460;530;144;1689;751;386;938;112;96;1
325;6.54522e-15;288;1494;21233;13526;1;1937;1027;3461;508;132;1763;736;376;1027;111;96;1
326;6.60323e-15;271;1536;21435;13619;1;1947;1007;3461;500;149;1742;747;351;995;111;95;1
327;6.67175e-15;269;1498;21649;13700;1;1947;1007;3462;499;131;1755;812;368;943;112;96;1
328;6.73161e-15;296;1494;21878;13793;1;1952;989;3462;497;136;1761;769;361;992;111;95;1
329;6.80057e-15;284;1451;22042;13874;1;1989;1008;3463;478;128;1720;754;350;966;112;95;1
330;6.86082e-15;254;1511;22244;13962;1;2005;1005;3464;503;144;1750;747;359;1003;112;96;1
331;6.92647e-15;306;1494;22463;14037;1;2002;1008;3464;474;131;1698;799;343;899;112;95;1
332;6.9826e-15;295;1547;22665;14133;1;2015;1029;3465;522;145;1752;763;377;989;112;95;1
333;7.05466e-15;274;1594;22885;14205;1;2014;1029;3465;480;157;1701;740;323;961;111;96;1
334;7.10886e-15;313;1542;23092;14271;1;2025;1012;3466;508;124;1697;818;384;879;110;96;2
335;7.15867e-15;279;1558;23290;14349;1;2058;1013;3466;466;134;1680;759;332;921;110;95;2
336;7.21769e-15;270;1516;23474;14421;1;2082;989;3467;482;119;1764;776;363;988;110;95;2
337;7.27231e-15;291;1516;23706;14508;1;2069;993;3467;481;146;1753;745;335;1008;109;95;2
338;7.33849e-15;299;1531;23930;14580;1;2065;1011;3468;507;140;1738;772;367;966;109;95;2
339;7.39342e-15;302;1487;24170;14665;1;2057;992;3469;531;142;1808;757;389;1051;109;95;2
340;7.45844e-15;265;1520;24353;14740;1;2080;1031;3469;459;150;1833;733;309;1100;109;96;2
341;7.51596e-15;279;1518;24581;14830;1;2079;987;3470;523;138;1719;749;385;970;109;95;2
342;7.58519e-15;299;1514;24780;14912;1;2098;1024;3470;530;139;1801;749;391;1052;109;94;2
343;7.64845e-15;273;1518;24998;15002;1;2092;1005;3471;509;138;1746;757;371;989;108;94;2
344;7.71808e-15;279;1526;25160;15081;1;2130;988;3471;497;145;1766;736;352;1030;108;94;2
345;7.77937e-15;292;1528;25318;15190;1;2161;987;3472;491;124;1787;776;367;1011;108;94;2
346;7.86421e-15;252;1459;25547;15272;1;2157;1027;3472;508;144;1728;747;364;981;108;94;2
347;7.92824e-15;303;1565;25767;15357;1;2142;989;3473;497;134;1789;729;363;1060;108;94;2
348;7.99479e-15;276;1567;25921;15435;1;2177;1024;3473;533;144;1727;744;389;983;108;94;2
349;8.05602e-15;294;1603;26160;15520;1;2164;1003;3474;529;140;1714;792;389;922;109;94;2
350;8.12293e-15;282;1674;26334;15613;1;2189;1023;3474;518;141;1776;761;377;1015;108;94;2
351;8.19634e-15;299;1511;26507;15693;1;2222;1026;3475;517;144;1690;814;373;876;108;94;2
352;8.25967e-15;298;1585;26692;15775;1;2235;1025;3475;516;158;1710;762;358;948;107;94;2
353;8.32476e-15;272;1572;26887;15860;1;2250;1008;3476;505;150;1779;745;355;1034;107;94;2
354;8.3924e-15;317;1526;27075;15933;1;2264;1027;3476;493;143;1681;771;350;910;106;93;2
355;8.45064e-15;292;1493;27316;16031;1;2264;1026;3477;512;157;1728;778;355;950;106;93;2
356;8.52904e-15;277;1450;27511;16124;1;2273;1029;3477;514;154;1748;763;360;985;105;93;2
357;8.60366e-15;287;1554;27680;16202;1;2297;988;3478;559;127;1775;756;432;1019;105;94;2
358;8.66641e-15;248;1526;27829;16296;1;2342;1003;3479;549;120;1703;755;429;948;105;93;2
359;8.74224e-15;257;1619;28031;16378;1;2349;999;3479;530;127;1728;774;403;954;106;92;2
360;8.80856e-15;305;1563;28269;16452;1;2334;974;3480;527;158;1724;757;369;967;105;92;2
361;8.86856e-15;262;1571;28451;16530;1;2352;993;3480;508;133;1746;765;375;981;104;92;2
362;8.93196e-15;274;1551;28613;16616;1;2379;973;3481;521;145;1654;777;376;877;104;92;2
363;9.00202e-15;261;1599;28820;16698;1;2391;995;3481;492;147;1699;784;345;915;103;92;2
364;9.069e-15;265;1629;29001;16765;1;2411;1016;3482;548;135;1779;810;413;969;103;91;2
365;9.12385e-15;286;1535;29230;16844;1;2406;978;3482;545;134;1789;760;411;1029;103;92;2
366;9.18867e-15;270;1569;29406;16918;1;2442;1016;3482;472;129;1752;788;343;964;103;92;2
367;9.24952e-15;277;1537;29562;17007;1;2480;1017;3483;525;145;1674;846;380;828;102;92;2
368;9.32289e-15;279;1510;29822;17082;1;2452;1019;3483;510;138;1717;793;372;924;102;92;2
369;9.38486e-15;283;1555;29940;17174;1;2505;1001;3484;519;155;1726;730;364;996;102;93;2
370;9.46107e-15;271;1525;30120;17242;1;2531;1000;3484;545;130;1728;758;415;970;102;93;2
371;9.51754e-15;268;1519;30302;17320;1;2566;999;3485;510;136;1762;763;374;999;102;94;2
372;9.58244e-15;260;1533;30482;17401;1;2599;978;3485;484;141;1759;777;343;982;102;94;2
373;9.64999e-15;280;1566;30645;17476;1;2629;944;3486;478;129;1689;764;349;925;102;94;2
374;9.71269e-15;270;1526;30859;17552;1;2632;946;3486;467;127;1778;790;340;988;102;94;2
375;9.77635e-15;257;1584;31013;17618;1;2661;896;3487;472;141;1676;756;331;920;101;94;2
376;9.83176e-15;254;1556;31257;17701;1;2632;876;3487;416;142;1690;730;274;960;101;94;2
377;9.90158e-15;226;1522;31494;17786;1;2601;889;3488;472;133;1732;815;339;917;100;95;2
378;9.97325e-15;224;1592;31753;17875;1;2557;865;3488;451;122;1755;724;329;1031;101;94;2
379;1.00485e-14;199;1564;31925;17965;1;2568;836;3489;451;110;1765;771;341;994;101;95;2
380;1.01248e-14;214;1573;32139;18045;1;2542;821;3489;392;130;1727;784;262;943;101;93;2
381;1.01927e-14;248;1605;32369;18109;1;2507;797;3490;406;114;1758;789;292;969;101;93;2
382;1.02472e-14;223;1576;32578;18180;1;2502;818;3490;386;99;1731;761;287;970;101;94;2
383;1.03077e-14;230;1602;32785;18248;1;2489;822;3491;401;121;1740;759;280;981;101;93;2
384;1.03658e-14;241;1590;32958;18333;1;2506;786;3491;412;113;1759;800;299;959;101;92;2
385;1.04386e-14;240;1573;33195;18407;1;2466;781;3491;386;100;1700;805;286;895;101;92;2
386;1.05021e-14;210;1623;33404;18490;1;2443;763;3492;381;118;1663;757;263;906;101;92;3
387;1.05735e-14;226;1554;33608;18570;1;2425;776;3492;385;107;1762;817;278;945;102;92;3
388;1.06424e-14;240;1526;33809;18647;1;2411;752;3493;373;122;1766;806;251;960;102;92;3
389;1.0709e-14;220;1586;34001;18733;1;2400;749;3493;360;127;1693;759;233;934;102;91;3
390;1.07834e-14;239;1568;34183;18823;1;2393;742;3494;360;116;1768;844;244;924;102;91;3
391;1.08615e-14;222;1580;34356;18909;1;2401;769;3494;390;102;1737;776;288;961;101;92;3
392;1.09363e-14;213;1583;34513;18987;1;2417;767;3495;363;105;1782;756;258;1026;101;91;3
393;1.10043e-14;219;1603;34634;19061;1;2444;733;3495;375;102;1771;771;273;1000;101;90;3
394;1.10689e-14;210;1622;34793;19138;1;2461;760;3496;373;99;1772;787;274;985;100;91;3
395;1.11363e-14;188;1605;34970;19199;1;2461;732;3496;376;88;1640;791;288;849;100;89;3
396;1.11898e-14;201;1584;35128;19284;1;2463;756;3496;355;107;1802;802;248;1000;99;89;3
397;1.12644e-14;198;1540;35308;19351;1;2454;724;3497;385;115;1747;774;270;973;99;89;3
398;1.13234e-14;214;1548;35463;19430;1;2458;766;3497;379;90;1785;814;289;971;99;90;3
399;1.1393e-14;207;1523;35596;19506;1;2475;747;3498;385;106;1763;796;279;967;98;90;3
400;1.14602e-14;213;1600;35755;19584;1;2478;722;3498;366;105;1777;759;261;1018;98;89;3
401;1.15293e-14;204;1609;35943;19651;1;2465;703;3499;341;119;1738;797;222;941;98;90;3
402;1.15887e-14;185;1605;36151;19713;1;2443;665;3499;372;122;1717;791;250;926;98;88;3
403;1.16438e-14;177;1598;36370;19808;1;2405;656;3499;332;97;1793;811;235;982;98;89;3
404;1.17283e-14;206;1581;36520;19891;1;2401;680;3500;362;82;1722;802;280;920;98;90;3
405;1.18024e-14;174;1576;36692;19983;1;2390;633;3500;337;98;1761;797;239;964;98;90;3
406;1.18847e-14;201;1578;36881;20060;1;2364;632;3501;310;73;1752;852;237;900;98;91;3
407;4.20775e-15;139;1148;13390;10116;1;2248;622;3501;302;58;1766;463;244;1303;97;91;3
408;4.26225e-15;155;1333;13922;10213;1;2050;595;3502;305;82;1766;630;223;1136;97;91;3
409;4.32401e-15;187;1341;14435;10291;1;1856;588;3502;298;88;1775;727;210;1048;97;89;3
410;4.37389e-15;177;1429;14882;10387;1;1703;586;3502;292;82;1818;696;210;1122;96;89;3
411;4.43554e-15;154;1490;15292;10474;1;1572;548;3503;270;92;1803;723;178;1080;95;90;3
412;4.49166e-15;139;1509;15668;10571;1;1455;549;3503;250;72;1740;748;178;992;95;88;3
413;4.55451e-15;171;1497;15980;10663;1;1363;490;3504;287;75;1736;764;212;972;94;89;3
414;4.61438e-15;147;1594;16258;10742;1;1285;534;3504;249;80;1782;747;169;1035;94;88;3
415;4.66601e-15;140;1557;16515;10829;1;1222;426;3405;278;68;1772;806;210;966;95;88;3
416;4.72308e-15;103;1515;16783;10924;1;1144;538;3505;222;46;1721;824;176;897;94;89;3
417;4.78501e-15;132;1585;17003;11014;1;1092;540;3505;250;72;1756;722;178;1034;94;89;3
418;4.84522e-15;154;1582;17273;11103;1;1021;498;3506;284;80;1754;751;204;1003;94;87;3
419;4.90435e-15;119;1593;17493;11187;1;967;516;3506;241;70;1737;802;171;935;94;87;3
420;4.96038e-15;148;1608;17679;11274;1;929;520;3507;243;64;1726;747;179;979;93;87;3
421;5.01863e-15;139;1596;17857;11350;1;898;505;3507;279;62;1705;825;217;880;94;87;3
422;5.0697e-15;115;1660;18005;11443;1;879;483;3507;237;73;1765;749;164;1016;93;87;3
423;5.13243e-15;126;1668;18197;11540;1;824;509;3508;259;70;1741;791;189;950;93;87;3
424;5.19814e-15;126;1577;18362;11629;1;800;483;3508;235;67;1790;795;168;995;92;85;3
425;5.25867e-15;122;1642;18492;11701;1;798;510;3509;241;60;1833;787;181;1046;92;85;3
426;5.30781e-15;138;1607;18616;11794;1;796;519;3509;277;65;1792;827;212;965;91;86;3
427;5.37151e-15;131;1605;18688;11900;1;823;488;3509;228;73;1761;835;155;926;91;85;3
428;5.44443e-15;114;1578;18816;11981;1;816;518;3510;233;70;1725;800;163;925;91;84;3
429;5.50037e-15;134;1568;18946;12062;1;805;491;3510;269;65;1763;797;204;966;90;84;3
430;5.5565e-15;131;1621;19029;12156;1;821;466;3511;245;64;1812;767;181;1045;90;84;3
431;5.62187e-15;133;1679;19166;12230;1;806;463;3511;286;67;1756;774;219;982;91;84;3
432;5.67352e-15;139;1679;19303;12311;1;793;462;3511;235;52;1731;828;183;903;91;83;3
433;5.73024e-15;114;1655;19403;12397;1;801;509;3512;231;61;1843;823;170;1020;91;84;3
434;5.79066e-15;146;1640;19471;12480;1;823;498;3512;245;67;1757;826;178;931;91;82;3
435;5.84917e-15;143;1688;19584;12557;1;826;508;3513;260;69;1742;796;191;946;90;83;4
436;5.90363e-15;135;1630;19690;12643;1;832;467;3513;283;81;1723;821;202;902;89;81;4
437;5.96466e-15;129;1561;19834;12738;1;810;501;3513;225;64;1811;827;161;984;89;82;4
438;6.03231e-15;143;1600;19952;12814;1;812;508;3514;246;70;1818;822;176;996;90;82;4
439;6.08662e-15;124;1605;20029;12906;1;828;513;3514;251;67;1614;827;184;787;89;83;4
440;6.15258e-15;127;1631;20133;12982;1;831;502;3514;224;60;1794;821;164;973;90;82;4
441;6.20724e-15;140;1583;20235;13079;1;833;507;3515;255;70;1745;787;185;958;90;83;4
442;6.27725e-15;151;1633;20318;13160;1;842;502;3515;244;68;1784;840;176;944;90;82;4
443;6.33591e-15;144;1616;20426;13233;1;839;514;3516;271;72;1710;867;199;843;90;83;4
444;6.38893e-15;146;1608;20547;13307;1;846;506;3516;252;71;1759;777;181;982;89;83;4
445;6.44283e-15;130;1655;20677;13401;1;829;491;3516;241;62;1789;797;179;992;89;82;4
446;6.51152e-15;131;1666;20772;13470;1;833;504;3517;230;76;1740;850;154;890;89;82;4
447;6.56209e-15;137;1755;20871;13539;1;833;510;3517;240;84;1736;846;156;890;88;82;4
448;6.6128e-15;163;1721;20975;13624;1;833;469;3517;248;53;1711;881;195;830;89;81;4
449;6.67544e-15;143;1614;21043;13711;1;862;541;3518;254;62;1794;857;192;937;88;82;4
450;6.73976e-15;159;1585;21141;13799;1;866;512;3518;257;84;1744;858;173;886;87;82;4
451;6.80503e-15;127;1630;21225;13893;1;875;466;3519;238;79;1753;765;159;988;87;79;4
452;6.87498e-15;128;1644;21346;13962;1;857;521;3519;268;57;1777;835;211;942;86;80;4
453;6.92647e-15;140;1642;21443;14033;1;860;470;3519;258;69;1801;849;189;952;85;79;4
454;6.9796e-15;136;1687;21541;14103;1;862;536;3520;200;66;1783;795;134;988;85;80;4
455;7.03211e-15;174;1657;21662;14190;1;853;497;3520;256;74;1763;838;182;925;85;79;4
456;7.09756e-15;141;1695;21736;14261;1;876;506;3520;240;79;1827;809;161;1018;85;79;4
457;7.15112e-15;139;1599;21878;14340;1;860;506;3521;226;74;1652;847;152;805;86;79;4
458;7.21087e-15;123;1637;21973;14415;1;865;482;3521;255;69;1738;808;186;930;86;79;4
459;7.26775e-15;140;1643;22102;14501;1;851;481;3521;242;70;1727;840;172;887;84;79;4
460;7.33316e-15;150;1654;22231;14582;1;837;480;3522;221;67;1686;795;154;891;83;79;4
461;7.39495e-15;152;1694;22325;14675;1;848;522;3522;233;65;1728;826;168;902;83;79;4
462;7.4661e-15;153;1714;22402;14755;1;875;426;3423;267;74;1727;832;193;895;84;80;4
463;7.52672e-15;118;1602;22508;14831;1;870;532;3523;194;62;1752;788;132;964;83;80;4
464;7.58596e-15;125;1648;22556;14885;1;902;536;3523;288;69;1787;805;219;982;82;79;4
465;7.6276e-15;137;1676;22611;14969;1;932;520;3524;277;77;1748;802;200;946;82;80;4
466;7.69252e-15;155;1692;22687;15041;1;943;524;3524;221;81;1717;812;140;905;82;80;4
467;7.74832e-15;155;1643;22788;15121;1;958;513;3524;285;80;1779;867;205;912;81;79;4
468;7.81047e-15;160;1688;22861;15199;1;983;511;3525;238;73;1767;856;165;911;81;78;4
469;7.87123e-15;150;1638;22966;15272;1;983;515;3525;261;82;1832;801;179;1031;82;78;4
470;7.92824e-15;148;1673;23057;15336;1;990;471;3525;242;71;1729;826;171;903;82;77;4
471;7.97833e-15;141;1610;23138;15407;1;1004;527;3526;235;74;1695;831;161;864;82;78;4
472;8.03402e-15;137;1702;23240;15486;1;999;532;3526;266;72;1730;773;194;957;81;78;4
473;8.09614e-15;143;1734;23292;15575;1;1035;520;3526;277;84;1706;852;193;854;81;78;4
474;8.16632e-15;140;1689;23431;15651;1;1023;521;3527;224;69;1789;861;155;928;82;78;4
475;8.2264e-15;147;1661;23551;15738;1;1016;530;3527;287;67;1724;791;220;933;81;78;4
476;8.29537e-15;154;1682;23646;15799;1;1021;498;3527;274;72;1714;791;202;923;81;78;4
477;8.34384e-15;126;1646;23767;15869;1;1009;515;3528;246;88;1778;823;158;955;81;78;4
478;8.39957e-15;142;1618;23881;15933;1;1002;514;3528;264;65;1705;816;199;889;81;77;4
479;8.45064e-15;141;1624;23970;16005;1;1015;515;3528;259;83;1824;795;176;1029;81;77;4
480;8.50741e-15;158;1680;24045;16065;1;1026;445;3529;239;80;1743;840;159;903;81;76;4
481;8.55629e-15;140;1697;24146;16137;1;1023;477;3529;224;85;1795;803;139;992;81;77;4
482;8.6141e-15;153;1667;24244;16216;1;1020;491;3529;208;70;1793;820;138;973;80;77;4
483;8.67769e-15;148;1688;24296;16287;1;1047;454;3530;264;71;1822;826;193;996;80;76;4
484;8.73416e-15;142;1717;24396;16358;1;1048;470;3530;220;76;1807;878;144;929;80;76;5
485;8.79237e-15;119;1718;24501;16428;1;1048;382;3430;216;78;1821;778;138;1043;81;76;5
486;8.84909e-15;110;1684;24613;16505;1;1032;474;3531;208;58;1733;832;150;901;79;75;5
487;8.91162e-15;153;1669;24718;16560;1;1022;368;3431;233;54;1735;868;179;867;80;75;5
488;8.95638e-15;128;1686;24818;16622;1;1021;460;3531;184;65;1709;847;119;862;80;75;5
489;9.00692e-15;134;1694;24877;16705;1;1041;359;3432;275;56;1778;807;219;971;81;74;5
490;9.07473e-15;101;1672;24966;16779;1;1041;470;3532;168;61;1706;818;107;888;79;74;5
491;9.13533e-15;139;1673;25087;16837;1;1022;455;3532;242;69;1815;864;173;951;79;74;5
492;9.18292e-15;117;1680;25169;16907;1;1025;419;3533;222;75;1757;875;147;882;78;74;5
493;9.24047e-15;131;1673;25282;16988;1;1012;439;3533;218;58;1815;861;160;954;78;73;5
494;9.30721e-15;122;1710;25361;17036;1;1021;447;3533;207;56;1780;774;151;1006;78;73;5
495;9.34683e-15;127;1676;25443;17110;1;1026;399;3534;251;66;1813;825;185;988;78;73;5
496;9.40804e-15;142;1636;25545;17167;1;1007;443;3534;199;60;1878;836;139;1042;78;73;5
497;9.45527e-15;119;1659;25639;17247;1;999;457;3534;203;76;1702;805;127;897;78;72;5
498;9.52169e-15;128;1610;25710;17334;1;1008;395;3535;222;62;1835;774;160;1061;77;72;5
499;9.5941e-15;123;1629;25815;17394;1;995;393;3535;187;63;1785;803;124;982;77;72;5
500;9.64415e-15;138;1702;25882;17444;1;1003;403;3535;173;61;1766;819;112;947;77;72;5
501;9.68592e-15;101;1731;25993;17515;1;987;394;3536;220;58;1701;883;162;818;76;72;5
502;9.74534e-15;106;1726;26049;17581;1;1003;341;3436;163;54;1760;857;109;903;77;72;5
503;9.80069e-15;108;1635;26169;17651;1;974;356;3436;185;55;1684;837;130;847;77;72;5
504;9.8595e-15;123;1657;26266;17713;1;951;412;3537;201;42;1696;802;159;894;75;72;5
505;9.91169e-15;136;1682;26347;17772;1;950;354;3437;206;60;1839;875;146;964;76;72;5
506;9.96144e-15;121;1647;26423;17842;1;954;420;3537;161;67;1720;876;94;844;74;71;5
507;1.00206e-14;141;1615;26489;17895;1;955;361;3437;220;72;1802;864;148;938;75;71;5
508;1.00654e-14;99;1626;26610;17964;1;934;441;3538;196;55;1753;827;141;926;75;71;5
509;1.01239e-14;98;1658;26673;18023;1;935;404;3538;221;63;1696;820;158;876;74;71;5
510;1.0174e-14;120;1696;26766;18072;1;926;421;3538;197;55;1779;833;142;946;74;71;5
511;1.02157e-14;126;1697;26832;18140;1;935;427;3539;195;57;1797;838;138;959;73;71;5
512;1.02736e-14;155;1661;26911;18203;1;934;422;3539;196;71;1768;817;125;951;72;71;5
513;1.03274e-14;121;1619;26982;18274;1;934;374;3539;183;89;1761;829;94;932;72;70;5
514;1.03881e-14;110;1620;27062;18338;1;926;372;3540;199;57;1743;792;142;951;72;70;5
515;1.04429e-14;109;1656;27138;18396;1;929;329;3540;196;53;1810;807;143;1003;72;69;5
516;1.04927e-14;114;1664;27196;18458;1;934;347;3540;154;53;1829;866;101;963;72;70;5
517;1.0546e-14;106;1620;27270;18530;1;933;318;3541;190;56;1763;822;134;941;73;70;5
518;1.0608e-14;111;1733;27333;18584;1;935;313;3541;158;49;1755;803;109;952;72;70;5
519;1.06545e-14;87;1751;27407;18654;1;931;316;3541;167;60;1798;873;107;925;71;70;5
520;1.0715e-14;110;1753;27498;18711;1;916;335;3541;155;49;1769;887;106;882;72;69;5
521;1.07643e-14;94;1687;27575;18777;1;915;348;3542;179;54;1723;865;125;858;71;69;5
522;1.08215e-14;121;1709;27652;18847;1;908;310;3542;176;62;1748;873;114;875;71;68;5
523;1.08823e-14;92;1661;27697;18918;1;931;315;3542;148;62;1813;887;86;926;70;68;5
524;1.09441e-14;78;1717;27780;18968;1;915;339;3543;167;57;1754;847;110;907;70;68;5
525;1.09877e-14;84;1695;27844;19034;1;916;365;3543;188;43;1770;843;145;927;70;68;5
526;1.10453e-14;104;1686;27894;19093;1;922;313;3543;172;38;1747;828;134;919;70;68;5
527;1.10969e-14;99;1641;28009;19165;1;890;368;3544;174;41;1803;839;133;964;69;68;5
528;1.11599e-14;111;1686;28053;19236;1;901;301;3544;179;49;1757;819;130;938;70;68;5
529;1.12222e-14;108;1696;28137;19286;1;894;359;3544;148;45;1675;851;103;824;70;67;5
530;1.12662e-14;129;1642;28201;19355;1;899;360;3544;169;66;1793;886;103;907;70;68;5
531;1.13269e-14;105;1665;28267;19415;1;900;319;3545;164;57;1680;872;107;808;70;68;5
532;1.13798e-14;85;1719;28362;19487;1;879;366;3545;170;52;1740;828;118;912;70;68;5
533;1.14434e-14;77;1788;28461;19541;1;858;322;3545;171;61;1865;829;110;1036;69;68;5
534;1.14912e-14;90;1692;28564;19604;1;831;323;3546;167;44;1790;843;123;947;69;68;5
535;1.1547e-14;125;1738;28635;19654;1;823;296;3546;169;50;1848;841;119;1007;69;68;5
536;1.15913e-14;115;1739;28683;19724;1;829;273;3546;135;58;1805;895;77;910;69;68;5
537;1.16535e-14;89;1760;28784;19790;1;805;273;3546;139;56;1815;862;83;953;68;68;5
538;1.17123e-14;77;1736;28850;19850;1;799;272;3547;131;44;1777;874;87;903;68;68;5
539;1.17658e-14;83;1647;28914;19899;1;791;286;3547;143;31;1827;889;112;938;68;67;6
540;1.18095e-14;93;1712;28969;19965;1;788;266;3547;128;37;1778;854;91;924;68;67;6
541;1.18686e-14;63;1667;29037;20027;1;775;340;3548;137;40;1818;839;97;979;68;66;6
542;4.197e-15;102;1270;10404;10068.5;1;722;289;3548;187;35;1783;483;152;1300;68;67;6
543;4.2318e-15;94;1471;10623;10130.5;1;638;244;3548;145;37;1855;720;108;1135;68;66;6
544;4.27115e-15;67;1577;10786;10195.5;1;586;281;3548;128;43;1804;776;85;1028;67;67;6
545;4.31253e-15;92;1645;11005;10268.5;1;499;300;3549;132;49;1786;787;83;999;68;67;6
546;4.35916e-15;112;1623;11140;10331.5;1;459;311;3549;143;45;1837;807;98;1030;68;67;6
547;4.39954e-15;89;1644;11246;10390.5;1;441;304;3549;150;52;1777;810;98;967;68;66;6
548;4.43747e-15;80;1647;11369;10452.5;1;406;311;3550;142;37;1802;844;105;958;67;66;6
549;4.47744e-15;89;1633;11444;10520.5;1;401;300;3550;139;32;1750;861;107;889;67;66;6
550;4.52142e-15;92;1651;11533;10591.5;1;385;212;3450;164;52;1797;865;112;932;68;66;6
551;4.5675e-15;79;1693;11586;10651.5;1;385;327;3550;98;30;1783;807;68;976;67;66;6
552;4.60656e-15;89;1707;11659;10719.5;1;377;328;3551;187;50;1717;868;137;849;67;66;6
553;4.65096e-15;115;1713;11748;10781.5;1;363;269;3551;190;56;1764;835;134;929;66;65;6
554;4.69157e-15;77;1707;11822;10840.5;1;363;312;3551;141;44;1762;876;97;886;66;65;6
555;4.73032e-15;95;1696;11894;10902.5;1;354;308;3551;147;40;1765;872;107;893;66;65;6
556;4.77115e-15;103;1718;11954;10972.5;1;359;310;3552;157;56;1764;867;101;897;66;65;6
557;4.8174e-15;88;1671;11995;11033.5;1;373;261;3552;141;45;1735;872;96;863;66;64;6
558;4.85782e-15;91;1705;12063;11107.5;1;367;244;3552;133;39;1748;890;94;858;66;63;6
559;4.90701e-15;72;1726;12148;11180.5;1;349;314;3553;120;42;1779;860;78;919;66;64;6
560;4.9557e-15;84;1748;12203;11249.5;1;353;209;3453;158;53;1774;812;105;962;66;64;6
561;5.00187e-15;63;1727;12292;11309.5;1;333;322;3553;109;39;1724;830;70;894;65;64;6
562;5.04213e-15;94;1701;12333;11369.5;1;336;308;3553;166;40;1828;850;126;978;65;63;6
563;5.0825e-15;83;1747;12377;11438.5;1;344;270;3554;144;42;1721;812;102;909;64;63;6
564;5.12906e-15;75;1728;12437;11493.5;1;337;1.07374e+08;-2.14748e+09;136;47;1781;875;89;906;64;63;6
565;5.16627e-15;75;1727;12437;11493.5;1;337;2.10574e+08;-2.06399e+09;0;0;-1;0;0;-1;64;62;6
566;5.16627e-15;77;1726;12437;11493.5;1;337;2.02414e+08;-1.98428e+09;0;0;-1;0;0;-1;64;63;6
567;5.16627e-15;77;1726;12437;11493.5;1;337;2.97823e+08;-1.90817e+09;0;0;-1;0;0;-1;239;238;6
568;5.16627e-15;77;1725;12437;11493.5;1;337;4.96971e+08;-1.83548e+09;1;0;-1;0;1;-1;913;913;6
569;5.16627e-15;77;1725;12437;11493.5;1;337;5.85273e+08;-1.76604e+09;0;0;-1;0;0;-1;2534;2533;6
570;5.16627e-15;77;1724;12437;11493.5;1;337;6.70258e+08;-1.69969e+09;1;0;-1;0;1;-1;5648;5647;6
571;5.16627e-15;77;1722;12437;11493.5;1;337;7.52072e+08;-1.63627e+09;1;0;-1;0;1;-1;10888;10887;6
572;5.16627e-15;77;1722;12437;11493.5;1;337;7.2348e+08;-1.57565e+09;0;0;-1;0;0;-1;18951;18950;6
573;5.16627e-15;77;1721;12437;11493.5;1;337;9.06739e+08;-1.51768e+09;1;0;-1;0;1;-1;30582;30581;6
574;5.16627e-15;77;1721;12437;11493.5;1;337;8.72477e+08;-1.46224e+09;0;0;-1;0;0;-1;46565;46564;6
575;5.16627e-15;80;1720;12437;11493.5;1;337;1.05031e+09;-1.40921e+09;2;0;-1;0;2;-1;67707;67706;6
576;5.16627e-15;81;1719;12437;11493.5;1;337;1.11824e+09;-1.35846e+09;0;0;-1;0;0;-1;94830;94828;6
577;5.16627e-15;81;1719;12437;11493.5;1;337;1.07636e+09;-1.30989e+09;0;0;-1;0;0;-1;128760;128758;6
578;5.16627e-15;82;1718;12437;11493.5;1;337;1.2469e+09;-1.2634e+09;1;0;-1;0;1;-1;170321;170319;6
579;5.16627e-15;82;1718;12437;11493.5;1;337;1.30785e+09;-1.21888e+09;1;0;-1;0;1;-1;220327;220326;6
580;5.16627e-15;84;1716;12437;11493.5;1;337;1.25928e+09;-1.17625e+09;3;0;-1;0;3;-1;279577;279575;6
581;5.16627e-15;85;1714;12437;11493.5;1;337;1.31605e+09;-1.13541e+09;3;0;-1;0;3;-1;348848;348846;6
582;5.16627e-15;86;1713;12437;11493.5;1;337;1.37087e+09;-1.09627e+09;0;0;-1;0;0;-1;428893;428891;6
583;5.16627e-15;88;1711;12437;11493.5;1;337;1.53118e+09;-1.05877e+09;2;0;-1;0;2;-1;520437;520436;6
584;5.16627e-15;89;1711;12437;11493.5;1;337;1.47495e+09;-1.02281e+09;1;0;-1;0;1;-1;624174;624173;6
585;5.16627e-15;89;1710;12437;11493.5;1;337;1.52436e+09;-9.88342e+08;0;0;-1;0;0;-1;740763;740762;6
586;5.16627e-15;90;1709;12437;11493.5;1;337;1.6795e+09;-9.5528e+08;2;0;-1;0;2;-1;870830;870828;6
587;5.16627e-15;90;1709;12437;11493.5;1;337;1.72568e+09;-9.23566e+08;2;0;-1;0;2;-1;1014962;1014960;6
588;5.16627e-15;91;1708;12437;11493.5;1;337;1.66296e+09;-8.93136e+08;0;0;-1;0;0;-1;1173709;1173707;6
589;5.16627e-15;92;1708;12437;11493.5;1;337;1.70616e+09;-8.63933e+08;1;0;-1;0;1;-1;1347583;1347581;6
590;5.16627e-15;92;1708;12437;11493.5;1;337;1.74796e+09;-8.359e+08;0;0;-1;0;0;-1;1537058;1537056;6
591;5.16627e-15;96;1706;12437;11493.5;1;337;1.78841e+09;-8.08984e+08;0;0;-1;0;0;-1;1742568;1742566;6
592;5.16627e-15;99;1705;12437;11493.5;1;337;1.82756e+09;-7.83135e+08;1;0;-1;0;1;-1;1964509;1964508;6
593;5.16627e-15;100;1704;12437;11493.5;1;337;1.86548e+09;-7.58305e+08;2;0;-1;0;2;-1;2203240;2203238;6
594;5.16627e-15;101;1704;12437;11493.5;1;337;1.9022e+09;-7.34449e+08;0;0;-1;0;0;-1;2459079;2459077;6
595;5.16627e-15;104;1704;12437;11493.5;1;337;1.93778e+09;-7.11523e+08;2;0;-1;0;2;-1;2732311;2732309;6
596;5.16627e-15;117;1703;12437;11493.5;1;337;2.07963e+09;-6.89486e+08;12;0;-1;0;12;-1;3023183;3023181;7
597;5.16627e-15;117;1703;12437;11493.5;1;337;2.11304e+09;-6.68298e+08;0;0;-1;0;0;-1;3331907;3331905;7
598;5.16627e-15;121;1702;12437;11493.5;1;337;2.14544e+09;-6.47923e+08;8;0;-1;0;8;-1;3658661;3658659;7
599;5.16627e-15;124;1702;12437;11493.5;1;337;-2.14748e+09;-6.28325e+08;0;0;-1;0;0;-1;4003589;4003587;7
600;5.16627e-15;123;1701;12437;11493.5;1;337;2.09995e+09;-6.0947e+08;-1;0;0;0;-1;0;4366806;4366804;7
601;5.16627e-15;128;1699;12437;11493.5;1;337;2.12952e+09;-5.91326e+08;2;0;-1;0;2;-1;4748392;4748390;7
602;5.16627e-15;132;1699;12437;11493.5;1;337;-2.14748e+09;-5.73862e+08;11;0;-1;0;11;-1;5148402;5148400;7
603;5.16627e-15;128;1699;12437;11493.5;1;337;-2.14748e+09;-5.57049e+08;-1;0;0;0;-1;0;5566860;5566858;8
604;5.16627e-15;128;1699;12437;11493.5;1;337;-2.14748e+09;-5.40859e+08;-1;0;0;0;-1;0;6003764;6003762;8
605;5.16627e-15;128;1699;12437;11493.5;1;337;-2.14748e+09;-5.25265e+08;-1;0;0;0;-1;0;6459086;6459085;8
606;5.16627e-15;124;1699;12437;11493.5;1;337;-2.14748e+09;-5.10244e+08;-1;0;0;0;-1;0;6932775;6932773;9
607;5.16627e-15;124;1699;12437;11493.5;1;337;-2.14748e+09;-4.95769e+08;0;0;-1;0;0;-1;7424755;7424753;9
608;5.16627e-15;124;1699;12437;11493.5;1;337;-2.14748e+09;-4.81819e+08;-1;0;0;0;-1;0;7934928;7934927;10
609;5.16627e-15;123;1699;12437;11493.5;1;337;-2.14748e+09;-4.68371e+08;-1;0;0;0;-1;0;8463179;8463177;11
610;5.16627e-15;123;1699;12437;11493.5;1;337;-2.14748e+09;-4.55404e+08;-1;0;0;0;-1;0;9009369;9009367;12
611;5.16627e-15;123;1699;12437;11493.5;1;337;-2.14748e+09;-4.429e+08;-1;0;0;0;-1;0;9573344;9573342;13
612;5.16627e-15;122;1699;12437;11493.5;1;337;-2.14748e+09;-4.30837e+08;-1;0;0;0;-1;0;10154931;10154930;14
613;5.16627e-15;122;1699;12437;11493.5;1;337;-2.14748e+09;-4.192e+08;-1;0;0;0;-1;0;10753944;10753942;16
614;5.16627e-15;121;1699;12437;11493.5;1;337;-2.14748e+09;-4.07969e+08;-1;0;0;0;-1;0;11370178;11370177;18
615;5.16627e-15;121;1699;12437;11493.5;1;337;-2.14748e+09;-3.97129e+08;-1;0;0;0;-1;0;12003419;12003418;20
616;5.16627e-15;121;1699;12437;11493.5;1;337;-2.14748e+09;-3.86664e+08;-1;0;0;0;-1;0;12653436;12653435;23
617;5.16627e-15;119;1699;12437;11493.5;1;337;-2.14748e+09;-3.76558e+08;-1;0;0;0;-1;0;13319990;13319989;26
618;5.16627e-15;118;1699;12437;11493.5;1;337;-2.14748e+09;-3.66798e+08;-1;0;0;0;-1;0;14002829;14002828;29
619;5.16627e-15;118;1699;12437;11493.5;1;337;-2.14748e+09;-3.57369e+08;-1;0;0;0;-1;0;14701692;14701692;33
620;5.16627e-15;118;1699;12437;11493.5;1;337;-2.14748e+09;-3.48258e+08;-1;0;0;0;-1;0;15416310;15416309;38
621;5.16627e-15;117;1698;12437;11493.5;1;337;-2.14748e+09;-3.39454e+08;-1;0;0;0;-1;0;16146404;16146404;43
622;5.16627e-15;117;1698;12437;11493.5;1;337;-2.14748e+09;-3.30943e+08;-1;0;0;0;-1;0;16891690;16891690;49
623;5.16627e-15;116;1697;12437;11493.5;1;337;-2.14748e+09;-3.22714e+08;-1;0;0;0;-1;0;17651876;17651876;56
624;5.16627e-15;114;1697;12437;11493.5;1;337;-2.14748e+09;-3.14757e+08;-1;0;0;0;-1;0;18426665;18426666;64
625;5.16627e-15;109;1697;12437;11493.5;1;337;-2.14748e+09;-3.07061e+08;-1;0;0;0;-1;0;19215756;19215757;72
626;5.16627e-15;104;1697;12437;11493.5;1;337;-2.14748e+09;-2.99615e+08;-1;0;0;0;-1;0;20018843;20018844;82
627;5.16627e-15;104;1697;12437;11493.5;1;337;-2.14748e+09;-2.92411e+08;-1;0;0;0;-1;0;20835615;20835617;93
628;5.16627e-15;103;1697;12437;11493.5;1;337;-2.14748e+09;-2.85438e+08;-1;0;0;0;-1;0;21665761;21665763;106
629;5.16627e-15;103;1697;12437;11493.5;1;337;-2.14748e+09;-2.78689e+08;0;0;-1;0;0;-1;22508964;22508967;120
630;5.16627e-15;103;1697;12437;11493.5;1;337;-2.14748e+09;-2.72154e+08;-1;0;0;0;-1;0;23364909;23364913;136
631;5.16627e-15;101;1697;12437;11493.5;1;337;-2.14748e+09;-2.65826e+08;-1;0;0;0;-1;0;24233278;24233283;153
632;5.16627e-15;101;1697;12437;11493.5;1;337;-2.14748e+09;-2.59697e+08;-1;0;0;0;-1;0;25113751;25113756;172
633;5.16627e-15;101;1697;12437;11493.5;1;337;-2.14748e+09;-2.53759e+08;-1;0;0;0;-1;0;26006008;26006015;194
634;5.16627e-15;101;1697;12437;11493.5;1;337;-2.14748e+09;-2.48005e+08;-1;0;0;0;-1;0;26909732;26909740;218
635;5.16627e-15;101;1697;12437;11493.5;1;337;-2.14748e+09;-2.42429e+08;-1;0;0;0;-1;0;27824602;27824611;244
636;5.16627e-15;98;1697;12437;11493.5;1;337;-2.14748e+09;-2.37024e+08;-1;0;0;0;-1;0;28750301;28750312;273
637;5.16627e-15;98;1697;12437;11493.5;1;337;-2.14748e+09;-2.31784e+08;-1;0;0;0;-1;0;29686513;29686525;305
638;5.16627e-15;98;1697;12437;11493.5;1;337;-2.14748e+09;-2.26703e+08;-1;0;0;0;-1;0;30632922;30632935;340
639;5.16627e-15;97;1697;12437;11493.5;1;337;-2.14748e+09;-2.21775e+08;-1;0;0;0;-1;0;31589215;31589230;379
640;5.16627e-15;95;1696;12437;11493.5;1;337;-2.14748e+09;-2.16994e+08;-1;0;0;0;-1;0;32555081;32555098;421
641;5.16627e-15;95;1696;12437;11493.5;1;337;-2.14748e+09;-2.12356e+08;-1;0;0;0;-1;0;33530210;33530230;467
642;5.16627e-15;94;1695;12437;11493.5;1;337;-2.14748e+09;-2.07855e+08;-1;0;0;0;-1;0;34514298;34514320;517
643;5.16627e-15;93;1695;12437;11493.5;1;337;-2.14748e+09;-2.03486e+08;-1;0;0;0;-1;0;35507041;35507065;572
644;5.16627e-15;93;1695;12437;11493.5;1;337;-2.14748e+09;-1.99245e+08;-1;0;0;0;-1;0;36508138;36508166;632
645;5.16627e-15;93;1695;12437;11493.5;1;337;-2.14748e+09;-1.95127e+08;-1;0;0;0;-1;0;37517293;37517324;697
646;5.16627e-15;92;1695;12437;11493.5;1;337;-2.14748e+09;-1.91128e+08;-1;0;0;0;-1;0;38534214;38534248;767
647;5.16627e-15;92;1695;12437;11493.5;1;337;-2.14748e+09;-1.87243e+08;-1;0;0;0;-1;0;39558609;39558647;843
648;5.16627e-15;91;1695;12437;11493.5;1;337;-2.14748e+09;-1.83469e+08;-1;0;0;0;-1;0;40590194;40590236;926
649;5.16627e-15;83;1695;12437;11493.5;1;337;-2.14748e+09;-1.79803e+08;-1;0;0;0;-1;0;41628686;41628732;1015
650;5.16627e-15;82;1695;12437;11493.5;1;337;-2.14748e+09;-1.76239e+08;-1;0;0;0;-1;0;42673808;42673858;1111
651;5.16627e-15;81;1694;12437;11493.5;1;337;-2.14748e+09;-1.72776e+08;-1;0;0;0;-1;0;43725285;43725340;1214
652;5.16627e-15;80;1694;12437;11493.5;1;337;-2.14748e+09;-1.69408e+08;-1;0;0;0;-1;0;44782848;44782909;1326
653;5.16627e-15;80;1694;12437;11493.5;1;337;-2.14748e+09;-1.66134e+08;-1;0;0;0;-1;0;45846232;45846298;1445
654;5.16627e-15;80;1694;12437;11493.5;1;337;-2.14748e+09;-1.6295e+08;-1;0;0;0;-1;0;46915175;46915248;1574
655;5.16627e-15;80;1694;12437;11493.5;1;337;-2.14748e+09;-1.59852e+08;-1;0;0;0;-1;0;47989423;47989502;1712
656;5.16627e-15;80;1694;12437;11493.5;1;337;-2.14748e+09;-1.56839e+08;-1;0;0;0;-1;0;49068721;49068807;1860
657;5.16627e-15;79;1694;12437;11493.5;1;337;-2.14748e+09;-1.53907e+08;-1;0;0;0;-1;0;50152824;50152917;2018
658;5.16627e-15;77;1694;12437;11493.5;1;337;-2.14748e+09;-1.51054e+08;-1;0;0;0;-1;0;51241487;51241589;2186
659;5.16627e-15;77;1694;12437;11493.5;1;337;-2.14748e+09;-1.48277e+08;-1;0;0;0;-1;0;52334473;52334584;2367
660;5.16627e-15;76;1694;12437;11493.5;1;337;-2.14748e+09;-1.45573e+08;-1;0;0;0;-1;0;53431548;53431668;2559
661;5.16627e-15;75;1694;12437;11493.5;1;337;-2.14748e+09;-1.42941e+08;-1;0;0;0;-1;0;54532483;54532613;2764
662;5.16627e-15;74;1694;12437;11493.5;1;337;-2.14748e+09;-1.40378e+08;-1;0;0;0;-1;0;55637054;55637194;2982
663;5.16627e-15;72;1694;12437;11493.5;1;337;-2.14748e+09;-1.37881e+08;-1;0;0;0;-1;0;56745040;56745192;3214
664;5.16627e-15;72;1694;12437;11493.5;1;337;-2.14748e+09;-1.35448e+08;-1;0;0;0;-1;0;57856226;57856390;3461
665;5.16627e-15;69;1694;12437;11493.5;1;337;-2.14748e+09;-1.33079e+08;-1;0;0;0;-1;0;58970402;58970579;3722
666;5.16627e-15;67;1694;12437;11493.5;1;337;-2.14748e+09;-1.30769e+08;-1;0;0;0;-1;0;60087362;60087552;4000
667;5.16627e-15;67;1693;12437;11493.5;1;337;-2.14748e+09;-1.28519e+08;-1;0;0;0;-1;0;61206903;61207107;4294
668;5.16627e-15;66;1693;12437;11493.5;1;337;-2.14748e+09;-1.26325e+08;-1;0;0;0;-1;0;62328829;62329048;4605
669;5.16627e-15;65;1693;12437;11493.5;1;337;-2.14748e+09;-1.24186e+08;-1;0;0;0;-1;0;63452947;63453183;4935
670;5.16627e-15;65;1693;12437;11493.5;1;337;-2.14748e+09;-1.221e+08;-1;0;0;0;-1;0;64579069;64579322;5283
671;5.16627e-15;65;1693;12437;11493.5;1;337;-2.14748e+09;-1.20066e+08;-1;0;0;0;-1;0;65707012;65707284;5651
672;5.16627e-15;65;1693;12437;11493.5;1;337;-2.14748e+09;-1.18082e+08;-1;0;0;0;-1;0;66836596;66836887;6039
673;5.16627e-15;63;1693;12437;11493.5;1;337;-2.14748e+09;-1.16147e+08;0;0;-1;0;0;-1;67967647;67967958;6448
674;5.16627e-15;60;1692;12437;11493.5;1;337;-2.14748e+09;-1.14258e+08;-1;0;0;0;-1;0;69099992;69100325;6879
675;5.16627e-15;60;1692;12437;11493.5;1;337;-2.14748e+09;-1.12415e+08;-1;0;0;0;-1;0;70233467;70233822;7333
676;5.16627e-15;60;1692;12437;11493.5;1;337;-2.14748e+09;-1.10617e+08;-1;0;0;0;-1;0;71367907;71368288;7811
677;5.16627e-15;60;1692;12437;11493.5;1;337;-2.14748e+09;-1.08861e+08;-1;0;0;0;-1;0;72503157;72503563;8313
678;5.16627e-15;57;1692;12437;11493.5;1;337;-2.14748e+09;-1.07148e+08;-1;0;0;0;-1;0;73639061;73639493;8841
679;5.16627e-15;57;1692;12437;11493.5;1;337;-2.14748e+09;-1.05474e+08;-1;0;0;0;-1;0;74775469;74775930;9395
680;5.16627e-15;57;1692;12437;11493.5;1;337;-2.14748e+09;-1.0384e+08;-1;0;0;0;-1;0;75912236;75912726;9976
681;5.16627e-15;57;1692;12437;11493.5;1;337;-2.14748e+09;-1.02244e+08;-1;0;0;0;-1;0;77049218;77049740;10585
682;5.16627e-15;57;1692;12437;11493.5;1;337;-2.14748e+09;-1.00684e+08;-1;0;0;0;-1;0;78186278;78186832;11224
683;5.16627e-15;57;1692;12437;11493.5;1;337;-2.14748e+09;-9.9161e+07;-1;0;0;0;-1;0;79323281;79323869;11893
684;5.16627e-15;55;1692;12437;11493.5;1;337;-2.14748e+09;-9.76726e+07;0;0;-1;0;0;-1;80460096;80460720;12593
685;5.16627e-15;55;1692;12437;11493.5;1;337;-2.14748e+09;-9.62178e+07;-1;0;0;0;-1;0;81596595;81597258;13325
686;5.16627e-15;55;1691;12437;11493.5;1;337;-2.14748e+09;-9.4796e+07;-1;0;0;0;-1;0;82732656;82733358;14091
687;5.16627e-15;55;1691;12437;11493.5;1;337;-2.14748e+09;-9.34062e+07;-1;0;0;0;-1;0;83868157;83868901;14890
688;5.16627e-15;47;1691;12437;11493.5;1;337;-2.14748e+09;-9.20473e+07;-1;0;0;0;-1;0;85002983;85003771;15725
689;5.16627e-15;45;1691;12437;11493.5;1;337;-2.14748e+09;-9.07187e+07;-1;0;0;0;-1;0;86137020;86137853;16596
690;5.16627e-15;45;1691;12437;11493.5;1;337;-2.14748e+09;-8.94192e+07;-1;0;0;0;-1;0;87270158;87271039;17505
691;5.16627e-15;45;1691;12437;11493.5;1;337;-2.14748e+09;-8.81483e+07;-1;0;0;0;-1;0;88402290;88403222;18452
692;5.16627e-15;44;1691;12437;11493.5;1;337;-2.14748e+09;-8.69051e+07;-1;0;0;0;-1;0;89533314;89534297;19438
693;5.16627e-15;41;1691;12437;11493.5;1;337;-2.14748e+09;-8.56888e+07;-1;0;0;0;-1;0;90663128;90664166;20466
694;5.16627e-15;41;1691;12437;11493.5;1;337;-2.14748e+09;-8.44987e+07;-1;0;0;0;-1;0;91791635;91792731;21535
695;5.16627e-15;40;1691;12437;11493.5;1;337;-2.14748e+09;-8.33342e+07;-1;0;0;0;-1;0;92918742;92919898;22647
696;5.16627e-15;40;1691;12437;11493.5;1;337;-2.14748e+09;-8.21942e+07;-1;0;0;0;-1;0;94044357;94045575;23804
697;5.16627e-15;40;1691;12437;11493.5;1;337;-2.14748e+09;-8.10785e+07;-1;0;0;0;-1;0;95168392;95169675;25005
698;5.16627e-15;40;1691;12437;11493.5;1;337;-2.14748e+09;-7.99863e+07;-1;0;0;0;-1;0;96290761;96292112;26253
699;5.16627e-15;39;1691;12437;11493.5;1;337;-2.14748e+09;-7.89167e+07;-1;0;0;0;-1;0;97411382;97412803;27549
700;5.16627e-15;35;1691;12437;11493.5;1;337;-2.14748e+09;-7.78695e+07;-1;0;0;0;-1;0;98530174;98531668;28894
701;5.16627e-15;35;1691;12437;11493.5;1;337;-2.14748e+09;-7.68437e+07;-1;0;0;0;-1;0;99647061;99648631;30288
702;5.16627e-15;34;1691;12437;11493.5;1;337;-2.14748e+09;-7.58392e+07;-1;0;0;0;-1;0;100761967;100763617;31734
703;5.16627e-15;33;1691;12437;11493.5;1;337;-2.14748e+09;-7.4855e+07;-1;0;0;0;-1;0;101874821;101876553;33233
704;5.16627e-15;33;1691;12437;11493.5;1;337;-2.14748e+09;-7.38908e+07;-1;0;0;0;-1;0;102985552;102987369;34785
705;5.16627e-15;33;1691;12437;11493.5;1;337;-2.14748e+09;-7.2946e+07;-1;0;0;0;-1;0;104094094;104096000;36392
706;5.16627e-15;33;1691;12437;11493.5;1;337;-2.14748e+09;-7.20202e+07;-1;0;0;0;-1;0;105200381;105202380;38055
707;5.16627e-15;32;1691;12437;11493.5;1;337;-2.14748e+09;-7.11128e+07;-1;0;0;0;-1;0;106304350;106306446;39776
708;5.16627e-15;32;1691;12437;11493.5;1;337;-2.14748e+09;-7.02234e+07;-1;0;0;0;-1;0;107405942;107408137;41555
709;5.16627e-15;30;1691;12437;11493.5;1;337;-2.14748e+09;-6.93515e+07;-1;0;0;0;-1;0;108505098;108507397;43394
710;5.16627e-15;30;1691;12437;11493.5;1;337;-2.14748e+09;-6.84966e+07;-1;0;0;0;-1;0;109601763;109604169;45295
711;5.16627e-15;30;1691;12437;11493.5;1;337;-2.14748e+09;-6.76584e+07;-1;0;0;0;-1;0;110695882;110698399;47258
712;5.16627e-15;28;1691;12437;11493.5;1;337;-2.14748e+09;-6.68363e+07;-1;0;0;0;-1;0;111787404;111790036;49285
713;5.16627e-15;28;1691;12437;11493.5;1;337;-2.14748e+09;-6.60301e+07;-1;0;0;0;-1;0;112876279;112879029;51377
714;5.16627e-15;28;1691;12437;11493.5;1;337;-2.14748e+09;-6.52393e+07;-1;0;0;0;-1;0;113962459;113965331;53535
715;5.16627e-15;28;1691;12437;11493.5;1;337;-2.14748e+09;-6.44635e+07;-1;0;0;0;-1;0;115045897;115048897;55762
716;5.16627e-15;23;1691;12437;11493.5;1;337;-2.14748e+09;-6.37024e+07;-1;0;0;0;-1;0;116126550;116129683;58057
717;5.16627e-15;23;1691;12437;11493.5;1;337;-2.14748e+09;-6.29556e+07;-1;0;0;0;-1;0;117204376;117207645;60422
718;5.16627e-15;19;1691;12437;11493.5;1;337;-2.14748e+09;-6.22227e+07;-1;0;0;0;-1;0;118279333;118282744;62859
719;5.16627e-15;17;1691;12437;11493.5;1;337;-2.14748e+09;-6.15032e+07;-1;0;0;0;-1;0;119351383;119354940;65369
720;5.16627e-15;17;1691;12437;11493.5;1;337;-2.14748e+09;-6.07973e+07;-1;0;0;0;-1;0;120420490;120424197;67953
721;5.16627e-15;16;1691;12437;11493.5;1;337;-2.14748e+09;-6.01041e+07;-1;0;0;0;-1;0;121486616;121490479;70612
722;5.16627e-15;16;1691;12437;11493.5;1;337;-2.14748e+09;-5.94236e+07;-1;0;0;0;-1;0;122549729;122553753;73348
723;5.16627e-15;16;1691;12437;11493.5;1;337;-2.14748e+09;-5.87556e+07;-1;0;0;0;-1;0;123609795;123613985;76163
724;5.16627e-15;16;1691;12437;11493.5;1;337;-2.14748e+09;-5.80994e+07;-1;0;0;0;-1;0;124666785;124671146;79057
725;5.16627e-15;16;1691;12437;11493.5;1;337;-2.14748e+09;-5.74551e+07;-1;0;0;0;-1;0;125720668;125725205;82031
726;5.16627e-15;15;1691;12437;11493.5;1;337;-2.14748e+09;-5.68223e+07;-1;0;0;0;-1;0;126771416;126776136;85088
727;5.16627e-15;14;1691;12437;11493.5;1;337;-2.14748e+09;-5.62006e+07;-1;0;0;0;-1;0;127819003;127823911;88228
728;5.16627e-15;13;1691;12437;11493.5;1;337;-2.14748e+09;-5.55901e+07;-1;0;0;0;-1;0;128863404;128868505;91453
729;5.16627e-15;13;1691;12437;11493.5;1;337;-2.14748e+09;-5.499e+07;-1;0;0;0;-1;0;129904594;129909894;94763
730;5.16627e-15;10;1691;12437;11493.5;1;337;-2.14748e+09;-5.44004e+07;-1;0;0;0;-1;0;130942550;130948056;98161
731;5.16627e-15;10;1691;12437;11493.5;1;337;-2.14748e+09;-5.38211e+07;-1;0;0;0;-1;0;131977251;131982970;101648
732;5.16627e-15;8;1691;12437;11493.5;1;337;-2.14748e+09;-5.32518e+07;-1;0;0;0;-1;0;133008677;133014614;105224
733;5.16627e-15;4;1691;12437;11493.5;1;337;-2.14748e+09;-5.26921e+07;-1;0;0;0;-1;0;134036809;134042970;108892
734;5.16627e-15;4;1691;12437;11493.5;1;337;-2.14748e+09;-5.2142e+07;-1;0;0;0;-1;0;135061629;135068021;112652
735;5.16627e-15;4;1690;12437;11493.5;1;337;-2.14748e+09;-5.16013e+07;-1;0;0;0;-1;0;136083119;136089749;116505
736;5.16627e-15;4;1690;12437;11493.5;1;337;-2.14748e+09;-5.10696e+07;-1;0;0;0;-1;0;137101264;137108138;120454
737;5.16627e-15;3;1690;12437;11493.5;1;337;-2.14748e+09;-5.05468e+07;-1;0;0;0;-1;0;138116049;138123175;124499
738;5.16627e-15;3;1690;12437;11493.5;1;337;-2.14748e+09;-5.00327e+07;-1;0;0;0;-1;0;139127460;139134844;128642
739;5.16627e-15;2;1690;12437;11493.5;1;337;-2.14748e+09;-4.95272e+07;-1;0;0;0;-1;0;140135485;140143135;132884
740;5.16627e-15;1;1690;12437;11493.5;1;337;-2.14748e+09;-4.90299e+07;-1;0;0;0;-1;0;141140112;141148035;137225
741;5.16627e-15;-1;1690;12437;11493.5;1;337;-2.14748e+09;-4.85409e+07;0;0;0;0;0;0;142141329;142149532;141668
742;5.16627e-15;-2;1690;12437;11493.5;1;337;-2.14748e+09;-4.80597e+07;0;0;0;0;0;0;143139127;143147618;146214
743;5.16627e-15;-3;1690;12437;11493.5;1;337;-2.14748e+09;-4.75863e+07;0;0;0;0;0;0;144133496;144142283;150864
744;5.16627e-15;-4;1690;12437;11493.5;1;337;-2.14748e+09;-4.71205e+07;0;0;0;0;0;0;145124429;145133519;155618
745;5.16627e-15;-5;1690;12437;11493.5;1;337;-2.14748e+09;-4.66622e+07;0;0;0;0;0;0;146111917;146121319;160479
746;5.16627e-15;-6;1690;12437;11493.5;1;337;-2.14748e+09;-4.62113e+07;0;0;0;0;0;0;147095954;147105676;165448
747;5.16627e-15;-7;1690;12437;11493.5;1;337;-2.14748e+09;-4.57674e+07;0;0;0;0;0;0;148076534;148086584;170525
748;5.16627e-15;-8;1690;12437;11493.5;1;337;-2.14748e+09;-4.53305e+07;0;0;0;0;0;0;149053653;149064038;175712
749;5.16627e-15;-8;1690;12437;11493.5;1;337;-2.14748e+09;-4.49004e+07;-1;0;0;0;-1;0;150027304;150038035;181010
750;5.16627e-15;-9;1690;12437;11493.5;1;337;-2.14748e+09;-4.44771e+07;0;0;0;0;0;0;150997485;151008569;186421
751;5.16627e-15;-10;1690;12437;11493.5;1;337;-2.14748e+09;-4.40603e+07;0;0;0;0;0;0;151964192;151975638;191945
752;5.16627e-15;-11;1690;12437;11493.5;1;337;-2.14748e+09;-4.36499e+07;0;0;0;0;0;0;152927424;152939241;197584
753;5.16627e-15;-11;1690;12437;11493.5;1;337;-2.14748e+09;-4.32458e+07;-1;0;0;0;-1;0;153887177;153899375;203339
754;5.16627e-15;-12;1690;12437;11493.5;1;337;-2.14748e+09;-4.2848e+07;0;0;0;0;0;0;154843452;154856039;209211
755;5.16627e-15;-12;1690;12437;11493.5;1;337;-2.14748e+09;-4.2456e+07;-1;0;0;0;-1;0;155796247;155809233;215201
756;5.16627e-15;-12;1689;12437;11493.5;1;337;-2.14748e+09;-4.207e+07;0;0;0;0;0;0;156745562;156758957;221310
757;5.16627e-15;-12;1689;12437;11493.5;1;337;-2.14748e+09;-4.16897e+07;-1;0;0;0;-1;0;157691398;157705212;227539
758;5.16627e-15;-13;1689;12437;11493.5;1;337;-2.14748e+09;-4.13152e+07;0;0;0;0;0;0;158633756;158647998;233890
759;5.16627e-15;-14;1689;12437;11493.5;1;337;-2.14748e+09;-4.09462e+07;0;0;0;0;0;0;159572638;159587318;240364
760;5.16627e-15;-15;1689;12437;11493.5;1;337;-2.14748e+09;-4.05826e+07;0;0;0;0;0;0;160508045;160523173;246961
761;5.16627e-15;-15;1689;12437;11493.5;1;337;-2.14748e+09;-4.02244e+07;-1;0;0;0;-1;0;161439981;161455567;253684
762;5.16627e-15;-16;1689;12437;11493.5;1;337;-2.14748e+09;-3.98714e+07;0;0;0;0;0;0;162368447;162384503;260532
763;5.16627e-15;-17;1689;12437;11493.5;1;337;-2.14748e+09;-3.95235e+07;0;0;0;0;0;0;163293449;163309984;267506
764;5.16627e-15;-18;1689;12437;11493.5;1;337;-2.14748e+09;-3.91808e+07;0;0;0;0;0;0;164214989;164232014;274609
765;5.16627e-15;-18;1689;12437;11493.5;1;337;-2.14748e+09;-3.88428e+07;-1;0;0;0;-1;0;165133072;165150598;281841
766;5.16627e-15;-18;1689;12437;11493.5;1;337;-2.14748e+09;-3.85097e+07;-1;0;0;0;-1;0;166047702;166065741;289202
767;5.16627e-15;-19;1689;12437;11493.5;1;337;-2.14748e+09;-3.81813e+07;0;0;0;0;0;0;166958886;166977448;296695
768;5.16627e-15;-19;1689;12437;11493.5;1;337;-2.14748e+09;-3.78576e+07;-1;0;0;0;-1;0;167866628;167885724;304320
769;5.16627e-15;-20;1689;12437;11493.5;1;337;-2.14748e+09;-3.75384e+07;0;0;0;0;0;0;168770934;168790577;312077
770;5.16627e-15;-20;1689;12437;11493.5;1;337;-2.14748e+09;-3.72237e+07;-1;0;0;0;-1;0;169671811;169692012;319969
771;5.16627e-15;-20;1689;12437;11493.5;1;337;-2.14748e+09;-3.69134e+07;-1;0;0;0;-1;0;170569266;170590035;327995
772;5.16627e-15;-20;1689;12437;11493.5;1;337;-2.14748e+09;-3.66073e+07;-1;0;0;0;-1;0;171463304;171484655;336157
773;5.16627e-15;-21;1689;12437;11493.5;1;337;-2.14748e+09;-3.63055e+07;0;0;0;0;0;0;172353933;172375878;344456
774;5.16627e-15;-21;1689;12437;11493.5;1;337;-2.14748e+09;-3.60078e+07;-1;0;0;0;-1;0;173241162;173263712;352892
775;5.16627e-15;-21;1689;12437;11493.5;1;337;-2.14748e+09;-3.57142e+07;-1;0;0;0;-1;0;174124997;174148165;361467
776;5.16627e-15;-22;1689;12437;11493.5;1;337;-2.14748e+09;-3.54246e+07;0;0;0;0;0;0;175005447;175029246;370182
777;5.16627e-15;-23;1689;12437;11493.5;1;337;-2.14748e+09;-3.51389e+07;0;0;0;0;0;0;175882520;175906962;379036
778;5.16627e-15;-24;1689;12437;11493.5;1;337;-2.14748e+09;-3.4857e+07;0;0;0;0;0;0;176756225;176781323;388032
779;5.16627e-15;-24;1689;12437;11493.5;1;337;-2.14748e+09;-3.45788e+07;-1;0;0;0;-1;0;177626570;177652338;397170
780;5.16627e-15;-24;1689;12437;11493.5;1;337;-2.14748e+09;-3.43044e+07;-1;0;0;0;-1;0;178493566;178520015;406451
781;5.16627e-15;-25;1689;12437;11493.5;1;337;-2.14748e+09;-3.40336e+07;0;0;0;0;0;0;179357220;179384365;415876
782;5.16627e-15;-25;1689;12437;11493.5;1;337;-2.14748e+09;-3.37664e+07;-1;0;0;0;-1;0;180217543;180245398;425445
783;5.16627e-15;-25;1689;12437;11493.5;1;337;-2.14748e+09;-3.35026e+07;-1;0;0;0;-1;0;181074545;181103122;435159
784;5.16627e-15;-26;1689;12437;11493.5;1;337;-2.14748e+09;-3.32423e+07;0;0;0;0;0;0;181928235;181957548;445019
785;5.16627e-15;-26;1689;12437;11493.5;1;337;-2.14748e+09;-3.29854e+07;-1;0;0;0;-1;0;182778623;182808688;455026
786;5.16627e-15;-27;1689;12437;11493.5;1;337;-2.14748e+09;-3.27318e+07;0;0;0;0;0;0;183625721;183656550;465181
787;5.16627e-15;-28;1689;12437;11493.5;1;337;-2.14748e+09;-3.24814e+07;0;0;0;0;0;0;184469538;184501146;475484
788;5.16627e-15;-28;1689;12437;11493.5;1;337;-2.14748e+09;-3.22343e+07;-1;0;0;0;-1;0;185310085;185342486;485936
789;5.16627e-15;-29;1689;12437;11493.5;1;337;-2.14748e+09;-3.19902e+07;0;0;0;0;0;0;186147373;186180582;496537
790;5.16627e-15;-30;1689;12437;11493.5;1;337;-2.14748e+09;-3.17492e+07;0;0;0;0;0;0;186981414;187015445;507289
791;5.16627e-15;-31;1689;12437;11493.5;1;337;-2.14748e+09;-3.15113e+07;0;0;0;0;0;0;187812217;187847086;518192
792;5.16627e-15;-31;1689;12437;11493.5;1;337;-2.14748e+09;-3.12764e+07;-1;0;0;0;-1;0;188639795;188675517;529247
793;5.16627e-15;-32;1689;12437;11493.5;1;337;-2.14748e+09;-3.10444e+07;0;0;0;0;0;0;189464159;189500748;540455
794;5.16627e-15;-32;1689;12437;11493.5;1;337;-2.14748e+09;-3.08153e+07;-1;0;0;0;-1;0;190285320;190322793;551815
795;5.16627e-15;-33;1689;12437;11493.5;1;337;-2.14748e+09;-3.0589e+07;0;0;0;0;0;0;191103291;191141662;563329
796;5.16627e-15;-33;1689;12437;11493.5;1;337;-2.14748e+09;-3.03654e+07;-1;0;0;0;-1;0;191918082;191957367;574997
797;5.16627e-15;-34;1689;12437;11493.5;1;337;-2.14748e+09;-3.01446e+07;0;0;0;0;0;0;192729706;192769921;586820
798;5.16627e-15;-34;1688;12437;11493.5;1;337;-2.14748e+09;-2.99265e+07;0;0;0;0;0;0;193538174;193579336;598799
799;5.16627e-15;-34;1688;12437;11493.5;1;337;-2.14748e+09;-2.97111e+07;-1;0;0;0;-1;0;194343500;194385624;610933
800;5.16627e-15;-34;1688;12437;11493.5;1;337;-2.14748e+09;-2.94982e+07;-1;0;0;0;-1;0;195145695;195188797;623224
801;5.16627e-15;-34;1688;12437;11493.5;1;337;-2.14748e+09;-2.92879e+07;-1;0;0;0;-1;0;195944770;195988868;635672
802;5.16627e-15;-34;1688;12437;11493.5;1;337;-2.14748e+09;-2.90801e+07;-1;0;0;0;-1;0;196740740;196785849;648278
803;5.16627e-15;-35;1688;12437;11493.5;1;337;-2.14748e+09;-2.88747e+07;0;0;0;0;0;0;197533615;197579753;661042
804;5.16627e-15;-36;1688;12437;11493.5;1;337;-2.14748e+09;-2.86718e+07;0;0;0;0;0;0;198323408;198370592;673964
805;5.16627e-15;-36;1688;12437;11493.5;1;337;-2.14748e+09;-2.84713e+07;-1;0;0;0;-1;0;199110133;199158379;687046
806;5.16627e-15;-36;1688;12437;11493.5;1;337;-2.14748e+09;-2.82731e+07;-1;0;0;0;-1;0;199893801;199943127;700287
807;5.16627e-15;-36;1688;12437;11493.5;1;337;-2.14748e+09;-2.80773e+07;-1;0;0;0;-1;0;200674426;200724848;713688
808;5.16627e-15;-37;1688;12437;11493.5;1;337;-2.14748e+09;-2.78837e+07;0;0;0;0;0;0;201452019;201503556;727249
809;5.16627e-15;-38;1688;12437;11493.5;1;337;-2.14748e+09;-2.76923e+07;0;0;0;0;0;0;202226593;202279263;740971
810;5.16627e-15;-39;1688;12437;11493.5;1;337;-2.14748e+09;-2.75033e+07;0;0;0;0;0;0;202998163;203051983;754854
811;5.16627e-15;-40;1688;12437;11493.5;1;337;-2.14748e+09;-2.73162e+07;0;0;0;0;0;0;203766739;203821727;768899
812;5.16627e-15;-41;1688;12437;11493.5;1;337;-2.14748e+09;-2.71313e+07;0;0;0;0;0;0;204532335;204588510;783106
813;5.16627e-15;-42;1688;12437;11493.5;1;337;-2.14748e+09;-2.69486e+07;0;0;0;0;0;0;205294965;205352345;797476
814;5.16627e-15;-43;1688;12437;11493.5;1;337;-2.14748e+09;-2.67678e+07;0;0;0;0;0;0;206054640;206113243;812008
815;5.16627e-15;-43;1688;12437;11493.5;1;337;-2.14748e+09;-2.65892e+07;-1;0;0;0;-1;0;206811374;206871219;826703
816;5.16627e-15;-43;1688;12437;11493.5;1;337;-2.14748e+09;-2.64125e+07;-1;0;0;0;-1;0;207565180;207626286;841561
817;5.16627e-15;-43;1688;12437;11493.5;1;337;-2.14748e+09;-2.62378e+07;-1;0;0;0;-1;0;208316071;208378456;856583
818;5.16627e-15;-43;1688;12437;11493.5;1;337;-2.14748e+09;-2.6065e+07;-1;0;0;0;-1;0;209064059;209127744;871769
819;5.16627e-15;-43;1688;12437;11493.5;1;337;-2.14748e+09;-2.58941e+07;-1;0;0;0;-1;0;209809158;209874161;887120
820;5.16627e-15;-44;1688;12437;11493.5;1;337;-2.14748e+09;-2.57251e+07;0;0;0;0;0;0;210551381;210617721;902634
821;5.16627e-15;-45;1688;12437;11493.5;1;337;-2.14748e+09;-2.5558e+07;0;0;0;0;0;0;211290741;211358438;918314
822;5.16627e-15;-46;1688;12437;11493.5;1;337;-2.14748e+09;-2.53927e+07;0;0;0;0;0;0;212027250;212096324;934158
823;5.16627e-15;-46;1688;12437;11493.5;1;337;-2.14748e+09;-2.52292e+07;-1;0;0;0;-1;0;212760922;212831393;950168
824;5.16627e-15;-47;1688;12437;11493.5;1;337;-2.14748e+09;-2.50674e+07;0;0;0;0;0;0;213491770;213563658;966343
825;5.16627e-15;-48;1688;12437;11493.5;1;337;-2.14748e+09;-2.49074e+07;0;0;0;0;0;0;214219807;214293132;982684
826;5.16627e-15;-49;1688;12437;11493.5;1;337;-2.14748e+09;-2.47491e+07;0;0;0;0;0;0;214945046;215019828;999191
827;5.16627e-15;-50;1688;12437;11493.5;1;337;-2.14748e+09;-2.45925e+07;0;0;0;0;0;0;215667500;215743759;1015864
828;5.16627e-15;-51;1688;12437;11493.5;1;337;-2.14748e+09;-2.44375e+07;0;0;0;0;0;0;216387181;216464939;1032703
829;5.16627e-15;-52;1688;12437;11493.5;1;337;-2.14748e+09;-2.42842e+07;0;0;0;0;0;0;217104103;217183380;1049708
830;5.16627e-15;-53;1688;12437;11493.5;1;337;-2.14748e+09;-2.41324e+07;0;0;0;0;0;0;217818279;217899096;1066879
831;5.16627e-15;-53;1688;12437;11493.5;1;337;-2.14748e+09;-2.39823e+07;-1;0;0;0;-1;0;218529722;218612100;1084217
832;5.16627e-15;-54;1688;12437;11493.5;1;337;-2.14748e+09;-2.38337e+07;0;0;0;0;0;0;219238444;219322404;1101722
833;5.16627e-15;-54;1688;12437;11493.5;1;337;-2.14748e+09;-2.36867e+07;-1;0;0;0;-1;0;219944459;220030023;1119394
834;5.16627e-15;-54;1688;12437;11493.5;1;337;-2.14748e+09;-2.35412e+07;-1;0;0;0;-1;0;220647779;220734968;1137232
835;5.16627e-15;-54;1688;12437;11493.5;1;337;-2.14748e+09;-2.33972e+07;-1;0;0;0;-1;0;221348418;221437254;1155238
836;5.16627e-15;-55;1688;12437;11493.5;1;337;-2.14748e+09;-2.32547e+07;0;0;0;0;0;0;222046388;222136892;1173410
837;5.16627e-15;-55;1688;12437;11493.5;1;337;-2.14748e+09;-2.31136e+07;-1;0;0;0;-1;0;222741701;222833896;1191750
838;5.16627e-15;-55;1688;12437;11493.5;1;337;-2.14748e+09;-2.29739e+07;-1;0;0;0;-1;0;223434371;223528279;1210256
839;5.16627e-15;-55;1688;12437;11493.5;1;337;-2.14748e+09;-2.28357e+07;-1;0;0;0;-1;0;224124411;224220053;1228930
840;5.16627e-15;-56;1688;12437;11493.5;1;337;-2.14748e+09;-2.26989e+07;0;0;0;0;0;0;224811832;224909232;1247771
841;5.16627e-15;-57;1688;12437;11493.5;1;337;-2.14748e+09;-2.25634e+07;0;0;0;0;0;0;225496649;225595828;1266779
842;5.16627e-15;-57;1688;12437;11493.5;1;337;-2.14748e+09;-2.24293e+07;-1;0;0;0;-1;0;226178873;226279854;1285954
843;5.16627e-15;-57;1688;12437;11493.5;1;337;-2.14748e+09;-2.22966e+07;-1;0;0;0;-1;0;226858517;226961324;1305296
844;5.16627e-15;-57;1688;12437;11493.5;1;337;-2.14748e+09;-2.21652e+07;-1;0;0;0;-1;0;227535593;227640248;1324805
845;5.16627e-15;-57;1688;12437;11493.5;1;337;-2.14748e+09;-2.20349e+07;-1;0;0;0;-1;0;228210115;228316641;1344482
846;5.16627e-15;-58;1688;12437;11493.5;1;337;-2.14748e+09;-2.19061e+07;0;0;0;0;0;0;228882094;228990515;1364325
847;5.16627e-15;-58;1688;12437;11493.5;1;337;-2.14748e+09;-2.17784e+07;-1;0;0;0;-1;0;229551544;229661882;1384335
848;5.16627e-15;-58;1688;12437;11493.5;1;337;-2.14748e+09;-2.16522e+07;-1;0;0;0;-1;0;230218475;230330755;1404512
849;5.16627e-15;-59;1688;12437;11493.5;1;337;-2.14748e+09;-2.15269e+07;0;0;0;0;0;0;230882902;230997147;1424856
850;5.16627e-15;-59;1688;12437;11493.5;1;337;-2.14748e+09;-2.1403e+07;-1;0;0;0;-1;0;231544836;231661069;1445366
851;5.16627e-15;-59;1688;12437;11493.5;1;337;-2.14748e+09;-2.12802e+07;-1;0;0;0;-1;0;232204289;232322535;1466043
852;5.16627e-15;-59;1688;12437;11493.5;1;337;-2.14748e+09;-2.11587e+07;-1;0;0;0;-1;0;232861274;232981557;1486886
853;5.16627e-15;-60;1688;12437;11493.5;1;337;-2.14748e+09;-2.10383e+07;0;0;0;0;0;0;233515803;233638146;1507896
854;5.16627e-15;-60;1688;12437;11493.5;1;337;-2.14748e+09;-2.09191e+07;-1;0;0;0;-1;0;234167888;234292317;1529072
855;5.16627e-15;-60;1688;12437;11493.5;1;337;-2.14748e+09;-2.08009e+07;-1;0;0;0;-1;0;234817541;234944079;1550414
856;5.16627e-15;-60;1688;12437;11493.5;1;337;-2.14748e+09;-2.06839e+07;-1;0;0;0;-1;0;235464775;235593447;1571921
857;5.16627e-15;-60;1688;12437;11493.5;1;337;-2.14748e+09;-2.05679e+07;-1;0;0;0;-1;0;236109600;236240431;1593595
858;5.16627e-15;-60;1688;12437;11493.5;1;337;-2.14748e+09;-2.04531e+07;-1;0;0;0;-1;0;236752030;236885044;1615433
859;5.16627e-15;-61;1688;12437;11493.5;1;337;-2.14748e+09;-2.03394e+07;0;0;0;0;0;0;237392075;237527299;1637437
860;5.16627e-15;-61;1688;12437;11493.5;1;337;-2.14748e+09;-2.02268e+07;-1;0;0;0;-1;0;238029749;238167206;1659607
861;5.16627e-15;-62;1688;12437;11493.5;1;337;-2.14748e+09;-2.0115e+07;0;0;0;0;0;0;238665062;238804778;1681941
862;5.16627e-15;-63;1688;12437;11493.5;1;337;-2.14748e+09;-2.00044e+07;0;0;0;0;0;0;239298027;239440027;1704440
863;5.16627e-15;-64;1688;12437;11493.5;1;337;-2.14748e+09;-1.98948e+07;0;0;0;0;0;0;239928655;240072965;1727103
864;5.16627e-15;-65;1688;12437;11493.5;1;337;-2.14748e+09;-1.97863e+07;0;0;0;0;0;0;240556958;240703603;1749930
865;5.16627e-15;-66;1688;12437;11493.5;1;337;-2.14748e+09;-1.96786e+07;0;0;0;0;0;0;241182947;241331953;1772922
866;5.16627e-15;-66;1688;12437;11493.5;1;337;-2.14748e+09;-1.95719e+07;-1;0;0;0;-1;0;241806634;241958027;1796077
867;5.16627e-15;-66;1688;12437;11493.5;1;337;-2.14748e+09;-1.94663e+07;-1;0;0;0;-1;0;242428031;242581837;1819396
868;5.16627e-15;-66;1688;12437;11493.5;1;337;-2.14748e+09;-1.93615e+07;-1;0;0;0;-1;0;243047148;243203394;1842878
869;5.16627e-15;-67;1688;12437;11493.5;1;337;-2.14748e+09;-1.92578e+07;0;0;0;0;0;0;243663998;243822709;1866523
870;5.16627e-15;-67;1688;12437;11493.5;1;337;-2.14748e+09;-1.91549e+07;-1;0;0;0;-1;0;244278591;244439794;1890330
871;5.16627e-15;-67;1688;12437;11493.5;1;337;-2.14748e+09;-1.9053e+07;-1;0;0;0;-1;0;244890940;245054660;1914300
872;5.16627e-15;-67;1688;12437;11493.5;1;337;-2.14748e+09;-1.89519e+07;-1;0;0;0;-1;0;245501054;245667319;1938432
873;5.16627e-15;-68;1688;12437;11493.5;1;337;-2.14748e+09;-1.88518e+07;0;0;0;0;0;0;246108946;246277782;1962725
874;5.16627e-15;-69;1688;12437;11493.5;1;337;-2.14748e+09;-1.87526e+07;0;0;0;0;0;0;246714626;246886061;1987180
875;5.16627e-15;-70;1688;12437;11493.5;1;337;-2.14748e+09;-1.86542e+07;0;0;0;0;0;0;247318106;247492166;2011796
876;5.16627e-15;-70;1688;12437;11493.5;1;337;-2.14748e+09;-1.85566e+07;-1;0;0;0;-1;0;247919396;248096108;2036573
877;5.16627e-15;-70;1688;12437;11493.5;1;337;-2.14748e+09;-1.846e+07;-1;0;0;0;-1;0;248518508;248697899;2061510
878;5.16627e-15;-70;1688;12437;11493.5;1;337;-2.14748e+09;-1.83641e+07;-1;0;0;0;-1;0;249115452;249297549;2086608
879;5.16627e-15;-71;1688;12437;11493.5;1;337;-2.14748e+09;-1.82692e+07;0;0;0;0;0;0;249710239;249895070;2111865
880;5.16627e-15;-72;1688;12437;11493.5;1;337;-2.14748e+09;-1.8175e+07;0;0;0;0;0;0;250302880;250490473;2137281
881;5.16627e-15;-72;1688;12437;11493.5;1;337;-2.14748e+09;-1.80816e+07;-1;0;0;0;-1;0;250893386;251083768;2162856
882;5.16627e-15;-72;1688;12437;11493.5;1;337;-2.14748e+09;-1.7989e+07;-1;0;0;0;-1;0;251481767;251674966;2188590
883;5.16627e-15;-72;1688;12437;11493.5;1;337;-2.14748e+09;-1.78972e+07;-1;0;0;0;-1;0;252068034;252264077;2214482
884;5.16627e-15;-73;1688;12437;11493.5;1;337;-2.14748e+09;-1.78062e+07;0;0;0;0;0;0;252652197;252851113;2240532
885;5.16627e-15;-73;1688;12437;11493.5;1;337;-2.14748e+09;-1.7716e+07;-1;0;0;0;-1;0;253234268;253436085;2266739
886;5.16627e-15;-74;1688;12437;11493.5;1;337;-2.14748e+09;-1.76265e+07;0;0;0;0;0;0;253814256;254019002;2293103
887;5.16627e-15;-75;1688;12437;11493.5;1;337;-2.14748e+09;-1.75378e+07;0;0;0;0;0;0;254392172;254599875;2319624
888;5.16627e-15;-75;1688;12437;11493.5;1;337;-2.14748e+09;-1.74498e+07;-1;0;0;0;-1;0;254968026;255178714;2346301
889;5.16627e-15;-76;1688;12437;11493.5;1;337;-2.14748e+09;-1.73625e+07;0;0;0;0;0;0;255541829;255755531;2373134
890;5.16627e-15;-77;1688;12437;11493.5;1;337;-2.14748e+09;-1.72761e+07;0;0;0;0;0;0;256113590;256330335;2400122
891;5.16627e-15;-78;1688;12437;11493.5;1;337;-2.14748e+09;-1.71902e+07;0;0;0;0;0;0;256683320;256903136;2427265
892;5.16627e-15;-79;1688;12437;11493.5;1;337;-2.14748e+09;-1.71052e+07;0;0;0;0;0;0;257251030;257473946;2454562
893;5.16627e-15;-80;1688;12437;11493.5;1;337;-2.14748e+09;-1.70207e+07;0;0;0;0;0;0;257816728;258042773;2482013
894;5.16627e-15;-80;1688;12437;11493.5;1;337;-2.14748e+09;-1.6937e+07;-1;0;0;0;-1;0;258380425;258609628;2509618
895;5.16627e-15;-81;1688;12437;11493.5;1;337;-2.14748e+09;-1.6854e+07;0;0;0;0;0;0;258942132;259174521;2537376
896;5.16627e-15;-82;1688;12437;11493.5;1;337;-2.14748e+09;-1.67716e+07;0;0;0;0;0;0;259501857;259737463;2565286
897;5.16627e-15;-82;1688;12437;11493.5;1;337;-2.14748e+09;-1.669e+07;-1;0;0;0;-1;0;260059611;260298462;2593349
898;5.16627e-15;-83;1688;12437;11493.5;1;337;-2.14748e+09;-1.66089e+07;0;0;0;0;0;0;260615404;260857530;2621563
899;5.16627e-15;-83;1688;12437;11493.5;1;337;-2.14748e+09;-1.65286e+07;-1;0;0;0;-1;0;261169244;261414675;2649928
900;5.16627e-15;-84;1688;12437;11493.5;1;337;-2.14748e+09;-1.64488e+07;0;0;0;0;0;0;261721143;261969907;2678444
901;5.16627e-15;-85;1688;12437;11493.5;1;337;-2.14748e+09;-1.63697e+07;0;0;0;0;0;0;262271109;262523237;2707110
902;5.16627e-15;-85;1688;12437;11493.5;1;337;-2.14748e+09;-1.62913e+07;-1;0;0;0;-1;0;262819153;263074673;2735926
903;5.16627e-15;-86;1688;12437;11493.5;1;337;-2.14748e+09;-1.62134e+07;0;0;0;0;0;0;263365283;263624226;2764891
904;5.16627e-15;-87;1688;12437;11493.5;1;337;-2.14748e+09;-1.61362e+07;0;0;0;0;0;0;263909509;264171905;2794005
905;5.16627e-15;-87;1688;12437;11493.5;1;337;-2.14748e+09;-1.60596e+07;-1;0;0;0;-1;0;264451840;264717720;2823266
906;5.16627e-15;-88;1688;12437;11493.5;1;337;-2.14748e+09;-1.59836e+07;0;0;0;0;0;0;264992286;265261679;2852676
907;5.16627e-15;-88;1688;12437;11493.5;1;337;-2.14748e+09;-1.59082e+07;-1;0;0;0;-1;0;265530857;265803793;2882232
908;5.16627e-15;-89;1688;12437;11493.5;1;337;-2.14748e+09;-1.58334e+07;0;0;0;0;0;0;266067560;266344070;2911936
909;5.16627e-15;-90;1688;12437;11493.5;1;337;-2.14748e+09;-1.57593e+07;0;0;0;0;0;0;266602406;266882520;2941785
910;5.16627e-15;-90;1688;12437;11493.5;1;337;-2.14748e+09;-1.56855e+07;-1;0;0;0;-1;0;267135404;267419152;2971779
911;5.16627e-15;-91;1688;12437;11493.5;1;337;-2.14748e+09;-1.56124e+07;0;0;0;0;0;0;267666563;267953975;3001919
912;5.16627e-15;-92;1688;12437;11493.5;1;337;-2.14748e+09;-1.55399e+07;0;0;0;0;0;0;268195891;268486999;3032203
913;5.16627e-15;-93;1688;12437;11493.5;1;337;-2.14748e+09;-1.54679e+07;0;0;0;0;0;0;268723398;269018232;3062631
914;5.16627e-15;-93;1688;12437;11493.5;1;337;-2.14748e+09;-1.53965e+07;-1;0;0;0;-1;0;269249092;269547683;3093202
915;5.16627e-15;-93;1688;12437;11493.5;1;337;-2.14748e+09;-1.53256e+07;-1;0;0;0;-1;0;269772983;270075362;3123916
916;5.16627e-15;-93;1688;12437;11493.5;1;337;-2.14748e+09;-1.52553e+07;-1;0;0;0;-1;0;270295079;270601277;3154773
917;5.16627e-15;-94;1688;12437;11493.5;1;337;-2.14748e+09;-1.51855e+07;0;0;0;0;0;0;270815390;271125437;3185771
918;5.16627e-15;-95;1688;12437;11493.5;1;337;-2.14748e+09;-1.51163e+07;0;0;0;0;0;0;271333923;271647851;3216910
919;5.16627e-15;-95;1688;12437;11493.5;1;337;-2.14748e+09;-1.50475e+07;-1;0;0;0;-1;0;271850687;272168527;3248189
920;5.16627e-15;-96;1688;12437;11493.5;1;337;-2.14748e+09;-1.49792e+07;0;0;0;0;0;0;272365692;272687474;3279608
921;5.16627e-15;-96;1688;12437;11493.5;1;337;-2.14748e+09;-1.49115e+07;-1;0;0;0;-1;0;272878945;273204702;3311167
922;5.16627e-15;-96;1688;12437;11493.5;1;337;-2.14748e+09;-1.48443e+07;-1;0;0;0;-1;0;273390455;273720218;3342865
923;5.16627e-15;-97;1688;12437;11493.5;1;337;-2.14748e+09;-1.47776e+07;0;0;0;0;0;0;273900230;274234031;3374701
924;5.16627e-15;-97;1688;12437;11493.5;1;337;-2.14748e+09;-1.47113e+07;-1;0;0;0;-1;0;274408280;274746149;3406674
925;5.16627e-15;-97;1688;12437;11493.5;1;337;-2.14748e+09;-1.46457e+07;-1;0;0;0;-1;0;274914612;275256581;3438784
926;5.16627e-15;-97;1688;12437;11493.5;1;337;-2.14748e+09;-1.45803e+07;-1;0;0;0;-1;0;275419234;275765336;3471031
927;5.16627e-15;-97;1688;12437;11493.5;1;337;-2.14748e+09;-1.45156e+07;0;0;-1;0;0;-1;275922155;276272421;3503414
928;5.16627e-15;-97;1688;12437;11493.5;1;337;-2.14748e+09;-1.44514e+07;-1;0;0;0;-1;0;276423384;276777845;3535932
929;5.16627e-15;-97;1688;12437;11493.5;1;337;-2.14748e+09;-1.43874e+07;-1;0;0;0;-1;0;276922927;277281615;3568584
930;5.16627e-15;-97;1688;12437;11493.5;1;337;-2.14748e+09;-1.43241e+07;-1;0;0;0;-1;0;277420794;277783741;3601371
931;5.16627e-15;-97;1688;12437;11493.5;1;337;-2.14748e+09;-1.42612e+07;-1;0;0;0;-1;0;277916992;278284231;3634291
932;5.16627e-15;-97;1688;12437;11493.5;1;337;-2.14748e+09;-1.41988e+07;-1;0;0;0;-1;0;278411530;278783091;3667344
933;5.16627e-15;-98;1688;12437;11493.5;1;337;-2.14748e+09;-1.41367e+07;0;0;0;0;0;0;278904415;279280332;3700529
934;5.16627e-15;-99;1688;12437;11493.5;1;337;-2.14748e+09;-1.40752e+07;0;0;0;0;0;0;279395655;279775959;3733845
935;5.16627e-15;-100;1688;12437;11493.5;1;337;-2.14748e+09;-1.4014e+07;0;0;0;0;0;0;279885258;280269982;3767293
936;5.16627e-15;-101;1688;12437;11493.5;1;337;-2.14748e+09;-1.39534e+07;0;0;0;0;0;0;280373232;280762408;3800871
937;5.16627e-15;-101;1688;12437;11493.5;1;337;-2.14748e+09;-1.38932e+07;-1;0;0;0;-1;0;280859584;281253245;3834578
938;5.16627e-15;-102;1688;12437;11493.5;1;337;-2.14748e+09;-1.38333e+07;0;0;0;0;0;0;281344324;281742501;3868415
939;5.16627e-15;-102;1688;12437;11493.5;1;337;-2.14748e+09;-1.37739e+07;-1;0;0;0;-1;0;281827457;282230183;3902380
940;5.16627e-15;-103;1688;12437;11493.5;1;337;-2.14748e+09;-1.3715e+07;0;0;0;0;0;0;282308992;282716300;3936473
941;5.16627e-15;-104;1688;12437;11493.5;1;337;-2.14748e+09;-1.36564e+07;0;0;0;0;0;0;282788936;283200858;3970693
942;5.16627e-15;-105;1688;12437;11493.5;1;337;-2.14748e+09;-1.35982e+07;0;0;0;0;0;0;283267297;283683866;4005040
943;5.16627e-15;-106;1688;12437;11493.5;1;337;-2.14748e+09;-1.35405e+07;0;0;0;0;0;0;283744082;284165331;4039513
944;5.16627e-15;-107;1688;12437;11493.5;1;337;-2.14748e+09;-1.34831e+07;0;0;0;0;0;0;284219299;284645260;4074111
945;5.16627e-15;-108;1688;12437;11493.5;1;337;-2.14748e+09;-1.34263e+07;0;0;0;0;0;0;284692955;285123661;4108834
946;5.16627e-15;-108;1688;12437;11493.5;1;337;-2.14748e+09;-1.33696e+07;-1;0;0;0;-1;0;285165058;285600541;4143681
947;5.16627e-15;-109;1688;12437;11493.5;1;337;-2.14748e+09;-1.33134e+07;0;0;0;0;0;0;285635615;286075908;4178652
948;5.16627e-15;-109;1688;12437;11493.5;1;337;-2.14748e+09;-1.32577e+07;-1;0;0;0;-1;0;286104632;286549770;4213745
949;5.16627e-15;-109;1688;12437;11493.5;1;337;-2.14748e+09;-1.32023e+07;-1;0;0;0;-1;0;286572118;287022132;4248960
950;5.16627e-15;-110;1688;12437;11493.5;1;337;-2.14748e+09;-1.31473e+07;0;0;0;0;0;0;287038080;287493003;4284297
951;5.16627e-15;-110;1688;12437;11493.5;1;337;-2.14748e+09;-1.30927e+07;-1;0;0;0;-1;0;287502524;287962389;4319755
952;5.16627e-15;-110;1688;12437;11493.5;1;337;-2.14748e+09;-1.30385e+07;-1;0;0;0;-1;0;287965458;288430298;4355333
953;5.16627e-15;-111;1688;12437;11493.5;1;337;-2.14748e+09;-1.29846e+07;0;0;0;0;0;0;288426888;288896737;4391030
954;5.16627e-15;-111;1688;12437;11493.5;1;337;-2.14748e+09;-1.29309e+07;-1;0;0;0;-1;0;288886823;289361713;4426846
955;5.16627e-15;-111;1688;12437;11493.5;1;337;-2.14748e+09;-1.28777e+07;-1;0;0;0;-1;0;289345268;289825233;4462781
956;5.16627e-15;-111;1688;12437;11493.5;1;337;-2.14748e+09;-1.2825e+07;-1;0;0;0;-1;0;289802231;290287304;4498833
957;5.16627e-15;-111;1688;12437;11493.5;1;337;-2.14748e+09;-1.27725e+07;-1;0;0;0;-1;0;290257718;290747933;4535003
958;5.16627e-15;-112;1688;12437;11493.5;1;337;-2.14748e+09;-1.27203e+07;0;0;0;0;0;0;290711737;291207126;4571288
959;5.16627e-15;-113;1688;12437;11493.5;1;337;-2.14748e+09;-1.26687e+07;0;0;0;0;0;0;291164294;291664891;4607689
960;5.16627e-15;-113;1688;12437;11493.5;1;337;-2.14748e+09;-1.26172e+07;-1;0;0;0;-1;0;291615395;292121234;4644206
961;5.16627e-15;-114;1688;12437;11493.5;1;337;-2.14748e+09;-1.25661e+07;0;0;0;0;0;0;292065049;292576162;4680836
962;5.16627e-15;-114;1688;12437;11493.5;1;337;-2.14748e+09;-1.25153e+07;-1;0;0;0;-1;0;292513260;293029682;4717581
963;5.16627e-15;-115;1688;12437;11493.5;1;337;-2.14748e+09;-1.24649e+07;0;0;0;0;0;0;292960037;293481800;4754438
964;5.16627e-15;-115;1688;12437;11493.5;1;337;-2.14748e+09;-1.24148e+07;-1;0;0;0;-1;0;293405385;293932523;4791408
965;5.16627e-15;-115;1688;12437;11493.5;1;337;-2.14748e+09;-1.23652e+07;-1;0;0;0;-1;0;293849312;294381858;4828489
966;5.16627e-15;-116;1688;12437;11493.5;1;337;-2.14748e+09;-1.23158e+07;0;0;0;0;0;0;294291823;294829811;4865682
967;5.16627e-15;-116;1688;12437;11493.5;1;337;-2.14748e+09;-1.22665e+07;-1;0;0;0;-1;0;294732925;295276388;4902985
968;5.16627e-15;-117;1688;12437;11493.5;1;337;-2.14748e+09;-1.22179e+07;0;0;0;0;0;0;295172624;295721597;4940398
969;5.16627e-15;-117;1688;12437;11493.5;1;337;-2.14748e+09;-1.21694e+07;-1;0;0;0;-1;0;295610927;296165443;4977920
970;5.16627e-15;-118;1688;12437;11493.5;1;337;-2.14748e+09;-1.21211e+07;0;0;0;0;0;0;296047841;296607934;5015550
971;5.16627e-15;-119;1688;12437;11493.5;1;337;-2.14748e+09;-1.20733e+07;0;0;0;0;0;0;296483371;297049074;5053288
972;5.16627e-15;-120;1688;12437;11493.5;1;337;-2.14748e+09;-1.20257e+07;0;0;0;0;0;0;296917524;297488871;5091134
973;5.16627e-15;-121;1688;12437;11493.5;1;337;-2.14748e+09;-1.19785e+07;0;0;0;0;0;0;297350307;297927331;5129086
974;5.16627e-15;-121;1688;12437;11493.5;1;337;-2.14748e+09;-1.19317e+07;-1;0;0;0;-1;0;297781724;298364459;5167143
975;5.16627e-15;-122;1688;12437;11493.5;1;337;-2.14748e+09;-1.18849e+07;0;0;0;0;0;0;298211783;298800263;5205306
976;5.16627e-15;-122;1688;12437;11493.5;1;337;-2.14748e+09;-1.18386e+07;-1;0;0;0;-1;0;298640490;299234749;5243574
977;5.16627e-15;-123;1688;12437;11493.5;1;337;-2.14748e+09;-1.17926e+07;0;0;0;0;0;0;299067850;299667922;5281945
978;5.16627e-15;-124;1688;12437;11493.5;1;337;-2.14748e+09;-1.17468e+07;0;0;0;0;0;0;299493870;300099788;5320419
979;5.16627e-15;-124;1688;12437;11493.5;1;337;-2.14748e+09;-1.17013e+07;-1;0;0;0;-1;0;299918556;300530354;5358996
980;5.16627e-15;-125;1688;12437;11493.5;1;337;-2.14748e+09;-1.16562e+07;0;0;0;0;0;0;300341913;300959626;5397675
981;5.16627e-15;-126;1688;12437;11493.5;1;337;-2.14748e+09;-1.16113e+07;0;0;0;0;0;0;300763949;301387609;5436455
982;5.16627e-15;-127;1688;12437;11493.5;1;337;-2.14748e+09;-1.15667e+07;0;0;0;0;0;0;301184668;301814310;5475336
983;5.16627e-15;-127;1688;12437;11493.5;1;337;-2.14748e+09;-1.15224e+07;-1;0;0;0;-1;0;301604076;302239734;5514317
984;5.16627e-15;-128;1688;12437;11493.5;1;337;-2.14748e+09;-1.14782e+07;0;0;0;0;0;0;302022180;302663887;5553396
985;5.16627e-15;-129;1688;12437;11493.5;1;337;-2.14748e+09;-1.14344e+07;0;0;0;0;0;0;302438984;303086775;5592575
986;5.16627e-15;-130;1688;12437;11493.5;1;337;-2.14748e+09;-1.13909e+07;0;0;0;0;0;0;302854496;303508405;5631851
987;5.16627e-15;-131;1688;12437;11493.5;1;337;-2.14748e+09;-1.13476e+07;0;0;0;0;0;0;303268721;303928780;5671225
988;5.16627e-15;-132;1688;12437;11493.5;1;337;-2.14748e+09;-1.13046e+07;0;0;0;0;0;0;303681663;304347908;5710695
989;5.16627e-15;-132;1688;12437;11493.5;1;337;-2.14748e+09;-1.12619e+07;-1;0;0;0;-1;0;304093330;304765794;5750262
990;5.16627e-15;-132;1688;12437;11493.5;1;337;-2.14748e+09;-1.12195e+07;-1;0;0;0;-1;0;304503727;305182444;5789923
991;5.16627e-15;-133;1688;12437;11493.5;1;337;-2.14748e+09;-1.11772e+07;0;0;0;0;0;0;304912858;305597862;5829680
992;5.16627e-15;-133;1688;12437;11493.5;1;337;-2.14748e+09;-1.11352e+07;-1;0;0;0;-1;0;305320731;306012056;5869530
993;5.16627e-15;-133;1688;12437;11493.5;1;337;-2.14748e+09;-1.10935e+07;-1;0;0;0;-1;0;305727349;306425029;5909474
994;5.16627e-15;-134;1688;12437;11493.5;1;337;-2.14748e+09;-1.10521e+07;0;0;0;0;0;0;306132720;306836789;5949510
995;5.16627e-15;-134;1688;12437;11493.5;1;337;-2.14748e+09;-1.10109e+07;-1;0;0;0;-1;0;306536848;307247340;5989639
996;5.16627e-15;-134;1688;12437;11493.5;1;337;-2.14748e+09;-1.097e+07;-1;0;0;0;-1;0;306939739;307656687;6029859
997;5.16627e-15;-135;1688;12437;11493.5;1;337;-2.14748e+09;-1.09292e+07;0;0;0;0;0;0;307341398;308064837;6070169
998;5.16627e-15;-136;1688;12437;11493.5;1;337;-2.14748e+09;-1.08888e+07;0;0;0;0;0;0;307741830;308471794;6110570
999;5.16627e-15;-136;1688;12437;11493.5;1;337;-2.14748e+09;-1.08486e+07;-1;0;0;0;-1;0;308141042;308877564;6151060
1000;5.16627e-15;-137;1688;12437;11493.5;1;337;-2.14748e+09;-1.08086e+07;0;0;0;0;0;0;308539037;309282152;6191639
1001;5.16627e-15;-137;1688;12437;11493.5;1;337;-2.14748e+09;-1.07688e+07;-1;0;0;0;-1;0;308935822;309685563;6232307
1002;5.16627e-15;-138;1688;12437;11493.5;1;337;-2.14748e+09;-1.07293e+07;0;0;0;0;0;0;309331402;310087803;6273061
1003;5.16627e-15;-138;1688;12437;11493.5;1;337;-2.14748e+09;-1.06901e+07;-1;0;0;0;-1;0;309725781;310488877;6313903
1004;5.16627e-15;-139;1688;12437;11493.5;1;337;-2.14748e+09;-1.0651e+07;0;0;0;0;0;0;310118966;310888790;6354831
1005;5.16627e-15;-140;1688;12437;11493.5;1;337;-2.14748e+09;-1.06122e+07;0;0;0;0;0;0;310510961;311287548;6395845
1006;5.16627e-15;-140;1688;12437;11493.5;1;337;-2.14748e+09;-1.05736e+07;-1;0;0;0;-1;0;310901771;311685154;6436943
1007;5.16627e-15;-140;1688;12437;11493.5;1;337;-2.14748e+09;-1.05352e+07;-1;0;0;0;-1;0;311291402;312081615;6478126
1008;5.16627e-15;-141;1688;12437;11493.5;1;337;-2.14748e+09;-1.04971e+07;0;0;0;0;0;0;311679858;312476935;6519392
1009;5.16627e-15;-141;1688;12437;11493.5;1;337;-2.14748e+09;-1.04593e+07;-1;0;0;0;-1;0;312067145;312871120;6560742
1010;5.16627e-15;-142;1688;12437;11493.5;1;337;-2.14748e+09;-1.04215e+07;0;0;0;0;0;0;312453268;313264174;6602174
1011;5.16627e-15;-142;1688;12437;11493.5;1;337;-2.14748e+09;-1.0384e+07;-1;0;0;0;-1;0;312838231;313656102;6643688
1012;5.16627e-15;-143;1688;12437;11493.5;1;337;-2.14748e+09;-1.03467e+07;0;0;0;0;0;0;313222039;314046910;6685282
1013;5.16627e-15;-144;1688;12437;11493.5;1;337;-2.14748e+09;-1.03096e+07;0;0;0;0;0;0;313604698;314436602;6726958
1014;5.16627e-15;-145;1688;12437;11493.5;1;337;-2.14748e+09;-1.02728e+07;0;0;0;0;0;0;313986212;314825184;6768713
1015;5.16627e-15;-146;1688;12437;11493.5;1;337;-2.14748e+09;-1.02362e+07;0;0;0;0;0;0;314366586;315212659;6810547
1016;5.16627e-15;-147;1688;12437;11493.5;1;337;-2.14748e+09;-1.01998e+07;0;0;0;0;0;0;314745826;315599033;6852460
1017;5.16627e-15;-147;1688;12437;11493.5;1;337;-2.14748e+09;-1.01635e+07;-1;0;0;0;-1;0;315123935;315984310;6894451
1018;5.16627e-15;-148;1688;12437;11493.5;1;337;-2.14748e+09;-1.01275e+07;0;0;0;0;0;0;315500919;316368496;6936520
1019;5.16627e-15;-148;1688;12437;11493.5;1;337;-2.14748e+09;-1.00917e+07;-1;0;0;0;-1;0;315876782;316751595;6978665
1020;5.16627e-15;-149;1688;12437;11493.5;1;337;-2.14748e+09;-1.00561e+07;0;0;0;0;0;0;316251529;317133611;7020886
1021;5.16627e-15;-149;1687;12437;11493.5;1;337;-2.14748e+09;-1.00207e+07;0;0;0;0;0;0;316625164;317514550;7063183
1022;5.16627e-15;-150;1687;12437;11493.5;1;337;-2.14748e+09;-9.98552e+06;0;0;0;0;0;0;316997693;317894416;7105554
1023;5.16627e-15;-151;1687;12437;11493.5;1;337;-2.14748e+09;-9.95051e+06;0;0;0;0;0;0;317369120;318273214;7148000
1024;5.16627e-15;-151;1687;12437;11493.5;1;337;-2.14748e+09;-9.9157e+06;-1;0;0;0;-1;0;317739450;318650948;7190519
1025;5.16627e-15;-152;1687;12437;11493.5;1;337;-2.14748e+09;-9.88108e+06;0;0;0;0;0;0;318108687;319027623;7233112
1026;5.16627e-15;-153;1687;12437;11493.5;1;337;-2.14748e+09;-9.84666e+06;0;0;0;0;0;0;318476836;319403243;7275777
1027;5.16627e-15;-153;1687;12437;11493.5;1;337;-2.14748e+09;-9.81242e+06;-1;0;0;0;-1;0;318843901;319777813;7318513
1028;5.16627e-15;-154;1687;12437;11493.5;1;337;-2.14748e+09;-9.77838e+06;0;0;0;0;0;0;319209887;320151337;7361321
1029;5.16627e-15;-154;1687;12437;11493.5;1;337;-2.14748e+09;-9.74452e+06;-1;0;0;0;-1;0;319574798;320523820;7404199
1030;5.16627e-15;-155;1687;12437;11493.5;1;337;-2.14748e+09;-9.71095e+06;0;0;0;0;0;0;319938639;320895267;7447147
1031;5.16627e-15;-155;1687;12437;11493.5;1;337;-2.14748e+09;-9.67736e+06;-1;0;0;0;-1;0;320301414;321265681;7490164
1032;5.16627e-15;-155;1687;12437;11493.5;1;337;-2.14748e+09;-9.64416e+06;-1;0;0;0;-1;0;320663127;321635067;7533251
1033;5.16627e-15;-156;1687;12437;11493.5;1;337;-2.14748e+09;-9.61104e+06;0;0;0;0;0;0;321023784;322003429;7576405
1034;5.16627e-15;-157;1687;12437;11493.5;1;337;-2.14748e+09;-9.5781e+06;0;0;0;0;0;0;321383388;322370772;7619627
1035;5.16627e-15;-157;1687;12437;11493.5;1;337;-2.14748e+09;-9.54524e+06;-1;0;0;0;-1;0;321741944;322737100;7662915
1036;5.16627e-15;-157;1687;12437;11493.5;1;337;-2.14748e+09;-9.51266e+06;-1;0;0;0;-1;0;322099455;323102417;7706270
1037;5.16627e-15;-157;1687;12437;11493.5;1;337;-2.14748e+09;-9.48035e+06;-1;0;0;0;-1;0;322455927;323466728;7749691
1038;5.16627e-15;-158;1687;12437;11493.5;1;337;-2.14748e+09;-9.44802e+06;0;0;0;0;0;0;322811363;323830036;7793176
1039;5.16627e-15;-159;1687;12437;11493.5;1;337;-2.14748e+09;-9.41606e+06;0;0;0;0;0;0;323165768;324192347;7836727
1040;5.16627e-15;-159;1687;12437;11493.5;1;337;-2.14748e+09;-9.38407e+06;-1;0;0;0;-1;0;323519146;324553663;7880341
1041;5.16627e-15;-159;1687;12437;11493.5;1;337;-2.14748e+09;-9.35236e+06;-1;0;0;0;-1;0;323871501;324913990;7924018
1042;5.16627e-15;-159;1687;12437;11493.5;1;337;-2.14748e+09;-9.32081e+06;-1;0;0;0;-1;0;324222837;325273331;7967758
1043;5.16627e-15;-159;1687;12437;11493.5;1;337;-2.14748e+09;-9.28943e+06;-1;0;0;0;-1;0;324573159;325631690;8011560
1044;5.16627e-15;-159;1687;12437;11493.5;1;337;-2.14748e+09;-9.25832e+06;-1;0;0;0;-1;0;324922470;325989072;8055424
1045;5.16627e-15;-159;1687;12437;11493.5;1;337;-2.14748e+09;-9.22718e+06;-1;0;0;0;-1;0;325270774;326345481;8099349
1046;5.16627e-15;-159;1687;12437;11493.5;1;337;-2.14748e+09;-9.1963e+06;-1;0;0;0;-1;0;325618077;326700920;8143334
1047;5.16627e-15;-160;1687;12437;11493.5;1;337;-2.14748e+09;-9.16558e+06;0;0;0;0;0;0;325964381;327055394;8187379
1048;5.16627e-15;-161;1687;12437;11493.5;1;337;-2.14748e+09;-9.13502e+06;0;0;0;0;0;0;326309691;327408906;8231483
1049;5.16627e-15;-161;1687;12437;11493.5;1;337;-2.14748e+09;-9.10463e+06;-1;0;0;0;-1;0;326654010;327761461;8275646
1050;5.16627e-15;-161;1687;12437;11493.5;1;337;-2.14748e+09;-9.07439e+06;-1;0;0;0;-1;0;326997343;328113063;8319866
1051;5.16627e-15;-161;1687;12437;11493.5;1;337;-2.14748e+09;-9.04431e+06;-1;0;0;0;-1;0;327339694;328463715;8364145
1052;5.16627e-15;-161;1687;12437;11493.5;1;337;-2.14748e+09;-9.01439e+06;-1;0;0;0;-1;0;327681067;328813421;8408480
1053;5.16627e-15;-161;1687;12437;11493.5;1;337;-2.14748e+09;-8.98462e+06;-1;0;0;0;-1;0;328021465;329162185;8452871
1054;5.16627e-15;-161;1687;12437;11493.5;1;337;-2.14748e+09;-8.95501e+06;-1;0;0;0;-1;0;328360892;329510012;8497318
1055;5.16627e-15;-161;1687;12437;11493.5;1;337;-2.14748e+09;-8.92556e+06;-1;0;0;0;-1;0;328699352;329856904;8541821
1056;5.16627e-15;-161;1687;12437;11493.5;1;337;-2.14748e+09;-8.89625e+06;-1;0;0;0;-1;0;329036850;330202866;8586378
1057;5.16627e-15;-162;1687;12437;11493.5;1;337;-2.14748e+09;-8.8671e+06;0;0;0;0;0;0;329373389;330547901;8630989
1058;5.16627e-15;-162;1687;12437;11493.5;1;337;-2.14748e+09;-8.83809e+06;-1;0;0;0;-1;0;329708972;330892014;8675653
1059;5.16627e-15;-163;1687;12437;11493.5;1;337;-2.14748e+09;-8.80934e+06;0;0;0;0;0;0;330043604;331235207;8720370
1060;5.16627e-15;-164;1687;12437;11493.5;1;337;-2.14748e+09;-8.78053e+06;0;0;0;0;0;0;330377288;331577485;8765140
1061;5.16627e-15;-164;1687;12437;11493.5;1;337;-2.14748e+09;-8.75197e+06;-1;0;0;0;-1;0;330710029;331918851;8809962
1062;5.16627e-15;-165;1687;12437;11493.5;1;337;-2.14748e+09;-8.72355e+06;0;0;0;0;0;0;331041828;332259309;8854835
1063;5.16627e-15;-165;1687;12437;11493.5;1;337;-2.14748e+09;-8.69538e+06;-1;0;0;0;-1;0;331372692;332598863;8899758
1064;5.16627e-15;-166;1687;12437;11493.5;1;337;-2.14748e+09;-8.66715e+06;0;0;0;0;0;0;331702622;332937516;8944732
1065;5.16627e-15;-167;1687;12437;11493.5;1;337;-2.14748e+09;-8.63917e+06;0;0;0;0;0;0;332031624;333275272;8989755
1066;5.16627e-15;-167;1687;12437;11493.5;1;337;-2.14748e+09;-8.61142e+06;-1;0;0;0;-1;0;332359699;333612135;9034827
1067;5.16627e-15;-167;1687;12437;11493.5;1;337;-2.14748e+09;-8.58362e+06;-1;0;0;0;-1;0;332686853;333948107;9079948
1068;5.16627e-15;-168;1687;12437;11493.5;1;337;-2.14748e+09;-8.55606e+06;0;0;0;0;0;0;333013088;334283193;9125117
1069;5.16627e-15;-168;1687;12437;11493.5;1;337;-2.14748e+09;-8.52863e+06;-1;0;0;0;-1;0;333338409;334617397;9170333
1070;5.16627e-15;-168;1687;12437;11493.5;1;337;-2.14748e+09;-8.50144e+06;-1;0;0;0;-1;0;333662818;334950720;9215596
1071;5.16627e-15;-169;1687;12437;11493.5;1;337;-2.14748e+09;-8.47429e+06;0;0;0;0;0;0;333986320;335283168;9260905
1072;5.16627e-15;-170;1687;12437;11493.5;1;337;-2.14748e+09;-8.44717e+06;0;0;0;0;0;0;334308917;335614744;9306260
1073;5.16627e-15;-171;1687;12437;11493.5;1;337;-2.14748e+09;-8.42028e+06;0;0;0;0;0;0;334630614;335945450;9351661
1074;5.16627e-15;-172;1687;12437;11493.5;1;337;-2.14748e+09;-8.39354e+06;0;0;0;0;0;0;334951413;336275291;9397106
1075;5.16627e-15;-173;1687;12437;11493.5;1;337;-2.14748e+09;-8.36702e+06;0;0;0;0;0;0;335271319;336604270;9442595
1076;5.16627e-15;-174;1687;12437;11493.5;1;337;-2.14748e+09;-8.34043e+06;0;0;0;0;0;0;335590335;336932390;9488128
1077;5.16627e-15;-174;1687;12437;11493.5;1;337;-2.14748e+09;-8.31407e+06;-1;0;0;0;-1;0;335908463;337259654;9533704
1078;5.16627e-15;-175;1687;12437;11493.5;1;337;-2.14748e+09;-8.28785e+06;0;0;0;0;0;0;336225709;337586067;9579323
1079;5.16627e-15;-175;1687;12437;11493.5;1;337;-2.14748e+09;-8.26185e+06;-1;0;0;0;-1;0;336542074;337911631;9624983
1080;5.16627e-15;-176;1687;12437;11493.5;1;337;-2.14748e+09;-8.23578e+06;0;0;0;0;0;0;336857563;338236349;9670686
1081;5.16627e-15;-176;1687;12437;11493.5;1;337;-2.14748e+09;-8.20994e+06;-1;0;0;0;-1;0;337172178;338560226;9716429
1082;5.16627e-15;-177;1687;12437;11493.5;1;337;-2.14748e+09;-8.18422e+06;0;0;0;0;0;0;337485923;338883263;9762213
1083;5.16627e-15;-178;1687;12437;11493.5;1;337;-2.14748e+09;-8.15862e+06;0;0;0;0;0;0;337798802;339205465;9808037
1084;5.16627e-15;-179;1687;12437;11493.5;1;337;-2.14748e+09;-8.13316e+06;0;0;0;0;0;0;338110817;339526835;9853900
1085;5.16627e-15;-179;1687;12437;11493.5;1;337;-2.14748e+09;-8.10781e+06;-1;0;0;0;-1;0;338421972;339847375;9899802
1086;5.16627e-15;-179;1687;12437;11493.5;1;337;-2.14748e+09;-8.08258e+06;-1;0;0;0;-1;0;338732271;340167090;9945743
1087;5.16627e-15;-180;1687;12437;11493.5;1;337;-2.14748e+09;-8.05758e+06;0;0;0;0;0;0;339041716;340485982;9991722
1088;5.16627e-15;-180;1687;12437;11493.5;1;337;-2.14748e+09;-8.0325e+06;-1;0;0;0;-1;0;339350310;340804054;10037738
1089;5.16627e-15;-181;1687;12437;11493.5;1;337;-2.14748e+09;-8.00764e+06;0;0;0;0;0;0;339658057;341121310;10083791
1090;5.16627e-15;-181;1687;12437;11493.5;1;337;-2.14748e+09;-7.9829e+06;-1;0;0;0;-1;0;339964961;341437753;10129881
1091;5.16627e-15;-181;1687;12437;11493.5;1;337;-2.14748e+09;-7.95827e+06;-1;0;0;0;-1;0;340271024;341753386;10176006
1092;5.16627e-15;-181;1687;12437;11493.5;1;337;-2.14748e+09;-7.93376e+06;-1;0;0;0;-1;0;340576249;342068211;10222167
1093;5.16627e-15;-181;1687;12437;11493.5;1;337;-2.14748e+09;-7.90947e+06;-1;0;0;0;-1;0;340880640;342382233;10268363
1094;5.16627e-15;-181;1687;12437;11493.5;1;337;-2.14748e+09;-7.8851e+06;-1;0;0;0;-1;0;341184199;342695454;10314594
1095;5.16627e-15;-182;1687;12437;11493.5;1;337;-2.14748e+09;-7.86094e+06;0;0;0;0;0;0;341486930;343007877;10360858
1096;5.16627e-15;-182;1687;12437;11493.5;1;337;-2.14748e+09;-7.83699e+06;-1;0;0;0;-1;0;341788837;343319505;10407156
1097;5.16627e-15;-183;1687;12437;11493.5;1;337;-2.14748e+09;-7.81296e+06;0;0;0;0;0;0;342089921;343630341;10453487
1098;5.16627e-15;-184;1687;12437;11493.5;1;337;-2.14748e+09;-7.78914e+06;0;0;0;0;0;0;342390186;343940389;10499850
1099;5.16627e-15;-184;1687;12437;11493.5;1;337;-2.14748e+09;-7.76543e+06;-1;0;0;0;-1;0;342689636;344249650;10546245
1100;5.16627e-15;-184;1687;12437;11493.5;1;337;-2.14748e+09;-7.74183e+06;-1;0;0;0;-1;0;342988272;344558129;10592672
1101;5.16627e-15;-184;1687;12437;11493.5;1;337;-2.14748e+09;-7.71834e+06;-1;0;0;0;-1;0;343286099;344865828;10639130
1102;5.16627e-15;-184;1687;12437;11493.5;1;337;-2.14748e+09;-7.69496e+06;-1;0;0;0;-1;0;343583119;345172750;10685619
1103;5.16627e-15;-185;1687;12437;11493.5;1;337;-2.14748e+09;-7.67169e+06;0;0;0;0;0;0;343879335;345478898;10732137
1104;5.16627e-15;-185;1687;12437;11493.5;1;337;-2.14748e+09;-7.64853e+06;-1;0;0;0;-1;0;344174750;345784275;10778685
1105;5.16627e-15;-185;1687;12437;11493.5;1;337;-2.14748e+09;-7.62557e+06;-1;0;0;0;-1;0;344469367;346088884;10825263
1106;5.16627e-15;-186;1687;12437;11493.5;1;337;-2.14748e+09;-7.60252e+06;0;0;0;0;0;0;344763189;346392727;10871869
1107;5.16627e-15;-186;1687;12437;11493.5;1;337;-2.14748e+09;-7.57968e+06;-1;0;0;0;-1;0;345056220;346695807;10918503
1108;5.16627e-15;-187;1687;12437;11493.5;1;337;-2.14748e+09;-7.55694e+06;0;0;0;0;0;0;345348461;346998128;10965165
1109;5.16627e-15;-188;1687;12437;11493.5;1;337;-2.14748e+09;-7.53431e+06;0;0;0;0;0;0;345639916;347299692;11011854
1110;5.16627e-15;-188;1687;12437;11493.5;1;337;-2.14748e+09;-7.51188e+06;-1;0;0;0;-1;0;345930587;347600502;11058571
1111;5.16627e-15;-189;1687;12437;11493.5;1;337;-2.14748e+09;-7.48936e+06;0;0;0;0;0;0;346220478;347900561;11105313
1112;5.16627e-15;-190;1687;12437;11493.5;1;337;-2.14748e+09;-7.46713e+06;0;0;0;0;0;0;346509591;348199871;11152081
1113;5.16627e-15;-190;1687;12437;11493.5;1;337;-2.14748e+09;-7.44491e+06;-1;0;0;0;-1;0;346797930;348498436;11198875
1114;5.16627e-15;-191;1687;12437;11493.5;1;337;-2.14748e+09;-7.42278e+06;0;0;0;0;0;0;347085497;348796257;11245694
1115;5.16627e-15;-192;1687;12437;11493.5;1;337;-2.14748e+09;-7.40076e+06;0;0;0;0;0;0;347372294;349093338;11292537
1116;5.16627e-15;-193;1687;12437;11493.5;1;337;-2.14748e+09;-7.37874e+06;0;0;0;0;0;0;347658325;349389682;11339405
1117;5.16627e-15;-194;1687;12437;11493.5;1;337;-2.14748e+09;-7.35692e+06;0;0;0;0;0;0;347943592;349685291;11386296
1118;5.16627e-15;-195;1687;12437;11493.5;1;337;-2.14748e+09;-7.33529e+06;0;0;0;0;0;0;348228099;349980168;11433210
1119;5.16627e-15;-196;1687;12437;11493.5;1;337;-2.14748e+09;-7.31357e+06;0;0;0;0;0;0;348511847;350274315;11480147
1120;5.16627e-15;-196;1687;12437;11493.5;1;337;-2.14748e+09;-7.29204e+06;-1;0;0;0;-1;0;348794840;350567736;11527107
1121;5.16627e-15;-197;1687;12437;11493.5;1;337;-2.14748e+09;-7.2707e+06;0;0;0;0;0;0;349077081;350860432;11574088
1122;5.16627e-15;-197;1687;12437;11493.5;1;337;-2.14748e+09;-7.24926e+06;-1;0;0;0;-1;0;349358571;351152407;11621091
1123;5.16627e-15;-197;1687;12437;11493.5;1;337;-2.14748e+09;-7.22802e+06;-1;0;0;0;-1;0;349639315;351443663;11668114
1124;5.16627e-15;-197;1687;12437;11493.5;1;337;-2.14748e+09;-7.20687e+06;-1;0;0;0;-1;0;349919313;351734202;11715158
1125;5.16627e-15;-197;1687;12437;11493.5;1;337;-2.14748e+09;-7.18582e+06;-1;0;0;0;-1;0;350198570;352024028;11762223
1126;5.16627e-15;-198;1687;12437;11493.5;1;337;-2.14748e+09;-7.16485e+06;0;0;0;0;0;0;350477088;352313143;11809307
1127;5.16627e-15;-198;1687;12437;11493.5;1;337;-2.14748e+09;-7.14398e+06;-1;0;0;0;-1;0;350754869;352601549;11856410
1128;5.16627e-15;-198;1687;12437;11493.5;1;337;-2.14748e+09;-7.12321e+06;-1;0;0;0;-1;0;351031916;352889249;11903532
1129;5.16627e-15;-198;1687;12437;11493.5;1;337;-2.14748e+09;-7.10252e+06;-1;0;0;0;-1;0;351308232;353176246;11950673
1130;5.16627e-15;-199;1687;12437;11493.5;1;337;-2.14748e+09;-7.08193e+06;0;0;0;0;0;0;351583819;353462542;11997831
1131;5.16627e-15;-200;1687;12437;11493.5;1;337;-2.14748e+09;-7.06142e+06;0;0;0;0;0;0;351858680;353748139;12045007
1132;5.16627e-15;-201;1687;12437;11493.5;1;337;-2.14748e+09;-7.04101e+06;0;0;0;0;0;0;352132818;354033040;12092200
1133;5.16627e-15;-201;1687;12437;11493.5;1;337;-2.14748e+09;-7.02068e+06;-1;0;0;0;-1;0;352406234;354317248;12139410
1134;5.16627e-15;-201;1687;12437;11493.5;1;337;-2.14748e+09;-7.00044e+06;-1;0;0;0;-1;0;352678932;354600765;12186637
1135;5.16627e-15;-201;1687;12437;11493.5;1;337;-2.14748e+09;-6.98029e+06;-1;0;0;0;-1;0;352950915;354883593;12233879
1136;5.16627e-15;-202;1687;12437;11493.5;1;337;-2.14748e+09;-6.96023e+06;0;0;0;0;0;0;353222183;355165736;12281136
1137;5.16627e-15;-203;1687;12437;11493.5;1;337;-2.14748e+09;-6.94026e+06;0;0;0;0;0;0;353492741;355447194;12328409
1138;5.16627e-15;-204;1687;12437;11493.5;1;337;-2.14748e+09;-6.92037e+06;0;0;0;0;0;0;353762591;355727971;12375697
1139;5.16627e-15;-205;1687;12437;11493.5;1;337;-2.14748e+09;-6.90056e+06;0;0;0;0;0;0;354031735;356008070;12422998
1140;5.16627e-15;-205;1687;12437;11493.5;1;337;-2.14748e+09;-6.88085e+06;-1;0;0;0;-1;0;354300175;356287492;12470314
1141;5.16627e-15;-206;1687;12437;11493.5;1;337;-2.14748e+09;-6.86121e+06;0;0;0;0;0;0;354567914;356566240;12517643
1142;5.16627e-15;-207;1687;12437;11493.5;1;337;-2.14748e+09;-6.84166e+06;0;0;0;0;0;0;354834955;356844316;12564985
1143;5.16627e-15;-208;1687;12437;11493.5;1;337;-2.14748e+09;-6.8222e+06;0;0;0;0;0;0;355101300;357121723;12612340
1144;5.16627e-15;-208;1687;12437;11493.5;1;337;-2.14748e+09;-6.80282e+06;-1;0;0;0;-1;0;355366951;357398463;12659707
1145;5.16627e-15;-208;1687;12437;11493.5;1;337;-2.14748e+09;-6.78352e+06;-1;0;0;0;-1;0;355631911;357674539;12707086
1146;5.16627e-15;-209;1687;12437;11493.5;1;337;-2.14748e+09;-6.7644e+06;0;0;0;0;0;0;355896183;357949952;12754476
1147;5.16627e-15;-209;1687;12437;11493.5;1;337;-2.14748e+09;-6.74516e+06;-1;0;0;0;-1;0;356159768;358224705;12801877
1148;5.16627e-15;-209;1687;12437;11493.5;1;337;-2.14748e+09;-6.72611e+06;-1;0;0;0;-1;0;356422668;358498800;12849290
1149;5.16627e-15;-209;1687;12437;11493.5;1;337;-2.14748e+09;-6.70723e+06;-1;0;0;0;-1;0;356684888;358772240;12896712
1150;5.16627e-15;-210;1687;12437;11493.5;1;337;-2.14748e+09;-6.68834e+06;0;0;0;0;0;0;356946428;359045027;12944145
1151;5.16627e-15;-210;1687;12437;11493.5;1;337;-2.14748e+09;-6.66942e+06;-1;0;0;0;-1;0;357207291;359317163;12991587
1152;5.16627e-15;-211;1687;12437;11493.5;1;337;-2.14748e+09;-6.65069e+06;0;0;0;0;0;0;357467479;359588650;13039038
1153;5.16627e-15;-212;1687;12437;11493.5;1;337;-2.14748e+09;-6.63203e+06;0;0;0;0;0;0;357726996;359859490;13086498
1154;5.16627e-15;-212;1687;12437;11493.5;1;337;-2.14748e+09;-6.61345e+06;-1;0;0;0;-1;0;357985842;360129687;13133966
1155;5.16627e-15;-212;1687;12437;11493.5;1;337;-2.14748e+09;-6.59495e+06;-1;0;0;0;-1;0;358244021;360399242;13181442
1156;5.16627e-15;-213;1687;12437;11493.5;1;337;-2.14748e+09;-6.57652e+06;0;0;0;0;0;0;358501534;360668156;13228927
1157;5.16627e-15;-214;1687;12437;11493.5;1;337;-2.14748e+09;-6.55818e+06;0;0;0;0;0;0;358758384;360936434;13276418
1158;5.16627e-15;-214;1687;12437;11493.5;1;337;-2.14748e+09;-6.5399e+06;-1;0;0;0;-1;0;359014574;361204076;13323916
1159;5.16627e-15;-214;1687;12437;11493.5;1;337;-2.14748e+09;-6.52171e+06;-1;0;0;0;-1;0;359270105;361471084;13371421
1160;5.16627e-15;-215;1687;12437;11493.5;1;337;-2.14748e+09;-6.50359e+06;0;0;0;0;0;0;359524979;361737462;13418932
1161;5.16627e-15;-215;1687;12437;11493.5;1;337;-2.14748e+09;-6.48564e+06;-1;0;0;0;-1;0;359779200;362003211;13466449
1162;5.16627e-15;-216;1687;12437;11493.5;1;337;-2.14748e+09;-6.46757e+06;0;0;0;0;0;0;360032769;362268333;13513972
1163;5.16627e-15;-216;1687;12437;11493.5;1;337;-2.14748e+09;-6.44967e+06;-1;0;0;0;-1;0;360285688;362532830;13561499
1164;5.16627e-15;-216;1687;12437;11493.5;1;337;-2.14748e+09;-6.43194e+06;-1;0;0;0;-1;0;360537960;362796705;13609031
1165;5.16627e-15;-217;1687;12437;11493.5;1;337;-2.14748e+09;-6.41419e+06;0;0;0;0;0;0;360789586;363059959;13656568
1166;5.16627e-15;-218;1687;12437;11493.5;1;337;-2.14748e+09;-6.39642e+06;0;0;0;0;0;0;361040569;363322595;13704109
1167;5.16627e-15;-219;1687;12437;11493.5;1;337;-2.14748e+09;-6.37881e+06;0;0;0;0;0;0;361290912;363584615;13751653
1168;5.16627e-15;-220;1687;12437;11493.5;1;337;-2.14748e+09;-6.36127e+06;0;0;0;0;0;0;361540616;363846021;13799201
1169;5.16627e-15;-220;1687;12437;11493.5;1;337;-2.14748e+09;-6.34381e+06;-1;0;0;0;-1;0;361789684;364106814;13846751
1170;5.16627e-15;-220;1687;12437;11493.5;1;337;-2.14748e+09;-6.32642e+06;-1;0;0;0;-1;0;362038117;364366998;13894305
1171;5.16627e-15;-221;1687;12437;11493.5;1;337;-2.14748e+09;-6.30909e+06;0;0;0;0;0;0;362285918;364626574;13941860
1172;5.16627e-15;-221;1687;12437;11493.5;1;337;-2.14748e+09;-6.29184e+06;-1;0;0;0;-1;0;362533088;364885543;13989418
1173;5.16627e-15;-221;1687;12437;11493.5;1;337;-2.14748e+09;-6.27466e+06;-1;0;0;0;-1;0;362779631;365143909;14036977
1174;5.16627e-15;-222;1687;12437;11493.5;1;337;-2.14748e+09;-6.25754e+06;0;0;0;0;0;0;363025548;365401673;14084537
1175;5.16627e-15;-222;1687;12437;11493.5;1;337;-2.14748e+09;-6.2405e+06;-1;0;0;0;-1;0;363270841;365658837;14132099
1176;5.16627e-15;-222;1687;12437;11493.5;1;337;-2.14748e+09;-6.22352e+06;-1;0;0;0;-1;0;363515512;365915403;14179661
1177;5.16627e-15;-222;1687;12437;11493.5;1;337;-2.14748e+09;-6.20661e+06;-1;0;0;0;-1;0;363759564;366171373;14227223
1178;5.16627e-15;-223;1687;12437;11493.5;1;337;-2.14748e+09;-6.18977e+06;0;0;0;0;0;0;364002998;366426749;14274785
1179;5.16627e-15;-224;1687;12437;11493.5;1;337;-2.14748e+09;-6.173e+06;0;0;0;0;0;0;364245816;366681533;14322347
1180;5.16627e-15;-224;1687;12437;11493.5;1;337;-2.14748e+09;-6.15639e+06;-1;0;0;0;-1;0;364488022;366935727;14369908
1181;5.16627e-15;-225;1687;12437;11493.5;1;337;-2.14748e+09;-6.13975e+06;0;0;0;0;0;0;364729615;367189333;14417467
1182;5.16627e-15;-226;1687;12437;11493.5;1;337;-2.14748e+09;-6.12307e+06;0;0;0;0;0;0;364970599;367442353;14465026
1183;5.16627e-15;-226;1687;12437;11493.5;1;337;-2.14748e+09;-6.10656e+06;-1;0;0;0;-1;0;365210976;367694789;14512583
1184;5.16627e-15;-226;1687;12437;11493.5;1;337;-2.14748e+09;-6.09012e+06;-1;0;0;0;-1;0;365450748;367946642;14560138
1185;5.16627e-15;-226;1687;12437;11493.5;1;337;-2.14748e+09;-6.07384e+06;-1;0;0;0;-1;0;365689916;368197915;14607690
1186;5.16627e-15;-226;1687;12437;11493.5;1;337;-2.14748e+09;-6.05753e+06;-1;0;0;0;-1;0;365928482;368448610;14655240
1187;5.16627e-15;-227;1687;12437;11493.5;1;337;-2.14748e+09;-6.04118e+06;0;0;0;0;0;0;366166450;368698728;14702786
1188;5.16627e-15;-227;1687;12437;11493.5;1;337;-2.14748e+09;-6.02499e+06;-1;0;0;0;-1;0;366403820;368948271;14750330
1189;5.16627e-15;-228;1687;12437;11493.5;1;337;-2.14748e+09;-6.00886e+06;0;0;0;0;0;0;366640594;369197241;14797870
1190;5.16627e-15;-229;1687;12437;11493.5;1;337;-2.14748e+09;-5.9928e+06;0;0;0;0;0;0;366876775;369445640;14845405
1191;5.16627e-15;-230;1687;12437;11493.5;1;337;-2.14748e+09;-5.97681e+06;0;0;0;0;0;0;367112364;369693471;14892937
1192;5.16627e-15;-230;1687;12437;11493.5;1;337;-2.14748e+09;-5.96097e+06;-1;0;0;0;-1;0;367347364;369940734;14940464
1193;5.16627e-15;-231;1687;12437;11493.5;1;337;-2.14748e+09;-5.945e+06;0;0;0;0;0;0;367581776;370187431;14987986
1194;5.16627e-15;-231;1687;12437;11493.5;1;337;-2.14748e+09;-5.92918e+06;-1;0;0;0;-1;0;367815602;370433565;15035503
1195;5.16627e-15;-232;1687;12437;11493.5;1;337;-2.14748e+09;-5.91343e+06;0;0;0;0;0;0;368048844;370679137;15083015
1196;5.16627e-15;-233;1687;12437;11493.5;1;337;-2.14748e+09;-5.89774e+06;0;0;0;0;0;0;368281505;370924149;15130520
1197;5.16627e-15;-234;1687;12437;11493.5;1;337;-2.14748e+09;-5.88211e+06;0;0;0;0;0;0;368513585;371168602;15178020
1198;5.16627e-15;-234;1687;12437;11493.5;1;337;-2.14748e+09;-5.86654e+06;-1;0;0;0;-1;0;368745087;371412500;15225513
1199;5.16627e-15;-235;1687;12437;11493.5;1;337;-2.14748e+09;-5.85103e+06;0;0;0;0;0;0;368976013;371655843;15273000
1200;5.16627e-15;-235;1687;12437;11493.5;1;337;-2.14748e+09;-5.83568e+06;-1;0;0;0;-1;0;369206364;371898632;15320479
1201;5.16627e-15;-235;1687;12437;11493.5;1;337;-2.14748e+09;-5.82019e+06;-1;0;0;0;-1;0;369436143;372140871;15367952
1202;5.16627e-15;-236;1687;12437;11493.5;1;337;-2.14748e+09;-5.80496e+06;0;0;0;0;0;0;369665351;372382561;15415416
1203;5.16627e-15;-237;1687;12437;11493.5;1;337;-2.14748e+09;-5.78968e+06;0;0;0;0;0;0;369893990;372623702;15462873
1204;5.16627e-15;-237;1687;12437;11493.5;1;337;-2.14748e+09;-5.77447e+06;-1;0;0;0;-1;0;370122062;372864299;15510322
1205;5.16627e-15;-238;1687;12437;11493.5;1;337;-2.14748e+09;-5.75921e+06;0;0;0;0;0;0;370349569;373104350;15557762
1206;5.16627e-15;-238;1687;12437;11493.5;1;337;-2.14748e+09;-5.74411e+06;-1;0;0;0;-1;0;370576513;373343860;15605194
1207;5.16627e-15;-239;1687;12437;11493.5;1;337;-2.14748e+09;-5.72907e+06;0;0;0;0;0;0;370802895;373582829;15652617
1208;5.16627e-15;-239;1687;12437;11493.5;1;337;-2.14748e+09;-5.71408e+06;-1;0;0;0;-1;0;371028717;373821259;15700030
1209;5.16627e-15;-240;1687;12437;11493.5;1;337;-2.14748e+09;-5.69915e+06;0;0;0;0;0;0;371253981;374059151;15747434
1210;5.16627e-15;-240;1687;12437;11493.5;1;337;-2.14748e+09;-5.68438e+06;-1;0;0;0;-1;0;371478689;374296508;15794828
1211;5.16627e-15;-240;1687;12437;11493.5;1;337;-2.14748e+09;-5.66946e+06;-1;0;0;0;-1;0;371702842;374533332;15842212
1212;5.16627e-15;-240;1687;12437;11493.5;1;337;-2.14748e+09;-5.6547e+06;-1;0;0;0;-1;0;371926443;374769623;15889585
1213;5.16627e-15;-241;1687;12437;11493.5;1;337;-2.14748e+09;-5.63999e+06;0;0;0;0;0;0;372149493;375005383;15936948
1214;5.16627e-15;-242;1687;12437;11493.5;1;337;-2.14748e+09;-5.62534e+06;0;0;0;0;0;0;372371994;375240615;15984300
1215;5.16627e-15;-243;1687;12437;11493.5;1;337;-2.14748e+09;-5.61074e+06;0;0;0;0;0;0;372593947;375475319;16031640
1216;5.16627e-15;-243;1687;12437;11493.5;1;337;-2.14748e+09;-5.5962e+06;-1;0;0;0;-1;0;372815355;375709498;16078969
1217;5.16627e-15;-244;1687;12437;11493.5;1;337;-2.14748e+09;-5.58171e+06;0;0;0;0;0;0;373036219;375943153;16126287
1218;5.16627e-15;-245;1687;12437;11493.5;1;337;-2.14748e+09;-5.56728e+06;0;0;0;0;0;0;373256540;376176285;16173592
1219;5.16627e-15;-245;1687;12437;11493.5;1;337;-2.14748e+09;-5.5529e+06;-1;0;0;0;-1;0;373476321;376408897;16220885
1220;5.16627e-15;-246;1687;12437;11493.5;1;337;-2.14748e+09;-5.53857e+06;0;0;0;0;0;0;373695564;376640990;16268166
1221;5.16627e-15;-246;1687;12437;11493.5;1;337;-2.14748e+09;-5.5243e+06;-1;0;0;0;-1;0;373914269;376872565;16315434
1222;5.16627e-15;-246;1687;12437;11493.5;1;337;-2.14748e+09;-5.51017e+06;-1;0;0;0;-1;0;374132439;377103625;16362688
1223;5.16627e-15;-247;1687;12437;11493.5;1;337;-2.14748e+09;-5.4959e+06;0;0;0;0;0;0;374350075;377334170;16409929
1224;5.16627e-15;-248;1687;12437;11493.5;1;337;-2.14748e+09;-5.48189e+06;0;0;0;0;0;0;374567180;377564203;16457157
1225;5.16627e-15;-249;1687;12437;11493.5;1;337;-2.14748e+09;-5.46772e+06;0;0;0;0;0;0;374783754;377793724;16504371
1226;5.16627e-15;-250;1687;12437;11493.5;1;337;-2.14748e+09;-5.45371e+06;0;0;0;0;0;0;374999799;378022736;16551571
1227;5.16627e-15;-250;1687;12437;11493.5;1;337;-2.14748e+09;-5.43974e+06;-1;0;0;0;-1;0;375215317;378251240;16598756
1228;5.16627e-15;-250;1687;12437;11493.5;1;337;-2.14748e+09;-5.42593e+06;-1;0;0;0;-1;0;375430310;378479237;16645927
1229;5.16627e-15;-250;1687;12437;11493.5;1;337;-2.14748e+09;-5.41197e+06;-1;0;0;0;-1;0;375644779;378706730;16693083
1230;5.16627e-15;-251;1687;12437;11493.5;1;337;-2.14748e+09;-5.39816e+06;0;0;0;0;0;0;375858727;378933719;16740224
1231;5.16627e-15;-251;1687;12437;11493.5;1;337;-2.14748e+09;-5.3844e+06;-1;0;0;0;-1;0;376072153;379160207;16787349
1232;5.16627e-15;-251;1687;12437;11493.5;1;337;-2.14748e+09;-5.37079e+06;-1;0;0;0;-1;0;376285061;379386194;16834459
1233;5.16627e-15;-251;1687;12437;11493.5;1;337;-2.14748e+09;-5.35702e+06;-1;0;0;0;-1;0;376497452;379611683;16881553
1234;5.16627e-15;-252;1687;12437;11493.5;1;337;-2.14748e+09;-5.34341e+06;0;0;0;0;0;0;376709327;379836674;16928631
1235;5.16627e-15;-252;1687;12437;11493.5;1;337;-2.14748e+09;-5.32985e+06;-1;0;0;0;-1;0;376920689;380061170;16975693
1236;5.16627e-15;-253;1687;12437;11493.5;1;337;-2.14748e+09;-5.31634e+06;0;0;0;0;0;0;377131537;380285171;17022738
1237;5.16627e-15;-253;1687;12437;11493.5;1;337;-2.14748e+09;-5.30287e+06;-1;0;0;0;-1;0;377341875;380508680;17069767
1238;5.16627e-15;-253;1687;12437;11493.5;1;337;-2.14748e+09;-5.28955e+06;-1;0;0;0;-1;0;377551704;380731697;17116778
1239;5.16627e-15;-254;1687;12437;11493.5;1;337;-2.14748e+09;-5.27608e+06;0;0;0;0;0;0;377761025;380954225;17163772
1240;5.16627e-15;-254;1687;12437;11493.5;1;337;-2.14748e+09;-5.26276e+06;-1;0;0;0;-1;0;377969841;381176264;17210748
1241;5.16627e-15;-254;1687;12437;11493.5;1;337;-2.14748e+09;-5.24949e+06;-1;0;0;0;-1;0;378178151;381397817;17257707
1242;5.16627e-15;-255;1687;12437;11493.5;1;337;-2.14748e+09;-5.23626e+06;0;0;0;0;0;0;378385959;381618884;17304648
1243;5.16627e-15;-256;1687;12437;11493.5;1;337;-2.14748e+09;-5.22308e+06;0;0;0;0;0;0;378593265;381839467;17351570
1244;5.16627e-15;-257;1687;12437;11493.5;1;337;-2.14748e+09;-5.21005e+06;0;0;0;0;0;0;378800072;382059568;17398474
1245;5.16627e-15;-258;1687;12437;11493.5;1;337;-2.14748e+09;-5.19696e+06;0;0;0;0;0;0;379006380;382279188;17445360
1246;5.16627e-15;-259;1687;12437;11493.5;1;337;-2.14748e+09;-5.18382e+06;0;0;0;0;0;0;379212191;382498328;17492226
1247;5.16627e-15;-259;1687;12437;11493.5;1;337;-2.14748e+09;-5.17083e+06;-1;0;0;0;-1;0;379417507;382716991;17539074
1248;5.16627e-15;-260;1687;12437;11493.5;1;337;-2.14748e+09;-5.15788e+06;0;0;0;0;0;0;379622330;382935176;17585902
1249;5.16627e-15;-260;1687;12437;11493.5;1;337;-2.14748e+09;-5.14498e+06;-1;0;0;0;-1;0;379826660;383152886;17632711
1250;5.16627e-15;-260;1687;12437;11493.5;1;337;-2.14748e+09;-5.13212e+06;-1;0;0;0;-1;0;380030499;383370122;17679500
1251;5.16627e-15;-261;1687;12437;11493.5;1;337;-2.14748e+09;-5.11931e+06;0;0;0;0;0;0;380233849;383586886;17726268
1252;5.16627e-15;-262;1687;12437;11493.5;1;337;-2.14748e+09;-5.10655e+06;0;0;0;0;0;0;380436712;383803179;17773017
1253;5.16627e-15;-262;1687;12437;11493.5;1;337;-2.14748e+09;-5.09382e+06;0;0;-1;0;0;-1;380639088;384019002;17819745
1254;5.16627e-15;-263;1687;12437;11493.5;1;337;-2.14748e+09;-5.08115e+06;0;0;0;0;0;0;380840979;384234356;17866453
1255;5.16627e-15;-264;1687;12437;11493.5;1;337;-2.14748e+09;-5.06861e+06;0;0;0;0;0;0;381042388;384449244;17913139
1256;5.16627e-15;-265;1687;12437;11493.5;1;337;-2.14748e+09;-5.05592e+06;0;0;0;0;0;0;381243314;384663666;17959805
1257;5.16627e-15;-265;1687;12437;11493.5;1;337;-2.14748e+09;-5.04338e+06;-1;0;0;0;-1;0;381443760;384877624;18006449
1258;5.16627e-15;-266;1687;12437;11493.5;1;337;-2.14748e+09;-5.03098e+06;0;0;0;0;0;0;381643727;385091119;18053072
1259;5.16627e-15;-267;1687;12437;11493.5;1;337;-2.14748e+09;-5.01842e+06;0;0;0;0;0;0;381843216;385304152;18099674
1260;5.16627e-15;-267;1687;12437;11493.5;1;337;-2.14748e+09;-5.0061e+06;-1;0;0;0;-1;0;382042230;385516726;18146253
1261;5.16627e-15;-268;1687;12437;11493.5;1;337;-2.14748e+09;-4.99363e+06;0;0;0;0;0;0;382240769;385728840;18192810
1262;5.16627e-15;-269;1687;12437;11493.5;1;337;-2.14748e+09;-4.9813e+06;0;0;0;0;0;0;382438834;385940497;18239345
1263;5.16627e-15;-269;1687;12437;11493.5;1;337;-2.14748e+09;-4.96901e+06;-1;0;0;0;-1;0;382636428;386151698;18285857
1264;5.16627e-15;-269;1687;12437;11493.5;1;337;-2.14748e+09;-4.95677e+06;-1;0;0;0;-1;0;382833552;386362445;18332347
1265;5.16627e-15;-270;1687;12437;11493.5;1;337;-2.14748e+09;-4.94456e+06;0;0;0;0;0;0;383030207;386572737;18378814
1266;5.16627e-15;-270;1687;12437;11493.5;1;337;-2.14748e+09;-4.9324e+06;-1;0;0;0;-1;0;383226394;386782578;18425257
1267;5.16627e-15;-271;1687;12437;11493.5;1;337;-2.14748e+09;-4.92028e+06;0;0;0;0;0;0;383422116;386991967;18471678
1268;5.16627e-15;-272;1687;12437;11493.5;1;337;-2.14748e+09;-4.9082e+06;0;0;0;0;0;0;383617372;387200908;18518074
1269;5.16627e-15;-273;1687;12437;11493.5;1;337;-2.14748e+09;-4.89617e+06;0;0;0;0;0;0;383812166;387409399;18564448
1270;5.16627e-15;-274;1687;12437;11493.5;1;337;-2.14748e+09;-4.88417e+06;0;0;0;0;0;0;384006497;387617444;18610797
1271;5.16627e-15;-274;1687;12437;11493.5;1;337;-2.14748e+09;-4.87222e+06;-1;0;0;0;-1;0;384200368;387825043;18657122
1272;5.16627e-15;-275;1687;12437;11493.5;1;337;-2.14748e+09;-4.8604e+06;0;0;0;0;0;0;384393780;388032198;18703423
1273;5.16627e-15;-275;1687;12437;11493.5;1;337;-2.14748e+09;-4.84843e+06;-1;0;0;0;-1;0;384586734;388238910;18749699
1274;5.16627e-15;-275;1687;12437;11493.5;1;337;-2.14748e+09;-4.83659e+06;-1;0;0;0;-1;0;384779231;388445179;18795951
1275;5.16627e-15;-275;1687;12437;11493.5;1;337;-2.14748e+09;-4.8248e+06;-1;0;0;0;-1;0;384971273;388651008;18842178
1276;5.16627e-15;-276;1687;12437;11493.5;1;337;-2.14748e+09;-4.81304e+06;0;0;0;0;0;0;385162862;388856398;18888380
1277;5.16627e-15;-276;1687;12437;11493.5;1;337;-2.14748e+09;-4.80133e+06;-1;0;0;0;-1;0;385353998;389061350;18934557
1278;5.16627e-15;-277;1687;12437;11493.5;1;337;-2.14748e+09;-4.78965e+06;0;0;0;0;0;0;385544684;389265865;18980708
1279;5.16627e-15;-277;1687;12437;11493.5;1;337;-2.14748e+09;-4.77802e+06;-1;0;0;0;-1;0;385734919;389469944;19026834
1280;5.16627e-15;-278;1687;12437;11493.5;1;337;-2.14748e+09;-4.76642e+06;0;0;0;0;0;0;385924707;389673589;19072933
1281;5.16627e-15;-279;1687;12437;11493.5;1;337;-2.14748e+09;-4.75486e+06;0;0;0;0;0;0;386114047;389876800;19119007
1282;5.16627e-15;-280;1687;12437;11493.5;1;337;-2.14748e+09;-4.74334e+06;0;0;0;0;0;0;386302942;390079580;19165055
1283;5.16627e-15;-280;1687;12437;11493.5;1;337;-2.14748e+09;-4.73186e+06;-1;0;0;0;-1;0;386491392;390281929;19211077
1284;5.16627e-15;-280;1687;12437;11493.5;1;337;-2.14748e+09;-4.72042e+06;-1;0;0;0;-1;0;386679399;390483849;19257072
1285;5.16627e-15;-280;1686;12437;11493.5;1;337;-2.14748e+09;-4.70901e+06;0;0;0;0;0;0;386866964;390685340;19303041
1286;5.16627e-15;-280;1686;12437;11493.5;1;337;-2.14748e+09;-4.69764e+06;-1;0;0;0;-1;0;387054089;390886404;19348982
1287;5.16627e-15;-281;1686;12437;11493.5;1;337;-2.14748e+09;-4.68631e+06;0;0;0;0;0;0;387240775;391087043;19394897
1288;5.16627e-15;-282;1686;12437;11493.5;1;337;-2.14748e+09;-4.67512e+06;0;0;0;0;0;0;387427022;391287257;19440784
1289;5.16627e-15;-283;1686;12437;11493.5;1;337;-2.14748e+09;-4.66377e+06;0;0;0;0;0;0;387612833;391487047;19486644
1290;5.16627e-15;-283;1686;12437;11493.5;1;337;-2.14748e+09;-4.65255e+06;-1;0;0;0;-1;0;387798209;391686415;19532477
1291;5.16627e-15;-284;1686;12437;11493.5;1;337;-2.14748e+09;-4.64137e+06;0;0;0;0;0;0;387983151;391885362;19578282
1292;5.16627e-15;-285;1686;12437;11493.5;1;337;-2.14748e+09;-4.63022e+06;0;0;0;0;0;0;388167660;392083889;19624059
1293;5.16627e-15;-286;1686;12437;11493.5;1;337;-2.14748e+09;-4.61922e+06;0;0;0;0;0;0;388351737;392281997;19669808
1294;5.16627e-15;-287;1686;12437;11493.5;1;337;-2.14748e+09;-4.60815e+06;0;0;0;0;0;0;388535384;392479688;19715529
1295;5.16627e-15;-288;1686;12437;11493.5;1;337;-2.14748e+09;-4.59701e+06;0;0;0;0;0;0;388718602;392676962;19761222
1296;5.16627e-15;-288;1686;12437;11493.5;1;337;-2.14748e+09;-4.58601e+06;-1;0;0;0;-1;0;388901393;392873821;19806886
1297;5.16627e-15;-288;1686;12437;11493.5;1;337;-2.14748e+09;-4.57505e+06;-1;0;0;0;-1;0;389083757;393070266;19852521
1298;5.16627e-15;-289;1686;12437;11493.5;1;337;-2.14748e+09;-4.56412e+06;0;0;0;0;0;0;389265695;393266298;19898128
1299;5.16627e-15;-290;1686;12437;11493.5;1;337;-2.14748e+09;-4.55323e+06;0;0;0;0;0;0;389447210;393461918;19943706
1300;5.16627e-15;-290;1686;12437;11493.5;1;337;-2.14748e+09;-4.54238e+06;-1;0;0;0;-1;0;389628301;393657127;19989254
1301;5.16627e-15;-291;1686;12437;11493.5;1;337;-2.14748e+09;-4.53156e+06;0;0;0;0;0;0;389808971;393851927;20034774
1302;5.16627e-15;-291;1686;12437;11493.5;1;337;-2.14748e+09;-4.52077e+06;-1;0;0;0;-1;0;389989221;394046318;20080263
1303;5.16627e-15;-292;1686;12437;11493.5;1;337;-2.14748e+09;-4.51002e+06;0;0;0;0;0;0;390169052;394240303;20125724
1304;5.16627e-15;-292;1686;12437;11493.5;1;337;-2.14748e+09;-4.4993e+06;-1;0;0;0;-1;0;390348464;394433880;20171154
1305;5.16627e-15;-292;1686;12437;11493.5;1;337;-2.14748e+09;-4.48862e+06;-1;0;0;0;-1;0;390527460;394627053;20216554
1306;5.16627e-15;-292;1686;12437;11493.5;1;337;-2.14748e+09;-4.47798e+06;-1;0;0;0;-1;0;390706040;394819822;20261925
1307;5.16627e-15;-293;1686;12437;11493.5;1;337;-2.14748e+09;-4.46736e+06;0;0;0;0;0;0;390884206;395012188;20307265
1308;5.16627e-15;-293;1686;12437;11493.5;1;337;-2.14748e+09;-4.45678e+06;-1;0;0;0;-1;0;391061959;395204152;20352575
1309;5.16627e-15;-294;1686;12437;11493.5;1;337;-2.14748e+09;-4.44624e+06;0;0;0;0;0;0;391239300;395395716;20397855
1310;5.16627e-15;-294;1686;12437;11493.5;1;337;-2.14748e+09;-4.43573e+06;-1;0;0;0;-1;0;391416230;395586880;20443103
1311;5.16627e-15;-294;1686;12437;11493.5;1;337;-2.14748e+09;-4.42525e+06;-1;0;0;0;-1;0;391592750;395777646;20488321
1312;5.16627e-15;-295;1686;12437;11493.5;1;337;-2.14748e+09;-4.41481e+06;0;0;0;0;0;0;391768862;395968014;20533508
1313;5.16627e-15;-296;1686;12437;11493.5;1;337;-2.14748e+09;-4.4044e+06;0;0;0;0;0;0;391944567;396157985;20578664
1314;5.16627e-15;-297;1686;12437;11493.5;1;337;-2.14748e+09;-4.39412e+06;0;0;0;0;0;0;392119866;396347562;20623789
1315;5.16627e-15;-297;1686;12437;11493.5;1;337;-2.14748e+09;-4.38368e+06;-1;0;0;0;-1;0;392294759;396536744;20668882
1316;5.16627e-15;-297;1686;12437;11493.5;1;337;-2.14748e+09;-4.37336e+06;-1;0;0;0;-1;0;392469249;396725534;20713944
1317;5.16627e-15;-298;1686;12437;11493.5;1;337;-2.14748e+09;-4.36308e+06;0;0;0;0;0;0;392643337;396913931;20758974
1318;5.16627e-15;-298;1686;12437;11493.5;1;337;-2.14748e+09;-4.35284e+06;-1;0;0;0;-1;0;392817023;397101937;20803972
1319;5.16627e-15;-299;1686;12437;11493.5;1;337;-2.14748e+09;-4.34262e+06;0;0;0;0;0;0;392990308;397289553;20848939
1320;5.16627e-15;-300;1686;12437;11493.5;1;337;-2.14748e+09;-4.33244e+06;0;0;0;0;0;0;393163194;397476781;20893873
1321;5.16627e-15;-300;1686;12437;11493.5;1;337;-2.14748e+09;-4.32229e+06;-1;0;0;0;-1;0;393335683;397663620;20938775
1322;5.16627e-15;-300;1686;12437;11493.5;1;337;-2.14748e+09;-4.31218e+06;-1;0;0;0;-1;0;393507774;397850073;20983645
1323;5.16627e-15;-301;1686;12437;11493.5;1;337;-2.14748e+09;-4.30209e+06;0;0;0;0;0;0;393679469;398036140;21028482
1324;5.16627e-15;-301;1686;12437;11493.5;1;337;-2.14748e+09;-4.29204e+06;-1;0;0;0;-1;0;393850770;398221823;21073287
1325;5.16627e-15;-302;1686;12437;11493.5;1;337;-2.14748e+09;-4.28201e+06;0;0;0;0;0;0;394021677;398407121;21118059
1326;5.16627e-15;-303;1686;12437;11493.5;1;337;-2.14748e+09;-4.27202e+06;0;0;0;0;0;0;394192192;398592037;21162798
1327;5.16627e-15;-303;1686;12437;11493.5;1;337;-2.14748e+09;-4.26206e+06;-1;0;0;0;-1;0;394362315;398776571;21207504
1328;5.16627e-15;-303;1686;12437;11493.5;1;337;-2.14748e+09;-4.25213e+06;-1;0;0;0;-1;0;394532048;398960725;21252178
1329;5.16627e-15;-303;1686;12437;11493.5;1;337;-2.14748e+09;-4.24224e+06;-1;0;0;0;-1;0;394701392;399144499;21296817
1330;5.16627e-15;-304;1686;12437;11493.5;1;337;-2.14748e+09;-4.23237e+06;0;0;0;0;0;0;394870348;399327894;21341424
1331;5.16627e-15;-305;1686;12437;11493.5;1;337;-2.14748e+09;-4.22253e+06;0;0;0;0;0;0;395038917;399510912;21385997
1332;5.16627e-15;-306;1686;12437;11493.5;1;337;-2.14748e+09;-4.21272e+06;0;0;0;0;0;0;395207100;399693553;21430536
1333;5.16627e-15;-306;1686;12437;11493.5;1;337;-2.14748e+09;-4.20295e+06;-1;0;0;0;-1;0;395374899;399875819;21475041
1334;5.16627e-15;-307;1686;12437;11493.5;1;337;-2.14748e+09;-4.1932e+06;0;0;0;0;0;0;395542313;400057709;21519513
1335;5.16627e-15;-307;1686;12437;11493.5;1;337;-2.14748e+09;-4.18349e+06;-1;0;0;0;-1;0;395709345;400239226;21563951
1336;5.16627e-15;-307;1686;12437;11493.5;1;337;-2.14748e+09;-4.1739e+06;-1;0;0;0;-1;0;395875996;400420371;21608354
1337;5.16627e-15;-308;1686;12437;11493.5;1;337;-2.14748e+09;-4.16415e+06;0;0;0;0;0;0;396042265;400601144;21652724
1338;5.16627e-15;-309;1686;12437;11493.5;1;337;-2.14748e+09;-4.15452e+06;0;0;0;0;0;0;396208156;400781546;21697059
1339;5.16627e-15;-310;1686;12437;11493.5;1;337;-2.14748e+09;-4.14502e+06;0;0;0;0;0;0;396373668;400961579;21741359
1340;5.16627e-15;-311;1686;12437;11493.5;1;337;-2.14748e+09;-4.13536e+06;0;0;0;0;0;0;396538803;401141242;21785625
1341;5.16627e-15;-312;1686;12437;11493.5;1;337;-2.14748e+09;-4.12582e+06;0;0;0;0;0;0;396703561;401320538;21829856
1342;5.16627e-15;-313;1686;12437;11493.5;1;337;-2.14748e+09;-4.11631e+06;0;0;0;0;0;0;396867944;401499467;21874053
1343;5.16627e-15;-313;1686;12437;11493.5;1;337;-2.14748e+09;-4.10693e+06;-1;0;0;0;-1;0;397031954;401678030;21918214
1344;5.16627e-15;-313;1686;12437;11493.5;1;337;-2.14748e+09;-4.09738e+06;-1;0;0;0;-1;0;397195590;401856229;21962340
1345;5.16627e-15;-313;1686;12437;11493.5;1;337;-2.14748e+09;-4.08796e+06;-1;0;0;0;-1;0;397358853;402034063;22006432
1346;5.16627e-15;-314;1686;12437;11493.5;1;337;-2.14748e+09;-4.07857e+06;0;0;0;0;0;0;397521746;402211534;22050488
1347;5.16627e-15;-315;1686;12437;11493.5;1;337;-2.14748e+09;-4.0693e+06;0;0;0;0;0;0;397684269;402388643;22094508
1348;5.16627e-15;-316;1686;12437;11493.5;1;337;-2.14748e+09;-4.05997e+06;0;0;0;0;0;0;397846423;402565391;22138493
1349;5.16627e-15;-316;1686;12437;11493.5;1;337;-2.14748e+09;-4.05056e+06;-1;0;0;0;-1;0;398008209;402741779;22182443
1350;5.16627e-15;-317;1686;12437;11493.5;1;337;-2.14748e+09;-4.04128e+06;0;0;0;0;0;0;398169628;402917808;22226356
1351;5.16627e-15;-317;1686;12437;11493.5;1;337;-2.14748e+09;-4.03203e+06;-1;0;0;0;-1;0;398330681;403093478;22270234
1352;5.16627e-15;-317;1686;12437;11493.5;1;337;-2.14748e+09;-4.02281e+06;-1;0;0;0;-1;0;398491369;403268791;22314076
1353;5.16627e-15;-318;1686;12437;11493.5;1;337;-2.14748e+09;-4.01361e+06;0;0;0;0;0;0;398651693;403443747;22357882
1354;5.16627e-15;-319;1686;12437;11493.5;1;337;-2.14748e+09;-4.00444e+06;0;0;0;0;0;0;398811654;403618348;22401652
1355;5.16627e-15;-320;1686;12437;11493.5;1;337;-2.14748e+09;-3.9953e+06;0;0;0;0;0;0;398971253;403792594;22445386
1356;5.16627e-15;-320;1686;12437;11493.5;1;337;-2.14748e+09;-3.98619e+06;-1;0;0;0;-1;0;399130491;403966486;22489083
1357;5.16627e-15;-321;1686;12437;11493.5;1;337;-2.14748e+09;-3.9772e+06;0;0;0;0;0;0;399289370;404140026;22532744
1358;5.16627e-15;-322;1686;12437;11493.5;1;337;-2.14748e+09;-3.96815e+06;0;0;0;0;0;0;399447889;404313214;22576368
1359;5.16627e-15;-322;1686;12437;11493.5;1;337;-2.14748e+09;-3.95912e+06;-1;0;0;0;-1;0;399606050;404486050;22619956
1360;5.16627e-15;-322;1686;12437;11493.5;1;337;-2.14748e+09;-3.95001e+06;-1;0;0;0;-1;0;399763855;404658537;22663507
1361;5.16627e-15;-322;1686;12437;11493.5;1;337;-2.14748e+09;-3.94103e+06;-1;0;0;0;-1;0;399921303;404830674;22707021
1362;5.16627e-15;-322;1686;12437;11493.5;1;337;-2.14748e+09;-3.93218e+06;-1;0;0;0;-1;0;400078397;405002463;22750498
1363;5.16627e-15;-322;1686;12437;11493.5;1;337;-2.14748e+09;-3.92316e+06;-1;0;0;0;-1;0;400235136;405173904;22793938
1364;5.16627e-15;-323;1686;12437;11493.5;1;337;-2.14748e+09;-3.91426e+06;0;0;0;0;0;0;400391522;405344999;22837341
1365;5.16627e-15;-324;1686;12437;11493.5;1;337;-2.14748e+09;-3.90549e+06;0;0;0;0;0;0;400547556;405515748;22880707
1366;5.16627e-15;-325;1686;12437;11493.5;1;337;-2.14748e+09;-3.89665e+06;0;0;0;0;0;0;400703239;405686152;22924036
1367;5.16627e-15;-325;1686;12437;11493.5;1;337;-2.14748e+09;-3.88783e+06;-1;0;0;0;-1;0;400858572;405856213;22967327
1368;5.16627e-15;-326;1686;12437;11493.5;1;337;-2.14748e+09;-3.87893e+06;0;0;0;0;0;0;401013555;406025930;23010580
1369;5.16627e-15;-326;1686;12437;11493.5;1;337;-2.14748e+09;-3.87017e+06;-1;0;0;0;-1;0;401168190;406195305;23053796
1370;5.16627e-15;-326;1686;12437;11493.5;1;337;-2.14748e+09;-3.86153e+06;-1;0;0;0;-1;0;401322478;406364339;23096974
1371;5.16627e-15;-327;1686;12437;11493.5;1;337;-2.14748e+09;-3.85281e+06;0;0;0;0;0;0;401476419;406533032;23140115
1372;5.16627e-15;-328;1686;12437;11493.5;1;337;-2.14748e+09;-3.84402e+06;0;0;0;0;0;0;401630015;406701386;23183217
1373;5.16627e-15;-328;1686;12437;11493.5;1;337;-2.14748e+09;-3.83536e+06;-1;0;0;0;-1;0;401783267;406869401;23226282
1374;5.16627e-15;-328;1686;12437;11493.5;1;337;-2.14748e+09;-3.82672e+06;-1;0;0;0;-1;0;401936174;407037078;23269309
1375;5.16627e-15;-329;1686;12437;11493.5;1;337;-2.14748e+09;-3.81811e+06;0;0;0;0;0;0;402088739;407204418;23312297
1376;5.16627e-15;-329;1686;12437;11493.5;1;337;-2.14748e+09;-3.80952e+06;-1;0;0;0;-1;0;402240963;407371421;23355247
1377;5.16627e-15;-329;1686;12437;11493.5;1;337;-2.14748e+09;-3.80096e+06;-1;0;0;0;-1;0;402392845;407538090;23398159
1378;5.16627e-15;-329;1686;12437;11493.5;1;337;-2.14748e+09;-3.79242e+06;-1;0;0;0;-1;0;402544388;407704424;23441033
1379;5.16627e-15;-329;1686;12437;11493.5;1;337;-2.14748e+09;-3.7839e+06;-1;0;0;0;-1;0;402695591;407870424;23483868
1380;5.16627e-15;-330;1686;12437;11493.5;1;337;-2.14748e+09;-3.77542e+06;0;0;0;0;0;0;402846457;408036091;23526664
1381;5.16627e-15;-331;1686;12437;11493.5;1;337;-2.14748e+09;-3.76695e+06;0;0;0;0;0;0;402996985;408201426;23569422
1382;5.16627e-15;-332;1686;12437;11493.5;1;337;-2.14748e+09;-3.75851e+06;0;0;0;0;0;0;403147177;408366431;23612141
1383;5.16627e-15;-332;1686;12437;11493.5;1;337;-2.14748e+09;-3.7501e+06;-1;0;0;0;-1;0;403297034;408531104;23654822
1384;5.16627e-15;-333;1686;12437;11493.5;1;337;-2.14748e+09;-3.74171e+06;0;0;0;0;0;0;403446556;408695448;23697463
1385;5.16627e-15;-334;1686;12437;11493.5;1;337;-2.14748e+09;-3.73334e+06;0;0;0;0;0;0;403595745;408859464;23740065
1386;5.16627e-15;-334;1686;12437;11493.5;1;337;-2.14748e+09;-3.725e+06;-1;0;0;0;-1;0;403744601;409023151;23782629
1387;5.16627e-15;-334;1686;12437;11493.5;1;337;-2.14748e+09;-3.71668e+06;-1;0;0;0;-1;0;403893125;409186512;23825153
1388;5.16627e-15;-335;1686;12437;11493.5;1;337;-2.14748e+09;-3.70839e+06;0;0;0;0;0;0;404041318;409349546;23867638
1389;5.16627e-15;-336;1686;12437;11493.5;1;337;-2.14748e+09;-3.70012e+06;0;0;0;0;0;0;404189181;409512255;23910084
1390;5.16627e-15;-337;1686;12437;11493.5;1;337;-2.14748e+09;-3.69197e+06;0;0;0;0;0;0;404336716;409674639;23952491
1391;5.16627e-15;-337;1686;12437;11493.5;1;337;-2.14748e+09;-3.68365e+06;-1;0;0;0;-1;0;404483922;409836699;23994858
1392;5.16627e-15;-337;1686;12437;11493.5;1;337;-2.14748e+09;-3.67545e+06;-1;0;0;0;-1;0;404630800;409998436;24037185
1393;5.16627e-15;-338;1686;12437;11493.5;1;337;-2.14748e+09;-3.66738e+06;0;0;0;0;0;0;404777352;410159850;24079473
1394;5.16627e-15;-338;1686;12437;11493.5;1;337;-2.14748e+09;-3.65922e+06;-1;0;0;0;-1;0;404923579;410320944;24121722
1395;5.16627e-15;-338;1686;12437;11493.5;1;337;-2.14748e+09;-3.651e+06;-1;0;0;0;-1;0;405069481;410481716;24163930
1396;5.16627e-15;-339;1686;12437;11493.5;1;337;-2.14748e+09;-3.64299e+06;0;0;0;0;0;0;405215059;410642169;24206099
1397;5.16627e-15;-339;1686;12437;11493.5;1;337;-2.14748e+09;-3.63481e+06;-1;0;0;0;-1;0;405360313;410802302;24248228
1398;5.16627e-15;-340;1686;12437;11493.5;1;337;-2.14748e+09;-3.62675e+06;0;0;0;0;0;0;405505246;410962117;24290317
1399;5.16627e-15;-340;1686;12437;11493.5;1;337;-2.14748e+09;-3.61871e+06;-1;0;0;0;-1;0;405649858;411121615;24332366
1400;5.16627e-15;-341;1686;12437;11493.5;1;337;-2.14748e+09;-3.6107e+06;0;0;0;0;0;0;405794149;411280795;24374376
1401;5.16627e-15;-342;1686;12437;11493.5;1;337;-2.14748e+09;-3.60271e+06;0;0;0;0;0;0;405938120;411439660;24416344
1402;5.16627e-15;-343;1686;12437;11493.5;1;337;-2.14748e+09;-3.59474e+06;0;0;0;0;0;0;406081772;411598210;24458273
1403;5.16627e-15;-343;1686;12437;11493.5;1;337;-2.14748e+09;-3.58689e+06;-1;0;0;0;-1;0;406225107;411756444;24500161
1404;5.16627e-15;-343;1686;12437;11493.5;1;337;-2.14748e+09;-3.57887e+06;-1;0;0;0;-1;0;406368125;411914366;24542010
1405;5.16627e-15;-343;1686;12437;11493.5;1;337;-2.14748e+09;-3.57097e+06;-1;0;0;0;-1;0;406510826;412071974;24583817
1406;5.16627e-15;-343;1686;12437;11493.5;1;337;-2.14748e+09;-3.56309e+06;-1;0;0;0;-1;0;406653212;412229270;24625584
1407;5.16627e-15;-343;1686;12437;11493.5;1;337;-2.14748e+09;-3.55533e+06;-1;0;0;0;-1;0;406795283;412386255;24667311
1408;5.16627e-15;-343;1686;12437;11493.5;1;337;-2.14748e+09;-3.5474e+06;-1;0;0;0;-1;0;406937041;412542929;24708997
1409;5.16627e-15;-343;1686;12437;11493.5;1;337;-2.14748e+09;-3.53959e+06;-1;0;0;0;-1;0;407078485;412699293;24750643
1410;5.16627e-15;-344;1686;12437;11493.5;1;337;-2.14748e+09;-3.5318e+06;0;0;0;0;0;0;407219618;412855348;24792247
1411;5.16627e-15;-345;1686;12437;11493.5;1;337;-2.14748e+09;-3.52413e+06;0;0;0;0;0;0;407360439;413011094;24833811
1412;5.16627e-15;-345;1686;12437;11493.5;1;337;-2.14748e+09;-3.51628e+06;-1;0;0;0;-1;0;407500950;413166533;24875334
1413;5.16627e-15;-346;1686;12437;11493.5;1;337;-2.14748e+09;-3.50866e+06;0;0;0;0;0;0;407641151;413321665;24916816
1414;5.16627e-15;-347;1686;12437;11493.5;1;337;-2.14748e+09;-3.50085e+06;0;0;0;0;0;0;407781044;413476490;24958258
1415;5.16627e-15;-347;1686;12437;11493.5;1;337;-2.14748e+09;-3.49317e+06;-1;0;0;0;-1;0;407920628;413631010;24999658
1416;5.16627e-15;-347;1686;12437;11493.5;1;337;-2.14748e+09;-3.48551e+06;-1;0;0;0;-1;0;408059905;413785226;25041017
1417;5.16627e-15;-348;1686;12437;11493.5;1;337;-2.14748e+09;-3.47797e+06;0;0;0;0;0;0;408198876;413939137;25082335
1418;5.16627e-15;-349;1686;12437;11493.5;1;337;-2.14748e+09;-3.47025e+06;0;0;0;0;0;0;408337541;414092745;25123612
1419;5.16627e-15;-349;1686;12437;11493.5;1;337;-2.14748e+09;-3.46265e+06;-1;0;0;0;-1;0;408475901;414246050;25164847
1420;5.16627e-15;-349;1686;12437;11493.5;1;337;-2.14748e+09;-3.45508e+06;-1;0;0;0;-1;0;408613957;414399054;25206042
1421;5.16627e-15;-349;1686;12437;11493.5;1;337;-2.14748e+09;-3.44752e+06;-1;0;0;0;-1;0;408751711;414551757;25247195
1422;5.16627e-15;-350;1686;12437;11493.5;1;337;-2.14748e+09;-3.43999e+06;0;0;0;0;0;0;408889161;414704159;25288306
1423;5.16627e-15;-350;1686;12437;11493.5;1;337;-2.14748e+09;-3.43258e+06;-1;0;0;0;-1;0;409026310;414856261;25329376
1424;5.16627e-15;-351;1686;12437;11493.5;1;337;-2.14748e+09;-3.42508e+06;0;0;0;0;0;0;409163158;415008065;25370405
1425;5.16627e-15;-351;1686;12437;11493.5;1;337;-2.14748e+09;-3.41751e+06;-1;0;0;0;-1;0;409299706;415159570;25411392
1426;5.16627e-15;-351;1686;12437;11493.5;1;337;-2.14748e+09;-3.41016e+06;-1;0;0;0;-1;0;409435955;415310778;25452337
1427;5.16627e-15;-352;1686;12437;11493.5;1;337;-2.14748e+09;-3.40273e+06;0;0;0;0;0;0;409571905;415461689;25493241
1428;5.16627e-15;-353;1686;12437;11493.5;1;337;-2.14748e+09;-3.39522e+06;0;0;0;0;0;0;409707558;415612303;25534103
1429;5.16627e-15;-353;1686;12437;11493.5;1;337;-2.14748e+09;-3.38793e+06;-1;0;0;0;-1;0;409842913;415762623;25574923
1430;5.16627e-15;-353;1686;12437;11493.5;1;337;-2.14748e+09;-3.38046e+06;-1;0;0;0;-1;0;409977973;415912647;25615701
1431;5.16627e-15;-354;1686;12437;11493.5;1;337;-2.14748e+09;-3.37321e+06;0;0;0;0;0;0;410112737;416062378;25656437
1432;5.16627e-15;-354;1686;12437;11493.5;1;337;-2.14748e+09;-3.36578e+06;-1;0;0;0;-1;0;410247206;416211815;25697132
1433;5.16627e-15;-354;1686;12437;11493.5;1;337;-2.14748e+09;-3.35847e+06;-1;0;0;0;-1;0;410381381;416360960;25737785
1434;5.16627e-15;-354;1686;12437;11493.5;1;337;-2.14748e+09;-3.35118e+06;-1;0;0;0;-1;0;410515263;416509812;25778395
1435;5.16627e-15;-355;1686;12437;11493.5;1;337;-2.14748e+09;-3.34391e+06;0;0;0;0;0;0;410648853;416658373;25818964
1436;5.16627e-15;-355;1686;12437;11493.5;1;337;-2.14748e+09;-3.33666e+06;-1;0;0;0;-1;0;410782151;416806644;25859490
1437;5.16627e-15;-355;1686;12437;11493.5;1;337;-2.14748e+09;-3.32943e+06;-1;0;0;0;-1;0;410915159;416954625;25899974
1438;5.16627e-15;-355;1686;12437;11493.5;1;337;-2.14748e+09;-3.32222e+06;-1;0;0;0;-1;0;411047876;417102317;25940416
1439;5.16627e-15;-355;1686;12437;11493.5;1;337;-2.14748e+09;-3.31503e+06;-1;0;0;0;-1;0;411180304;417249720;25980816
1440;5.16627e-15;-355;1686;12437;11493.5;1;337;-2.14748e+09;-3.30786e+06;-1;0;0;0;-1;0;411312443;417396835;26021174
1441;5.16627e-15;-356;1686;12437;11493.5;1;337;-2.14748e+09;-3.3007e+06;0;0;0;0;0;0;411444294;417543663;26061489
1442;5.16627e-15;-357;1686;12437;11493.5;1;337;-2.14748e+09;-3.29357e+06;0;0;0;0;0;0;411575858;417690204;26101762
1443;5.16627e-15;-358;1686;12437;11493.5;1;337;-2.14748e+09;-3.28656e+06;0;0;0;0;0;0;411707136;417836460;26141992
1444;5.16627e-15;-359;1686;12437;11493.5;1;337;-2.14748e+09;-3.27936e+06;0;0;0;0;0;0;411838128;417982431;26182180
1445;5.16627e-15;-360;1686;12437;11493.5;1;337;-2.14748e+09;-3.27229e+06;0;0;0;0;0;0;411968835;418128116;26222325
1446;5.16627e-15;-361;1686;12437;11493.5;1;337;-2.14748e+09;-3.26533e+06;0;0;0;0;0;0;412099258;418273519;26262428
1447;5.16627e-15;-361;1686;12437;11493.5;1;337;-2.14748e+09;-3.2582e+06;-1;0;0;0;-1;0;412229397;418418638;26302488
1448;5.16627e-15;-361;1686;12437;11493.5;1;337;-2.14748e+09;-3.25118e+06;-1;0;0;0;-1;0;412359254;418563474;26342506
1449;5.16627e-15;-362;1686;12437;11493.5;1;337;-2.14748e+09;-3.24418e+06;0;0;0;0;0;0;412488828;418708028;26382481
1450;5.16627e-15;-363;1686;12437;11493.5;1;337;-2.14748e+09;-3.2372e+06;0;0;0;0;0;0;412618121;418852302;26422414
1451;5.16627e-15;-364;1686;12437;11493.5;1;337;-2.14748e+09;-3.23024e+06;0;0;0;0;0;0;412747134;418996294;26462303
1452;5.16627e-15;-364;1686;12437;11493.5;1;337;-2.14748e+09;-3.22329e+06;-1;0;0;0;-1;0;412875867;419140007;26502150
1453;5.16627e-15;-364;1686;12437;11493.5;1;337;-2.14748e+09;-3.21647e+06;-1;0;0;0;-1;0;413004320;419283441;26541954
1454;5.16627e-15;-364;1686;12437;11493.5;1;337;-2.14748e+09;-3.20946e+06;-1;0;0;0;-1;0;413132495;419426595;26581715
1455;5.16627e-15;-364;1686;12437;11493.5;1;337;-2.14748e+09;-3.20257e+06;-1;0;0;0;-1;0;413260392;419569472;26621434
1456;5.16627e-15;-364;1686;12437;11493.5;1;337;-2.14748e+09;-3.1957e+06;-1;0;0;0;-1;0;413388013;419712072;26661109
1457;5.16627e-15;-364;1686;12437;11493.5;1;337;-2.14748e+09;-3.18885e+06;-1;0;0;0;-1;0;413515357;419854395;26700742
1458;5.16627e-15;-364;1686;12437;11493.5;1;337;-2.14748e+09;-3.18202e+06;-1;0;0;0;-1;0;413642425;419996442;26740331
1459;5.16627e-15;-364;1686;12437;11493.5;1;337;-2.14748e+09;-3.1752e+06;-1;0;0;0;-1;0;413769218;420138213;26779878
1460;5.16627e-15;-364;1686;12437;11493.5;1;337;-2.14748e+09;-3.16841e+06;-1;0;0;0;-1;0;413895737;420279709;26819381
1461;5.16627e-15;-365;1686;12437;11493.5;1;337;-2.14748e+09;-3.16163e+06;0;0;0;0;0;0;414021983;420420932;26858841
1462;5.16627e-15;-366;1686;12437;11493.5;1;337;-2.14748e+09;-3.15487e+06;0;0;0;0;0;0;414147955;420561880;26898259
1463;5.16627e-15;-366;1686;12437;11493.5;1;337;-2.14748e+09;-3.14812e+06;-1;0;0;0;-1;0;414273656;420702556;26937633
1464;5.16627e-15;-367;1686;12437;11493.5;1;337;-2.14748e+09;-3.1414e+06;0;0;0;0;0;0;414399085;420842960;26976964
1465;5.16627e-15;-368;1686;12437;11493.5;1;337;-2.14748e+09;-3.13479e+06;0;0;0;0;0;0;414524243;420983092;27016252
1466;5.16627e-15;-369;1686;12437;11493.5;1;337;-2.14748e+09;-3.128e+06;0;0;0;0;0;0;414649131;421122953;27055496
1467;5.16627e-15;-370;1686;12437;11493.5;1;337;-2.14748e+09;-3.12133e+06;0;0;0;0;0;0;414773750;421262544;27094697
1468;5.16627e-15;-371;1686;12437;11493.5;1;337;-2.14748e+09;-3.11468e+06;0;0;0;0;0;0;414898099;421401864;27133855
1469;5.16627e-15;-372;1686;12437;11493.5;1;337;-2.14748e+09;-3.10804e+06;0;0;0;0;0;0;415022181;421540916;27172970
1470;5.16627e-15;-372;1686;12437;11493.5;1;337;-2.14748e+09;-3.10142e+06;-1;0;0;0;-1;0;415145996;421679699;27212041
1471;5.16627e-15;-372;1686;12437;11493.5;1;337;-2.14748e+09;-3.09482e+06;-1;0;0;0;-1;0;415269543;421818214;27251069
1472;5.16627e-15;-373;1686;12437;11493.5;1;337;-2.14748e+09;-3.08833e+06;0;0;0;0;0;0;415392825;421956461;27290054
1473;5.16627e-15;-373;1686;12437;11493.5;1;337;-2.14748e+09;-3.08176e+06;-1;0;0;0;-1;0;415515841;422094442;27328995
1474;5.16627e-15;-373;1686;12437;11493.5;1;337;-2.14748e+09;-3.07511e+06;-1;0;0;0;-1;0;415638593;422232157;27367892
1475;5.16627e-15;-373;1686;12437;11493.5;1;337;-2.14748e+09;-3.06858e+06;-1;0;0;0;-1;0;415761080;422369606;27406746
1476;5.16627e-15;-373;1686;12437;11493.5;1;337;-2.14748e+09;-3.06206e+06;-1;0;0;0;-1;0;415883305;422506790;27445557
1477;5.16627e-15;-373;1686;12437;11493.5;1;337;-2.14748e+09;-3.05556e+06;-1;0;0;0;-1;0;416005266;422643710;27484324
1478;5.16627e-15;-373;1686;12437;11493.5;1;337;-2.14748e+09;-3.04918e+06;-1;0;0;0;-1;0;416126965;422780366;27523048
1479;5.16627e-15;-373;1686;12437;11493.5;1;337;-2.14748e+09;-3.04262e+06;-1;0;0;0;-1;0;416248403;422916759;27561728
1480;5.16627e-15;-373;1686;12437;11493.5;1;337;-2.14748e+09;-3.03627e+06;-1;0;0;0;-1;0;416369581;423052890;27600364
1481;5.16627e-15;-374;1686;12437;11493.5;1;337;-2.14748e+09;-3.02974e+06;0;0;0;0;0;0;416490498;423188758;27638957
1482;5.16627e-15;-375;1686;12437;11493.5;1;337;-2.14748e+09;-3.02332e+06;0;0;0;0;0;0;416611155;423324366;27677506
1483;5.16627e-15;-375;1686;12437;11493.5;1;337;-2.14748e+09;-3.01702e+06;-1;0;0;0;-1;0;416731554;423459712;27716011
1484;5.16627e-15;-376;1686;12437;11493.5;1;337;-2.14748e+09;-3.01054e+06;0;0;0;0;0;0;416851695;423594798;27754473
1485;5.16627e-15;-376;1686;12437;11493.5;1;337;-2.14748e+09;-3.00427e+06;-1;0;0;0;-1;0;416971578;423729625;27792891
1486;5.16627e-15;-377;1686;12437;11493.5;1;337;-2.14748e+09;-2.99792e+06;0;0;0;0;0;0;417091204;423864192;27831265
1487;5.16627e-15;-377;1686;12437;11493.5;1;337;-2.14748e+09;-2.99149e+06;-1;0;0;0;-1;0;417210574;423998501;27869596
1488;5.16627e-15;-377;1686;12437;11493.5;1;337;-2.14748e+09;-2.98518e+06;-1;0;0;0;-1;0;417329689;424132552;27907882
1489;5.16627e-15;-377;1686;12437;11493.5;1;337;-2.14748e+09;-2.97888e+06;-1;0;0;0;-1;0;417448548;424266346;27946125
1490;5.16627e-15;-377;1686;12437;11493.5;1;337;-2.14748e+09;-2.97259e+06;-1;0;0;0;-1;0;417567153;424399884;27984324
1491;5.16627e-15;-377;1686;12437;11493.5;1;337;-2.14748e+09;-2.96632e+06;-1;0;0;0;-1;0;417685505;424533165;28022480
1492;5.16627e-15;-378;1686;12437;11493.5;1;337;-2.14748e+09;-2.96007e+06;0;0;0;0;0;0;417803603;424666190;28060591
1493;5.16627e-15;-378;1686;12437;11493.5;1;337;-2.14748e+09;-2.95384e+06;-1;0;0;0;-1;0;417921449;424798961;28098659
1494;5.16627e-15;-379;1686;12437;11493.5;1;337;-2.14748e+09;-2.94772e+06;0;0;0;0;0;0;418039043;424931477;28136682
1495;5.16627e-15;-379;1686;12437;11493.5;1;337;-2.14748e+09;-2.94141e+06;-1;0;0;0;-1;0;418156386;425063739;28174662
1496;5.16627e-15;-379;1686;12437;11493.5;1;337;-2.14748e+09;-2.93522e+06;-1;0;0;0;-1;0;418273479;425195748;28212598
1497;5.16627e-15;-380;1686;12437;11493.5;1;337;-2.14748e+09;-2.92905e+06;0;0;0;0;0;0;418390321;425327505;28250490
1498;5.16627e-15;-380;1686;12437;11493.5;1;337;-2.14748e+09;-2.9229e+06;-1;0;0;0;-1;0;418506914;425459009;28288338
1499;5.16627e-15;-381;1686;12437;11493.5;1;337;-2.14748e+09;-2.91676e+06;0;0;0;0;0;0;418623259;425590261;28326142
1500;5.16627e-15;-382;1686;12437;11493.5;1;337;-2.14748e+09;-2.91073e+06;0;0;0;0;0;0;418739355;425721262;28363902
1501;5.16627e-15;-383;1686;12437;11493.5;1;337;-2.14748e+09;-2.90452e+06;0;0;0;0;0;0;418855204;425852013;28401618
1502;5.16627e-15;-383;1686;12437;11493.5;1;337;-2.14748e+09;-2.89843e+06;-1;0;0;0;-1;0;418970806;425982514;28439290
1503;5.16627e-15;-383;1686;12437;11493.5;1;337;-2.14748e+09;-2.89235e+06;-1;0;0;0;-1;0;419086162;426112766;28476918
1504;5.16627e-15;-383;1686;12437;11493.5;1;337;-2.14748e+09;-2.88629e+06;-1;0;0;0;-1;0;419201272;426242769;28514502
1505;5.16627e-15;-384;1686;12437;11493.5;1;337;-2.14748e+09;-2.88024e+06;0;0;0;0;0;0;419316137;426372523;28552042
1506;5.16627e-15;-384;1686;12437;11493.5;1;337;-2.14748e+09;-2.87431e+06;-1;0;0;0;-1;0;419430758;426502030;28589538
1507;5.16627e-15;-384;1686;12437;11493.5;1;337;-2.14748e+09;-2.86829e+06;-1;0;0;0;-1;0;419545134;426631290;28626989
1508;5.16627e-15;-385;1686;12437;11493.5;1;337;-2.14748e+09;-2.86219e+06;0;0;0;0;0;0;419659268;426760303;28664397
1509;5.16627e-15;-386;1686;12437;11493.5;1;337;-2.14748e+09;-2.8562e+06;0;0;0;0;0;0;419773159;426889069;28701761
1510;5.16627e-15;-386;1686;12437;11493.5;1;337;-2.14748e+09;-2.85033e+06;-1;0;0;0;-1;0;419886808;427017591;28739080
1511;5.16627e-15;-386;1686;12437;11493.5;1;337;-2.14748e+09;-2.84427e+06;-1;0;0;0;-1;0;420000215;427145867;28776355
1512;5.16627e-15;-386;1686;12437;11493.5;1;337;-2.14748e+09;-2.83843e+06;-1;0;0;0;-1;0;420113382;427273899;28813587
1513;5.16627e-15;-386;1686;12437;11493.5;1;337;-2.14748e+09;-2.8324e+06;-1;0;0;0;-1;0;420226308;427401687;28850774
1514;5.16627e-15;-387;1686;12437;11493.5;1;337;-2.14748e+09;-2.82659e+06;0;0;0;0;0;0;420338994;427529231;28887917
1515;5.16627e-15;-387;1686;12437;11493.5;1;337;-2.14748e+09;-2.8207e+06;-1;0;0;0;-1;0;420451442;427656533;28925015
1516;5.16627e-15;-387;1686;12437;11493.5;1;337;-2.14748e+09;-2.81472e+06;-1;0;0;0;-1;0;420563651;427783592;28962070
1517;5.16627e-15;-388;1686;12437;11493.5;1;337;-2.14748e+09;-2.80885e+06;0;0;0;0;0;0;420675622;427910409;28999081
1518;5.16627e-15;-389;1686;12437;11493.5;1;337;-2.14748e+09;-2.803e+06;0;0;0;0;0;0;420787355;428036985;29036047
1519;5.16627e-15;-389;1686;12437;11493.5;1;337;-2.14748e+09;-2.79716e+06;-1;0;0;0;-1;0;420898852;428163321;29072969
1520;5.16627e-15;-389;1686;12437;11493.5;1;337;-2.14748e+09;-2.79144e+06;-1;0;0;0;-1;0;421010113;428289416;29109847
1521;5.16627e-15;-390;1686;12437;11493.5;1;337;-2.14748e+09;-2.78553e+06;0;0;0;0;0;0;421121138;428415271;29146680
1522;5.16627e-15;-390;1686;12437;11493.5;1;337;-2.14748e+09;-2.77983e+06;-1;0;0;0;-1;0;421231928;428540887;29183470
1523;5.16627e-15;-391;1686;12437;11493.5;1;337;-2.14748e+09;-2.77395e+06;0;0;0;0;0;0;421342484;428666265;29220215
1524;5.16627e-15;-392;1686;12437;11493.5;1;337;-2.14748e+09;-2.76819e+06;0;0;0;0;0;0;421452805;428791404;29256916
1525;5.16627e-15;-392;1686;12437;11493.5;1;337;-2.14748e+09;-2.76254e+06;-1;0;0;0;-1;0;421562894;428916306;29293573
1526;5.16627e-15;-392;1686;12437;11493.5;1;337;-2.14748e+09;-2.7567e+06;-1;0;0;0;-1;0;421672750;429040971;29330186
1527;5.16627e-15;-393;1686;12437;11493.5;1;337;-2.14748e+09;-2.75098e+06;0;0;0;0;0;0;421782373;429165399;29366754
1528;5.16627e-15;-393;1686;12437;11493.5;1;337;-2.14748e+09;-2.74527e+06;-1;0;0;0;-1;0;421891765;429289591;29403278
1529;5.16627e-15;-393;1686;12437;11493.5;1;337;-2.14748e+09;-2.73958e+06;-1;0;0;0;-1;0;422000926;429413548;29439758
1530;5.16627e-15;-393;1686;12437;11493.5;1;337;-2.14748e+09;-2.734e+06;-1;0;0;0;-1;0;422109856;429537269;29476193
1531;5.16627e-15;-393;1686;12437;11493.5;1;337;-2.14748e+09;-2.72833e+06;-1;0;0;0;-1;0;422218556;429660756;29512585
1532;5.16627e-15;-393;1686;12437;11493.5;1;337;-2.14748e+09;-2.72268e+06;-1;0;0;0;-1;0;422327027;429784009;29548932
1533;5.16627e-15;-393;1686;12437;11493.5;1;337;-2.14748e+09;-2.71704e+06;-1;0;0;0;-1;0;422435269;429907028;29585235
1534;5.16627e-15;-393;1686;12437;11493.5;1;337;-2.14748e+09;-2.71132e+06;-1;0;0;0;-1;0;422543283;430029814;29621493
1535;5.16627e-15;-393;1686;12437;11493.5;1;337;-2.14748e+09;-2.70571e+06;-1;0;0;0;-1;0;422651069;430152368;29657707
1536;5.16627e-15;-393;1686;12437;11493.5;1;337;-2.14748e+09;-2.70011e+06;-1;0;0;0;-1;0;422758628;430274690;29693877
1537;5.16627e-15;-394;1686;12437;11493.5;1;337;-2.14748e+09;-2.69453e+06;0;0;0;0;0;0;422865960;430396780;29730003
1538;5.16627e-15;-394;1686;12437;11493.5;1;337;-2.14748e+09;-2.68896e+06;-1;0;0;0;-1;0;422973066;430518639;29766085
1539;5.16627e-15;-395;1686;12437;11493.5;1;337;-2.14748e+09;-2.68351e+06;0;0;0;0;0;0;423079947;430640268;29802122
1540;5.16627e-15;-396;1686;12437;11493.5;1;337;-2.14748e+09;-2.67786e+06;0;0;0;0;0;0;423186602;430761666;29838115
1541;5.16627e-15;-396;1686;12437;11493.5;1;337;-2.14748e+09;-2.67234e+06;-1;0;0;0;-1;0;423293034;430882835;29874064
1542;5.16627e-15;-396;1686;12437;11493.5;1;337;-2.14748e+09;-2.66682e+06;-1;0;0;0;-1;0;423399241;431003776;29909968
1543;5.16627e-15;-396;1686;12437;11493.5;1;337;-2.14748e+09;-2.66132e+06;-1;0;0;0;-1;0;423505225;431124487;29945828
1544;5.16627e-15;-396;1686;12437;11493.5;1;337;-2.14748e+09;-2.65584e+06;-1;0;0;0;-1;0;423610986;431244970;29981644
1545;5.16627e-15;-397;1686;12437;11493.5;1;337;-2.14748e+09;-2.65036e+06;0;0;0;0;0;0;423716525;431365226;30017416
1546;5.16627e-15;-397;1686;12437;11493.5;1;337;-2.14748e+09;-2.6449e+06;-1;0;0;0;-1;0;423821842;431485255;30053143
1547;5.16627e-15;-398;1686;12437;11493.5;1;337;-2.14748e+09;-2.63946e+06;0;0;0;0;0;0;423926938;431605057;30088826
1548;5.16627e-15;-399;1686;12437;11493.5;1;337;-2.14748e+09;-2.63402e+06;0;0;0;0;0;0;424031813;431724633;30124465
1549;5.16627e-15;-399;1686;12437;11493.5;1;337;-2.14748e+09;-2.6286e+06;-1;0;0;0;-1;0;424136468;431843983;30160060
1550;5.16627e-15;-399;1686;12437;11493.5;1;337;-2.14748e+09;-2.62319e+06;-1;0;0;0;-1;0;424240903;431963109;30195610
1551;5.16627e-15;-399;1686;12437;11493.5;1;337;-2.14748e+09;-2.6178e+06;-1;0;0;0;-1;0;424345119;432082009;30231116
1552;5.16627e-15;-399;1686;12437;11493.5;1;337;-2.14748e+09;-2.61242e+06;-1;0;0;0;-1;0;424449117;432200685;30266578
1553;5.16627e-15;-399;1686;12437;11493.5;1;337;-2.14748e+09;-2.60705e+06;-1;0;0;0;-1;0;424552897;432319138;30301995
1554;5.16627e-15;-399;1686;12437;11493.5;1;337;-2.14748e+09;-2.6017e+06;-1;0;0;0;-1;0;424656459;432437367;30337369
1555;5.16627e-15;-399;1686;12437;11493.5;1;337;-2.14748e+09;-2.59636e+06;-1;0;0;0;-1;0;424759804;432555374;30372698
1556;5.16627e-15;-400;1686;12437;11493.5;1;337;-2.14748e+09;-2.59103e+06;0;0;0;0;0;0;424862932;432673158;30407983
1557;5.16627e-15;-400;1686;12437;11493.5;1;337;-2.14748e+09;-2.58571e+06;-1;0;0;0;-1;0;424965845;432790721;30443223
1558;5.16627e-15;-401;1686;12437;11493.5;1;337;-2.14748e+09;-2.58041e+06;0;0;0;0;0;0;425068542;432908062;30478420
1559;5.16627e-15;-401;1686;12437;11493.5;1;337;-2.14748e+09;-2.57512e+06;-1;0;0;0;-1;0;425171024;433025182;30513572
1560;5.16627e-15;-401;1686;12437;11493.5;1;337;-2.14748e+09;-2.56984e+06;-1;0;0;0;-1;0;425273291;433142082;30548680
1561;5.16627e-15;-401;1686;12437;11493.5;1;337;-2.14748e+09;-2.56458e+06;-1;0;0;0;-1;0;425375345;433258762;30583744
1562;5.16627e-15;-402;1686;12437;11493.5;1;337;-2.14748e+09;-2.55932e+06;0;0;0;0;0;0;425477185;433375222;30618763
1563;5.16627e-15;-403;1686;12437;11493.5;1;337;-2.14748e+09;-2.55408e+06;0;0;0;0;0;0;425578813;433491464;30653739
1564;5.16627e-15;-404;1686;12437;11493.5;1;337;-2.14748e+09;-2.54886e+06;0;0;0;0;0;0;425680228;433607487;30688670
1565;5.16627e-15;-405;1686;12437;11493.5;1;337;-2.14748e+09;-2.54374e+06;0;0;0;0;0;0;425781431;433723292;30723557
1566;5.16627e-15;-406;1686;12437;11493.5;1;337;-2.14748e+09;-2.53854e+06;0;0;0;0;0;0;425882423;433838879;30758400
1567;5.16627e-15;-407;1686;12437;11493.5;1;337;-2.14748e+09;-2.53325e+06;0;0;0;0;0;0;425983204;433954249;30793199
1568;5.16627e-15;-408;1686;12437;11493.5;1;337;-2.14748e+09;-2.52808e+06;0;0;0;0;0;0;426083774;434069402;30827953
1569;5.16627e-15;-409;1686;12437;11493.5;1;337;-2.14748e+09;-2.52291e+06;0;0;0;0;0;0;426184134;434184339;30862664
1570;5.16627e-15;-410;1686;12437;11493.5;1;337;-2.14748e+09;-2.51776e+06;0;0;0;0;0;0;426284286;434299060;30897330
1571;5.16627e-15;-410;1686;12437;11493.5;1;337;-2.14748e+09;-2.51262e+06;-1;0;0;0;-1;0;426384228;434413566;30931952
1572;5.16627e-15;-411;1686;12437;11493.5;1;337;-2.14748e+09;-2.5075e+06;0;0;0;0;0;0;426483962;434527857;30966530
1573;5.16627e-15;-412;1686;12437;11493.5;1;337;-2.14748e+09;-2.50248e+06;0;0;0;0;0;0;426583488;434641934;31001064
1574;5.16627e-15;-412;1686;12437;11493.5;1;337;-2.14748e+09;-2.49728e+06;-1;0;0;0;-1;0;426682806;434755796;31035554
1575;5.16627e-15;-413;1686;12437;11493.5;1;337;-2.14748e+09;-2.49219e+06;0;0;0;0;0;0;426781918;434869445;31070000
1576;5.16627e-15;-414;1686;12437;11493.5;1;337;-2.14748e+09;-2.48711e+06;0;0;0;0;0;0;426880823;434982881;31104401
1577;5.16627e-15;-415;1686;12437;11493.5;1;337;-2.14748e+09;-2.48204e+06;0;0;0;0;0;0;426979522;435096104;31138759
1578;5.16627e-15;-416;1686;12437;11493.5;1;337;-2.14748e+09;-2.47699e+06;0;0;0;0;0;0;427078016;435209115;31173072
1579;5.16627e-15;-417;1686;12437;11493.5;1;337;-2.14748e+09;-2.47195e+06;0;0;0;0;0;0;427176305;435321915;31207342
1580;5.16627e-15;-418;1686;12437;11493.5;1;337;-2.14748e+09;-2.46692e+06;0;0;0;0;0;0;427274389;435434503;31241567
1581;5.16627e-15;-419;1686;12437;11493.5;1;337;-2.14748e+09;-2.4619e+06;0;0;0;0;0;0;427372269;435546880;31275748
1582;5.16627e-15;-419;1686;12437;11493.5;1;337;-2.14748e+09;-2.45689e+06;-1;0;0;0;-1;0;427469946;435659046;31309886
1583;5.16627e-15;-419;1686;12437;11493.5;1;337;-2.14748e+09;-2.452e+06;-1;0;0;0;-1;0;427567419;435771003;31343979
1584;5.16627e-15;-420;1686;12437;11493.5;1;337;-2.14748e+09;-2.44692e+06;0;0;0;0;0;0;427664690;435882750;31378029
1585;5.16627e-15;-420;1686;12437;11493.5;1;337;-2.14748e+09;-2.44204e+06;-1;0;0;0;-1;0;427761759;435994288;31412034
1586;5.16627e-15;-420;1686;12437;11493.5;1;337;-2.14748e+09;-2.43699e+06;-1;0;0;0;-1;0;427858627;436105618;31445995
1587;5.16627e-15;-420;1686;12437;11493.5;1;337;-2.14748e+09;-2.43204e+06;-1;0;0;0;-1;0;427955293;436216739;31479913
1588;5.16627e-15;-421;1686;12437;11493.5;1;337;-2.14748e+09;-2.4271e+06;0;0;0;0;0;0;428051759;436327652;31513786
1589;5.16627e-15;-422;1686;12437;11493.5;1;337;-2.14748e+09;-2.42218e+06;0;0;0;0;0;0;428148024;436438358;31547616
1590;5.16627e-15;-423;1686;12437;11493.5;1;337;-2.14748e+09;-2.41727e+06;0;0;0;0;0;0;428244090;436548857;31581402
1591;5.16627e-15;-423;1686;12437;11493.5;1;337;-2.14748e+09;-2.41237e+06;-1;0;0;0;-1;0;428339956;436659149;31615143
1592;5.16627e-15;-424;1686;12437;11493.5;1;337;-2.14748e+09;-2.40748e+06;0;0;0;0;0;0;428435623;436769235;31648841
1593;5.16627e-15;-425;1686;12437;11493.5;1;337;-2.14748e+09;-2.4026e+06;0;0;0;0;0;0;428531093;436879116;31682495
1594;5.16627e-15;-425;1686;12437;11493.5;1;337;-2.14748e+09;-2.39774e+06;-1;0;0;0;-1;0;428626364;436988791;31716105
1595;5.16627e-15;-425;1686;12437;11493.5;1;337;-2.14748e+09;-2.39288e+06;-1;0;0;0;-1;0;428721438;437098262;31749672
1596;5.16627e-15;-425;1686;12437;11493.5;1;337;-2.14748e+09;-2.38804e+06;-1;0;0;0;-1;0;428816315;437207528;31783194
1597;5.16627e-15;-426;1686;12437;11493.5;1;337;-2.14748e+09;-2.38331e+06;0;0;0;0;0;0;428910996;437316590;31816673
1598;5.16627e-15;-427;1686;12437;11493.5;1;337;-2.14748e+09;-2.37838e+06;0;0;0;0;0;0;429005480;437425449;31850108
1599;5.16627e-15;-427;1686;12437;11493.5;1;337;-2.14748e+09;-2.37368e+06;-1;0;0;0;-1;0;429099769;437534105;31883499
1600;5.16627e-15;-428;1686;12437;11493.5;1;337;-2.14748e+09;-2.36878e+06;0;0;0;0;0;0;429193863;437642557;31916846
1601;5.16627e-15;-429;1686;12437;11493.5;1;337;-2.14748e+09;-2.36399e+06;0;0;0;0;0;0;429287762;437750808;31950150
1602;5.16627e-15;-430;1686;12437;11493.5;1;337;-2.14748e+09;-2.35922e+06;0;0;0;0;0;0;429381467;437858857;31983409
1603;5.16627e-15;-431;1686;12437;11493.5;1;337;-2.14748e+09;-2.35445e+06;0;0;0;0;0;0;429474978;437966704;32016626
1604;5.16627e-15;-432;1686;12437;11493.5;1;337;-2.14748e+09;-2.3497e+06;0;0;0;0;0;0;429568296;438074350;32049798
1605;5.16627e-15;-432;1686;12437;11493.5;1;337;-2.14748e+09;-2.34496e+06;-1;0;0;0;-1;0;429661421;438181796;32082927
1606;5.16627e-15;-432;1686;12437;11493.5;1;337;-2.14748e+09;-2.34023e+06;-1;0;0;0;-1;0;429754354;438289041;32116012
1607;5.16627e-15;-432;1686;12437;11493.5;1;337;-2.14748e+09;-2.33551e+06;-1;0;0;0;-1;0;429847095;438396087;32149053
1608;5.16627e-15;-433;1686;12437;11493.5;1;337;-2.14748e+09;-2.3308e+06;0;0;0;0;0;0;429939644;438502933;32182051
1609;5.16627e-15;-433;1686;12437;11493.5;1;337;-2.14748e+09;-2.3261e+06;-1;0;0;0;-1;0;430032002;438609580;32215005
1610;5.16627e-15;-433;1686;12437;11493.5;1;337;-2.14748e+09;-2.32141e+06;-1;0;0;0;-1;0;430124170;438716028;32247916
1611;5.16627e-15;-433;1686;12437;11493.5;1;337;-2.14748e+09;-2.31674e+06;-1;0;0;0;-1;0;430216148;438822279;32280783
1612;5.16627e-15;-433;1686;12437;11493.5;1;337;-2.14748e+09;-2.31207e+06;-1;0;0;0;-1;0;430307935;438928331;32313606
1613;5.16627e-15;-434;1686;12437;11493.5;1;337;-2.14748e+09;-2.30742e+06;0;0;0;0;0;0;430399534;439034187;32346386
1614;5.16627e-15;-435;1686;12437;11493.5;1;337;-2.14748e+09;-2.30277e+06;0;0;0;0;0;0;430490943;439139845;32379122
1615;5.16627e-15;-435;1686;12437;11493.5;1;337;-2.14748e+09;-2.29814e+06;-1;0;0;0;-1;0;430582165;439245307;32411815
1616;5.16627e-15;-435;1686;12437;11493.5;1;337;-2.14748e+09;-2.29352e+06;-1;0;0;0;-1;0;430673198;439350573;32444464
1617;5.16627e-15;-436;1686;12437;11493.5;1;337;-2.14748e+09;-2.28891e+06;0;0;0;0;0;0;430764044;439455643;32477070
1618;5.16627e-15;-437;1686;12437;11493.5;1;337;-2.14748e+09;-2.28431e+06;0;0;0;0;0;0;430854702;439560517;32509633
1619;5.16627e-15;-438;1686;12437;11493.5;1;337;-2.14748e+09;-2.27972e+06;0;0;0;0;0;0;430945174;439665197;32542152
1620;5.16627e-15;-438;1686;12437;11493.5;1;337;-2.14748e+09;-2.27514e+06;-1;0;0;0;-1;0;431035460;439769682;32574627
1621;5.16627e-15;-439;1686;12437;11493.5;1;337;-2.14748e+09;-2.27057e+06;0;0;0;0;0;0;431125560;439873973;32607059
1622;5.16627e-15;-439;1686;12437;11493.5;1;337;-2.14748e+09;-2.26601e+06;-1;0;0;0;-1;0;431215475;439978071;32639448
1623;5.16627e-15;-440;1686;12437;11493.5;1;337;-2.14748e+09;-2.26146e+06;0;0;0;0;0;0;431305204;440081974;32671794
1624;5.16627e-15;-440;1686;12437;11493.5;1;337;-2.14748e+09;-2.25692e+06;-1;0;0;0;-1;0;431394749;440185685;32704096
1625;5.16627e-15;-440;1686;12437;11493.5;1;337;-2.14748e+09;-2.2524e+06;-1;0;0;0;-1;0;431484110;440289204;32736355
1626;5.16627e-15;-441;1686;12437;11493.5;1;337;-2.14748e+09;-2.24798e+06;0;0;0;0;0;0;431573288;440392530;32768570
1627;5.16627e-15;-442;1686;12437;11493.5;1;337;-2.14748e+09;-2.24347e+06;0;0;0;0;0;0;431662282;440495664;32800743
1628;5.16627e-15;-442;1686;12437;11493.5;1;337;-2.14748e+09;-2.23888e+06;-1;0;0;0;-1;0;431751093;440598607;32832872
1629;5.16627e-15;-443;1686;12437;11493.5;1;337;-2.14748e+09;-2.23449e+06;0;0;0;0;0;0;431839722;440701359;32864958
1630;5.16627e-15;-444;1686;12437;11493.5;1;337;-2.14748e+09;-2.22992e+06;0;0;0;0;0;0;431928169;440803921;32897000
1631;5.16627e-15;-445;1686;12437;11493.5;1;337;-2.14748e+09;-2.22555e+06;0;0;0;0;0;0;432016434;440906292;32929000
1632;5.16627e-15;-445;1686;12437;11493.5;1;337;-2.14748e+09;-2.221e+06;-1;0;0;0;-1;0;432104518;441008473;32960956
1633;5.16627e-15;-446;1686;12437;11493.5;1;337;-2.14748e+09;-2.21655e+06;0;0;0;0;0;0;432192422;441110465;32992869
1634;5.16627e-15;-446;1686;12437;11493.5;1;337;-2.14748e+09;-2.21212e+06;-1;0;0;0;-1;0;432280145;441212268;33024740
1635;5.16627e-15;-446;1686;12437;11493.5;1;337;-2.14748e+09;-2.2077e+06;-1;0;0;0;-1;0;432367688;441313882;33056567
1636;5.16627e-15;-447;1686;12437;11493.5;1;337;-2.14748e+09;-2.20328e+06;0;0;0;0;0;0;432455052;441415307;33088351
1637;5.16627e-15;-447;1686;12437;11493.5;1;337;-2.14748e+09;-2.19898e+06;-1;0;0;0;-1;0;432542236;441516545;33120091
1638;5.16627e-15;-448;1686;12437;11493.5;1;337;-2.14748e+09;-2.19448e+06;0;0;0;0;0;0;432629242;441617595;33151789
1639;5.16627e-15;-448;1686;12437;11493.5;1;337;-2.14748e+09;-2.1901e+06;-1;0;0;0;-1;0;432716070;441718458;33183444
1640;5.16627e-15;-448;1686;12437;11493.5;1;337;-2.14748e+09;-2.18572e+06;-1;0;0;0;-1;0;432802720;441819135;33215056
1641;5.16627e-15;-448;1686;12437;11493.5;1;337;-2.14748e+09;-2.18136e+06;-1;0;0;0;-1;0;432889192;441919625;33246625
1642;5.16627e-15;-449;1686;12437;11493.5;1;337;-2.14748e+09;-2.17701e+06;0;0;0;0;0;0;432975488;442019928;33278151
1643;5.16627e-15;-450;1686;12437;11493.5;1;337;-2.14748e+09;-2.17266e+06;0;0;0;0;0;0;433061607;442120047;33309634
1644;5.16627e-15;-451;1686;12437;11493.5;1;337;-2.14748e+09;-2.16833e+06;0;0;0;0;0;0;433147549;442219979;33341075
1645;5.16627e-15;-451;1686;12437;11493.5;1;337;-2.14748e+09;-2.164e+06;-1;0;0;0;-1;0;433233316;442319727;33372472
1646;5.16627e-15;-451;1686;12437;11493.5;1;337;-2.14748e+09;-2.15969e+06;-1;0;0;0;-1;0;433318907;442419291;33403827
1647;5.16627e-15;-451;1686;12437;11493.5;1;337;-2.14748e+09;-2.15548e+06;-1;0;0;0;-1;0;433404324;442518670;33435139
1648;5.16627e-15;-451;1686;12437;11493.5;1;337;-2.14748e+09;-2.15109e+06;-1;0;0;0;-1;0;433489565;442617865;33466408
1649;5.16627e-15;-452;1686;12437;11493.5;1;337;-2.14748e+09;-2.1468e+06;0;0;0;0;0;0;433574633;442716877;33497634
1650;5.16627e-15;-453;1686;12437;11493.5;1;337;-2.14748e+09;-2.14263e+06;0;0;0;0;0;0;433659527;442815706;33528818
1651;5.16627e-15;-453;1686;12437;11493.5;1;337;-2.14748e+09;-2.13836e+06;-1;0;0;0;-1;0;433744247;442914352;33559959
1652;5.16627e-15;-453;1686;12437;11493.5;1;337;-2.14748e+09;-2.13401e+06;-1;0;0;0;-1;0;433828794;443012816;33591057
1653;5.16627e-15;-453;1686;12437;11493.5;1;337;-2.14748e+09;-2.12976e+06;-1;0;0;0;-1;0;433913168;443111098;33622112
1654;5.16627e-15;-454;1686;12437;11493.5;1;337;-2.14748e+09;-2.12552e+06;0;0;0;0;0;0;433997371;443209198;33653125
1655;5.16627e-15;-455;1686;12437;11493.5;1;337;-2.14748e+09;-2.1213e+06;0;0;0;0;0;0;434081401;443307117;33684096
1656;5.16627e-15;-455;1686;12437;11493.5;1;337;-2.14748e+09;-2.11708e+06;-1;0;0;0;-1;0;434165260;443404855;33715023
1657;5.16627e-15;-455;1686;12437;11493.5;1;337;-2.14748e+09;-2.11287e+06;-1;0;0;0;-1;0;434248948;443502413;33745909
1658;5.16627e-15;-456;1686;12437;11493.5;1;337;-2.14748e+09;-2.10877e+06;0;0;0;0;0;0;434332466;443599791;33776751
1659;5.16627e-15;-456;1686;12437;11493.5;1;337;-2.14748e+09;-2.10448e+06;-1;0;0;0;-1;0;434415813;443696988;33807552
1660;5.16627e-15;-456;1686;12437;11493.5;1;337;-2.14748e+09;-2.1004e+06;-1;0;0;0;-1;0;434498990;443794007;33838309
1661;5.16627e-15;-457;1686;12437;11493.5;1;337;-2.14748e+09;-2.09623e+06;0;0;0;0;0;0;434581997;443890846;33869025
1662;5.16627e-15;-457;1686;12437;11493.5;1;337;-2.14748e+09;-2.09197e+06;-1;0;0;0;-1;0;434664835;443987506;33899698
1663;5.16627e-15;-457;1686;12437;11493.5;1;337;-2.14748e+09;-2.08782e+06;-1;0;0;0;-1;0;434747505;444083988;33930328
1664;5.16627e-15;-458;1686;12437;11493.5;1;337;-2.14748e+09;-2.08367e+06;0;0;0;0;0;0;434830006;444180292;33960916
1665;5.16627e-15;-458;1686;12437;11493.5;1;337;-2.14748e+09;-2.07954e+06;-1;0;0;0;-1;0;434912340;444276419;33991462
1666;5.16627e-15;-459;1686;12437;11493.5;1;337;-2.14748e+09;-2.07542e+06;0;0;0;0;0;0;434994505;444372368;34021966
1667;5.16627e-15;-459;1686;12437;11493.5;1;337;-2.14748e+09;-2.0713e+06;-1;0;0;0;-1;0;435076504;444468140;34052427
1668;5.16627e-15;-459;1686;12437;11493.5;1;337;-2.14748e+09;-2.0672e+06;-1;0;0;0;-1;0;435158335;444563736;34082846
1669;5.16627e-15;-459;1686;12437;11493.5;1;337;-2.14748e+09;-2.0632e+06;-1;0;0;0;-1;0;435240001;444659155;34113223
1670;5.16627e-15;-459;1686;12437;11493.5;1;337;-2.14748e+09;-2.05901e+06;-1;0;0;0;-1;0;435321499;444754399;34143558
1671;5.16627e-15;-459;1686;12437;11493.5;1;337;-2.14748e+09;-2.05503e+06;-1;0;0;0;-1;0;435402833;444849467;34173850
1672;5.16627e-15;-460;1686;12437;11493.5;1;337;-2.14748e+09;-2.05086e+06;0;0;0;0;0;0;435484001;444944359;34204101
1673;5.16627e-15;-461;1686;12437;11493.5;1;337;-2.14748e+09;-2.04681e+06;0;0;0;0;0;0;435565004;445039077;34234309
1674;5.16627e-15;-461;1686;12437;11493.5;1;337;-2.14748e+09;-2.04275e+06;-1;0;0;0;-1;0;435645842;445133621;34264475
1675;5.16627e-15;-461;1686;12437;11493.5;1;337;-2.14748e+09;-2.03881e+06;-1;0;0;0;-1;0;435726516;445227990;34294599
1676;5.16627e-15;-461;1686;12437;11493.5;1;337;-2.14748e+09;-2.03468e+06;-1;0;0;0;-1;0;435807027;445322185;34324681
1677;5.16627e-15;-462;1686;12437;11493.5;1;337;-2.14748e+09;-2.03066e+06;0;0;0;0;0;0;435887373;445416207;34354721
1678;5.16627e-15;-462;1686;12437;11493.5;1;337;-2.14748e+09;-2.02674e+06;-1;0;0;0;-1;0;435967557;445510056;34384720
1679;5.16627e-15;-463;1686;12437;11493.5;1;337;-2.14748e+09;-2.02273e+06;0;0;0;0;0;0;436047578;445603732;34414676
1680;5.16627e-15;-463;1686;12437;11493.5;1;337;-2.14748e+09;-2.01864e+06;-1;0;0;0;-1;0;436127436;445697236;34444590
1681;5.16627e-15;-463;1686;12437;11493.5;1;337;-2.14748e+09;-2.01465e+06;-1;0;0;0;-1;0;436207133;445790568;34474463
1682;5.16627e-15;-464;1686;12437;11493.5;1;337;-2.14748e+09;-2.01067e+06;0;0;0;0;0;0;436286668;445883728;34504293
1683;5.16627e-15;-464;1686;12437;11493.5;1;337;-2.14748e+09;-2.0067e+06;-1;0;0;0;-1;0;436366041;445976716;34534082
1684;5.16627e-15;-465;1686;12437;11493.5;1;337;-2.14748e+09;-2.00274e+06;0;0;0;0;0;0;436445254;446069533;34563829
1685;5.16627e-15;-466;1686;12437;11493.5;1;337;-2.14748e+09;-1.99878e+06;0;0;0;0;0;0;436524306;446162180;34593535
1686;5.16627e-15;-467;1686;12437;11493.5;1;337;-2.14748e+09;-1.99484e+06;0;0;0;0;0;0;436603198;446254656;34623198
1687;5.16627e-15;-467;1686;12437;11493.5;1;337;-2.14748e+09;-1.9909e+06;-1;0;0;0;-1;0;436681930;446346962;34652820
1688;5.16627e-15;-467;1686;12437;11493.5;1;337;-2.14748e+09;-1.98698e+06;-1;0;0;0;-1;0;436760502;446439099;34682400
1689;5.16627e-15;-468;1686;12437;11493.5;1;337;-2.14748e+09;-1.98306e+06;0;0;0;0;0;0;436838916;446531066;34711939
1690;5.16627e-15;-468;1686;12437;11493.5;1;337;-2.14748e+09;-1.97915e+06;-1;0;0;0;-1;0;436917170;446622864;34741436
1691;5.16627e-15;-468;1686;12437;11493.5;1;337;-2.14748e+09;-1.97525e+06;-1;0;0;0;-1;0;436995267;446714493;34770892
1692;5.16627e-15;-469;1686;12437;11493.5;1;337;-2.14748e+09;-1.97136e+06;0;0;0;0;0;0;437073205;446805954;34800305
1693;5.16627e-15;-469;1686;12437;11493.5;1;337;-2.14748e+09;-1.96747e+06;-1;0;0;0;-1;0;437150985;446897247;34829678
1694;5.16627e-15;-469;1686;12437;11493.5;1;337;-2.14748e+09;-1.9636e+06;-1;0;0;0;-1;0;437228608;446988372;34859009
1695;5.16627e-15;-470;1686;12437;11493.5;1;337;-2.14748e+09;-1.95983e+06;0;0;0;0;0;0;437306074;447079330;34888298
1696;5.16627e-15;-471;1686;12437;11493.5;1;337;-2.14748e+09;-1.95598e+06;0;0;0;0;0;0;437383383;447170120;34917547
1697;5.16627e-15;-472;1686;12437;11493.5;1;337;-2.14748e+09;-1.95203e+06;0;0;0;0;0;0;437460536;447260744;34946753
1698;5.16627e-15;-473;1686;12437;11493.5;1;337;-2.14748e+09;-1.94829e+06;0;0;0;0;0;0;437537534;447351202;34975919
1699;5.16627e-15;-474;1686;12437;11493.5;1;337;-2.14748e+09;-1.94445e+06;0;0;0;0;0;0;437614375;447441493;35005043
1700;5.16627e-15;-475;1686;12437;11493.5;1;337;-2.14748e+09;-1.94053e+06;0;0;0;0;0;0;437691061;447531619;35034126
1701;5.16627e-15;-475;1686;12437;11493.5;1;337;-2.14748e+09;-1.93671e+06;-1;0;0;0;-1;0;437767593;447621579;35063167
1702;5.16627e-15;-476;1686;12437;11493.5;1;337;-2.14748e+09;-1.9329e+06;0;0;0;0;0;0;437843969;447711374;35092167
1703;5.16627e-15;-476;1686;12437;11493.5;1;337;-2.14748e+09;-1.92911e+06;-1;0;0;0;-1;0;437920192;447801005;35121127
1704;5.16627e-15;-476;1686;12437;11493.5;1;337;-2.14748e+09;-1.92532e+06;-1;0;0;0;-1;0;437996261;447890470;35150045
1705;5.16627e-15;-477;1686;12437;11493.5;1;337;-2.14748e+09;-1.92153e+06;0;0;0;0;0;0;438072176;447979772;35178921
1706;5.16627e-15;-478;1686;12437;11493.5;1;337;-2.14748e+09;-1.91776e+06;0;0;0;0;0;0;438147938;448068910;35207757
1707;5.16627e-15;-479;1686;12437;11493.5;1;337;-2.14748e+09;-1.91409e+06;0;0;0;0;0;0;438223547;448157884;35236552
1708;5.16627e-15;-479;1686;12437;11493.5;1;337;-2.14748e+09;-1.91024e+06;-1;0;0;0;-1;0;438299003;448246696;35265306
1709;5.16627e-15;-480;1686;12437;11493.5;1;337;-2.14748e+09;-1.90649e+06;0;0;0;0;0;0;438374308;448335344;35294018
1710;5.16627e-15;-480;1686;12437;11493.5;1;337;-2.14748e+09;-1.90274e+06;-1;0;0;0;-1;0;438449460;448423830;35322690
1711;5.16627e-15;-480;1686;12437;11493.5;1;337;-2.14748e+09;-1.89901e+06;-1;0;0;0;-1;0;438524461;448512153;35351321
1712;5.16627e-15;-480;1686;12437;11493.5;1;337;-2.14748e+09;-1.89529e+06;-1;0;0;0;-1;0;438599311;448600315;35379911
1713;5.16627e-15;-481;1686;12437;11493.5;1;337;-2.14748e+09;-1.89167e+06;0;0;0;0;0;0;438674010;448688315;35408460
1714;5.16627e-15;-482;1686;12437;11493.5;1;337;-2.14748e+09;-1.88786e+06;0;0;0;0;0;0;438748559;448776154;35436968
1715;5.16627e-15;-482;1686;12437;11493.5;1;337;-2.14748e+09;-1.88426e+06;-1;0;0;0;-1;0;438822957;448863832;35465436
1716;5.16627e-15;-482;1686;12437;11493.5;1;337;-2.14748e+09;-1.88047e+06;-1;0;0;0;-1;0;438897206;448951349;35493863
1717;5.16627e-15;-482;1686;12437;11493.5;1;337;-2.14748e+09;-1.87678e+06;-1;0;0;0;-1;0;438971305;449038706;35522249
1718;5.16627e-15;-483;1686;12437;11493.5;1;337;-2.14748e+09;-1.87311e+06;0;0;0;0;0;0;439045255;449125903;35550594
1719;5.16627e-15;-484;1686;12437;11493.5;1;337;-2.14748e+09;-1.86944e+06;0;0;0;0;0;0;439119056;449212940;35578899
1720;5.16627e-15;-484;1686;12437;11493.5;1;337;-2.14748e+09;-1.86588e+06;-1;0;0;0;-1;0;439192709;449299818;35607163
1721;5.16627e-15;-485;1686;12437;11493.5;1;337;-2.14748e+09;-1.86213e+06;0;0;0;0;0;0;439266213;449386536;35635386
1722;5.16627e-15;-485;1686;12437;11493.5;1;337;-2.14748e+09;-1.85848e+06;-1;0;0;0;-1;0;439339570;449473096;35663569
1723;5.16627e-15;-485;1686;12437;11493.5;1;337;-2.14748e+09;-1.85495e+06;-1;0;0;0;-1;0;439412779;449559498;35691711
1724;5.16627e-15;-486;1686;12437;11493.5;1;337;-2.14748e+09;-1.85122e+06;0;0;0;0;0;0;439485841;449645741;35719813
1725;5.16627e-15;-486;1686;12437;11493.5;1;337;-2.14748e+09;-1.8476e+06;-1;0;0;0;-1;0;439558756;449731826;35747875
1726;5.16627e-15;-487;1686;12437;11493.5;1;337;-2.14748e+09;-1.84398e+06;0;0;0;0;0;0;439631524;449817754;35775896
1727;5.16627e-15;-487;1686;12437;11493.5;1;337;-2.14748e+09;-1.84038e+06;-1;0;0;0;-1;0;439704146;449903525;35803876
1728;5.16627e-15;-488;1686;12437;11493.5;1;337;-2.14748e+09;-1.83678e+06;0;0;0;0;0;0;439776623;449989138;35831817
1729;5.16627e-15;-488;1686;12437;11493.5;1;337;-2.14748e+09;-1.83319e+06;-1;0;0;0;-1;0;439848954;450074595;35859717
1730;5.16627e-15;-489;1686;12437;11493.5;1;337;-2.14748e+09;-1.82971e+06;0;0;0;0;0;0;439921139;450159896;35887576
1731;5.16627e-15;-489;1686;12437;11493.5;1;337;-2.14748e+09;-1.82604e+06;-1;0;0;0;-1;0;439993180;450245041;35915396
1732;5.16627e-15;-490;1686;12437;11493.5;1;337;-2.14748e+09;-1.82247e+06;0;0;0;0;0;0;440065076;450330030;35943175
1733;5.16627e-15;-490;1686;12437;11493.5;1;337;-2.14748e+09;-1.81891e+06;-1;0;0;0;-1;0;440136828;450414863;35970914
1734;5.16627e-15;-490;1686;12437;11493.5;1;337;-2.14748e+09;-1.81536e+06;-1;0;0;0;-1;0;440208435;450499542;35998613
1735;5.16627e-15;-491;1686;12437;11493.5;1;337;-2.14748e+09;-1.81182e+06;0;0;0;0;0;0;440279899;450584065;36026272
1736;5.16627e-15;-492;1686;12437;11493.5;1;337;-2.14748e+09;-1.80828e+06;0;0;0;0;0;0;440351220;450668434;36053891
1737;5.16627e-15;-493;1686;12437;11493.5;1;337;-2.14748e+09;-1.80476e+06;0;0;0;0;0;0;440422398;450752649;36081469
1738;5.16627e-15;-493;1686;12437;11493.5;1;337;-2.14748e+09;-1.80123e+06;-1;0;0;0;-1;0;440493433;450836710;36109008
1739;5.16627e-15;-494;1686;12437;11493.5;1;337;-2.14748e+09;-1.79772e+06;0;0;0;0;0;0;440564326;450920617;36136507
1740;5.16627e-15;-495;1686;12437;11493.5;1;337;-2.14748e+09;-1.79422e+06;0;0;0;0;0;0;440635076;451004371;36163966
1741;5.16627e-15;-496;1686;12437;11493.5;1;337;-2.14748e+09;-1.79072e+06;0;0;0;0;0;0;440705685;451087972;36191385
1742;5.16627e-15;-496;1686;12437;11493.5;1;337;-2.14748e+09;-1.78723e+06;-1;0;0;0;-1;0;440776152;451171421;36218764
1743;5.16627e-15;-497;1686;12437;11493.5;1;337;-2.14748e+09;-1.78375e+06;0;0;0;0;0;0;440846479;451254716;36246103
1744;5.16627e-15;-498;1686;12437;11493.5;1;337;-2.14748e+09;-1.78037e+06;0;0;0;0;0;0;440916664;451337860;36273402
1745;5.16627e-15;-498;1686;12437;11493.5;1;337;-2.14748e+09;-1.7768e+06;-1;0;0;0;-1;0;440986709;451420852;36300662
1746;5.16627e-15;-499;1686;12437;11493.5;1;337;-2.14748e+09;-1.77334e+06;0;0;0;0;0;0;441056613;451503692;36327882
1747;5.16627e-15;-499;1686;12437;11493.5;1;337;-2.14748e+09;-1.76989e+06;-1;0;0;0;-1;0;441126378;451586381;36355063
1748;5.16627e-15;-500;1686;12437;11493.5;1;337;-2.14748e+09;-1.76644e+06;0;0;0;0;0;0;441196003;451668919;36382203
1749;5.16627e-15;-500;1686;12437;11493.5;1;337;-2.14748e+09;-1.76301e+06;-1;0;0;0;-1;0;441265489;451751306;36409304
1750;5.16627e-15;-500;1686;12437;11493.5;1;337;-2.14748e+09;-1.75958e+06;-1;0;0;0;-1;0;441334836;451833543;36436366
1751;5.16627e-15;-500;1686;12437;11493.5;1;337;-2.14748e+09;-1.75615e+06;-1;0;0;0;-1;0;441404044;451915629;36463388
1752;5.16627e-15;-501;1686;12437;11493.5;1;337;-2.14748e+09;-1.75274e+06;0;0;0;0;0;0;441473114;451997566;36490371
1753;5.16627e-15;-501;1686;12437;11493.5;1;337;-2.14748e+09;-1.74933e+06;-1;0;0;0;-1;0;441542045;452079354;36517314
1754;5.16627e-15;-501;1686;12437;11493.5;1;337;-2.14748e+09;-1.74593e+06;-1;0;0;0;-1;0;441610839;452160992;36544217
1755;5.16627e-15;-502;1686;12437;11493.5;1;337;-2.14748e+09;-1.74263e+06;0;0;0;0;0;0;441679496;452242481;36571082
1756;5.16627e-15;-502;1686;12437;11493.5;1;337;-2.14748e+09;-1.73914e+06;-1;0;0;0;-1;0;441748015;452323821;36597907
1757;5.16627e-15;-502;1686;12437;11493.5;1;337;-2.14748e+09;-1.73576e+06;-1;0;0;0;-1;0;441816397;452405014;36624692
1758;5.16627e-15;-503;1686;12437;11493.5;1;337;-2.14748e+09;-1.73239e+06;0;0;0;0;0;0;441884643;452486058;36651439
1759;5.16627e-15;-504;1686;12437;11493.5;1;337;-2.14748e+09;-1.72903e+06;0;0;0;0;0;0;441952752;452566954;36678146
1760;5.16627e-15;-504;1686;12437;11493.5;1;337;-2.14748e+09;-1.72567e+06;-1;0;0;0;-1;0;442020726;452647702;36704814
1761;5.16627e-15;-505;1686;12437;11493.5;1;337;-2.14748e+09;-1.72232e+06;0;0;0;0;0;0;442088564;452728304;36731442
1762;5.16627e-15;-505;1686;12437;11493.5;1;337;-2.14748e+09;-1.71898e+06;-1;0;0;0;-1;0;442156266;452808758;36758032
1763;5.16627e-15;-506;1686;12437;11493.5;1;337;-2.14748e+09;-1.71564e+06;0;0;0;0;0;0;442223833;452889066;36784583
1764;5.16627e-15;-507;1686;12437;11493.5;1;337;-2.14748e+09;-1.71231e+06;0;0;0;0;0;0;442291266;452969227;36811094
1765;5.16627e-15;-507;1686;12437;11493.5;1;337;-2.14748e+09;-1.70909e+06;-1;0;0;0;-1;0;442358564;453049243;36837567
1766;5.16627e-15;-508;1686;12437;11493.5;1;337;-2.14748e+09;-1.70567e+06;0;0;0;0;0;0;442425728;453129112;36864000
1767;5.16627e-15;-508;1686;12437;11493.5;1;337;-2.14748e+09;-1.70246e+06;-1;0;0;0;-1;0;442492758;453208836;36890395
1768;5.16627e-15;-509;1686;12437;11493.5;1;337;-2.14748e+09;-1.69906e+06;0;0;0;0;0;0;442559654;453288414;36916750
1769;5.16627e-15;-509;1686;12437;11493.5;1;337;-2.14748e+09;-1.69577e+06;-1;0;0;0;-1;0;442626417;453367848;36943067
1770;5.16627e-15;-509;1686;12437;11493.5;1;337;-2.14748e+09;-1.69248e+06;-1;0;0;0;-1;0;442693046;453447137;36969345
1771;5.16627e-15;-510;1686;12437;11493.5;1;337;-2.14748e+09;-1.6892e+06;0;0;0;0;0;0;442759543;453526281;36995584
1772;5.16627e-15;-511;1686;12437;11493.5;1;337;-2.14748e+09;-1.68592e+06;0;0;0;0;0;0;442825908;453605281;37021785
1773;5.16627e-15;-512;1686;12437;11493.5;1;337;-2.14748e+09;-1.68266e+06;0;0;0;0;0;0;442892140;453684138;37047947
1774;5.16627e-15;-512;1686;12437;11493.5;1;337;-2.14748e+09;-1.6794e+06;-1;0;0;0;-1;0;442958241;453762850;37074070
1775;5.16627e-15;-512;1686;12437;11493.5;1;337;-2.14748e+09;-1.67625e+06;-1;0;0;0;-1;0;443024210;453841420;37100154
1776;5.16627e-15;-513;1686;12437;11493.5;1;337;-2.14748e+09;-1.6729e+06;0;0;0;0;0;0;443090047;453919846;37126200
1777;5.16627e-15;-514;1686;12437;11493.5;1;337;-2.14748e+09;-1.66976e+06;0;0;0;0;0;0;443155754;453998129;37152207
1778;5.16627e-15;-514;1686;12437;11493.5;1;337;-2.14748e+09;-1.66643e+06;-1;0;0;0;-1;0;443221330;454076270;37178176
1779;5.16627e-15;-515;1686;12437;11493.5;1;337;-2.14748e+09;-1.6633e+06;0;0;0;0;0;0;443286775;454154269;37204106
1780;5.16627e-15;-516;1686;12437;11493.5;1;337;-2.14748e+09;-1.66009e+06;0;0;0;0;0;0;443352090;454232125;37229998
1781;5.16627e-15;-516;1686;12437;11493.5;1;337;-2.14748e+09;-1.65677e+06;-1;0;0;0;-1;0;443417275;454309840;37255851
1782;5.16627e-15;-517;1686;12437;11493.5;1;337;-2.14748e+09;-1.65367e+06;0;0;0;0;0;0;443482331;454387414;37281666
1783;5.16627e-15;-518;1686;12437;11493.5;1;337;-2.14748e+09;-1.65037e+06;0;0;0;0;0;0;443547257;454464846;37307443
1784;5.16627e-15;-518;1686;12437;11493.5;1;337;-2.14748e+09;-1.64718e+06;-1;0;0;0;-1;0;443612054;454542137;37333182
1785;5.16627e-15;-519;1686;12437;11493.5;1;337;-2.14748e+09;-1.644e+06;0;0;0;0;0;0;443676723;454619288;37358882
1786;5.16627e-15;-519;1686;12437;11493.5;1;337;-2.14748e+09;-1.64082e+06;-1;0;0;0;-1;0;443741263;454696298;37384544
1787;5.16627e-15;-519;1686;12437;11493.5;1;337;-2.14748e+09;-1.63765e+06;-1;0;0;0;-1;0;443805674;454773168;37410167
1788;5.16627e-15;-520;1686;12437;11493.5;1;337;-2.14748e+09;-1.63448e+06;0;0;0;0;0;0;443869958;454849899;37435753
1789;5.16627e-15;-520;1686;12437;11493.5;1;337;-2.14748e+09;-1.63132e+06;-1;0;0;0;-1;0;443934114;454926490;37461301
1790;5.16627e-15;-521;1686;12437;11493.5;1;337;-2.14748e+09;-1.62817e+06;0;0;0;0;0;0;443998142;455002941;37486810
1791;5.16627e-15;-522;1686;12437;11493.5;1;337;-2.14748e+09;-1.62503e+06;0;0;0;0;0;0;444062044;455079253;37512282
1792;5.16627e-15;-523;1686;12437;11493.5;1;337;-2.14748e+09;-1.62189e+06;0;0;0;0;0;0;444125819;455155427;37537715
1793;5.16627e-15;-524;1686;12437;11493.5;1;337;-2.14748e+09;-1.61876e+06;0;0;0;0;0;0;444189467;455231462;37563111
1794;5.16627e-15;-524;1686;12437;11493.5;1;337;-2.14748e+09;-1.61563e+06;-1;0;0;0;-1;0;444252988;455307359;37588468
1795;5.16627e-15;-525;1686;12437;11493.5;1;337;-2.14748e+09;-1.61252e+06;0;0;0;0;0;0;444316384;455383118;37613788
1796;5.16627e-15;-525;1686;12437;11493.5;1;337;-2.14748e+09;-1.6094e+06;-1;0;0;0;-1;0;444379654;455458739;37639070
1797;5.16627e-15;-526;1686;12437;11493.5;1;337;-2.14748e+09;-1.6063e+06;0;0;0;0;0;0;444442799;455534223;37664314
1798;5.16627e-15;-526;1686;12437;11493.5;1;337;-2.14748e+09;-1.6032e+06;-1;0;0;0;-1;0;444505818;455609569;37689520
1799;5.16627e-15;-526;1686;12437;11493.5;1;337;-2.14748e+09;-1.60011e+06;-1;0;0;0;-1;0;444568712;455684779;37714689
1800;5.16627e-15;-526;1686;12437;11493.5;1;337;-2.14748e+09;-1.59702e+06;-1;0;0;0;-1;0;444631482;455759852;37739820
1801;5.16627e-15;-527;1686;12437;11493.5;1;337;-2.14748e+09;-1.59404e+06;0;0;0;0;0;0;444694127;455834788;37764913
1802;5.16627e-15;-528;1686;12437;11493.5;1;337;-2.14748e+09;-1.59087e+06;0;0;0;0;0;0;444756648;455909588;37789969
1803;5.16627e-15;-529;1686;12437;11493.5;1;337;-2.14748e+09;-1.5879e+06;0;0;0;0;0;0;444819045;455984253;37814987
1804;5.16627e-15;-530;1686;12437;11493.5;1;337;-2.14748e+09;-1.58474e+06;0;0;0;0;0;0;444881319;456058781;37839968
1805;5.16627e-15;-530;1686;12437;11493.5;1;337;-2.14748e+09;-1.58179e+06;-1;0;0;0;-1;0;444943469;456133175;37864911
1806;5.16627e-15;-530;1686;12437;11493.5;1;337;-2.14748e+09;-1.57864e+06;-1;0;0;0;-1;0;445005496;456207433;37889817
1807;5.16627e-15;-531;1686;12437;11493.5;1;337;-2.14748e+09;-1.5757e+06;0;0;0;0;0;0;445067400;456281556;37914685
1808;5.16627e-15;-531;1686;12437;11493.5;1;337;-2.14748e+09;-1.57257e+06;-1;0;0;0;-1;0;445129182;456355544;37939516
1809;5.16627e-15;-531;1686;12437;11493.5;1;337;-2.14748e+09;-1.56954e+06;-1;0;0;0;-1;0;445190842;456429399;37964310
1810;5.16627e-15;-531;1686;12437;11493.5;1;337;-2.14748e+09;-1.56662e+06;-1;0;0;0;-1;0;445252379;456503119;37989067
1811;5.16627e-15;-532;1686;12437;11493.5;1;337;-2.14748e+09;-1.5635e+06;0;0;0;0;0;0;445313795;456576705;38013786
1812;5.16627e-15;-533;1686;12437;11493.5;1;337;-2.14748e+09;-1.56049e+06;0;0;0;0;0;0;445375089;456650158;38038468
1813;5.16627e-15;-533;1686;12437;11493.5;1;337;-2.14748e+09;-1.55759e+06;-1;0;0;0;-1;0;445436262;456723477;38063113
1814;5.16627e-15;-534;1686;12437;11493.5;1;337;-2.14748e+09;-1.55459e+06;0;0;0;0;0;0;445497314;456796663;38087720
1815;5.16627e-15;-535;1686;12437;11493.5;1;337;-2.14748e+09;-1.5515e+06;0;0;0;0;0;0;445558245;456869716;38112291
1816;5.16627e-15;-535;1686;12437;11493.5;1;337;-2.14748e+09;-1.54852e+06;-1;0;0;0;-1;0;445619056;456942637;38136825
1817;5.16627e-15;-535;1686;12437;11493.5;1;337;-2.14748e+09;-1.54564e+06;-1;0;0;0;-1;0;445679747;457015425;38161321
1818;5.16627e-15;-536;1686;12437;11493.5;1;337;-2.14748e+09;-1.54267e+06;0;0;0;0;0;0;445740318;457088081;38185781
1819;5.16627e-15;-536;1686;12437;11493.5;1;337;-2.14748e+09;-1.5396e+06;-1;0;0;0;-1;0;445800768;457160605;38210203
1820;5.16627e-15;-536;1686;12437;11493.5;1;337;-2.14748e+09;-1.53664e+06;-1;0;0;0;-1;0;445861100;457232998;38234589
1821;5.16627e-15;-536;1686;12437;11493.5;1;337;-2.14748e+09;-1.53379e+06;-1;0;0;0;-1;0;445921312;457305259;38258938
1822;5.16627e-15;-536;1686;12437;11493.5;1;337;-2.14748e+09;-1.53084e+06;-1;0;0;0;-1;0;445981406;457377390;38283250
1823;5.16627e-15;-536;1686;12437;11493.5;1;337;-2.14748e+09;-1.5278e+06;-1;0;0;0;-1;0;446041381;457449389;38307526
1824;5.16627e-15;-537;1686;12437;11493.5;1;337;-2.14748e+09;-1.52497e+06;0;0;0;0;0;0;446101237;457521258;38331764
1825;5.16627e-15;-537;1686;12437;11493.5;1;337;-2.14748e+09;-1.52204e+06;-1;0;0;0;-1;0;446160975;457592996;38355966
1826;5.16627e-15;-538;1686;12437;11493.5;1;337;-2.14748e+09;-1.51912e+06;0;0;0;0;0;0;446220595;457664604;38380132
1827;5.16627e-15;-538;1686;12437;11493.5;1;337;-2.14748e+09;-1.5161e+06;-1;0;0;0;-1;0;446280098;457736082;38404261
1828;5.16627e-15;-539;1686;12437;11493.5;1;337;-2.14748e+09;-1.51319e+06;0;0;0;0;0;0;446339483;457807431;38428353
1829;5.16627e-15;-539;1686;12437;11493.5;1;337;-2.14748e+09;-1.51028e+06;-1;0;0;0;-1;0;446398751;457878650;38452408
1830;5.16627e-15;-540;1686;12437;11493.5;1;337;-2.14748e+09;-1.50738e+06;0;0;0;0;0;0;446457902;457949740;38476428
1831;5.16627e-15;-540;1686;12437;11493.5;1;337;-2.14748e+09;-1.50449e+06;-1;0;0;0;-1;0;446516937;458020702;38500410
1832;5.16627e-15;-540;1686;12437;11493.5;1;337;-2.14748e+09;-1.5016e+06;-1;0;0;0;-1;0;446575855;458091534;38524357
1833;5.16627e-15;-540;1686;12437;11493.5;1;337;-2.14748e+09;-1.49872e+06;-1;0;0;0;-1;0;446634657;458162238;38548267
1834;5.16627e-15;-540;1686;12437;11493.5;1;337;-2.14748e+09;-1.49585e+06;-1;0;0;0;-1;0;446693343;458232814;38572140
1835;5.16627e-15;-541;1686;12437;11493.5;1;337;-2.14748e+09;-1.49298e+06;0;0;0;0;0;0;446751913;458303262;38595978
1836;5.16627e-15;-541;1686;12437;11493.5;1;337;-2.14748e+09;-1.49022e+06;-1;0;0;0;-1;0;446810368;458373582;38619779
1837;5.16627e-15;-541;1686;12437;11493.5;1;337;-2.14748e+09;-1.48726e+06;-1;0;0;0;-1;0;446868708;458443775;38643544
1838;5.16627e-15;-542;1686;12437;11493.5;1;337;-2.14748e+09;-1.48441e+06;0;0;0;0;0;0;446926932;458513840;38667272
1839;5.16627e-15;-542;1686;12437;11493.5;1;337;-2.14748e+09;-1.48156e+06;-1;0;0;0;-1;0;446985042;458583779;38690965
1840;5.16627e-15;-543;1686;12437;11493.5;1;337;-2.14748e+09;-1.47872e+06;0;0;0;0;0;0;447043038;458653591;38714622
1841;5.16627e-15;-543;1686;12437;11493.5;1;337;-2.14748e+09;-1.47589e+06;-1;0;0;0;-1;0;447100919;458723276;38738242
1842;5.16627e-15;-544;1686;12437;11493.5;1;337;-2.14748e+09;-1.47306e+06;0;0;0;0;0;0;447158687;458792835;38761827
1843;5.16627e-15;-545;1686;12437;11493.5;1;337;-2.14748e+09;-1.47024e+06;0;0;0;0;0;0;447216341;458862268;38785375
1844;5.16627e-15;-545;1686;12437;11493.5;1;337;-2.14748e+09;-1.46752e+06;-1;0;0;0;-1;0;447273881;458931575;38808888
1845;5.16627e-15;-546;1686;12437;11493.5;1;337;-2.14748e+09;-1.46472e+06;0;0;0;0;0;0;447331308;459000756;38832365
1846;5.16627e-15;-546;1686;12437;11493.5;1;337;-2.14748e+09;-1.46181e+06;-1;0;0;0;-1;0;447388622;459069813;38855806
1847;5.16627e-15;-547;1686;12437;11493.5;1;337;-2.14748e+09;-1.45901e+06;0;0;0;0;0;0;447445823;459138744;38879211
1848;5.16627e-15;-548;1686;12437;11493.5;1;337;-2.14748e+09;-1.45622e+06;0;0;0;0;0;0;447502912;459207550;38902580
1849;5.16627e-15;-549;1686;12437;11493.5;1;337;-2.14748e+09;-1.45353e+06;0;0;0;0;0;0;447559889;459276232;38925914
1850;5.16627e-15;-550;1686;12437;11493.5;1;337;-2.14748e+09;-1.45065e+06;0;0;0;0;0;0;447616753;459344789;38949212
1851;5.16627e-15;-550;1686;12437;11493.5;1;337;-2.14748e+09;-1.44787e+06;-1;0;0;0;-1;0;447673506;459413222;38972474
1852;5.16627e-15;-550;1686;12437;11493.5;1;337;-2.14748e+09;-1.4451e+06;-1;0;0;0;-1;0;447730147;459481531;38995701
1853;5.16627e-15;-551;1686;12437;11493.5;1;337;-2.14748e+09;-1.44234e+06;0;0;0;0;0;0;447786677;459549716;39018892
1854;5.16627e-15;-552;1686;12437;11493.5;1;337;-2.14748e+09;-1.43958e+06;0;0;0;0;0;0;447843096;459617778;39042048
1855;5.16627e-15;-553;1686;12437;11493.5;1;337;-2.14748e+09;-1.43683e+06;0;0;0;0;0;0;447899404;459685717;39065168
1856;5.16627e-15;-554;1686;12437;11493.5;1;337;-2.14748e+09;-1.43408e+06;0;0;0;0;0;0;447955601;459753533;39088253
1857;5.16627e-15;-555;1686;12437;11493.5;1;337;-2.14748e+09;-1.43134e+06;0;0;0;0;0;0;448011688;459821226;39111302
1858;5.16627e-15;-556;1686;12437;11493.5;1;337;-2.14748e+09;-1.4286e+06;0;0;0;0;0;0;448067664;459888796;39134316
1859;5.16627e-15;-557;1686;12437;11493.5;1;337;-2.14748e+09;-1.42597e+06;0;0;0;0;0;0;448123531;459956244;39157295
1860;5.16627e-15;-558;1686;12437;11493.5;1;337;-2.14748e+09;-1.42325e+06;0;0;0;0;0;0;448179288;460023570;39180238
1861;5.16627e-15;-558;1686;12437;11493.5;1;337;-2.14748e+09;-1.42053e+06;-1;0;0;0;-1;0;448234936;460090774;39203146
1862;5.16627e-15;-558;1686;12437;11493.5;1;337;-2.14748e+09;-1.41771e+06;-1;0;0;0;-1;0;448290474;460157857;39226019
1863;5.16627e-15;-559;1686;12437;11493.5;1;337;-2.14748e+09;-1.41501e+06;0;0;0;0;0;0;448345904;460224818;39248857
1864;5.16627e-15;-560;1686;12437;11493.5;1;337;-2.14748e+09;-1.4123e+06;0;0;0;0;0;0;448401224;460291657;39271660
1865;5.16627e-15;-560;1686;12437;11493.5;1;337;-2.14748e+09;-1.40961e+06;-1;0;0;0;-1;0;448456437;460358376;39294428
1866;5.16627e-15;-560;1686;12437;11493.5;1;337;-2.14748e+09;-1.40691e+06;-1;0;0;0;-1;0;448511540;460424974;39317160
1867;5.16627e-15;-560;1686;12437;11493.5;1;337;-2.14748e+09;-1.40423e+06;-1;0;0;0;-1;0;448566536;460491452;39339858
1868;5.16627e-15;-560;1686;12437;11493.5;1;337;-2.14748e+09;-1.40165e+06;-1;0;0;0;-1;0;448621424;460557810;39362521
1869;5.16627e-15;-561;1686;12437;11493.5;1;337;-2.14748e+09;-1.39887e+06;0;0;0;0;0;0;448676204;460624047;39385149
1870;5.16627e-15;-561;1686;12437;11493.5;1;337;-2.14748e+09;-1.3962e+06;-1;0;0;0;-1;0;448730877;460690164;39407742
1871;5.16627e-15;-562;1686;12437;11493.5;1;337;-2.14748e+09;-1.39354e+06;0;0;0;0;0;0;448785443;460756162;39430300
1872;5.16627e-15;-563;1686;12437;11493.5;1;337;-2.14748e+09;-1.39098e+06;0;0;0;0;0;0;448839902;460822041;39452823
1873;5.16627e-15;-564;1686;12437;11493.5;1;337;-2.14748e+09;-1.38823e+06;0;0;0;0;0;0;448894254;460887800;39475312
1874;5.16627e-15;-564;1686;12437;11493.5;1;337;-2.14748e+09;-1.38558e+06;-1;0;0;0;-1;0;448948499;460953440;39497766
1875;5.16627e-15;-564;1686;12437;11493.5;1;337;-2.14748e+09;-1.38294e+06;-1;0;0;0;-1;0;449002638;461018962;39520185
1876;5.16627e-15;-564;1686;12437;11493.5;1;337;-2.14748e+09;-1.3803e+06;-1;0;0;0;-1;0;449056672;461084365;39542570
1877;5.16627e-15;-565;1686;12437;11493.5;1;337;-2.14748e+09;-1.37767e+06;0;0;0;0;0;0;449110599;461149650;39564920
1878;5.16627e-15;-565;1686;12437;11493.5;1;337;-2.14748e+09;-1.37514e+06;-1;0;0;0;-1;0;449164421;461214817;39587235
1879;5.16627e-15;-565;1686;12437;11493.5;1;337;-2.14748e+09;-1.37242e+06;-1;0;0;0;-1;0;449218137;461279866;39609516
1880;5.16627e-15;-566;1686;12437;11493.5;1;337;-2.14748e+09;-1.3698e+06;0;0;0;0;0;0;449271749;461344797;39631763
1881;5.16627e-15;-567;1686;12437;11493.5;1;337;-2.14748e+09;-1.36729e+06;0;0;0;0;0;0;449325255;461409611;39653975
1882;5.16627e-15;-568;1686;12437;11493.5;1;337;-2.14748e+09;-1.36469e+06;0;0;0;0;0;0;449378657;461474307;39676153
1883;5.16627e-15;-569;1686;12437;11493.5;1;337;-2.14748e+09;-1.36209e+06;0;0;0;0;0;0;449431954;461538887;39698296
1884;5.16627e-15;-569;1686;12437;11493.5;1;337;-2.14748e+09;-1.35939e+06;-1;0;0;0;-1;0;449485147;461603350;39720406
1885;5.16627e-15;-570;1686;12437;11493.5;1;337;-2.14748e+09;-1.3569e+06;0;0;0;0;0;0;449538236;461667697;39742481
1886;5.16627e-15;-570;1686;12437;11493.5;1;337;-2.14748e+09;-1.35422e+06;-1;0;0;0;-1;0;449591221;461731927;39764521
1887;5.16627e-15;-570;1686;12437;11493.5;1;337;-2.14748e+09;-1.35174e+06;-1;0;0;0;-1;0;449644102;461796041;39786528
1888;5.16627e-15;-570;1686;12437;11493.5;1;337;-2.14748e+09;-1.34907e+06;-1;0;0;0;-1;0;449696880;461860039;39808500
1889;5.16627e-15;-571;1686;12437;11493.5;1;337;-2.14748e+09;-1.3466e+06;0;0;0;0;0;0;449749555;461923921;39830439
1890;5.16627e-15;-571;1686;12437;11493.5;1;337;-2.14748e+09;-1.34393e+06;-1;0;0;0;-1;0;449802126;461987688;39852343
1891;5.16627e-15;-571;1686;12437;11493.5;1;337;-2.14748e+09;-1.34138e+06;-1;0;0;0;-1;0;449854596;462051340;39874213
1892;5.16627e-15;-571;1686;12437;11493.5;1;337;-2.14748e+09;-1.33882e+06;-1;0;0;0;-1;0;449906962;462114877;39896050
1893;5.16627e-15;-572;1686;12437;11493.5;1;337;-2.14748e+09;-1.33628e+06;0;0;0;0;0;0;449959226;462178299;39917852
1894;5.16627e-15;-573;1686;12437;11493.5;1;337;-2.14748e+09;-1.33373e+06;0;0;0;0;0;0;450011388;462241606;39939621
1895;5.16627e-15;-573;1686;12437;11493.5;1;337;-2.14748e+09;-1.3313e+06;-1;0;0;0;-1;0;450063449;462304799;39961355
1896;5.16627e-15;-574;1686;12437;11493.5;1;337;-2.14748e+09;-1.32866e+06;0;0;0;0;0;0;450115407;462367878;39983056
1897;5.16627e-15;-574;1686;12437;11493.5;1;337;-2.14748e+09;-1.32614e+06;-1;0;0;0;-1;0;450167264;462430843;40004723
1898;5.16627e-15;-575;1686;12437;11493.5;1;337;-2.14748e+09;-1.32361e+06;0;0;0;0;0;0;450219020;462493694;40026357
1899;5.16627e-15;-575;1686;12437;11493.5;1;337;-2.14748e+09;-1.3211e+06;-1;0;0;0;-1;0;450270675;462556431;40047957
1900;5.16627e-15;-575;1686;12437;11493.5;1;337;-2.14748e+09;-1.31858e+06;-1;0;0;0;-1;0;450322229;462619055;40069523
1901;5.16627e-15;-576;1686;12437;11493.5;1;337;-2.14748e+09;-1.31608e+06;0;0;0;0;0;0;450373682;462681566;40091055
1902;5.16627e-15;-576;1686;12437;11493.5;1;337;-2.14748e+09;-1.31358e+06;-1;0;0;0;-1;0;450425035;462743964;40112554
1903;5.16627e-15;-576;1686;12437;11493.5;1;337;-2.14748e+09;-1.31108e+06;-1;0;0;0;-1;0;450476288;462806250;40134020
1904;5.16627e-15;-576;1686;12437;11493.5;1;337;-2.14748e+09;-1.30869e+06;-1;0;0;0;-1;0;450527440;462868423;40155452
1905;5.16627e-15;-577;1686;12437;11493.5;1;337;-2.14748e+09;-1.3061e+06;0;0;0;0;0;0;450578493;462930483;40176850
1906;5.16627e-15;-578;1686;12437;11493.5;1;337;-2.14748e+09;-1.30372e+06;0;0;0;0;0;0;450629447;462992432;40198215
1907;5.16627e-15;-578;1686;12437;11493.5;1;337;-2.14748e+09;-1.30114e+06;-1;0;0;0;-1;0;450680300;463054268;40219547
1908;5.16627e-15;-579;1686;12437;11493.5;1;337;-2.14748e+09;-1.29867e+06;0;0;0;0;0;0;450731055;463115993;40240846
1909;5.16627e-15;-580;1686;12437;11493.5;1;337;-2.14748e+09;-1.2963e+06;0;0;0;0;0;0;450781711;463177607;40262111
1910;5.16627e-15;-580;1686;12437;11493.5;1;337;-2.14748e+09;-1.29374e+06;-1;0;0;0;-1;0;450832268;463239109;40283343
1911;5.16627e-15;-580;1686;12437;11493.5;1;337;-2.14748e+09;-1.29139e+06;-1;0;0;0;-1;0;450882727;463300501;40304542
1912;5.16627e-15;-581;1686;12437;11493.5;1;337;-2.14748e+09;-1.28884e+06;0;0;0;0;0;0;450933087;463361781;40325707
1913;5.16627e-15;-581;1686;12437;11493.5;1;337;-2.14748e+09;-1.28639e+06;-1;0;0;0;-1;0;450983349;463422951;40346840
1914;5.16627e-15;-582;1686;12437;11493.5;1;337;-2.14748e+09;-1.28395e+06;0;0;0;0;0;0;451033513;463484010;40367940
1915;5.16627e-15;-583;1686;12437;11493.5;1;337;-2.14748e+09;-1.28151e+06;0;0;0;0;0;0;451083580;463544959;40389006
1916;5.16627e-15;-583;1686;12437;11493.5;1;337;-2.14748e+09;-1.27908e+06;-1;0;0;0;-1;0;451133549;463605798;40410040
1917;5.16627e-15;-584;1686;12437;11493.5;1;337;-2.14748e+09;-1.27665e+06;0;0;0;0;0;0;451183420;463666527;40431040
1918;5.16627e-15;-584;1686;12437;11493.5;1;337;-2.14748e+09;-1.27433e+06;-1;0;0;0;-1;0;451233195;463727147;40452008
1919;5.16627e-15;-584;1686;12437;11493.5;1;337;-2.14748e+09;-1.27181e+06;-1;0;0;0;-1;0;451282873;463787657;40472943
1920;5.16627e-15;-584;1686;12437;11493.5;1;337;-2.14748e+09;-1.2694e+06;-1;0;0;0;-1;0;451332453;463848058;40493845
1921;5.16627e-15;-584;1686;12437;11493.5;1;337;-2.14748e+09;-1.26699e+06;-1;0;0;0;-1;0;451381938;463908350;40514714
1922;5.16627e-15;-584;1686;12437;11493.5;1;337;-2.14748e+09;-1.26459e+06;-1;0;0;0;-1;0;451431326;463968533;40535551
1923;5.16627e-15;-585;1686;12437;11493.5;1;337;-2.14748e+09;-1.26219e+06;0;0;0;0;0;0;451480618;464028608;40556354
1924;5.16627e-15;-586;1686;12437;11493.5;1;337;-2.14748e+09;-1.2598e+06;0;0;0;0;0;0;451529814;464088574;40577126
1925;5.16627e-15;-586;1686;12437;11493.5;1;337;-2.14748e+09;-1.25741e+06;-1;0;0;0;-1;0;451578914;464148432;40597864
1926;5.16627e-15;-587;1686;12437;11493.5;1;337;-2.14748e+09;-1.25502e+06;0;0;0;0;0;0;451627919;464208181;40618570
1927;5.16627e-15;-588;1686;12437;11493.5;1;337;-2.14748e+09;-1.25265e+06;0;0;0;0;0;0;451676829;464267823;40639244
1928;5.16627e-15;-588;1686;12437;11493.5;1;337;-2.14748e+09;-1.25027e+06;-1;0;0;0;-1;0;451725643;464327358;40659885
1929;5.16627e-15;-588;1685;12437;11493.5;1;337;-2.14748e+09;-1.2479e+06;0;0;0;0;0;0;451774362;464386785;40680493
1930;5.16627e-15;-588;1685;12437;11493.5;1;337;-2.14748e+09;-1.24554e+06;-1;0;0;0;-1;0;451822987;464446105;40701069
1931;5.16627e-15;-589;1685;12437;11493.5;1;337;-2.14748e+09;-1.24318e+06;0;0;0;0;0;0;451871517;464505317;40721613
1932;5.16627e-15;-590;1685;12437;11493.5;1;337;-2.14748e+09;-1.24082e+06;0;0;0;0;0;0;451919953;464564423;40742125
1933;5.16627e-15;-591;1685;12437;11493.5;1;337;-2.14748e+09;-1.23847e+06;0;0;0;0;0;0;451968295;464623423;40762604
1934;5.16627e-15;-592;1685;12437;11493.5;1;337;-2.14748e+09;-1.23623e+06;0;0;0;0;0;0;452016543;464682316;40783051
1935;5.16627e-15;-593;1685;12437;11493.5;1;337;-2.14748e+09;-1.23378e+06;0;0;0;0;0;0;452064697;464741102;40803465
1936;5.16627e-15;-594;1685;12437;11493.5;1;337;-2.14748e+09;-1.23145e+06;0;0;0;0;0;0;452112758;464799783;40823848
1937;5.16627e-15;-594;1685;12437;11493.5;1;337;-2.14748e+09;-1.22912e+06;-1;0;0;0;-1;0;452160725;464858358;40844198
1938;5.16627e-15;-595;1685;12437;11493.5;1;337;-2.14748e+09;-1.22679e+06;0;0;0;0;0;0;452208599;464916827;40864517
1939;5.16627e-15;-595;1685;12437;11493.5;1;337;-2.14748e+09;-1.22447e+06;-1;0;0;0;-1;0;452256380;464975190;40884803
1940;5.16627e-15;-595;1685;12437;11493.5;1;337;-2.14748e+09;-1.22215e+06;-1;0;0;0;-1;0;452304068;465033449;40905057
1941;5.16627e-15;-596;1685;12437;11493.5;1;337;-2.14748e+09;-1.21994e+06;0;0;0;0;0;0;452351664;465091602;40925280
1942;5.16627e-15;-597;1685;12437;11493.5;1;337;-2.14748e+09;-1.21763e+06;0;0;0;0;0;0;452399167;465149650;40945470
1943;5.16627e-15;-598;1685;12437;11493.5;1;337;-2.14748e+09;-1.21522e+06;0;0;0;0;0;0;452446578;465207594;40965629
1944;5.16627e-15;-599;1685;12437;11493.5;1;337;-2.14748e+09;-1.21293e+06;0;0;0;0;0;0;452493897;465265434;40985755
1945;5.16627e-15;-600;1685;12437;11493.5;1;337;-2.14748e+09;-1.21063e+06;0;0;0;0;0;0;452541125;465323168;41005850
1946;5.16627e-15;-601;1685;12437;11493.5;1;337;-2.14748e+09;-1.20844e+06;0;0;0;0;0;0;452588260;465380799;41025914
1947;5.16627e-15;-601;1685;12437;11493.5;1;337;-2.14748e+09;-1.20606e+06;-1;0;0;0;-1;0;452635305;465438326;41045945
1948;5.16627e-15;-601;1685;12437;11493.5;1;337;-2.14748e+09;-1.20377e+06;-1;0;0;0;-1;0;452682258;465495749;41065945
1949;5.16627e-15;-602;1685;12437;11493.5;1;337;-2.14748e+09;-1.2015e+06;0;0;0;0;0;0;452729119;465553069;41085913
1950;5.16627e-15;-603;1685;12437;11493.5;1;337;-2.14748e+09;-1.19923e+06;0;0;0;0;0;0;452775890;465610286;41105850
1951;5.16627e-15;-604;1685;12437;11493.5;1;337;-2.14748e+09;-1.19696e+06;0;0;0;0;0;0;452822571;465667399;41125755
1952;5.16627e-15;-604;1685;12437;11493.5;1;337;-2.14748e+09;-1.1947e+06;-1;0;0;0;-1;0;452869161;465724409;41145628
1953;5.16627e-15;-605;1685;12437;11493.5;1;337;-2.14748e+09;-1.19244e+06;0;0;0;0;0;0;452915660;465781316;41165470
1954;5.16627e-15;-605;1685;12437;11493.5;1;337;-2.14748e+09;-1.19018e+06;-1;0;0;0;-1;0;452962069;465838121;41185281
1955;5.16627e-15;-605;1685;12437;11493.5;1;337;-2.14748e+09;-1.18793e+06;-1;0;0;0;-1;0;453008389;465894824;41205060
1956;5.16627e-15;-606;1685;12437;11493.5;1;337;-2.14748e+09;-1.18579e+06;0;0;0;0;0;0;453054619;465951424;41224808
1957;5.16627e-15;-606;1685;12437;11493.5;1;337;-2.14748e+09;-1.18345e+06;-1;0;0;0;-1;0;453100759;466007922;41244525
1958;5.16627e-15;-606;1685;12437;11493.5;1;337;-2.14748e+09;-1.18121e+06;-1;0;0;0;-1;0;453146809;466064319;41264210
1959;5.16627e-15;-606;1685;12437;11493.5;1;337;-2.14748e+09;-1.17898e+06;-1;0;0;0;-1;0;453192771;466120613;41283864
1960;5.16627e-15;-607;1685;12437;11493.5;1;337;-2.14748e+09;-1.17675e+06;0;0;0;0;0;0;453238644;466176807;41303487
1961;5.16627e-15;-607;1685;12437;11493.5;1;337;-2.14748e+09;-1.17453e+06;-1;0;0;0;-1;0;453284427;466232899;41323079
1962;5.16627e-15;-608;1685;12437;11493.5;1;337;-2.14748e+09;-1.17241e+06;0;0;0;0;0;0;453330122;466288890;41342639
1963;5.16627e-15;-609;1685;12437;11493.5;1;337;-2.14748e+09;-1.1701e+06;0;0;0;0;0;0;453375729;466344779;41362169
1964;5.16627e-15;-609;1685;12437;11493.5;1;337;-2.14748e+09;-1.16789e+06;-1;0;0;0;-1;0;453421247;466400569;41381668
1965;5.16627e-15;-610;1685;12437;11493.5;1;337;-2.14748e+09;-1.16568e+06;0;0;0;0;0;0;453466677;466456258;41401135
1966;5.16627e-15;-610;1685;12437;11493.5;1;337;-2.14748e+09;-1.16348e+06;-1;0;0;0;-1;0;453512020;466511846;41420572
1967;5.16627e-15;-610;1685;12437;11493.5;1;337;-2.14748e+09;-1.16139e+06;-1;0;0;0;-1;0;453557274;466567334;41439978
1968;5.16627e-15;-610;1685;12437;11493.5;1;337;-2.14748e+09;-1.1591e+06;-1;0;0;0;-1;0;453602441;466622722;41459353
1969;5.16627e-15;-610;1685;12437;11493.5;1;337;-2.14748e+09;-1.15691e+06;-1;0;0;0;-1;0;453647521;466678011;41478697
1970;5.16627e-15;-611;1685;12437;11493.5;1;337;-2.14748e+09;-1.15472e+06;0;0;0;0;0;0;453692513;466733200;41498010
1971;5.16627e-15;-612;1685;12437;11493.5;1;337;-2.14748e+09;-1.15255e+06;0;0;0;0;0;0;453737418;466788289;41517292
1972;5.16627e-15;-613;1685;12437;11493.5;1;337;-2.14748e+09;-1.15047e+06;0;0;0;0;0;0;453782237;466843279;41536544
1973;5.16627e-15;-614;1685;12437;11493.5;1;337;-2.14748e+09;-1.1482e+06;0;0;0;0;0;0;453826968;466898170;41555766
1974;5.16627e-15;-614;1685;12437;11493.5;1;337;-2.14748e+09;-1.14604e+06;-1;0;0;0;-1;0;453871614;466952962;41574956
1975;5.16627e-15;-614;1685;12437;11493.5;1;337;-2.14748e+09;-1.14387e+06;-1;0;0;0;-1;0;453916173;467007656;41594116
1976;5.16627e-15;-614;1685;12437;11493.5;1;337;-2.14748e+09;-1.14172e+06;-1;0;0;0;-1;0;453960646;467062251;41613246
1977;5.16627e-15;-614;1685;12437;11493.5;1;337;-2.14748e+09;-1.13956e+06;-1;0;0;0;-1;0;454005033;467116747;41632345
1978;5.16627e-15;-615;1685;12437;11493.5;1;337;-2.14748e+09;-1.13751e+06;0;0;0;0;0;0;454049334;467171146;41651413
1979;5.16627e-15;-616;1685;12437;11493.5;1;337;-2.14748e+09;-1.13527e+06;0;0;0;0;0;0;454093549;467225446;41670451
1980;5.16627e-15;-617;1685;12437;11493.5;1;337;-2.14748e+09;-1.13313e+06;0;0;0;0;0;0;454137679;467279649;41689459
1981;5.16627e-15;-617;1685;12437;11493.5;1;337;-2.14748e+09;-1.13099e+06;-1;0;0;0;-1;0;454181724;467333754;41708436
1982;5.16627e-15;-617;1685;12437;11493.5;1;337;-2.14748e+09;-1.12886e+06;-1;0;0;0;-1;0;454225684;467387761;41727384
1983;5.16627e-15;-618;1685;12437;11493.5;1;337;-2.14748e+09;-1.12673e+06;0;0;0;0;0;0;454269559;467441672;41746300
1984;5.16627e-15;-618;1685;12437;11493.5;1;337;-2.14748e+09;-1.12461e+06;-1;0;0;0;-1;0;454313349;467495485;41765187
1985;5.16627e-15;-618;1685;12437;11493.5;1;337;-2.14748e+09;-1.12249e+06;-1;0;0;0;-1;0;454357054;467549201;41784044
1986;5.16627e-15;-619;1685;12437;11493.5;1;337;-2.14748e+09;-1.12037e+06;0;0;0;0;0;0;454400675;467602821;41802870
1987;5.16627e-15;-620;1685;12437;11493.5;1;337;-2.14748e+09;-1.11836e+06;0;0;0;0;0;0;454444212;467656343;41821666
1988;5.16627e-15;-621;1685;12437;11493.5;1;337;-2.14748e+09;-1.11626e+06;0;0;0;0;0;0;454487665;467709770;41840432
1989;5.16627e-15;-622;1685;12437;11493.5;1;337;-2.14748e+09;-1.11405e+06;0;0;0;0;0;0;454531034;467763100;41859169
1990;5.16627e-15;-623;1685;12437;11493.5;1;337;-2.14748e+09;-1.11206e+06;0;0;0;0;0;0;454574320;467816335;41877875
1991;5.16627e-15;-624;1685;12437;11493.5;1;337;-2.14748e+09;-1.10986e+06;0;0;0;0;0;0;454617521;467869473;41896551
1992;5.16627e-15;-624;1685;12437;11493.5;1;337;-2.14748e+09;-1.10777e+06;-1;0;0;0;-1;0;454660640;467922516;41915197
1993;5.16627e-15;-624;1685;12437;11493.5;1;337;-2.14748e+09;-1.10568e+06;-1;0;0;0;-1;0;454703675;467975463;41933814
1994;5.16627e-15;-624;1685;12437;11493.5;1;337;-2.14748e+09;-1.1036e+06;-1;0;0;0;-1;0;454746627;468028315;41952401
1995;5.16627e-15;-624;1685;12437;11493.5;1;337;-2.14748e+09;-1.10162e+06;-1;0;0;0;-1;0;454789497;468081072;41970957
1996;5.16627e-15;-625;1685;12437;11493.5;1;337;-2.14748e+09;-1.09945e+06;0;0;0;0;0;0;454832283;468133734;41989485
1997;5.16627e-15;-625;1685;12437;11493.5;1;337;-2.14748e+09;-1.09748e+06;-1;0;0;0;-1;0;454874988;468186301;42007982
1998;5.16627e-15;-625;1685;12437;11493.5;1;337;-2.14748e+09;-1.09532e+06;-1;0;0;0;-1;0;454917609;468238773;42026450
1999;5.16627e-15;-625;1685;12437;11493.5;1;337;-2.14748e+09;-1.09325e+06;-1;0;0;0;-1;0;454960149;468291151;42044888
