step;volume;A_0;B_0;C;L;p;Compl;Aext;Bext;A_ingresso;A_uscita;B_ingresso;B_uscita;A_netto;B_netto;Avicino;Amedio;Alontano
372;4.18816e-15;95;522;15753;10045;1;0;1038;3485;495;145;480;129;350;351;102;95;2
373;4.2166e-15;245;1282;15595;10150;1;162;1013;3486;505;69;1752;477;436;1275;102;95;2
374;4.28323e-15;272;1523;15450;10234;1;348;999;3486;530;116;1745;726;414;1019;102;95;2
375;4.33678e-15;281;1593;15315;10308;1;541;968;3487;480;147;1714;760;333;954;101;95;2
376;4.38414e-15;236;1646;15295;10385;1;676;957;3487;481;145;1710;754;336;956;101;95;2
377;4.43361e-15;282;1647;15359;10474;1;750;871;3488;473;108;1749;805;365;944;100;94;2
378;4.49101e-15;262;1619;15427;10542;1;828;899;3488;458;115;1690;795;343;895;101;95;2
379;4.53504e-15;228;1502;15508;10636;1;903;887;3489;385;144;1817;829;241;988;101;95;2
380;4.59613e-15;248;1544;15576;10715;1;972;852;3489;474;99;1722;785;375;937;101;95;2
381;4.64834e-15;225;1610;15714;10795;1;1007;856;3490;413;140;1777;780;273;997;101;94;2
382;4.70009e-15;236;1585;15875;10864;1;1028;849;3490;407;116;1760;845;291;915;101;94;2
383;4.74545e-15;229;1567;16027;10964;1;1060;836;3491;460;118;1757;764;342;993;101;93;2
384;4.81145e-15;236;1511;16192;11044;1;1065;847;3491;373;98;1740;782;275;958;101;93;2
385;4.86446e-15;212;1513;16387;11138;1;1055;812;3491;410;130;1710;739;280;971;101;93;2
386;4.927e-15;221;1573;16567;11202;1;1055;819;3492;402;106;1752;757;296;995;101;93;3
387;4.96974e-15;249;1634;16683;11268;1;1082;819;3492;416;109;1717;787;307;930;102;93;3
388;5.01393e-15;223;1664;16793;11356;1;1126;828;3493;415;114;1709;786;301;923;102;93;3
389;5.07307e-15;233;1534;16987;11428;1;1116;803;3493;421;109;1744;804;312;940;102;93;3
390;5.12162e-15;246;1590;17166;11514;1;1120;816;3494;408;99;1700;751;309;949;102;92;3
391;5.17982e-15;216;1562;17345;11594;1;1112;813;3494;358;118;1765;795;240;970;101;92;3
392;5.23416e-15;231;1610;17498;11671;1;1129;811;3495;406;99;1774;801;307;973;101;91;3
393;5.28664e-15;234;1516;17635;11758;1;1163;790;3495;424;95;1710;810;329;900;101;91;3
394;5.34614e-15;211;1536;17785;11844;1;1184;788;3496;401;120;1769;752;281;1017;100;91;3
395;5.40518e-15;232;1533;17929;11924;1;1210;788;3496;389;100;1864;736;289;1128;100;89;3
396;5.46029e-15;238;1595;18108;12005;1;1212;741;3496;420;116;1717;755;304;962;99;89;3
397;5.51629e-15;251;1537;18280;12069;1;1207;799;3497;366;108;1752;791;258;961;99;90;3
398;5.56066e-15;217;1488;18426;12162;1;1232;780;3497;393;125;1711;807;268;904;99;90;3
399;5.62536e-15;219;1513;18577;12238;1;1244;776;3498;384;94;1806;781;290;1025;98;90;3
400;5.67842e-15;221;1519;18711;12304;1;1267;791;3498;363;109;1719;802;254;917;98;90;3
401;5.72463e-15;222;1544;18874;12367;1;1267;714;3499;372;132;1738;801;240;937;98;90;3
402;5.76885e-15;208;1521;19043;12454;1;1274;732;3499;377;133;1819;838;244;981;98;88;3
403;5.83011e-15;234;1505;19219;12533;1;1272;682;3499;356;82;1778;755;274;1023;98;89;3
404;5.88593e-15;188;1600;19373;12614;1;1277;641;3500;343;92;1683;745;251;938;98;89;3
405;5.94334e-15;167;1559;19591;12695;1;1239;668;3500;318;112;1809;806;206;1003;98;90;3
406;6.00094e-15;186;1590;19789;12772;1;1208;657;3501;353;100;1719;743;253;976;98;91;3
407;6.05587e-15;161;1552;19980;12851;1;1191;646;3501;322;86;1724;786;236;938;97;91;3
408;6.1124e-15;170;1521;20107;12905;1;1200;563;3502;319;103;1709;729;216;980;97;88;3
409;6.15114e-15;152;1569;20319;12983;1;1143;558;3502;271;82;1751;824;189;927;97;88;3
410;6.20724e-15;135;1569;20435;13073;1;1146;566;3502;283;82;1730;798;201;932;96;89;3
411;6.27219e-15;167;1598;20623;13167;1;1104;527;3503;319;79;1770;772;240;998;95;88;3
412;6.34026e-15;153;1626;20797;13258;1;1083;529;3503;303;81;1719;809;222;910;95;88;3
413;6.4064e-15;144;1571;20929;13343;1;1076;520;3504;259;85;1777;827;174;950;94;89;3
414;6.46838e-15;172;1609;21073;13435;1;1053;514;3504;261;89;1750;811;172;939;94;88;3
415;6.53569e-15;143;1611;21190;13504;1;1057;418;3405;259;91;1754;821;168;933;95;88;3
416;6.58633e-15;102;1598;21300;13593;1;1061;531;3505;197;69;1622;801;128;821;94;89;3
417;6.65183e-15;148;1617;21495;13663;1;1008;492;3505;280;67;1796;809;213;987;94;87;3
418;6.70351e-15;123;1663;21617;13749;1;1005;516;3506;234;62;1693;808;172;885;94;87;3
419;6.76717e-15;158;1621;21784;13833;1;968;487;3506;276;63;1773;810;213;963;94;87;3
420;6.82956e-15;116;1617;21915;13909;1;956;482;3507;247;72;1690;778;175;912;93;87;3
421;6.88616e-15;126;1619;22051;13989;1;943;488;3507;224;59;1781;808;165;973;94;87;3
422;6.94591e-15;125;1599;22181;14052;1;931;520;3507;260;58;1753;802;202;951;93;87;3
423;6.99309e-15;149;1629;22298;14130;1;919;490;3508;286;63;1866;793;223;1073;93;87;3
424;7.05165e-15;139;1576;22362;14205;1;951;475;3508;239;64;1778;830;175;948;92;85;3
425;7.10811e-15;129;1607;22445;14286;1;966;503;3509;209;68;1720;836;141;884;92;85;3
426;7.16925e-15;126;1628;22565;14368;1;955;509;3509;249;62;1780;809;187;971;91;86;3
427;7.23133e-15;129;1709;22706;14443;1;933;525;3509;263;65;1733;789;198;944;91;85;3
428;7.28827e-15;151;1649;22821;14522;1;927;501;3510;272;63;1778;814;209;964;91;84;3
429;7.3484e-15;141;1601;22912;14588;1;938;474;3510;258;59;1820;819;199;1001;90;84;3
430;7.39877e-15;144;1630;23003;14671;1;950;500;3511;226;65;1762;808;161;954;90;84;3
431;7.46227e-15;132;1614;23099;14772;1;957;500;3511;263;79;1752;852;184;900;91;84;3
432;7.53978e-15;157;1641;23160;14821;1;980;517;3511;253;67;1742;813;186;929;91;83;3
433;7.57749e-15;148;1623;23224;14899;1;1014;502;3512;221;91;1753;846;130;907;91;84;3
434;7.63763e-15;141;1674;23321;14983;1;1017;491;3512;235;83;1667;833;152;834;91;82;3
435;7.70259e-15;122;1646;23424;15058;1;1027;498;3513;265;66;1788;796;199;992;90;83;4
436;7.76073e-15;156;1678;23540;15138;1;1017;518;3513;251;69;1714;814;182;900;89;82;4
437;7.82292e-15;146;1694;23651;15218;1;1015;483;3513;277;76;1716;823;201;893;89;81;4
438;7.88527e-15;133;1688;23738;15285;1;1032;498;3514;274;72;1748;882;202;866;90;82;4
439;7.93762e-15;139;1631;23885;15368;1;1005;469;3514;264;86;1744;791;178;953;89;82;4
440;8.00341e-15;133;1670;23961;15439;1;1023;464;3514;258;65;1787;823;193;964;90;82;4
441;8.05838e-15;134;1729;24047;15500;1;1028;490;3515;223;63;1695;855;160;840;90;83;4
442;8.10638e-15;147;1743;24151;15570;1;1031;469;3515;231;65;1746;870;166;876;90;82;4
443;8.16158e-15;122;1715;24274;15646;1;1022;489;3516;219;76;1763;844;143;919;90;83;4
444;8.22166e-15;122;1759;24420;15731;1;993;496;3516;274;80;1713;821;194;892;89;83;4
445;8.28902e-15;150;1733;24477;15810;1;1011;500;3516;260;75;1771;857;185;914;89;82;4
446;8.35179e-15;153;1749;24570;15890;1;1018;495;3517;243;62;1790;852;181;938;89;82;4
447;8.41632e-15;142;1711;24670;15962;1;1024;475;3517;252;64;1717;834;188;883;88;82;4
448;8.47301e-15;156;1664;24769;16034;1;1028;519;3517;230;67;1706;881;163;825;89;81;4
449;8.53064e-15;166;1684;24816;16095;1;1064;522;3518;254;75;1803;877;179;926;88;81;4
450;8.57956e-15;142;1654;24900;16168;1;1076;502;3518;273;73;1813;820;200;993;87;82;4
451;8.63823e-15;146;1645;25017;16236;1;1067;510;3519;242;65;1793;792;177;1001;87;79;4
452;8.693e-15;150;1686;25109;16318;1;1075;504;3519;257;75;1752;821;182;931;86;80;4
453;8.75921e-15;151;1702;25236;16405;1;1062;525;3519;249;89;1811;811;160;1000;85;79;4
454;8.83044e-15;154;1648;25304;16463;1;1084;526;3520;261;70;1741;851;191;890;85;80;4
455;8.8775e-15;158;1601;25392;16529;1;1087;490;3520;226;74;1707;853;152;854;85;79;4
456;8.93114e-15;143;1633;25465;16603;1;1102;498;3520;252;74;1680;850;178;830;85;79;4
457;8.99142e-15;150;1659;25568;16672;1;1101;497;3521;254;59;1763;870;195;893;86;79;4
458;9.04775e-15;150;1738;25695;16724;1;1092;549;3521;238;80;1732;830;158;902;86;79;4
459;9.09027e-15;137;1717;25790;16795;1;1103;518;3521;280;69;1731;843;211;888;84;79;4
460;9.14845e-15;170;1667;25888;16857;1;1109;524;3522;261;71;1786;844;190;942;83;79;4
461;9.19935e-15;153;1663;25991;16928;1;1113;512;3522;276;84;1723;843;192;880;83;79;4
462;9.25776e-15;133;1605;26085;17009;1;1118;509;3523;237;69;1824;861;168;963;83;80;4
463;9.32454e-15;145;1629;26214;17080;1;1097;494;3523;245;79;1769;804;166;965;83;79;4
464;9.38321e-15;158;1644;26290;17148;1;1118;527;3523;250;64;1817;792;186;1025;82;79;4
465;9.43951e-15;139;1607;26389;17216;1;1125;502;3524;242;69;1756;831;173;925;82;80;4
466;9.49593e-15;151;1598;26486;17291;1;1120;498;3524;230;72;1789;817;158;972;82;78;4
467;9.55829e-15;140;1596;26590;17358;1;1123;486;3524;252;76;1775;833;176;942;81;78;4
468;9.61411e-15;150;1656;26654;17443;1;1144;519;3525;240;64;1749;807;176;942;81;78;4
469;9.68509e-15;135;1667;26742;17508;1;1163;491;3525;234;79;1838;789;155;1049;82;77;4
470;9.73948e-15;130;1705;26881;17566;1;1138;505;3525;238;60;1743;811;178;932;82;77;4
471;9.7881e-15;150;1664;26956;17640;1;1160;499;3526;246;68;1793;864;178;929;82;78;4
472;9.85025e-15;126;1654;27065;17721;1;1158;524;3526;229;73;1746;807;156;939;81;78;4
473;9.91843e-15;155;1666;27161;17794;1;1155;490;3526;305;70;1795;853;235;942;81;78;4
474;9.98001e-15;146;1665;27239;17882;1;1158;505;3527;238;78;1777;831;160;946;82;77;4
475;1.00544e-14;138;1743;27345;17933;1;1154;512;3527;255;75;1720;806;180;914;81;78;4
476;1.00976e-14;160;1676;27450;18001;1;1151;478;3527;263;70;1763;860;193;903;81;78;4
477;1.01553e-14;147;1713;27501;18057;1;1180;487;3528;246;73;1702;861;173;841;81;77;4
478;1.02029e-14;165;1662;27563;18108;1;1202;496;3528;250;83;1703;840;167;863;81;77;4
479;1.02463e-14;168;1667;27660;18185;1;1209;497;3528;252;71;1790;826;181;964;81;77;4
480;1.0312e-14;159;1625;27786;18261;1;1197;479;3529;257;71;1761;775;186;986;81;76;4
481;1.0377e-14;138;1638;27907;18330;1;1180;468;3529;257;76;1836;815;181;1021;81;77;4
482;1.04361e-14;143;1657;28002;18395;1;1171;474;3529;235;59;1734;834;176;900;80;77;4
483;1.04918e-14;131;1649;28093;18461;1;1173;480;3530;216;83;1791;771;133;1020;80;76;4
484;1.05485e-14;160;1662;28173;18521;1;1181;444;3530;275;62;1691;819;213;872;80;76;5
485;1.06002e-14;120;1638;28227;18590;1;1204;419;3430;231;69;1737;831;162;906;81;76;5
486;1.06597e-14;121;1680;28303;18654;1;1209;504;3531;232;57;1670;810;175;860;79;75;5
487;1.0715e-14;133;1716;28406;18724;1;1203;391;3431;256;87;1787;824;169;963;80;75;5
488;1.07756e-14;97;1678;28492;18789;1;1202;447;3531;198;76;1761;862;122;899;80;75;5
489;1.0832e-14;134;1663;28619;18852;1;1172;394;3432;236;74;1778;860;162;918;81;74;5
490;1.08867e-14;130;1666;28705;18912;1;1168;446;3532;189;56;1735;806;133;929;79;74;5
491;1.09389e-14;120;1625;28811;18978;1;1160;499;3532;227;66;1683;835;161;848;79;74;5
492;1.09964e-14;141;1631;28897;19038;1;1164;489;3533;280;77;1729;813;203;916;78;74;5
493;1.10488e-14;159;1697;28938;19095;1;1198;478;3533;238;70;1784;813;168;971;78;73;5
494;1.10986e-14;165;1646;29022;19164;1;1203;479;3533;249;69;1843;838;180;1005;78;73;5
495;1.11591e-14;144;1689;29089;19224;1;1220;484;3534;247;91;1762;828;156;934;78;73;5
496;1.12117e-14;138;1686;29187;19296;1;1215;480;3534;273;67;1653;859;206;794;78;73;5
497;1.1275e-14;146;1766;29281;19372;1;1210;464;3534;288;77;1712;810;211;902;78;72;5
498;1.13419e-14;140;1749;29356;19434;1;1220;469;3535;240;65;1723;844;175;879;77;72;5
499;1.13966e-14;141;1665;29462;19488;1;1211;478;3535;236;66;1803;867;170;936;77;72;5
500;1.14443e-14;159;1682;29515;19560;1;1238;438;3535;247;61;1772;846;186;926;77;72;5
501;1.1508e-14;141;1654;29582;19620;1;1251;482;3536;196;71;1742;859;125;883;76;73;5
502;1.15612e-14;157;1737;29675;19691;1;1256;369;3436;267;82;1809;835;185;974;77;72;5
503;1.16242e-14;105;1665;29780;19755;1;1249;368;3436;216;68;1692;860;148;832;77;72;5
504;1.16811e-14;114;1681;29876;19819;1;1238;492;3537;176;60;1698;826;116;872;75;72;5
505;1.17381e-14;139;1651;29957;19873;1;1238;393;3437;260;56;1803;823;204;980;76;72;5
506;1.17863e-14;121;1676;30020;19928;1;1247;457;3537;192;67;1657;831;125;826;74;71;5
507;1.18355e-14;137;1676;30117;20000;1;1245;392;3437;236;48;1819;797;188;1022;75;71;5
508;1.18999e-14;142;1668;30255;20062;1;1209;489;3538;205;68;1692;801;137;891;75;72;5
509;4.20838e-15;117;1231;10893;10094;1;1142;382;3438;245;53;1725;519;192;1206;75;72;5
510;4.24829e-15;99;1369;11194;10148;1;1039;450;3538;184;47;1716;671;137;1045;74;71;5
511;4.28259e-15;129;1567;11482;10196;1;935;453;3539;191;51;1707;713;140;994;73;71;5
512;4.31317e-15;150;1592;11719;10269;1;864;401;3539;189;63;1784;734;126;1050;72;71;5
513;4.3598e-15;144;1554;11928;10333;1;802;444;3539;208;60;1739;792;148;947;72;71;5
514;4.40082e-15;110;1622;12134;10404;1;741;354;3540;205;78;1692;793;127;899;72;70;5
515;4.44649e-15;95;1650;12311;10495;1;689;404;3540;164;57;1779;820;107;959;72;71;5
516;4.50524e-15;114;1584;12504;10569;1;633;392;3540;201;55;1724;829;146;895;72;70;5
517;4.55256e-15;118;1666;12649;10637;1;606;337;3541;181;42;1784;757;139;1027;73;70;5
518;4.59678e-15;100;1647;12812;10703;1;562;366;3541;138;59;1850;846;79;1004;72;70;5
519;4.6405e-15;109;1701;12951;10772;1;523;384;3541;217;64;1784;810;153;974;71;70;5
520;4.68501e-15;103;1671;13004;10839;1;540;388;3541;218;58;1733;801;160;932;72;70;5
521;4.729e-15;103;1618;13136;10898;1;513;390;3542;207;48;1769;861;159;908;71;69;5
522;4.76852e-15;108;1656;13247;10964;1;494;380;3542;187;54;1747;788;133;959;71;70;5
523;4.81211e-15;100;1634;13351;11033;1;481;382;3542;159;60;1805;878;99;927;70;69;5
524;4.85782e-15;121;1606;13439;11103;1;475;395;3543;224;43;1741;853;181;888;70;69;5
525;4.90435e-15;127;1725;13536;11168;1;462;391;3543;199;54;1758;782;145;976;70;68;5
526;4.94769e-15;134;1698;13626;11262;1;460;394;3543;193;66;1862;855;127;1007;70;69;5
527;5.01058e-15;126;1766;13701;11334;1;466;382;3544;208;67;1686;842;141;844;69;68;5
528;5.05894e-15;113;1694;13792;11407;1;459;379;3544;194;59;1801;888;135;913;70;68;5
529;5.10812e-15;107;1740;13860;11458;1;468;340;3544;221;64;1783;906;157;877;70;67;5
530;5.14258e-15;90;1689;13950;11529;1;456;390;3544;158;56;1803;865;102;938;70;68;5
531;5.19068e-15;101;1684;14040;11582;1;444;360;3545;174;48;1740;853;126;887;70;68;5
532;5.22668e-15;90;1688;14084;11656;1;459;393;3545;168;73;1706;845;95;861;70;68;5
533;5.27708e-15;119;1686;14155;11712;1;455;354;3545;186;48;1796;862;138;934;69;68;5
534;5.31533e-15;115;1729;14247;11769;1;451;310;3546;210;60;1777;825;150;952;69;68;5
535;5.35437e-15;100;1703;14345;11836;1;437;347;3546;151;49;1779;874;102;905;69;69;5
536;5.40037e-15;129;1676;14419;11901;1;431;329;3546;184;48;1782;875;136;907;69;68;5
537;5.44512e-15;96;1719;14474;11977;1;440;353;3546;179;56;1791;803;123;988;68;68;5
538;5.4976e-15;117;1667;14542;12049;1;447;353;3547;181;56;1762;835;125;927;68;68;5
539;5.54748e-15;97;1728;14612;12113;1;443;357;3547;183;70;1701;835;113;866;68;67;6
540;5.59194e-15;94;1749;14703;12188;1;429;353;3547;181;52;1665;826;129;839;68;68;6
541;5.64419e-15;96;1725;14750;12260;1;442;313;3548;191;35;1805;901;156;904;68;66;6
542;5.6945e-15;92;1715;14829;12323;1;431;274;3548;162;53;1796;813;109;983;68;67;6
543;5.73865e-15;81;1757;14894;12396;1;425;231;3548;142;44;1817;848;98;969;68;66;6
544;5.78995e-15;59;1752;14965;12457;1;411;268;3548;123;38;1766;854;85;912;67;67;6
545;5.83294e-15;94;1698;15034;12526;1;398;286;3549;138;37;1779;899;101;880;68;67;6
546;5.88168e-15;104;1698;15101;12598;1;395;297;3549;132;41;1780;856;91;924;68;65;6
547;5.9327e-15;69;1656;15166;12651;1;392;295;3549;141;45;1800;841;96;959;68;66;6
548;5.97034e-15;95;1693;15229;12700;1;385;295;3550;164;36;1752;828;128;924;67;66;6
549;6.00522e-15;103;1718;15302;12762;1;377;287;3550;142;41;1800;840;101;960;67;66;6
550;6.04944e-15;93;1746;15365;12821;1;373;280;3550;158;60;1780;828;98;952;67;66;6
551;6.09163e-15;89;1788;15430;12894;1;367;314;3550;146;47;1717;864;99;853;67;66;6
552;6.14396e-15;103;1795;15460;12959;1;384;313;3551;141;45;1810;871;96;939;67;65;6
553;6.19068e-15;110;1753;15533;13025;1;375;254;3551;168;46;1757;880;122;877;66;65;6
554;6.23824e-15;89;1807;15570;13077;1;391;302;3551;116;40;1762;805;76;957;66;65;6
555;6.2758e-15;94;1715;15599;13133;1;409;294;3551;143;42;1819;874;101;945;66;65;6
556;6.31634e-15;90;1678;15643;13204;1;418;301;3552;135;43;1843;848;92;995;66;65;6
557;6.36785e-15;106;1685;15693;13281;1;422;243;3552;137;36;1753;871;101;882;66;64;6
558;6.42388e-15;86;1754;15738;13340;1;434;240;3552;126;41;1789;860;85;929;66;63;6
559;6.46692e-15;85;1749;15802;13421;1;424;299;3553;140;42;1815;854;98;961;66;64;6
560;6.52616e-15;84;1782;15843;13481;1;427;194;3453;162;47;1760;849;115;911;66;64;6
561;6.57017e-15;65;1722;15899;13538;1;416;313;3553;84;29;1777;847;55;930;65;64;6
562;6.61206e-15;107;1704;15961;13595;1;407;293;3553;135;40;1809;898;95;911;65;63;6
563;6.65404e-15;111;1662;16015;13656;1;414;260;3554;155;46;1781;879;109;902;64;63;6
564;6.69907e-15;97;1719;16038;13726;1;435;1.07374e+08;-2.14748e+09;139;43;1752;867;96;885;64;63;6
565;6.75087e-15;97;1719;16038;13726;1;435;2.10574e+08;-2.06399e+09;0;0;-1;0;0;-1;64;62;6
566;6.75087e-15;97;1719;16038;13726;1;435;3.09788e+08;-1.98428e+09;0;0;-1;0;0;-1;64;62;6
567;6.75087e-15;97;1719;16038;13726;1;435;2.97823e+08;-1.90817e+09;0;0;-1;0;0;-1;239;238;6
568;6.75087e-15;97;1716;16038;13726;1;435;4.96971e+08;-1.83548e+09;0;0;-1;0;0;-1;913;913;6
569;6.75087e-15;98;1715;16038;13726;1;435;5.85273e+08;-1.76604e+09;0;0;-1;0;0;-1;2534;2533;6
570;6.75087e-15;98;1715;16038;13726;1;435;6.70258e+08;-1.69969e+09;0;0;-1;0;0;-1;5648;5647;6
571;6.75087e-15;98;1715;16038;13726;1;435;7.52072e+08;-1.63627e+09;0;0;-1;0;0;-1;10888;10887;6
572;6.75087e-15;99;1715;16038;13726;1;435;7.2348e+08;-1.57565e+09;0;0;-1;0;0;-1;18951;18950;6
573;6.75087e-15;99;1715;16038;13726;1;435;9.06739e+08;-1.51768e+09;1;0;-1;0;1;-1;30582;30581;6
574;6.75087e-15;99;1714;16038;13726;1;435;8.72477e+08;-1.46224e+09;0;0;-1;0;0;-1;46565;46564;6
575;6.75087e-15;99;1714;16038;13726;1;435;1.05031e+09;-1.40921e+09;0;0;-1;0;0;-1;67707;67706;6
576;6.75087e-15;100;1713;16038;13726;1;435;1.11824e+09;-1.35846e+09;3;0;-1;0;3;-1;94830;94828;6
577;6.75087e-15;100;1712;16038;13726;1;435;1.07636e+09;-1.30989e+09;0;0;-1;0;0;-1;128760;128758;6
578;6.75087e-15;102;1710;16038;13726;1;435;1.2469e+09;-1.2634e+09;0;0;-1;0;0;-1;170321;170319;6
579;6.75087e-15;102;1710;16038;13726;1;435;1.30785e+09;-1.21888e+09;1;0;-1;0;1;-1;220327;220326;6
580;6.75087e-15;106;1705;16038;13726;1;435;1.25928e+09;-1.17625e+09;4;0;-1;0;4;-1;279577;279575;6
581;6.75087e-15;106;1704;16038;13726;1;435;1.31605e+09;-1.13541e+09;2;0;-1;0;2;-1;348848;348846;6
582;6.75087e-15;111;1703;16038;13726;1;435;1.37087e+09;-1.09627e+09;1;0;-1;0;1;-1;428893;428891;6
583;6.75087e-15;111;1703;16038;13726;1;435;1.53118e+09;-1.05877e+09;1;0;-1;0;1;-1;520437;520436;6
584;6.75087e-15;113;1702;16038;13726;1;435;1.47495e+09;-1.02281e+09;2;0;-1;0;2;-1;624174;624173;6
585;6.75087e-15;116;1698;16038;13726;1;435;1.52436e+09;-9.88342e+08;4;0;-1;0;4;-1;740763;740762;6
586;6.75087e-15;117;1698;16038;13726;1;435;1.6795e+09;-9.5528e+08;5;0;-1;0;5;-1;870830;870828;6
587;6.75087e-15;118;1697;16038;13726;1;435;1.72568e+09;-9.23566e+08;2;0;-1;0;2;-1;1014962;1014960;6
588;6.75087e-15;118;1697;16038;13726;1;435;1.66296e+09;-8.93136e+08;2;0;-1;0;2;-1;1173709;1173707;6
589;6.75087e-15;121;1697;16038;13726;1;435;1.70616e+09;-8.63933e+08;6;0;-1;0;6;-1;1347583;1347581;6
590;6.75087e-15;126;1694;16038;13726;1;435;1.85533e+09;-8.359e+08;4;0;-1;0;4;-1;1537058;1537056;6
591;6.75087e-15;130;1693;16038;13726;1;435;1.78841e+09;-8.08984e+08;4;0;-1;0;4;-1;1742568;1742566;6
592;6.75087e-15;133;1693;16038;13726;1;435;1.82756e+09;-7.83135e+08;1;0;-1;0;1;-1;1964509;1964508;6
593;6.75087e-15;134;1693;16038;13726;1;435;1.97285e+09;-7.58305e+08;2;0;-1;0;2;-1;2203240;2203238;6
594;6.75087e-15;137;1690;16038;13726;1;435;1.9022e+09;-7.34449e+08;1;0;-1;0;1;-1;2459079;2459077;6
595;6.75087e-15;137;1688;16038;13726;1;435;1.93778e+09;-7.11523e+08;1;0;-1;0;1;-1;2732311;2732309;6
596;6.75087e-15;144;1684;16038;13726;1;435;2.07963e+09;-6.89486e+08;6;0;-1;0;6;-1;3023183;3023181;7
597;6.75087e-15;145;1684;16038;13726;1;435;2.11304e+09;-6.68298e+08;1;0;-1;0;1;-1;3331907;3331905;7
598;6.75087e-15;145;1684;16038;13726;1;435;2.14544e+09;-6.47923e+08;0;0;-1;0;0;-1;3658661;3658659;7
599;6.75087e-15;147;1681;16038;13726;1;435;-2.14748e+09;-6.28325e+08;4;0;-1;0;4;-1;4003589;4003587;7
600;6.75087e-15;147;1680;16038;13726;1;435;2.09995e+09;-6.0947e+08;-1;0;0;0;-1;0;4366806;4366804;7
601;6.75087e-15;147;1680;16038;13726;1;435;-2.14748e+09;-5.91326e+08;0;0;-1;0;0;-1;4748392;4748390;7
602;6.75087e-15;147;1680;16038;13726;1;435;-2.14748e+09;-5.73862e+08;-1;0;0;0;-1;0;5148402;5148400;7
603;6.75087e-15;146;1680;16038;13726;1;435;-2.14748e+09;-5.57049e+08;-1;0;0;0;-1;0;5566860;5566858;8
604;6.75087e-15;146;1680;16038;13726;1;435;-2.14748e+09;-5.40859e+08;-1;0;0;0;-1;0;6003764;6003762;8
605;6.75087e-15;142;1679;16038;13726;1;435;-2.14748e+09;-5.25265e+08;-1;0;0;0;-1;0;6459086;6459085;8
606;6.75087e-15;142;1679;16038;13726;1;435;-2.14748e+09;-5.10244e+08;-1;0;0;0;-1;0;6932775;6932773;9
607;6.75087e-15;142;1679;16038;13726;1;435;-2.14748e+09;-4.95769e+08;-1;0;0;0;-1;0;7424755;7424753;9
608;6.75087e-15;140;1679;16038;13726;1;435;-2.14748e+09;-4.81819e+08;-1;0;0;0;-1;0;7934928;7934927;10
609;6.75087e-15;140;1679;16038;13726;1;435;-2.14748e+09;-4.68371e+08;-1;0;0;0;-1;0;8463179;8463177;11
610;6.75087e-15;140;1678;16038;13726;1;435;-2.14748e+09;-4.55404e+08;0;0;-1;0;0;-1;9009369;9009367;12
611;6.75087e-15;137;1678;16038;13726;1;435;-2.14748e+09;-4.429e+08;-1;0;0;0;-1;0;9573344;9573342;13
612;6.75087e-15;135;1678;16038;13726;1;435;-2.14748e+09;-4.30837e+08;-1;0;0;0;-1;0;10154931;10154930;14
613;6.75087e-15;134;1678;16038;13726;1;435;-2.14748e+09;-4.192e+08;0;0;-1;0;0;-1;10753944;10753942;16
614;6.75087e-15;133;1678;16038;13726;1;435;-2.14748e+09;-4.07969e+08;-1;0;0;0;-1;0;11370178;11370177;18
615;6.75087e-15;131;1678;16038;13726;1;435;-2.14748e+09;-3.97129e+08;-1;0;0;0;-1;0;12003419;12003418;20
616;6.75087e-15;130;1677;16038;13726;1;435;-2.14748e+09;-3.86664e+08;0;0;-1;0;0;-1;12653436;12653435;23
617;6.75087e-15;130;1677;16038;13726;1;435;-2.14748e+09;-3.76558e+08;-1;0;0;0;-1;0;13319990;13319989;26
618;6.75087e-15;130;1677;16038;13726;1;435;-2.14748e+09;-3.66798e+08;-1;0;0;0;-1;0;14002829;14002828;29
619;6.75087e-15;129;1677;16038;13726;1;435;-2.14748e+09;-3.57369e+08;-1;0;0;0;-1;0;14701692;14701692;33
620;6.75087e-15;129;1677;16038;13726;1;435;-2.14748e+09;-3.48258e+08;-1;0;0;0;-1;0;15416310;15416309;38
621;6.75087e-15;128;1677;16038;13726;1;435;-2.14748e+09;-3.39454e+08;-1;0;0;0;-1;0;16146404;16146404;43
622;6.75087e-15;128;1677;16038;13726;1;435;-2.14748e+09;-3.30943e+08;-1;0;0;0;-1;0;16891690;16891690;49
623;6.75087e-15;127;1677;16038;13726;1;435;-2.14748e+09;-3.22714e+08;-1;0;0;0;-1;0;17651876;17651876;56
624;6.75087e-15;124;1677;16038;13726;1;435;-2.14748e+09;-3.14757e+08;-1;0;0;0;-1;0;18426665;18426666;64
625;6.75087e-15;124;1677;16038;13726;1;435;-2.14748e+09;-3.07061e+08;-1;0;0;0;-1;0;19215756;19215757;72
626;6.75087e-15;124;1677;16038;13726;1;435;-2.14748e+09;-2.99615e+08;-1;0;0;0;-1;0;20018843;20018844;82
627;6.75087e-15;124;1677;16038;13726;1;435;-2.14748e+09;-2.92411e+08;-1;0;0;0;-1;0;20835615;20835617;93
628;6.75087e-15;122;1677;16038;13726;1;435;-2.14748e+09;-2.85438e+08;-1;0;0;0;-1;0;21665760;21665763;106
629;6.75087e-15;121;1677;16038;13726;1;435;-2.14748e+09;-2.78689e+08;0;0;-1;0;0;-1;22508964;22508967;120
630;6.75087e-15;120;1677;16038;13726;1;435;-2.14748e+09;-2.72154e+08;-1;0;0;0;-1;0;23364909;23364913;136
631;6.75087e-15;118;1677;16038;13726;1;435;-2.14748e+09;-2.65826e+08;-1;0;0;0;-1;0;24233278;24233283;153
632;6.75087e-15;118;1677;16038;13726;1;435;-2.14748e+09;-2.59697e+08;-1;0;0;0;-1;0;25113751;25113756;172
633;6.75087e-15;118;1677;16038;13726;1;435;-2.14748e+09;-2.53759e+08;-1;0;0;0;-1;0;26006008;26006015;194
634;6.75087e-15;116;1677;16038;13726;1;435;-2.14748e+09;-2.48005e+08;0;0;-1;0;0;-1;26909732;26909739;218
635;6.75087e-15;114;1676;16038;13726;1;435;-2.14748e+09;-2.42429e+08;-1;0;0;0;-1;0;27824602;27824611;244
636;6.75087e-15;114;1676;16038;13726;1;435;-2.14748e+09;-2.37024e+08;-1;0;0;0;-1;0;28750301;28750312;273
637;6.75087e-15;111;1675;16038;13726;1;435;-2.14748e+09;-2.31784e+08;-1;0;0;0;-1;0;29686513;29686525;305
638;6.75087e-15;111;1675;16038;13726;1;435;-2.14748e+09;-2.26703e+08;-1;0;0;0;-1;0;30632922;30632935;340
639;6.75087e-15;110;1675;16038;13726;1;435;-2.14748e+09;-2.21775e+08;-1;0;0;0;-1;0;31589215;31589230;379
640;6.75087e-15;107;1675;16038;13726;1;435;-2.14748e+09;-2.16994e+08;-1;0;0;0;-1;0;32555080;32555098;421
641;6.75087e-15;105;1675;16038;13726;1;435;-2.14748e+09;-2.12356e+08;0;0;-1;0;0;-1;33530210;33530230;467
642;6.75087e-15;105;1675;16038;13726;1;435;-2.14748e+09;-2.07855e+08;-1;0;0;0;-1;0;34514298;34514320;517
643;6.75087e-15;105;1675;16038;13726;1;435;-2.14748e+09;-2.03486e+08;-1;0;0;0;-1;0;35507041;35507065;572
644;6.75087e-15;105;1675;16038;13726;1;435;-2.14748e+09;-1.99245e+08;0;0;-1;0;0;-1;36508138;36508166;632
645;6.75087e-15;104;1675;16038;13726;1;435;-2.14748e+09;-1.95127e+08;-1;0;0;0;-1;0;37517293;37517324;697
646;6.75087e-15;102;1675;16038;13726;1;435;-2.14748e+09;-1.91128e+08;-1;0;0;0;-1;0;38534214;38534248;767
647;6.75087e-15;102;1675;16038;13726;1;435;-2.14748e+09;-1.87243e+08;-1;0;0;0;-1;0;39558609;39558647;843
648;6.75087e-15;102;1675;16038;13726;1;435;-2.14748e+09;-1.83469e+08;-1;0;0;0;-1;0;40590194;40590236;926
649;6.75087e-15;98;1675;16038;13726;1;435;-2.14748e+09;-1.79803e+08;-1;0;0;0;-1;0;41628686;41628732;1015
650;6.75087e-15;97;1675;16038;13726;1;435;-2.14748e+09;-1.76239e+08;-1;0;0;0;-1;0;42673808;42673858;1111
651;6.75087e-15;97;1675;16038;13726;1;435;-2.14748e+09;-1.72776e+08;-1;0;0;0;-1;0;43725285;43725340;1214
652;6.75087e-15;93;1675;16038;13726;1;435;-2.14748e+09;-1.69408e+08;-1;0;0;0;-1;0;44782848;44782908;1326
653;6.75087e-15;93;1675;16038;13726;1;435;-2.14748e+09;-1.66134e+08;-1;0;0;0;-1;0;45846232;45846298;1445
654;6.75087e-15;92;1675;16038;13726;1;435;-2.14748e+09;-1.6295e+08;-1;0;0;0;-1;0;46915175;46915248;1574
655;6.75087e-15;92;1675;16038;13726;1;435;-2.14748e+09;-1.59852e+08;-1;0;0;0;-1;0;47989423;47989502;1712
656;6.75087e-15;92;1675;16038;13726;1;435;-2.14748e+09;-1.56839e+08;-1;0;0;0;-1;0;49068721;49068807;1860
657;6.75087e-15;92;1675;16038;13726;1;435;-2.14748e+09;-1.53907e+08;0;0;-1;0;0;-1;50152824;50152917;2018
658;6.75087e-15;91;1675;16038;13726;1;435;-2.14748e+09;-1.51054e+08;-1;0;0;0;-1;0;51241487;51241589;2186
659;6.75087e-15;91;1675;16038;13726;1;435;-2.14748e+09;-1.48277e+08;-1;0;0;0;-1;0;52334473;52334584;2367
660;6.75087e-15;91;1675;16038;13726;1;435;-2.14748e+09;-1.45573e+08;-1;0;0;0;-1;0;53431548;53431668;2559
661;6.75087e-15;91;1675;16038;13726;1;435;-2.14748e+09;-1.42941e+08;-1;0;0;0;-1;0;54532483;54532613;2764
662;6.75087e-15;91;1675;16038;13726;1;435;-2.14748e+09;-1.40378e+08;-1;0;0;0;-1;0;55637054;55637194;2982
663;6.75087e-15;90;1675;16038;13726;1;435;-2.14748e+09;-1.37881e+08;-1;0;0;0;-1;0;56745040;56745192;3214
664;6.75087e-15;88;1675;16038;13726;1;435;-2.14748e+09;-1.35448e+08;-1;0;0;0;-1;0;57856226;57856390;3461
665;6.75087e-15;88;1675;16038;13726;1;435;-2.14748e+09;-1.33079e+08;-1;0;0;0;-1;0;58970402;58970579;3722
666;6.75087e-15;87;1675;16038;13726;1;435;-2.14748e+09;-1.30769e+08;-1;0;0;0;-1;0;60087362;60087552;4000
667;6.75087e-15;86;1675;16038;13726;1;435;-2.14748e+09;-1.28519e+08;-1;0;0;0;-1;0;61206903;61207107;4294
668;6.75087e-15;85;1675;16038;13726;1;435;-2.14748e+09;-1.26325e+08;-1;0;0;0;-1;0;62328829;62329048;4605
669;6.75087e-15;85;1675;16038;13726;1;435;-2.14748e+09;-1.24186e+08;-1;0;0;0;-1;0;63452947;63453183;4935
670;6.75087e-15;84;1675;16038;13726;1;435;-2.14748e+09;-1.221e+08;-1;0;0;0;-1;0;64579069;64579322;5283
671;6.75087e-15;83;1675;16038;13726;1;435;-2.14748e+09;-1.20066e+08;-1;0;0;0;-1;0;65707012;65707284;5651
672;6.75087e-15;83;1675;16038;13726;1;435;-2.14748e+09;-1.18082e+08;-1;0;0;0;-1;0;66836596;66836887;6039
673;6.75087e-15;83;1675;16038;13726;1;435;-2.14748e+09;-1.16147e+08;-1;0;0;0;-1;0;67967647;67967958;6448
674;6.75087e-15;83;1675;16038;13726;1;435;-2.14748e+09;-1.14258e+08;-1;0;0;0;-1;0;69099992;69100325;6879
675;6.75087e-15;81;1675;16038;13726;1;435;-2.14748e+09;-1.12415e+08;-1;0;0;0;-1;0;70233467;70233822;7333
676;6.75087e-15;81;1675;16038;13726;1;435;-2.14748e+09;-1.10617e+08;-1;0;0;0;-1;0;71367907;71368288;7811
677;6.75087e-15;80;1675;16038;13726;1;435;-2.14748e+09;-1.08861e+08;-1;0;0;0;-1;0;72503157;72503563;8313
678;6.75087e-15;80;1675;16038;13726;1;435;-2.14748e+09;-1.07148e+08;-1;0;0;0;-1;0;73639061;73639493;8841
679;6.75087e-15;80;1675;16038;13726;1;435;-2.14748e+09;-1.05474e+08;-1;0;0;0;-1;0;74775469;74775930;9395
680;6.75087e-15;76;1675;16038;13726;1;435;-2.14748e+09;-1.0384e+08;-1;0;0;0;-1;0;75912236;75912726;9976
681;6.75087e-15;75;1675;16038;13726;1;435;-2.14748e+09;-1.02244e+08;-1;0;0;0;-1;0;77049218;77049740;10585
682;6.75087e-15;71;1675;16038;13726;1;435;-2.14748e+09;-1.00684e+08;-1;0;0;0;-1;0;78186278;78186832;11224
683;6.75087e-15;71;1675;16038;13726;1;435;-2.14748e+09;-9.9161e+07;-1;0;0;0;-1;0;79323281;79323869;11893
684;6.75087e-15;70;1675;16038;13726;1;435;-2.14748e+09;-9.76726e+07;-1;0;0;0;-1;0;80460096;80460720;12593
685;6.75087e-15;68;1675;16038;13726;1;435;-2.14748e+09;-9.62178e+07;-1;0;0;0;-1;0;81596595;81597258;13325
686;6.75087e-15;65;1675;16038;13726;1;435;-2.14748e+09;-9.4796e+07;-1;0;0;0;-1;0;82732656;82733358;14091
687;6.75087e-15;65;1675;16038;13726;1;435;-2.14748e+09;-9.34062e+07;-1;0;0;0;-1;0;83868157;83868901;14890
688;6.75087e-15;65;1675;16038;13726;1;435;-2.14748e+09;-9.20473e+07;-1;0;0;0;-1;0;85002983;85003771;15725
689;6.75087e-15;63;1675;16038;13726;1;435;-2.14748e+09;-9.07186e+07;-1;0;0;0;-1;0;86137020;86137853;16596
690;6.75087e-15;63;1675;16038;13726;1;435;-2.14748e+09;-8.94192e+07;-1;0;0;0;-1;0;87270158;87271039;17505
691;6.75087e-15;63;1675;16038;13726;1;435;-2.14748e+09;-8.81483e+07;-1;0;0;0;-1;0;88402290;88403222;18452
692;6.75087e-15;63;1675;16038;13726;1;435;-2.14748e+09;-8.69051e+07;0;0;-1;0;0;-1;89533314;89534297;19438
693;6.75087e-15;63;1675;16038;13726;1;435;-2.14748e+09;-8.56888e+07;-1;0;0;0;-1;0;90663128;90664166;20466
694;6.75087e-15;63;1675;16038;13726;1;435;-2.14748e+09;-8.44987e+07;-1;0;0;0;-1;0;91791635;91792731;21535
695;6.75087e-15;62;1675;16038;13726;1;435;-2.14748e+09;-8.33341e+07;-1;0;0;0;-1;0;92918742;92919898;22647
696;6.75087e-15;62;1675;16038;13726;1;435;-2.14748e+09;-8.21942e+07;-1;0;0;0;-1;0;94044357;94045575;23804
697;6.75087e-15;62;1675;16038;13726;1;435;-2.14748e+09;-8.10785e+07;-1;0;0;0;-1;0;95168392;95169675;25005
698;6.75087e-15;62;1675;16038;13726;1;435;-2.14748e+09;-7.99863e+07;-1;0;0;0;-1;0;96290761;96292112;26253
699;6.75087e-15;62;1675;16038;13726;1;435;-2.14748e+09;-7.89167e+07;-1;0;0;0;-1;0;97411382;97412803;27549
700;6.75087e-15;62;1675;16038;13726;1;435;-2.14748e+09;-7.78695e+07;-1;0;0;0;-1;0;98530174;98531668;28894
701;6.75087e-15;62;1675;16038;13726;1;435;-2.14748e+09;-7.68437e+07;-1;0;0;0;-1;0;99647061;99648631;30288
702;6.75087e-15;62;1675;16038;13726;1;435;-2.14748e+09;-7.58392e+07;-1;0;0;0;-1;0;100761967;100763617;31734
703;6.75087e-15;61;1675;16038;13726;1;435;-2.14748e+09;-7.4855e+07;-1;0;0;0;-1;0;101874821;101876553;33233
704;6.75087e-15;60;1675;16038;13726;1;435;-2.14748e+09;-7.38908e+07;-1;0;0;0;-1;0;102985552;102987369;34785
705;6.75087e-15;56;1675;16038;13726;1;435;-2.14748e+09;-7.2946e+07;-1;0;0;0;-1;0;104094094;104096000;36392
706;6.75087e-15;53;1675;16038;13726;1;435;-2.14748e+09;-7.20202e+07;-1;0;0;0;-1;0;105200381;105202380;38055
707;6.75087e-15;53;1675;16038;13726;1;435;-2.14748e+09;-7.11128e+07;-1;0;0;0;-1;0;106304350;106306445;39776
708;6.75087e-15;51;1675;16038;13726;1;435;-2.14748e+09;-7.02234e+07;-1;0;0;0;-1;0;107405942;107408137;41555
709;6.75087e-15;49;1674;16038;13726;1;435;-2.14748e+09;-6.93515e+07;-1;0;0;0;-1;0;108505098;108507397;43394
710;6.75087e-15;45;1674;16038;13726;1;435;-2.14748e+09;-6.84966e+07;-1;0;0;0;-1;0;109601763;109604169;45295
711;6.75087e-15;45;1674;16038;13726;1;435;-2.14748e+09;-6.76584e+07;-1;0;0;0;-1;0;110695882;110698399;47258
712;6.75087e-15;41;1674;16038;13726;1;435;-2.14748e+09;-6.68363e+07;-1;0;0;0;-1;0;111787404;111790035;49285
713;6.75087e-15;40;1674;16038;13726;1;435;-2.14748e+09;-6.60301e+07;-1;0;0;0;-1;0;112876279;112879028;51377
714;6.75087e-15;40;1674;16038;13726;1;435;-2.14748e+09;-6.52393e+07;-1;0;0;0;-1;0;113962459;113965331;53535
715;6.75087e-15;39;1674;16038;13726;1;435;-2.14748e+09;-6.44635e+07;-1;0;0;0;-1;0;115045897;115048897;55762
716;6.75087e-15;36;1674;16038;13726;1;435;-2.14748e+09;-6.37024e+07;-1;0;0;0;-1;0;116126550;116129683;58057
717;6.75087e-15;35;1673;16038;13726;1;435;-2.14748e+09;-6.29556e+07;-1;0;0;0;-1;0;117204376;117207645;60422
718;6.75087e-15;34;1673;16038;13726;1;435;-2.14748e+09;-6.22227e+07;-1;0;0;0;-1;0;118279333;118282744;62859
719;6.75087e-15;32;1673;16038;13726;1;435;-2.14748e+09;-6.15032e+07;-1;0;0;0;-1;0;119351383;119354940;65369
720;6.75087e-15;32;1673;16038;13726;1;435;-2.14748e+09;-6.07972e+07;-1;0;0;0;-1;0;120420489;120424197;67953
721;6.75087e-15;32;1673;16038;13726;1;435;-2.14748e+09;-6.01041e+07;-1;0;0;0;-1;0;121486616;121490479;70612
722;6.75087e-15;32;1673;16038;13726;1;435;-2.14748e+09;-5.94236e+07;-1;0;0;0;-1;0;122549729;122553753;73348
723;6.75087e-15;32;1673;16038;13726;1;435;-2.14748e+09;-5.87555e+07;-1;0;0;0;-1;0;123609795;123613985;76163
724;6.75087e-15;32;1673;16038;13726;1;435;-2.14748e+09;-5.80994e+07;-1;0;0;0;-1;0;124666785;124671146;79057
725;6.75087e-15;32;1673;16038;13726;1;435;-2.14748e+09;-5.74551e+07;-1;0;0;0;-1;0;125720668;125725205;82031
726;6.75087e-15;32;1673;16038;13726;1;435;-2.14748e+09;-5.68223e+07;-1;0;0;0;-1;0;126771416;126776136;85088
727;6.75087e-15;28;1673;16038;13726;1;435;-2.14748e+09;-5.62006e+07;-1;0;0;0;-1;0;127819003;127823911;88228
728;6.75087e-15;28;1673;16038;13726;1;435;-2.14748e+09;-5.55901e+07;-1;0;0;0;-1;0;128863404;128868505;91453
729;6.75087e-15;28;1673;16038;13726;1;435;-2.14748e+09;-5.499e+07;-1;0;0;0;-1;0;129904594;129909894;94763
730;6.75087e-15;24;1673;16038;13726;1;435;-2.14748e+09;-5.44004e+07;-1;0;0;0;-1;0;130942550;130948056;98161
731;6.75087e-15;23;1673;16038;13726;1;435;-2.14748e+09;-5.38211e+07;-1;0;0;0;-1;0;131977251;131982970;101648
732;6.75087e-15;20;1673;16038;13726;1;435;-2.14748e+09;-5.32518e+07;-1;0;0;0;-1;0;133008677;133014614;105224
733;6.75087e-15;20;1673;16038;13726;1;435;-2.14748e+09;-5.26921e+07;-1;0;0;0;-1;0;134036809;134042970;108892
734;6.75087e-15;20;1673;16038;13726;1;435;-2.14748e+09;-5.2142e+07;-1;0;0;0;-1;0;135061629;135068021;112652
735;6.75087e-15;19;1673;16038;13726;1;435;-2.14748e+09;-5.16013e+07;-1;0;0;0;-1;0;136083119;136089749;116505
736;6.75087e-15;19;1673;16038;13726;1;435;-2.14748e+09;-5.10696e+07;-1;0;0;0;-1;0;137101264;137108138;120454
737;6.75087e-15;17;1673;16038;13726;1;435;-2.14748e+09;-5.05468e+07;-1;0;0;0;-1;0;138116049;138123175;124499
738;6.75087e-15;16;1673;16038;13726;1;435;-2.14748e+09;-5.00327e+07;-1;0;0;0;-1;0;139127460;139134844;128642
739;6.75087e-15;14;1672;16038;13726;1;435;-2.14748e+09;-4.95272e+07;-1;0;0;0;-1;0;140135485;140143135;132884
740;6.75087e-15;14;1672;16038;13726;1;435;-2.14748e+09;-4.90299e+07;-1;0;0;0;-1;0;141140112;141148035;137225
741;6.75087e-15;13;1672;16038;13726;1;435;-2.14748e+09;-4.85408e+07;-1;0;0;0;-1;0;142141329;142149532;141668
742;6.75087e-15;12;1672;16038;13726;1;435;-2.14748e+09;-4.80597e+07;-1;0;0;0;-1;0;143139127;143147618;146214
743;6.75087e-15;10;1672;16038;13726;1;435;-2.14748e+09;-4.75863e+07;-1;0;0;0;-1;0;144133496;144142283;150864
744;6.75087e-15;10;1672;16038;13726;1;435;-2.14748e+09;-4.71205e+07;-1;0;0;0;-1;0;145124429;145133519;155618
745;6.75087e-15;9;1672;16038;13726;1;435;-2.14748e+09;-4.66622e+07;-1;0;0;0;-1;0;146111917;146121319;160479
746;6.75087e-15;9;1672;16038;13726;1;435;-2.14748e+09;-4.62113e+07;-1;0;0;0;-1;0;147095954;147105676;165448
747;6.75087e-15;8;1672;16038;13726;1;435;-2.14748e+09;-4.57674e+07;-1;0;0;0;-1;0;148076534;148086584;170525
748;6.75087e-15;8;1672;16038;13726;1;435;-2.14748e+09;-4.53305e+07;-1;0;0;0;-1;0;149053653;149064038;175712
749;6.75087e-15;7;1672;16038;13726;1;435;-2.14748e+09;-4.49004e+07;-1;0;0;0;-1;0;150027304;150038035;181010
750;6.75087e-15;7;1672;16038;13726;1;435;-2.14748e+09;-4.44771e+07;-1;0;0;0;-1;0;150997485;151008569;186421
751;6.75087e-15;5;1672;16038;13726;1;435;-2.14748e+09;-4.40603e+07;-1;0;0;0;-1;0;151964192;151975638;191945
752;6.75087e-15;5;1672;16038;13726;1;435;-2.14748e+09;-4.36499e+07;-1;0;0;0;-1;0;152927424;152939241;197584
753;6.75087e-15;5;1672;16038;13726;1;435;-2.14748e+09;-4.32458e+07;-1;0;0;0;-1;0;153887177;153899375;203339
754;6.75087e-15;2;1672;16038;13726;1;435;-2.14748e+09;-4.2848e+07;-1;0;0;0;-1;0;154843452;154856039;209211
755;6.75087e-15;2;1672;16038;13726;1;435;-2.14748e+09;-4.2456e+07;-1;0;0;0;-1;0;155796247;155809233;215201
756;6.75087e-15;2;1672;16038;13726;1;435;-2.14748e+09;-4.207e+07;-1;0;0;0;-1;0;156745562;156758957;221310
757;6.75087e-15;2;1672;16038;13726;1;435;-2.14748e+09;-4.16897e+07;-1;0;0;0;-1;0;157691398;157705212;227539
758;6.75087e-15;0;1672;16038;13726;1;435;-2.14748e+09;-4.13152e+07;-1;0;0;0;-1;0;158633756;158647998;233890
759;6.75087e-15;0;1672;16038;13726;1;435;-2.14748e+09;-4.09462e+07;-1;0;0;0;-1;0;159572638;159587318;240364
760;6.75087e-15;0;1672;16038;13726;1;435;-2.14748e+09;-4.05826e+07;-1;0;0;0;-1;0;160508045;160523173;246961
761;6.75087e-15;-1;1672;16038;13726;1;435;-2.14748e+09;-4.02244e+07;0;0;0;0;0;0;161439981;161455567;253684
762;6.75087e-15;-1;1672;16038;13726;1;435;-2.14748e+09;-3.98714e+07;-1;0;0;0;-1;0;162368447;162384503;260532
763;6.75087e-15;-2;1672;16038;13726;1;435;-2.14748e+09;-3.95235e+07;0;0;0;0;0;0;163293449;163309984;267506
764;6.75087e-15;-2;1672;16038;13726;1;435;-2.14748e+09;-3.91808e+07;-1;0;0;0;-1;0;164214989;164232014;274609
765;6.75087e-15;-2;1672;16038;13726;1;435;-2.14748e+09;-3.88428e+07;-1;0;0;0;-1;0;165133072;165150598;281841
766;6.75087e-15;-2;1672;16038;13726;1;435;-2.14748e+09;-3.85097e+07;-1;0;0;0;-1;0;166047702;166065741;289202
767;6.75087e-15;-3;1672;16038;13726;1;435;-2.14748e+09;-3.81813e+07;0;0;0;0;0;0;166958886;166977448;296695
768;6.75087e-15;-3;1672;16038;13726;1;435;-2.14748e+09;-3.78576e+07;-1;0;0;0;-1;0;167866628;167885724;304320
769;6.75087e-15;-4;1672;16038;13726;1;435;-2.14748e+09;-3.75384e+07;0;0;0;0;0;0;168770934;168790577;312077
770;6.75087e-15;-4;1672;16038;13726;1;435;-2.14748e+09;-3.72237e+07;-1;0;0;0;-1;0;169671811;169692012;319969
771;6.75087e-15;-4;1672;16038;13726;1;435;-2.14748e+09;-3.69134e+07;-1;0;0;0;-1;0;170569266;170590035;327995
772;6.75087e-15;-4;1672;16038;13726;1;435;-2.14748e+09;-3.66073e+07;-1;0;0;0;-1;0;171463304;171484655;336157
773;6.75087e-15;-5;1672;16038;13726;1;435;-2.14748e+09;-3.63055e+07;0;0;0;0;0;0;172353933;172375878;344456
774;6.75087e-15;-6;1672;16038;13726;1;435;-2.14748e+09;-3.60078e+07;0;0;0;0;0;0;173241162;173263712;352892
775;6.75087e-15;-6;1672;16038;13726;1;435;-2.14748e+09;-3.57142e+07;-1;0;0;0;-1;0;174124997;174148165;361467
776;6.75087e-15;-7;1672;16038;13726;1;435;-2.14748e+09;-3.54246e+07;0;0;0;0;0;0;175005447;175029246;370182
777;6.75087e-15;-8;1672;16038;13726;1;435;-2.14748e+09;-3.51389e+07;0;0;0;0;0;0;175882520;175906962;379036
778;6.75087e-15;-8;1672;16038;13726;1;435;-2.14748e+09;-3.4857e+07;-1;0;0;0;-1;0;176756225;176781323;388032
779;6.75087e-15;-9;1672;16038;13726;1;435;-2.14748e+09;-3.45788e+07;0;0;0;0;0;0;177626570;177652338;397170
780;6.75087e-15;-9;1672;16038;13726;1;435;-2.14748e+09;-3.43044e+07;-1;0;0;0;-1;0;178493566;178520015;406451
781;6.75087e-15;-10;1672;16038;13726;1;435;-2.14748e+09;-3.40336e+07;0;0;0;0;0;0;179357220;179384365;415876
782;6.75087e-15;-11;1672;16038;13726;1;435;-2.14748e+09;-3.37664e+07;0;0;0;0;0;0;180217543;180245398;425445
783;6.75087e-15;-12;1672;16038;13726;1;435;-2.14748e+09;-3.35026e+07;0;0;0;0;0;0;181074545;181103122;435159
784;6.75087e-15;-13;1672;16038;13726;1;435;-2.14748e+09;-3.32423e+07;0;0;0;0;0;0;181928235;181957548;445019
785;6.75087e-15;-14;1672;16038;13726;1;435;-2.14748e+09;-3.29854e+07;0;0;0;0;0;0;182778623;182808688;455026
786;6.75087e-15;-14;1672;16038;13726;1;435;-2.14748e+09;-3.27318e+07;-1;0;0;0;-1;0;183625721;183656550;465181
787;6.75087e-15;-14;1672;16038;13726;1;435;-2.14748e+09;-3.24814e+07;-1;0;0;0;-1;0;184469538;184501146;475484
788;6.75087e-15;-14;1672;16038;13726;1;435;-2.14748e+09;-3.22343e+07;-1;0;0;0;-1;0;185310085;185342486;485936
789;6.75087e-15;-14;1672;16038;13726;1;435;-2.14748e+09;-3.19902e+07;-1;0;0;0;-1;0;186147373;186180582;496537
790;6.75087e-15;-14;1672;16038;13726;1;435;-2.14748e+09;-3.17492e+07;-1;0;0;0;-1;0;186981414;187015445;507289
791;6.75087e-15;-15;1672;16038;13726;1;435;-2.14748e+09;-3.15113e+07;0;0;0;0;0;0;187812217;187847086;518192
792;6.75087e-15;-15;1672;16038;13726;1;435;-2.14748e+09;-3.12764e+07;-1;0;0;0;-1;0;188639795;188675517;529247
793;6.75087e-15;-15;1672;16038;13726;1;435;-2.14748e+09;-3.10444e+07;-1;0;0;0;-1;0;189464159;189500748;540455
794;6.75087e-15;-16;1672;16038;13726;1;435;-2.14748e+09;-3.08153e+07;0;0;0;0;0;0;190285320;190322793;551815
795;6.75087e-15;-16;1672;16038;13726;1;435;-2.14748e+09;-3.0589e+07;-1;0;0;0;-1;0;191103291;191141662;563329
796;6.75087e-15;-16;1672;16038;13726;1;435;-2.14748e+09;-3.03654e+07;0;0;-1;0;0;-1;191918082;191957367;574997
797;6.75087e-15;-16;1672;16038;13726;1;435;-2.14748e+09;-3.01446e+07;-1;0;0;0;-1;0;192729706;192769921;586820
798;6.75087e-15;-17;1672;16038;13726;1;435;-2.14748e+09;-2.99265e+07;0;0;0;0;0;0;193538174;193579336;598799
799;6.75087e-15;-18;1672;16038;13726;1;435;-2.14748e+09;-2.97111e+07;0;0;0;0;0;0;194343500;194385624;610933
800;6.75087e-15;-19;1672;16038;13726;1;435;-2.14748e+09;-2.94982e+07;0;0;0;0;0;0;195145695;195188797;623224
801;6.75087e-15;-20;1672;16038;13726;1;435;-2.14748e+09;-2.92879e+07;0;0;0;0;0;0;195944770;195988868;635672
802;6.75087e-15;-21;1672;16038;13726;1;435;-2.14748e+09;-2.90801e+07;0;0;0;0;0;0;196740740;196785849;648278
803;6.75087e-15;-21;1672;16038;13726;1;435;-2.14748e+09;-2.88747e+07;-1;0;0;0;-1;0;197533615;197579753;661042
804;6.75087e-15;-21;1672;16038;13726;1;435;-2.14748e+09;-2.86718e+07;-1;0;0;0;-1;0;198323408;198370592;673964
805;6.75087e-15;-21;1672;16038;13726;1;435;-2.14748e+09;-2.84713e+07;-1;0;0;0;-1;0;199110133;199158379;687046
806;6.75087e-15;-21;1672;16038;13726;1;435;-2.14748e+09;-2.82731e+07;-1;0;0;0;-1;0;199893801;199943127;700287
807;6.75087e-15;-21;1672;16038;13726;1;435;-2.14748e+09;-2.80773e+07;-1;0;0;0;-1;0;200674426;200724848;713688
808;6.75087e-15;-22;1672;16038;13726;1;435;-2.14748e+09;-2.78837e+07;0;0;0;0;0;0;201452019;201503556;727249
809;6.75087e-15;-23;1672;16038;13726;1;435;-2.14748e+09;-2.76923e+07;0;0;0;0;0;0;202226593;202279263;740971
810;6.75087e-15;-24;1672;16038;13726;1;435;-2.14748e+09;-2.75033e+07;0;0;0;0;0;0;202998163;203051983;754854
811;6.75087e-15;-25;1672;16038;13726;1;435;-2.14748e+09;-2.73162e+07;0;0;0;0;0;0;203766739;203821727;768899
812;6.75087e-15;-26;1672;16038;13726;1;435;-2.14748e+09;-2.71313e+07;0;0;0;0;0;0;204532335;204588510;783106
813;6.75087e-15;-27;1672;16038;13726;1;435;-2.14748e+09;-2.69486e+07;0;0;0;0;0;0;205294965;205352345;797476
814;6.75087e-15;-28;1672;16038;13726;1;435;-2.14748e+09;-2.67678e+07;0;0;0;0;0;0;206054640;206113243;812008
815;6.75087e-15;-28;1672;16038;13726;1;435;-2.14748e+09;-2.65892e+07;-1;0;0;0;-1;0;206811374;206871219;826703
816;6.75087e-15;-28;1672;16038;13726;1;435;-2.14748e+09;-2.64125e+07;-1;0;0;0;-1;0;207565180;207626286;841561
817;6.75087e-15;-29;1672;16038;13726;1;435;-2.14748e+09;-2.62378e+07;0;0;0;0;0;0;208316071;208378456;856583
818;6.75087e-15;-29;1672;16038;13726;1;435;-2.14748e+09;-2.6065e+07;-1;0;0;0;-1;0;209064059;209127744;871769
819;6.75087e-15;-30;1672;16038;13726;1;435;-2.14748e+09;-2.58941e+07;0;0;0;0;0;0;209809158;209874161;887120
820;6.75087e-15;-30;1672;16038;13726;1;435;-2.14748e+09;-2.57251e+07;-1;0;0;0;-1;0;210551381;210617721;902634
821;6.75087e-15;-31;1672;16038;13726;1;435;-2.14748e+09;-2.5558e+07;0;0;0;0;0;0;211290741;211358438;918314
822;6.75087e-15;-32;1672;16038;13726;1;435;-2.14748e+09;-2.53927e+07;0;0;0;0;0;0;212027250;212096324;934158
823;6.75087e-15;-32;1672;16038;13726;1;435;-2.14748e+09;-2.52292e+07;-1;0;0;0;-1;0;212760922;212831393;950168
824;6.75087e-15;-33;1672;16038;13726;1;435;-2.14748e+09;-2.50674e+07;0;0;0;0;0;0;213491770;213563658;966343
825;6.75087e-15;-34;1672;16038;13726;1;435;-2.14748e+09;-2.49074e+07;0;0;0;0;0;0;214219807;214293132;982684
826;6.75087e-15;-34;1672;16038;13726;1;435;-2.14748e+09;-2.47491e+07;-1;0;0;0;-1;0;214945046;215019828;999191
827;6.75087e-15;-35;1672;16038;13726;1;435;-2.14748e+09;-2.45924e+07;0;0;0;0;0;0;215667500;215743759;1015864
828;6.75087e-15;-35;1672;16038;13726;1;435;-2.14748e+09;-2.44375e+07;-1;0;0;0;-1;0;216387181;216464939;1032703
829;6.75087e-15;-35;1672;16038;13726;1;435;-2.14748e+09;-2.42842e+07;-1;0;0;0;-1;0;217104103;217183380;1049708
830;6.75087e-15;-35;1672;16038;13726;1;435;-2.14748e+09;-2.41324e+07;-1;0;0;0;-1;0;217818279;217899096;1066879
831;6.75087e-15;-35;1672;16038;13726;1;435;-2.14748e+09;-2.39823e+07;-1;0;0;0;-1;0;218529722;218612100;1084217
832;6.75087e-15;-36;1672;16038;13726;1;435;-2.14748e+09;-2.38337e+07;0;0;0;0;0;0;219238444;219322404;1101722
833;6.75087e-15;-37;1672;16038;13726;1;435;-2.14748e+09;-2.36867e+07;0;0;0;0;0;0;219944459;220030023;1119394
834;6.75087e-15;-37;1672;16038;13726;1;435;-2.14748e+09;-2.35412e+07;-1;0;0;0;-1;0;220647779;220734968;1137232
835;6.75087e-15;-37;1672;16038;13726;1;435;-2.14748e+09;-2.33972e+07;-1;0;0;0;-1;0;221348418;221437254;1155238
836;6.75087e-15;-37;1672;16038;13726;1;435;-2.14748e+09;-2.32547e+07;-1;0;0;0;-1;0;222046388;222136892;1173410
837;6.75087e-15;-37;1672;16038;13726;1;435;-2.14748e+09;-2.31136e+07;-1;0;0;0;-1;0;222741701;222833896;1191750
838;6.75087e-15;-38;1672;16038;13726;1;435;-2.14748e+09;-2.29739e+07;0;0;0;0;0;0;223434371;223528279;1210256
839;6.75087e-15;-39;1672;16038;13726;1;435;-2.14748e+09;-2.28357e+07;0;0;0;0;0;0;224124411;224220053;1228930
840;6.75087e-15;-39;1672;16038;13726;1;435;-2.14748e+09;-2.26989e+07;-1;0;0;0;-1;0;224811832;224909232;1247771
841;6.75087e-15;-39;1672;16038;13726;1;435;-2.14748e+09;-2.25634e+07;-1;0;0;0;-1;0;225496649;225595828;1266779
842;6.75087e-15;-39;1672;16038;13726;1;435;-2.14748e+09;-2.24293e+07;-1;0;0;0;-1;0;226178873;226279854;1285954
843;6.75087e-15;-39;1672;16038;13726;1;435;-2.14748e+09;-2.22966e+07;-1;0;0;0;-1;0;226858517;226961324;1305296
844;6.75087e-15;-39;1672;16038;13726;1;435;-2.14748e+09;-2.21652e+07;-1;0;0;0;-1;0;227535593;227640248;1324805
845;6.75087e-15;-39;1672;16038;13726;1;435;-2.14748e+09;-2.20349e+07;-1;0;0;0;-1;0;228210115;228316641;1344482
846;6.75087e-15;-39;1672;16038;13726;1;435;-2.14748e+09;-2.19061e+07;-1;0;0;0;-1;0;228882094;228990515;1364325
847;6.75087e-15;-40;1672;16038;13726;1;435;-2.14748e+09;-2.17784e+07;0;0;0;0;0;0;229551544;229661882;1384335
848;6.75087e-15;-41;1672;16038;13726;1;435;-2.14748e+09;-2.16522e+07;0;0;0;0;0;0;230218475;230330755;1404512
849;6.75087e-15;-42;1672;16038;13726;1;435;-2.14748e+09;-2.15269e+07;0;0;0;0;0;0;230882902;230997147;1424856
850;6.75087e-15;-43;1672;16038;13726;1;435;-2.14748e+09;-2.1403e+07;0;0;0;0;0;0;231544836;231661069;1445366
851;6.75087e-15;-44;1672;16038;13726;1;435;-2.14748e+09;-2.12802e+07;0;0;0;0;0;0;232204289;232322535;1466043
852;6.75087e-15;-44;1671;16038;13726;1;435;-2.14748e+09;-2.11587e+07;0;0;0;0;0;0;232861274;232981557;1486886
853;6.75087e-15;-45;1671;16038;13726;1;435;-2.14748e+09;-2.10383e+07;0;0;0;0;0;0;233515803;233638146;1507896
854;6.75087e-15;-46;1671;16038;13726;1;435;-2.14748e+09;-2.09191e+07;0;0;0;0;0;0;234167888;234292317;1529072
855;6.75087e-15;-46;1671;16038;13726;1;435;-2.14748e+09;-2.08009e+07;-1;0;0;0;-1;0;234817541;234944079;1550414
856;6.75087e-15;-46;1671;16038;13726;1;435;-2.14748e+09;-2.06839e+07;-1;0;0;0;-1;0;235464775;235593447;1571921
857;6.75087e-15;-46;1671;16038;13726;1;435;-2.14748e+09;-2.05679e+07;-1;0;0;0;-1;0;236109600;236240431;1593595
858;6.75087e-15;-46;1671;16038;13726;1;435;-2.14748e+09;-2.04531e+07;-1;0;0;0;-1;0;236752030;236885044;1615433
859;6.75087e-15;-47;1671;16038;13726;1;435;-2.14748e+09;-2.03394e+07;0;0;0;0;0;0;237392075;237527299;1637437
860;6.75087e-15;-47;1671;16038;13726;1;435;-2.14748e+09;-2.02268e+07;-1;0;0;0;-1;0;238029749;238167206;1659607
861;6.75087e-15;-48;1671;16038;13726;1;435;-2.14748e+09;-2.0115e+07;0;0;0;0;0;0;238665062;238804778;1681941
862;6.75087e-15;-49;1671;16038;13726;1;435;-2.14748e+09;-2.00044e+07;0;0;0;0;0;0;239298027;239440027;1704440
863;6.75087e-15;-50;1671;16038;13726;1;435;-2.14748e+09;-1.98948e+07;0;0;0;0;0;0;239928655;240072965;1727103
864;6.75087e-15;-51;1671;16038;13726;1;435;-2.14748e+09;-1.97863e+07;0;0;0;0;0;0;240556958;240703603;1749930
865;6.75087e-15;-51;1671;16038;13726;1;435;-2.14748e+09;-1.96786e+07;-1;0;0;0;-1;0;241182947;241331953;1772922
866;6.75087e-15;-51;1671;16038;13726;1;435;-2.14748e+09;-1.95719e+07;-1;0;0;0;-1;0;241806634;241958027;1796077
867;6.75087e-15;-51;1671;16038;13726;1;435;-2.14748e+09;-1.94663e+07;-1;0;0;0;-1;0;242428031;242581837;1819396
868;6.75087e-15;-51;1671;16038;13726;1;435;-2.14748e+09;-1.93615e+07;-1;0;0;0;-1;0;243047148;243203394;1842878
869;6.75087e-15;-52;1671;16038;13726;1;435;-2.14748e+09;-1.92578e+07;0;0;0;0;0;0;243663998;243822709;1866523
870;6.75087e-15;-53;1671;16038;13726;1;435;-2.14748e+09;-1.91549e+07;0;0;0;0;0;0;244278591;244439794;1890330
871;6.75087e-15;-53;1671;16038;13726;1;435;-2.14748e+09;-1.9053e+07;-1;0;0;0;-1;0;244890940;245054660;1914300
872;6.75087e-15;-54;1671;16038;13726;1;435;-2.14748e+09;-1.89519e+07;0;0;0;0;0;0;245501054;245667319;1938432
873;6.75087e-15;-55;1671;16038;13726;1;435;-2.14748e+09;-1.88518e+07;0;0;0;0;0;0;246108946;246277782;1962725
874;6.75087e-15;-55;1671;16038;13726;1;435;-2.14748e+09;-1.87526e+07;0;0;-1;0;0;-1;246714626;246886061;1987180
875;6.75087e-15;-55;1671;16038;13726;1;435;-2.14748e+09;-1.86542e+07;-1;0;0;0;-1;0;247318106;247492166;2011796
876;6.75087e-15;-55;1671;16038;13726;1;435;-2.14748e+09;-1.85566e+07;-1;0;0;0;-1;0;247919396;248096108;2036573
877;6.75087e-15;-55;1671;16038;13726;1;435;-2.14748e+09;-1.846e+07;-1;0;0;0;-1;0;248518508;248697899;2061510
878;6.75087e-15;-56;1671;16038;13726;1;435;-2.14748e+09;-1.83641e+07;0;0;0;0;0;0;249115452;249297549;2086608
879;6.75087e-15;-57;1671;16038;13726;1;435;-2.14748e+09;-1.82692e+07;0;0;0;0;0;0;249710239;249895070;2111865
880;6.75087e-15;-58;1671;16038;13726;1;435;-2.14748e+09;-1.8175e+07;0;0;0;0;0;0;250302880;250490473;2137281
881;6.75087e-15;-59;1671;16038;13726;1;435;-2.14748e+09;-1.80816e+07;0;0;0;0;0;0;250893386;251083768;2162856
882;6.75087e-15;-60;1671;16038;13726;1;435;-2.14748e+09;-1.7989e+07;0;0;0;0;0;0;251481767;251674966;2188590
883;6.75087e-15;-60;1671;16038;13726;1;435;-2.14748e+09;-1.78972e+07;-1;0;0;0;-1;0;252068034;252264077;2214482
884;6.75087e-15;-61;1671;16038;13726;1;435;-2.14748e+09;-1.78062e+07;0;0;0;0;0;0;252652197;252851113;2240532
885;6.75087e-15;-61;1671;16038;13726;1;435;-2.14748e+09;-1.7716e+07;-1;0;0;0;-1;0;253234268;253436085;2266739
886;6.75087e-15;-61;1671;16038;13726;1;435;-2.14748e+09;-1.76265e+07;-1;0;0;0;-1;0;253814256;254019002;2293103
887;6.75087e-15;-62;1671;16038;13726;1;435;-2.14748e+09;-1.75378e+07;0;0;0;0;0;0;254392172;254599875;2319624
888;6.75087e-15;-62;1671;16038;13726;1;435;-2.14748e+09;-1.74498e+07;-1;0;0;0;-1;0;254968026;255178714;2346301
889;6.75087e-15;-62;1671;16038;13726;1;435;-2.14748e+09;-1.73625e+07;-1;0;0;0;-1;0;255541829;255755531;2373134
890;6.75087e-15;-62;1671;16038;13726;1;435;-2.14748e+09;-1.72761e+07;-1;0;0;0;-1;0;256113590;256330335;2400122
891;6.75087e-15;-63;1671;16038;13726;1;435;-2.14748e+09;-1.71902e+07;0;0;0;0;0;0;256683320;256903136;2427265
892;6.75087e-15;-63;1671;16038;13726;1;435;-2.14748e+09;-1.71052e+07;-1;0;0;0;-1;0;257251030;257473946;2454562
893;6.75087e-15;-64;1671;16038;13726;1;435;-2.14748e+09;-1.70207e+07;0;0;0;0;0;0;257816728;258042773;2482013
894;6.75087e-15;-65;1671;16038;13726;1;435;-2.14748e+09;-1.6937e+07;0;0;0;0;0;0;258380425;258609628;2509618
895;6.75087e-15;-66;1671;16038;13726;1;435;-2.14748e+09;-1.6854e+07;0;0;0;0;0;0;258942132;259174521;2537376
896;6.75087e-15;-66;1671;16038;13726;1;435;-2.14748e+09;-1.67716e+07;-1;0;0;0;-1;0;259501857;259737463;2565286
897;6.75087e-15;-67;1671;16038;13726;1;435;-2.14748e+09;-1.66899e+07;0;0;0;0;0;0;260059611;260298462;2593349
898;6.75087e-15;-68;1671;16038;13726;1;435;-2.14748e+09;-1.66089e+07;0;0;0;0;0;0;260615404;260857530;2621563
899;6.75087e-15;-69;1671;16038;13726;1;435;-2.14748e+09;-1.65286e+07;0;0;0;0;0;0;261169244;261414675;2649928
900;6.75087e-15;-70;1671;16038;13726;1;435;-2.14748e+09;-1.64488e+07;0;0;0;0;0;0;261721143;261969907;2678444
901;6.75087e-15;-70;1671;16038;13726;1;435;-2.14748e+09;-1.63697e+07;-1;0;0;0;-1;0;262271109;262523237;2707110
902;6.75087e-15;-71;1671;16038;13726;1;435;-2.14748e+09;-1.62913e+07;0;0;0;0;0;0;262819153;263074673;2735926
903;6.75087e-15;-72;1671;16038;13726;1;435;-2.14748e+09;-1.62134e+07;0;0;0;0;0;0;263365283;263624226;2764891
904;6.75087e-15;-72;1671;16038;13726;1;435;-2.14748e+09;-1.61362e+07;-1;0;0;0;-1;0;263909509;264171905;2794005
905;6.75087e-15;-73;1671;16038;13726;1;435;-2.14748e+09;-1.60596e+07;0;0;0;0;0;0;264451840;264717720;2823266
906;6.75087e-15;-73;1671;16038;13726;1;435;-2.14748e+09;-1.59836e+07;-1;0;0;0;-1;0;264992286;265261679;2852676
907;6.75087e-15;-74;1671;16038;13726;1;435;-2.14748e+09;-1.59082e+07;0;0;0;0;0;0;265530857;265803793;2882232
908;6.75087e-15;-74;1671;16038;13726;1;435;-2.14748e+09;-1.58334e+07;-1;0;0;0;-1;0;266067560;266344070;2911936
909;6.75087e-15;-74;1671;16038;13726;1;435;-2.14748e+09;-1.57593e+07;-1;0;0;0;-1;0;266602406;266882520;2941785
910;6.75087e-15;-75;1671;16038;13726;1;435;-2.14748e+09;-1.56855e+07;0;0;0;0;0;0;267135404;267419152;2971779
911;6.75087e-15;-75;1671;16038;13726;1;435;-2.14748e+09;-1.56124e+07;-1;0;0;0;-1;0;267666563;267953975;3001919
912;6.75087e-15;-76;1671;16038;13726;1;435;-2.14748e+09;-1.55399e+07;0;0;0;0;0;0;268195891;268486999;3032203
913;6.75087e-15;-77;1671;16038;13726;1;435;-2.14748e+09;-1.54679e+07;0;0;0;0;0;0;268723398;269018232;3062631
914;6.75087e-15;-77;1671;16038;13726;1;435;-2.14748e+09;-1.53965e+07;-1;0;0;0;-1;0;269249092;269547683;3093202
915;6.75087e-15;-78;1671;16038;13726;1;435;-2.14748e+09;-1.53256e+07;0;0;0;0;0;0;269772983;270075362;3123916
916;6.75087e-15;-79;1671;16038;13726;1;435;-2.14748e+09;-1.52553e+07;0;0;0;0;0;0;270295079;270601277;3154773
917;6.75087e-15;-80;1671;16038;13726;1;435;-2.14748e+09;-1.51855e+07;0;0;0;0;0;0;270815390;271125437;3185771
918;6.75087e-15;-80;1671;16038;13726;1;435;-2.14748e+09;-1.51163e+07;-1;0;0;0;-1;0;271333923;271647851;3216910
919;6.75087e-15;-81;1671;16038;13726;1;435;-2.14748e+09;-1.50475e+07;0;0;0;0;0;0;271850687;272168527;3248189
920;6.75087e-15;-82;1671;16038;13726;1;435;-2.14748e+09;-1.49792e+07;0;0;0;0;0;0;272365692;272687474;3279608
921;6.75087e-15;-82;1671;16038;13726;1;435;-2.14748e+09;-1.49115e+07;-1;0;0;0;-1;0;272878945;273204702;3311167
922;6.75087e-15;-83;1671;16038;13726;1;435;-2.14748e+09;-1.48443e+07;0;0;0;0;0;0;273390455;273720218;3342865
923;6.75087e-15;-84;1671;16038;13726;1;435;-2.14748e+09;-1.47776e+07;0;0;0;0;0;0;273900230;274234031;3374701
924;6.75087e-15;-84;1671;16038;13726;1;435;-2.14748e+09;-1.47113e+07;-1;0;0;0;-1;0;274408280;274746149;3406674
925;6.75087e-15;-84;1671;16038;13726;1;435;-2.14748e+09;-1.46457e+07;-1;0;0;0;-1;0;274914612;275256581;3438784
926;6.75087e-15;-84;1671;16038;13726;1;435;-2.14748e+09;-1.45803e+07;-1;0;0;0;-1;0;275419234;275765336;3471031
927;6.75087e-15;-85;1671;16038;13726;1;435;-2.14748e+09;-1.45156e+07;0;0;0;0;0;0;275922155;276272421;3503414
928;6.75087e-15;-86;1671;16038;13726;1;435;-2.14748e+09;-1.44514e+07;0;0;0;0;0;0;276423384;276777845;3535932
929;6.75087e-15;-86;1671;16038;13726;1;435;-2.14748e+09;-1.43874e+07;-1;0;0;0;-1;0;276922927;277281615;3568584
930;6.75087e-15;-87;1671;16038;13726;1;435;-2.14748e+09;-1.43241e+07;0;0;0;0;0;0;277420794;277783741;3601371
931;6.75087e-15;-88;1671;16038;13726;1;435;-2.14748e+09;-1.42612e+07;0;0;0;0;0;0;277916992;278284231;3634291
932;6.75087e-15;-88;1671;16038;13726;1;435;-2.14748e+09;-1.41987e+07;-1;0;0;0;-1;0;278411530;278783091;3667344
933;6.75087e-15;-88;1671;16038;13726;1;435;-2.14748e+09;-1.41367e+07;-1;0;0;0;-1;0;278904415;279280332;3700529
934;6.75087e-15;-88;1671;16038;13726;1;435;-2.14748e+09;-1.40752e+07;-1;0;0;0;-1;0;279395655;279775959;3733845
935;6.75087e-15;-88;1671;16038;13726;1;435;-2.14748e+09;-1.4014e+07;-1;0;0;0;-1;0;279885258;280269982;3767293
936;6.75087e-15;-89;1671;16038;13726;1;435;-2.14748e+09;-1.39534e+07;0;0;0;0;0;0;280373232;280762408;3800871
937;6.75087e-15;-89;1671;16038;13726;1;435;-2.14748e+09;-1.38932e+07;-1;0;0;0;-1;0;280859584;281253245;3834578
938;6.75087e-15;-89;1671;16038;13726;1;435;-2.14748e+09;-1.38333e+07;-1;0;0;0;-1;0;281344324;281742501;3868415
939;6.75087e-15;-89;1671;16038;13726;1;435;-2.14748e+09;-1.37739e+07;-1;0;0;0;-1;0;281827457;282230183;3902380
940;6.75087e-15;-90;1671;16038;13726;1;435;-2.14748e+09;-1.3715e+07;0;0;0;0;0;0;282308992;282716300;3936473
941;6.75087e-15;-90;1671;16038;13726;1;435;-2.14748e+09;-1.36564e+07;-1;0;0;0;-1;0;282788936;283200858;3970693
942;6.75087e-15;-90;1671;16038;13726;1;435;-2.14748e+09;-1.35982e+07;-1;0;0;0;-1;0;283267297;283683866;4005040
943;6.75087e-15;-91;1671;16038;13726;1;435;-2.14748e+09;-1.35405e+07;0;0;0;0;0;0;283744082;284165331;4039513
944;6.75087e-15;-92;1671;16038;13726;1;435;-2.14748e+09;-1.34831e+07;0;0;0;0;0;0;284219299;284645260;4074111
945;6.75087e-15;-92;1671;16038;13726;1;435;-2.14748e+09;-1.34263e+07;-1;0;0;0;-1;0;284692955;285123661;4108834
946;6.75087e-15;-92;1671;16038;13726;1;435;-2.14748e+09;-1.33696e+07;-1;0;0;0;-1;0;285165058;285600541;4143681
947;6.75087e-15;-92;1671;16038;13726;1;435;-2.14748e+09;-1.33134e+07;-1;0;0;0;-1;0;285635615;286075908;4178652
948;6.75087e-15;-93;1671;16038;13726;1;435;-2.14748e+09;-1.32577e+07;0;0;0;0;0;0;286104632;286549770;4213745
949;6.75087e-15;-93;1671;16038;13726;1;435;-2.14748e+09;-1.32023e+07;-1;0;0;0;-1;0;286572118;287022132;4248960
950;6.75087e-15;-94;1671;16038;13726;1;435;-2.14748e+09;-1.31473e+07;0;0;0;0;0;0;287038080;287493003;4284297
951;6.75087e-15;-95;1671;16038;13726;1;435;-2.14748e+09;-1.30927e+07;0;0;0;0;0;0;287502524;287962389;4319755
952;6.75087e-15;-96;1671;16038;13726;1;435;-2.14748e+09;-1.30385e+07;0;0;0;0;0;0;287965458;288430298;4355333
953;6.75087e-15;-97;1671;16038;13726;1;435;-2.14748e+09;-1.29846e+07;0;0;0;0;0;0;288426888;288896737;4391030
954;6.75087e-15;-98;1671;16038;13726;1;435;-2.14748e+09;-1.29309e+07;0;0;0;0;0;0;288886823;289361713;4426846
955;6.75087e-15;-99;1671;16038;13726;1;435;-2.14748e+09;-1.28777e+07;0;0;0;0;0;0;289345268;289825233;4462781
956;6.75087e-15;-99;1671;16038;13726;1;435;-2.14748e+09;-1.28249e+07;-1;0;0;0;-1;0;289802231;290287304;4498833
957;6.75087e-15;-100;1671;16038;13726;1;435;-2.14748e+09;-1.27725e+07;0;0;0;0;0;0;290257718;290747933;4535003
958;6.75087e-15;-101;1671;16038;13726;1;435;-2.14748e+09;-1.27203e+07;0;0;0;0;0;0;290711737;291207126;4571288
959;6.75087e-15;-102;1671;16038;13726;1;435;-2.14748e+09;-1.26687e+07;0;0;0;0;0;0;291164294;291664891;4607689
960;6.75087e-15;-102;1671;16038;13726;1;435;-2.14748e+09;-1.26172e+07;-1;0;0;0;-1;0;291615395;292121234;4644206
961;6.75087e-15;-102;1671;16038;13726;1;435;-2.14748e+09;-1.25661e+07;-1;0;0;0;-1;0;292065049;292576162;4680836
962;6.75087e-15;-102;1671;16038;13726;1;435;-2.14748e+09;-1.25153e+07;-1;0;0;0;-1;0;292513260;293029682;4717581
963;6.75087e-15;-102;1671;16038;13726;1;435;-2.14748e+09;-1.24649e+07;-1;0;0;0;-1;0;292960037;293481800;4754438
964;6.75087e-15;-103;1671;16038;13726;1;435;-2.14748e+09;-1.24148e+07;0;0;0;0;0;0;293405385;293932523;4791408
965;6.75087e-15;-103;1671;16038;13726;1;435;-2.14748e+09;-1.23652e+07;-1;0;0;0;-1;0;293849312;294381858;4828489
966;6.75087e-15;-104;1671;16038;13726;1;435;-2.14748e+09;-1.23158e+07;0;0;0;0;0;0;294291823;294829811;4865682
967;6.75087e-15;-104;1671;16038;13726;1;435;-2.14748e+09;-1.22665e+07;-1;0;0;0;-1;0;294732925;295276388;4902985
968;6.75087e-15;-104;1671;16038;13726;1;435;-2.14748e+09;-1.22179e+07;-1;0;0;0;-1;0;295172624;295721597;4940398
969;6.75087e-15;-104;1671;16038;13726;1;435;-2.14748e+09;-1.21694e+07;-1;0;0;0;-1;0;295610927;296165443;4977920
970;6.75087e-15;-104;1671;16038;13726;1;435;-2.14748e+09;-1.21211e+07;-1;0;0;0;-1;0;296047841;296607933;5015550
971;6.75087e-15;-104;1671;16038;13726;1;435;-2.14748e+09;-1.20733e+07;-1;0;0;0;-1;0;296483371;297049074;5053288
972;6.75087e-15;-104;1671;16038;13726;1;435;-2.14748e+09;-1.20257e+07;-1;0;0;0;-1;0;296917524;297488871;5091134
973;6.75087e-15;-105;1671;16038;13726;1;435;-2.14748e+09;-1.19785e+07;0;0;0;0;0;0;297350307;297927331;5129086
974;6.75087e-15;-105;1671;16038;13726;1;435;-2.14748e+09;-1.19316e+07;-1;0;0;0;-1;0;297781724;298364459;5167143
975;6.75087e-15;-106;1671;16038;13726;1;435;-2.14748e+09;-1.18849e+07;0;0;0;0;0;0;298211783;298800263;5205306
976;6.75087e-15;-107;1671;16038;13726;1;435;-2.14748e+09;-1.18386e+07;0;0;0;0;0;0;298640490;299234749;5243574
977;6.75087e-15;-107;1671;16038;13726;1;435;-2.14748e+09;-1.17926e+07;-1;0;0;0;-1;0;299067850;299667922;5281945
978;6.75087e-15;-107;1671;16038;13726;1;435;-2.14748e+09;-1.17468e+07;-1;0;0;0;-1;0;299493870;300099788;5320419
979;6.75087e-15;-107;1671;16038;13726;1;435;-2.14748e+09;-1.17013e+07;-1;0;0;0;-1;0;299918556;300530354;5358996
980;6.75087e-15;-107;1671;16038;13726;1;435;-2.14748e+09;-1.16562e+07;-1;0;0;0;-1;0;300341913;300959626;5397675
981;6.75087e-15;-108;1671;16038;13726;1;435;-2.14748e+09;-1.16113e+07;0;0;0;0;0;0;300763949;301387609;5436455
982;6.75087e-15;-109;1671;16038;13726;1;435;-2.14748e+09;-1.15667e+07;0;0;0;0;0;0;301184668;301814310;5475336
983;6.75087e-15;-109;1671;16038;13726;1;435;-2.14748e+09;-1.15224e+07;-1;0;0;0;-1;0;301604076;302239734;5514317
984;6.75087e-15;-109;1671;16038;13726;1;435;-2.14748e+09;-1.14782e+07;-1;0;0;0;-1;0;302022180;302663887;5553396
985;6.75087e-15;-110;1671;16038;13726;1;435;-2.14748e+09;-1.14344e+07;0;0;0;0;0;0;302438984;303086775;5592575
986;6.75087e-15;-110;1671;16038;13726;1;435;-2.14748e+09;-1.13909e+07;-1;0;0;0;-1;0;302854496;303508405;5631851
987;6.75087e-15;-110;1671;16038;13726;1;435;-2.14748e+09;-1.13476e+07;-1;0;0;0;-1;0;303268721;303928780;5671225
988;6.75087e-15;-110;1671;16038;13726;1;435;-2.14748e+09;-1.13046e+07;-1;0;0;0;-1;0;303681663;304347908;5710695
989;6.75087e-15;-110;1671;16038;13726;1;435;-2.14748e+09;-1.12619e+07;-1;0;0;0;-1;0;304093330;304765794;5750262
990;6.75087e-15;-110;1671;16038;13726;1;435;-2.14748e+09;-1.12195e+07;-1;0;0;0;-1;0;304503727;305182444;5789923
991;6.75087e-15;-110;1671;16038;13726;1;435;-2.14748e+09;-1.11772e+07;-1;0;0;0;-1;0;304912858;305597862;5829680
992;6.75087e-15;-110;1671;16038;13726;1;435;-2.14748e+09;-1.11352e+07;-1;0;0;0;-1;0;305320731;306012056;5869530
993;6.75087e-15;-111;1671;16038;13726;1;435;-2.14748e+09;-1.10935e+07;0;0;0;0;0;0;305727349;306425029;5909474
994;6.75087e-15;-112;1671;16038;13726;1;435;-2.14748e+09;-1.10521e+07;0;0;0;0;0;0;306132720;306836789;5949510
995;6.75087e-15;-113;1671;16038;13726;1;435;-2.14748e+09;-1.10109e+07;0;0;0;0;0;0;306536848;307247340;5989639
996;6.75087e-15;-114;1671;16038;13726;1;435;-2.14748e+09;-1.097e+07;0;0;0;0;0;0;306939739;307656687;6029859
997;6.75087e-15;-114;1671;16038;13726;1;435;-2.14748e+09;-1.09292e+07;-1;0;0;0;-1;0;307341398;308064837;6070169
998;6.75087e-15;-115;1671;16038;13726;1;435;-2.14748e+09;-1.08888e+07;0;0;0;0;0;0;307741830;308471794;6110570
999;6.75087e-15;-116;1671;16038;13726;1;435;-2.14748e+09;-1.08486e+07;0;0;0;0;0;0;308141042;308877564;6151060
1000;6.75087e-15;-116;1671;16038;13726;1;435;-2.14748e+09;-1.08086e+07;-1;0;0;0;-1;0;308539037;309282152;6191639
1001;6.75087e-15;-116;1671;16038;13726;1;435;-2.14748e+09;-1.07688e+07;-1;0;0;0;-1;0;308935822;309685563;6232307
1002;6.75087e-15;-117;1671;16038;13726;1;435;-2.14748e+09;-1.07293e+07;0;0;0;0;0;0;309331402;310087803;6273061
1003;6.75087e-15;-118;1671;16038;13726;1;435;-2.14748e+09;-1.06901e+07;0;0;0;0;0;0;309725781;310488877;6313903
1004;6.75087e-15;-119;1671;16038;13726;1;435;-2.14748e+09;-1.0651e+07;0;0;0;0;0;0;310118966;310888790;6354831
1005;6.75087e-15;-119;1671;16038;13726;1;435;-2.14748e+09;-1.06122e+07;-1;0;0;0;-1;0;310510961;311287548;6395845
1006;6.75087e-15;-119;1671;16038;13726;1;435;-2.14748e+09;-1.05736e+07;-1;0;0;0;-1;0;310901771;311685154;6436943
1007;6.75087e-15;-120;1671;16038;13726;1;435;-2.14748e+09;-1.05352e+07;0;0;0;0;0;0;311291402;312081615;6478126
1008;6.75087e-15;-121;1671;16038;13726;1;435;-2.14748e+09;-1.04971e+07;0;0;0;0;0;0;311679858;312476935;6519392
1009;6.75087e-15;-122;1671;16038;13726;1;435;-2.14748e+09;-1.04593e+07;0;0;0;0;0;0;312067145;312871120;6560742
1010;6.75087e-15;-123;1671;16038;13726;1;435;-2.14748e+09;-1.04215e+07;0;0;0;0;0;0;312453268;313264174;6602174
1011;6.75087e-15;-124;1671;16038;13726;1;435;-2.14748e+09;-1.0384e+07;0;0;0;0;0;0;312838231;313656102;6643688
1012;6.75087e-15;-125;1671;16038;13726;1;435;-2.14748e+09;-1.03467e+07;0;0;0;0;0;0;313222039;314046910;6685282
1013;6.75087e-15;-126;1671;16038;13726;1;435;-2.14748e+09;-1.03096e+07;0;0;0;0;0;0;313604698;314436602;6726958
1014;6.75087e-15;-126;1671;16038;13726;1;435;-2.14748e+09;-1.02728e+07;-1;0;0;0;-1;0;313986212;314825184;6768713
1015;6.75087e-15;-126;1671;16038;13726;1;435;-2.14748e+09;-1.02362e+07;-1;0;0;0;-1;0;314366586;315212659;6810547
1016;6.75087e-15;-126;1671;16038;13726;1;435;-2.14748e+09;-1.01998e+07;-1;0;0;0;-1;0;314745826;315599033;6852460
1017;6.75087e-15;-127;1671;16038;13726;1;435;-2.14748e+09;-1.01635e+07;0;0;0;0;0;0;315123935;315984310;6894451
1018;6.75087e-15;-127;1671;16038;13726;1;435;-2.14748e+09;-1.01275e+07;-1;0;0;0;-1;0;315500919;316368496;6936520
1019;6.75087e-15;-127;1671;16038;13726;1;435;-2.14748e+09;-1.00917e+07;-1;0;0;0;-1;0;315876782;316751595;6978665
1020;6.75087e-15;-128;1671;16038;13726;1;435;-2.14748e+09;-1.00561e+07;0;0;0;0;0;0;316251529;317133611;7020886
1021;6.75087e-15;-129;1671;16038;13726;1;435;-2.14748e+09;-1.00207e+07;0;0;0;0;0;0;316625164;317514550;7063183
1022;6.75087e-15;-130;1671;16038;13726;1;435;-2.14748e+09;-9.98552e+06;0;0;0;0;0;0;316997693;317894416;7105554
1023;6.75087e-15;-131;1671;16038;13726;1;435;-2.14748e+09;-9.95051e+06;0;0;0;0;0;0;317369120;318273214;7148000
1024;6.75087e-15;-132;1671;16038;13726;1;435;-2.14748e+09;-9.9157e+06;0;0;0;0;0;0;317739450;318650948;7190519
1025;6.75087e-15;-133;1671;16038;13726;1;435;-2.14748e+09;-9.88108e+06;0;0;0;0;0;0;318108687;319027623;7233112
1026;6.75087e-15;-133;1671;16038;13726;1;435;-2.14748e+09;-9.84666e+06;-1;0;0;0;-1;0;318476836;319403243;7275777
1027;6.75087e-15;-134;1671;16038;13726;1;435;-2.14748e+09;-9.81242e+06;0;0;0;0;0;0;318843901;319777813;7318513
1028;6.75087e-15;-134;1671;16038;13726;1;435;-2.14748e+09;-9.77838e+06;-1;0;0;0;-1;0;319209887;320151337;7361321
1029;6.75087e-15;-135;1671;16038;13726;1;435;-2.14748e+09;-9.74452e+06;0;0;0;0;0;0;319574798;320523820;7404199
1030;6.75087e-15;-136;1671;16038;13726;1;435;-2.14748e+09;-9.71095e+06;0;0;0;0;0;0;319938639;320895267;7447147
1031;6.75087e-15;-136;1671;16038;13726;1;435;-2.14748e+09;-9.67736e+06;-1;0;0;0;-1;0;320301414;321265681;7490164
1032;6.75087e-15;-137;1671;16038;13726;1;435;-2.14748e+09;-9.64416e+06;0;0;0;0;0;0;320663127;321635067;7533251
1033;6.75087e-15;-137;1671;16038;13726;1;435;-2.14748e+09;-9.61104e+06;-1;0;0;0;-1;0;321023784;322003429;7576405
1034;6.75087e-15;-137;1671;16038;13726;1;435;-2.14748e+09;-9.578e+06;-1;0;0;0;-1;0;321383388;322370772;7619627
1035;6.75087e-15;-137;1671;16038;13726;1;435;-2.14748e+09;-9.54524e+06;-1;0;0;0;-1;0;321741944;322737100;7662915
1036;6.75087e-15;-137;1671;16038;13726;1;435;-2.14748e+09;-9.51266e+06;-1;0;0;0;-1;0;322099455;323102417;7706270
1037;6.75087e-15;-137;1671;16038;13726;1;435;-2.14748e+09;-9.48025e+06;-1;0;0;0;-1;0;322455927;323466728;7749691
1038;6.75087e-15;-137;1671;16038;13726;1;435;-2.14748e+09;-9.44802e+06;-1;0;0;0;-1;0;322811363;323830036;7793176
1039;6.75087e-15;-137;1671;16038;13726;1;435;-2.14748e+09;-9.41596e+06;-1;0;0;0;-1;0;323165768;324192347;7836727
1040;6.75087e-15;-138;1671;16038;13726;1;435;-2.14748e+09;-9.38407e+06;0;0;0;0;0;0;323519146;324553663;7880341
1041;6.75087e-15;-139;1671;16038;13726;1;435;-2.14748e+09;-9.35236e+06;0;0;0;0;0;0;323871501;324913990;7924018
1042;6.75087e-15;-139;1671;16038;13726;1;435;-2.14748e+09;-9.32081e+06;-1;0;0;0;-1;0;324222837;325273331;7967758
1043;6.75087e-15;-140;1671;16038;13726;1;435;-2.14748e+09;-9.28943e+06;0;0;0;0;0;0;324573159;325631690;8011560
1044;6.75087e-15;-141;1671;16038;13726;1;435;-2.14748e+09;-9.25822e+06;0;0;0;0;0;0;324922470;325989072;8055424
1045;6.75087e-15;-141;1671;16038;13726;1;435;-2.14748e+09;-9.22718e+06;-1;0;0;0;-1;0;325270774;326345481;8099349
1046;6.75087e-15;-141;1671;16038;13726;1;435;-2.14748e+09;-9.1963e+06;-1;0;0;0;-1;0;325618077;326700920;8143334
1047;6.75087e-15;-142;1671;16038;13726;1;435;-2.14748e+09;-9.16558e+06;0;0;0;0;0;0;325964381;327055394;8187379
1048;6.75087e-15;-142;1671;16038;13726;1;435;-2.14748e+09;-9.13502e+06;-1;0;0;0;-1;0;326309691;327408906;8231483
1049;6.75087e-15;-142;1671;16038;13726;1;435;-2.14748e+09;-9.10463e+06;-1;0;0;0;-1;0;326654010;327761461;8275646
1050;6.75087e-15;-142;1671;16038;13726;1;435;-2.14748e+09;-9.07439e+06;-1;0;0;0;-1;0;326997343;328113063;8319866
1051;6.75087e-15;-143;1671;16038;13726;1;435;-2.14748e+09;-9.04431e+06;0;0;0;0;0;0;327339694;328463715;8364145
1052;6.75087e-15;-143;1671;16038;13726;1;435;-2.14748e+09;-9.01439e+06;-1;0;0;0;-1;0;327681067;328813421;8408480
1053;6.75087e-15;-143;1671;16038;13726;1;435;-2.14748e+09;-8.98462e+06;-1;0;0;0;-1;0;328021465;329162185;8452871
1054;6.75087e-15;-144;1671;16038;13726;1;435;-2.14748e+09;-8.95501e+06;0;0;0;0;0;0;328360892;329510012;8497318
1055;6.75087e-15;-145;1671;16038;13726;1;435;-2.14748e+09;-8.92556e+06;0;0;0;0;0;0;328699352;329856904;8541821
1056;6.75087e-15;-145;1671;16038;13726;1;435;-2.14748e+09;-8.89625e+06;-1;0;0;0;-1;0;329036850;330202866;8586378
1057;6.75087e-15;-146;1671;16038;13726;1;435;-2.14748e+09;-8.8671e+06;0;0;0;0;0;0;329373389;330547901;8630989
1058;6.75087e-15;-147;1671;16038;13726;1;435;-2.14748e+09;-8.83809e+06;0;0;0;0;0;0;329708972;330892014;8675653
1059;6.75087e-15;-148;1671;16038;13726;1;435;-2.14748e+09;-8.80934e+06;0;0;0;0;0;0;330043604;331235207;8720370
1060;6.75087e-15;-149;1671;16038;13726;1;435;-2.14748e+09;-8.78053e+06;0;0;0;0;0;0;330377288;331577485;8765140
1061;6.75087e-15;-149;1671;16038;13726;1;435;-2.14748e+09;-8.75197e+06;-1;0;0;0;-1;0;330710029;331918851;8809962
1062;6.75087e-15;-150;1671;16038;13726;1;435;-2.14748e+09;-8.72355e+06;0;0;0;0;0;0;331041828;332259309;8854835
1063;6.75087e-15;-150;1671;16038;13726;1;435;-2.14748e+09;-8.69538e+06;-1;0;0;0;-1;0;331372692;332598863;8899758
1064;6.75087e-15;-150;1671;16038;13726;1;435;-2.14748e+09;-8.66715e+06;-1;0;0;0;-1;0;331702622;332937516;8944732
1065;6.75087e-15;-151;1671;16038;13726;1;435;-2.14748e+09;-8.63917e+06;0;0;0;0;0;0;332031624;333275272;8989755
1066;6.75087e-15;-151;1671;16038;13726;1;435;-2.14748e+09;-8.61142e+06;-1;0;0;0;-1;0;332359699;333612135;9034827
1067;6.75087e-15;-152;1671;16038;13726;1;435;-2.14748e+09;-8.58362e+06;0;0;0;0;0;0;332686853;333948107;9079948
1068;6.75087e-15;-152;1671;16038;13726;1;435;-2.14748e+09;-8.55606e+06;-1;0;0;0;-1;0;333013088;334283193;9125117
1069;6.75087e-15;-153;1671;16038;13726;1;435;-2.14748e+09;-8.52863e+06;0;0;0;0;0;0;333338409;334617397;9170333
1070;6.75087e-15;-153;1671;16038;13726;1;435;-2.14748e+09;-8.50144e+06;-1;0;0;0;-1;0;333662818;334950720;9215596
1071;6.75087e-15;-153;1671;16038;13726;1;435;-2.14748e+09;-8.47419e+06;-1;0;0;0;-1;0;333986320;335283168;9260905
1072;6.75087e-15;-153;1671;16038;13726;1;435;-2.14748e+09;-8.44717e+06;-1;0;0;0;-1;0;334308917;335614744;9306260
1073;6.75087e-15;-154;1671;16038;13726;1;435;-2.14748e+09;-8.42028e+06;0;0;0;0;0;0;334630614;335945450;9351661
1074;6.75087e-15;-154;1671;16038;13726;1;435;-2.14748e+09;-8.39354e+06;-1;0;0;0;-1;0;334951413;336275291;9397106
1075;6.75087e-15;-154;1671;16038;13726;1;435;-2.14748e+09;-8.36702e+06;-1;0;0;0;-1;0;335271319;336604270;9442595
1076;6.75087e-15;-155;1671;16038;13726;1;435;-2.14748e+09;-8.34043e+06;0;0;0;0;0;0;335590335;336932390;9488128
1077;6.75087e-15;-155;1671;16038;13726;1;435;-2.14748e+09;-8.31407e+06;-1;0;0;0;-1;0;335908463;337259654;9533704
1078;6.75087e-15;-155;1671;16038;13726;1;435;-2.14748e+09;-8.28785e+06;-1;0;0;0;-1;0;336225709;337586067;9579323
1079;6.75087e-15;-156;1671;16038;13726;1;435;-2.14748e+09;-8.26175e+06;0;0;0;0;0;0;336542074;337911631;9624983
1080;6.75087e-15;-156;1671;16038;13726;1;435;-2.14748e+09;-8.23578e+06;-1;0;0;0;-1;0;336857563;338236349;9670686
1081;6.75087e-15;-156;1671;16038;13726;1;435;-2.14748e+09;-8.20994e+06;-1;0;0;0;-1;0;337172178;338560226;9716429
1082;6.75087e-15;-157;1671;16038;13726;1;435;-2.14748e+09;-8.18422e+06;0;0;0;0;0;0;337485923;338883263;9762213
1083;6.75087e-15;-157;1671;16038;13726;1;435;-2.14748e+09;-8.15862e+06;-1;0;0;0;-1;0;337798802;339205465;9808037
1084;6.75087e-15;-157;1671;16038;13726;1;435;-2.14748e+09;-8.13316e+06;-1;0;0;0;-1;0;338110817;339526835;9853900
1085;6.75087e-15;-158;1671;16038;13726;1;435;-2.14748e+09;-8.10781e+06;0;0;0;0;0;0;338421972;339847375;9899802
1086;6.75087e-15;-158;1671;16038;13726;1;435;-2.14748e+09;-8.08258e+06;-1;0;0;0;-1;0;338732271;340167090;9945743
1087;6.75087e-15;-159;1671;16038;13726;1;435;-2.14748e+09;-8.05758e+06;0;0;0;0;0;0;339041716;340485982;9991722
1088;6.75087e-15;-160;1671;16038;13726;1;435;-2.14748e+09;-8.0325e+06;0;0;0;0;0;0;339350310;340804054;10037738
1089;6.75087e-15;-160;1671;16038;13726;1;435;-2.14748e+09;-8.00764e+06;-1;0;0;0;-1;0;339658057;341121310;10083791
1090;6.75087e-15;-161;1671;16038;13726;1;435;-2.14748e+09;-7.9829e+06;0;0;0;0;0;0;339964961;341437753;10129881
1091;6.75087e-15;-161;1671;16038;13726;1;435;-2.14748e+09;-7.95827e+06;-1;0;0;0;-1;0;340271024;341753386;10176006
1092;6.75087e-15;-162;1671;16038;13726;1;435;-2.14748e+09;-7.93376e+06;0;0;0;0;0;0;340576249;342068211;10222167
1093;6.75087e-15;-163;1671;16038;13726;1;435;-2.14748e+09;-7.90947e+06;0;0;0;0;0;0;340880640;342382233;10268363
1094;6.75087e-15;-163;1671;16038;13726;1;435;-2.14748e+09;-7.8851e+06;-1;0;0;0;-1;0;341184199;342695454;10314594
1095;6.75087e-15;-164;1671;16038;13726;1;435;-2.14748e+09;-7.86094e+06;0;0;0;0;0;0;341486930;343007877;10360858
1096;6.75087e-15;-164;1671;16038;13726;1;435;-2.14748e+09;-7.83699e+06;-1;0;0;0;-1;0;341788837;343319505;10407156
1097;6.75087e-15;-165;1671;16038;13726;1;435;-2.14748e+09;-7.81296e+06;0;0;0;0;0;0;342089921;343630341;10453487
1098;6.75087e-15;-165;1671;16038;13726;1;435;-2.14748e+09;-7.78914e+06;-1;0;0;0;-1;0;342390186;343940389;10499850
1099;6.75087e-15;-165;1671;16038;13726;1;435;-2.14748e+09;-7.76543e+06;-1;0;0;0;-1;0;342689636;344249650;10546245
1100;6.75087e-15;-166;1671;16038;13726;1;435;-2.14748e+09;-7.74183e+06;0;0;0;0;0;0;342988272;344558129;10592672
1101;6.75087e-15;-167;1671;16038;13726;1;435;-2.14748e+09;-7.71834e+06;0;0;0;0;0;0;343286099;344865828;10639130
1102;6.75087e-15;-167;1671;16038;13726;1;435;-2.14748e+09;-7.69496e+06;-1;0;0;0;-1;0;343583119;345172750;10685619
1103;6.75087e-15;-167;1671;16038;13726;1;435;-2.14748e+09;-7.67169e+06;-1;0;0;0;-1;0;343879335;345478898;10732137
1104;6.75087e-15;-168;1671;16038;13726;1;435;-2.14748e+09;-7.64853e+06;0;0;0;0;0;0;344174750;345784275;10778685
1105;6.75087e-15;-169;1671;16038;13726;1;435;-2.14748e+09;-7.62547e+06;0;0;0;0;0;0;344469367;346088884;10825263
1106;6.75087e-15;-169;1671;16038;13726;1;435;-2.14748e+09;-7.60252e+06;0;0;-1;0;0;-1;344763189;346392727;10871869
1107;6.75087e-15;-169;1671;16038;13726;1;435;-2.14748e+09;-7.57968e+06;-1;0;0;0;-1;0;345056220;346695807;10918503
1108;6.75087e-15;-169;1671;16038;13726;1;435;-2.14748e+09;-7.55694e+06;-1;0;0;0;-1;0;345348461;346998128;10965165
1109;6.75087e-15;-169;1671;16038;13726;1;435;-2.14748e+09;-7.53431e+06;-1;0;0;0;-1;0;345639916;347299692;11011854
1110;6.75087e-15;-170;1671;16038;13726;1;435;-2.14748e+09;-7.51178e+06;0;0;0;0;0;0;345930587;347600502;11058571
1111;6.75087e-15;-171;1671;16038;13726;1;435;-2.14748e+09;-7.48936e+06;0;0;0;0;0;0;346220478;347900561;11105313
1112;6.75087e-15;-172;1671;16038;13726;1;435;-2.14748e+09;-7.46713e+06;0;0;0;0;0;0;346509591;348199871;11152081
1113;6.75087e-15;-173;1671;16038;13726;1;435;-2.14748e+09;-7.44491e+06;0;0;0;0;0;0;346797930;348498436;11198875
1114;6.75087e-15;-173;1671;16038;13726;1;435;-2.14748e+09;-7.42278e+06;-1;0;0;0;-1;0;347085497;348796257;11245694
1115;6.75087e-15;-173;1671;16038;13726;1;435;-2.14748e+09;-7.40076e+06;-1;0;0;0;-1;0;347372294;349093338;11292537
1116;6.75087e-15;-174;1671;16038;13726;1;435;-2.14748e+09;-7.37874e+06;0;0;0;0;0;0;347658325;349389682;11339405
1117;6.75087e-15;-174;1671;16038;13726;1;435;-2.14748e+09;-7.35692e+06;-1;0;0;0;-1;0;347943592;349685291;11386296
1118;6.75087e-15;-174;1671;16038;13726;1;435;-2.14748e+09;-7.33529e+06;-1;0;0;0;-1;0;348228099;349980168;11433210
1119;6.75087e-15;-174;1671;16038;13726;1;435;-2.14748e+09;-7.31357e+06;-1;0;0;0;-1;0;348511847;350274315;11480147
1120;6.75087e-15;-174;1671;16038;13726;1;435;-2.14748e+09;-7.29204e+06;-1;0;0;0;-1;0;348794840;350567736;11527107
1121;6.75087e-15;-175;1671;16038;13726;1;435;-2.14748e+09;-7.2707e+06;0;0;0;0;0;0;349077081;350860432;11574088
1122;6.75087e-15;-176;1671;16038;13726;1;435;-2.14748e+09;-7.24926e+06;0;0;0;0;0;0;349358571;351152407;11621091
1123;6.75087e-15;-177;1671;16038;13726;1;435;-2.14748e+09;-7.22802e+06;0;0;0;0;0;0;349639315;351443663;11668114
1124;6.75087e-15;-178;1671;16038;13726;1;435;-2.14748e+09;-7.20687e+06;0;0;0;0;0;0;349919313;351734202;11715158
1125;6.75087e-15;-178;1671;16038;13726;1;435;-2.14748e+09;-7.18582e+06;-1;0;0;0;-1;0;350198570;352024028;11762223
1126;6.75087e-15;-179;1671;16038;13726;1;435;-2.14748e+09;-7.16485e+06;0;0;0;0;0;0;350477088;352313143;11809307
1127;6.75087e-15;-180;1671;16038;13726;1;435;-2.14748e+09;-7.14398e+06;0;0;0;0;0;0;350754869;352601549;11856410
1128;6.75087e-15;-180;1671;16038;13726;1;435;-2.14748e+09;-7.12321e+06;-1;0;0;0;-1;0;351031916;352889249;11903532
1129;6.75087e-15;-180;1671;16038;13726;1;435;-2.14748e+09;-7.10252e+06;-1;0;0;0;-1;0;351308232;353176246;11950673
1130;6.75087e-15;-181;1671;16038;13726;1;435;-2.14748e+09;-7.08193e+06;0;0;0;0;0;0;351583819;353462542;11997831
1131;6.75087e-15;-182;1671;16038;13726;1;435;-2.14748e+09;-7.06142e+06;0;0;0;0;0;0;351858680;353748139;12045007
1132;6.75087e-15;-182;1671;16038;13726;1;435;-2.14748e+09;-7.04101e+06;-1;0;0;0;-1;0;352132818;354033040;12092200
1133;6.75087e-15;-182;1671;16038;13726;1;435;-2.14748e+09;-7.02068e+06;-1;0;0;0;-1;0;352406234;354317248;12139410
1134;6.75087e-15;-183;1671;16038;13726;1;435;-2.14748e+09;-7.00044e+06;0;0;0;0;0;0;352678932;354600765;12186637
1135;6.75087e-15;-184;1671;16038;13726;1;435;-2.14748e+09;-6.98029e+06;0;0;0;0;0;0;352950915;354883593;12233879
1136;6.75087e-15;-185;1671;16038;13726;1;435;-2.14748e+09;-6.96023e+06;0;0;0;0;0;0;353222183;355165736;12281136
1137;6.75087e-15;-185;1671;16038;13726;1;435;-2.14748e+09;-6.94026e+06;-1;0;0;0;-1;0;353492741;355447194;12328409
1138;6.75087e-15;-186;1671;16038;13726;1;435;-2.14748e+09;-6.92037e+06;0;0;0;0;0;0;353762591;355727971;12375697
1139;6.75087e-15;-187;1671;16038;13726;1;435;-2.14748e+09;-6.90056e+06;0;0;0;0;0;0;354031735;356008070;12422998
1140;6.75087e-15;-187;1671;16038;13726;1;435;-2.14748e+09;-6.88085e+06;-1;0;0;0;-1;0;354300175;356287492;12470314
1141;6.75087e-15;-188;1671;16038;13726;1;435;-2.14748e+09;-6.86121e+06;0;0;0;0;0;0;354567914;356566240;12517643
1142;6.75087e-15;-188;1671;16038;13726;1;435;-2.14748e+09;-6.84166e+06;-1;0;0;0;-1;0;354834955;356844316;12564985
1143;6.75087e-15;-189;1671;16038;13726;1;435;-2.14748e+09;-6.8222e+06;0;0;0;0;0;0;355101300;357121723;12612340
1144;6.75087e-15;-189;1671;16038;13726;1;435;-2.14748e+09;-6.80282e+06;-1;0;0;0;-1;0;355366951;357398463;12659707
1145;6.75087e-15;-190;1671;16038;13726;1;435;-2.14748e+09;-6.78352e+06;0;0;0;0;0;0;355631911;357674539;12707086
1146;6.75087e-15;-190;1671;16038;13726;1;435;-2.14748e+09;-6.7643e+06;-1;0;0;0;-1;0;355896183;357949952;12754476
1147;6.75087e-15;-190;1671;16038;13726;1;435;-2.14748e+09;-6.74516e+06;-1;0;0;0;-1;0;356159768;358224705;12801877
1148;6.75087e-15;-190;1671;16038;13726;1;435;-2.14748e+09;-6.72611e+06;-1;0;0;0;-1;0;356422668;358498800;12849290
1149;6.75087e-15;-191;1671;16038;13726;1;435;-2.14748e+09;-6.70723e+06;0;0;0;0;0;0;356684888;358772240;12896712
1150;6.75087e-15;-192;1671;16038;13726;1;435;-2.14748e+09;-6.68834e+06;0;0;0;0;0;0;356946428;359045027;12944145
1151;6.75087e-15;-192;1671;16038;13726;1;435;-2.14748e+09;-6.66942e+06;-1;0;0;0;-1;0;357207291;359317163;12991587
1152;6.75087e-15;-193;1671;16038;13726;1;435;-2.14748e+09;-6.65069e+06;0;0;0;0;0;0;357467479;359588650;13039038
1153;6.75087e-15;-194;1671;16038;13726;1;435;-2.14748e+09;-6.63203e+06;0;0;0;0;0;0;357726996;359859490;13086498
1154;6.75087e-15;-194;1671;16038;13726;1;435;-2.14748e+09;-6.61345e+06;-1;0;0;0;-1;0;357985842;360129687;13133966
1155;6.75087e-15;-194;1671;16038;13726;1;435;-2.14748e+09;-6.59495e+06;-1;0;0;0;-1;0;358244021;360399242;13181442
1156;6.75087e-15;-195;1671;16038;13726;1;435;-2.14748e+09;-6.57652e+06;0;0;0;0;0;0;358501534;360668156;13228927
1157;6.75087e-15;-196;1671;16038;13726;1;435;-2.14748e+09;-6.55818e+06;0;0;0;0;0;0;358758384;360936434;13276418
1158;6.75087e-15;-197;1671;16038;13726;1;435;-2.14748e+09;-6.5399e+06;0;0;0;0;0;0;359014574;361204076;13323916
1159;6.75087e-15;-198;1671;16038;13726;1;435;-2.14748e+09;-6.52171e+06;0;0;0;0;0;0;359270105;361471084;13371421
1160;6.75087e-15;-199;1671;16038;13726;1;435;-2.14748e+09;-6.50359e+06;0;0;0;0;0;0;359524979;361737462;13418932
1161;6.75087e-15;-199;1671;16038;13726;1;435;-2.14748e+09;-6.48564e+06;-1;0;0;0;-1;0;359779200;362003211;13466449
1162;6.75087e-15;-199;1671;16038;13726;1;435;-2.14748e+09;-6.46757e+06;-1;0;0;0;-1;0;360032769;362268333;13513972
1163;6.75087e-15;-200;1671;16038;13726;1;435;-2.14748e+09;-6.44967e+06;0;0;0;0;0;0;360285688;362532830;13561499
1164;6.75087e-15;-200;1671;16038;13726;1;435;-2.14748e+09;-6.43194e+06;-1;0;0;0;-1;0;360537960;362796705;13609031
1165;6.75087e-15;-201;1671;16038;13726;1;435;-2.14748e+09;-6.41419e+06;0;0;0;0;0;0;360789586;363059959;13656568
1166;6.75087e-15;-202;1671;16038;13726;1;435;-2.14748e+09;-6.39642e+06;0;0;0;0;0;0;361040569;363322595;13704109
1167;6.75087e-15;-202;1671;16038;13726;1;435;-2.14748e+09;-6.37881e+06;-1;0;0;0;-1;0;361290912;363584615;13751653
1168;6.75087e-15;-203;1671;16038;13726;1;435;-2.14748e+09;-6.36127e+06;0;0;0;0;0;0;361540616;363846021;13799201
1169;6.75087e-15;-204;1671;16038;13726;1;435;-2.14748e+09;-6.34381e+06;0;0;0;0;0;0;361789684;364106814;13846751
1170;6.75087e-15;-204;1671;16038;13726;1;435;-2.14748e+09;-6.32642e+06;0;0;-1;0;0;-1;362038117;364366998;13894305
1171;6.75087e-15;-204;1671;16038;13726;1;435;-2.14748e+09;-6.30909e+06;-1;0;0;0;-1;0;362285918;364626574;13941860
1172;6.75087e-15;-205;1671;16038;13726;1;435;-2.14748e+09;-6.29184e+06;0;0;0;0;0;0;362533088;364885543;13989418
1173;6.75087e-15;-205;1671;16038;13726;1;435;-2.14748e+09;-6.27466e+06;-1;0;0;0;-1;0;362779631;365143909;14036977
1174;6.75087e-15;-206;1671;16038;13726;1;435;-2.14748e+09;-6.25754e+06;0;0;0;0;0;0;363025548;365401673;14084537
1175;6.75087e-15;-207;1671;16038;13726;1;435;-2.14748e+09;-6.2405e+06;0;0;0;0;0;0;363270841;365658837;14132099
1176;6.75087e-15;-208;1671;16038;13726;1;435;-2.14748e+09;-6.22352e+06;0;0;0;0;0;0;363515512;365915403;14179661
1177;6.75087e-15;-209;1671;16038;13726;1;435;-2.14748e+09;-6.20661e+06;0;0;0;0;0;0;363759564;366171373;14227223
1178;6.75087e-15;-209;1671;16038;13726;1;435;-2.14748e+09;-6.18977e+06;-1;0;0;0;-1;0;364002998;366426749;14274785
1179;6.75087e-15;-209;1671;16038;13726;1;435;-2.14748e+09;-6.173e+06;-1;0;0;0;-1;0;364245816;366681533;14322347
1180;6.75087e-15;-209;1671;16038;13726;1;435;-2.14748e+09;-6.15639e+06;-1;0;0;0;-1;0;364488022;366935727;14369908
1181;6.75087e-15;-210;1671;16038;13726;1;435;-2.14748e+09;-6.13975e+06;0;0;0;0;0;0;364729615;367189333;14417467
1182;6.75087e-15;-210;1671;16038;13726;1;435;-2.14748e+09;-6.12307e+06;-1;0;0;0;-1;0;364970599;367442353;14465026
1183;6.75087e-15;-210;1671;16038;13726;1;435;-2.14748e+09;-6.10656e+06;-1;0;0;0;-1;0;365210976;367694789;14512583
1184;6.75087e-15;-211;1671;16038;13726;1;435;-2.14748e+09;-6.09012e+06;0;0;0;0;0;0;365450748;367946642;14560138
1185;6.75087e-15;-211;1671;16038;13726;1;435;-2.14748e+09;-6.07384e+06;-1;0;0;0;-1;0;365689916;368197915;14607690
1186;6.75087e-15;-212;1671;16038;13726;1;435;-2.14748e+09;-6.05753e+06;0;0;0;0;0;0;365928482;368448610;14655240
1187;6.75087e-15;-213;1671;16038;13726;1;435;-2.14748e+09;-6.04118e+06;0;0;0;0;0;0;366166450;368698728;14702786
1188;6.75087e-15;-214;1671;16038;13726;1;435;-2.14748e+09;-6.02499e+06;0;0;0;0;0;0;366403820;368948271;14750330
1189;6.75087e-15;-214;1671;16038;13726;1;435;-2.14748e+09;-6.00886e+06;-1;0;0;0;-1;0;366640594;369197241;14797870
1190;6.75087e-15;-214;1671;16038;13726;1;435;-2.14748e+09;-5.9928e+06;-1;0;0;0;-1;0;366876775;369445640;14845405
1191;6.75087e-15;-215;1671;16038;13726;1;435;-2.14748e+09;-5.97681e+06;0;0;0;0;0;0;367112364;369693471;14892937
1192;6.75087e-15;-216;1671;16038;13726;1;435;-2.14748e+09;-5.96097e+06;0;0;0;0;0;0;367347364;369940734;14940464
1193;6.75087e-15;-217;1671;16038;13726;1;435;-2.14748e+09;-5.945e+06;0;0;0;0;0;0;367581776;370187431;14987986
1194;6.75087e-15;-217;1671;16038;13726;1;435;-2.14748e+09;-5.92918e+06;-1;0;0;0;-1;0;367815602;370433565;15035503
1195;6.75087e-15;-217;1671;16038;13726;1;435;-2.14748e+09;-5.91343e+06;-1;0;0;0;-1;0;368048844;370679137;15083015
1196;6.75087e-15;-217;1671;16038;13726;1;435;-2.14748e+09;-5.89774e+06;-1;0;0;0;-1;0;368281505;370924149;15130520
1197;6.75087e-15;-218;1671;16038;13726;1;435;-2.14748e+09;-5.88211e+06;0;0;0;0;0;0;368513585;371168602;15178020
1198;6.75087e-15;-218;1671;16038;13726;1;435;-2.14748e+09;-5.86654e+06;-1;0;0;0;-1;0;368745087;371412500;15225513
1199;6.75087e-15;-218;1671;16038;13726;1;435;-2.14748e+09;-5.85103e+06;-1;0;0;0;-1;0;368976013;371655843;15273000
1200;6.75087e-15;-218;1671;16038;13726;1;435;-2.14748e+09;-5.83558e+06;-1;0;0;0;-1;0;369206364;371898632;15320479
1201;6.75087e-15;-218;1671;16038;13726;1;435;-2.14748e+09;-5.82019e+06;-1;0;0;0;-1;0;369436143;372140871;15367952
1202;6.75087e-15;-219;1671;16038;13726;1;435;-2.14748e+09;-5.80496e+06;0;0;0;0;0;0;369665351;372382561;15415416
1203;6.75087e-15;-219;1671;16038;13726;1;435;-2.14748e+09;-5.78968e+06;-1;0;0;0;-1;0;369893990;372623702;15462873
1204;6.75087e-15;-219;1671;16038;13726;1;435;-2.14748e+09;-5.77447e+06;-1;0;0;0;-1;0;370122062;372864299;15510322
1205;6.75087e-15;-220;1671;16038;13726;1;435;-2.14748e+09;-5.75921e+06;0;0;0;0;0;0;370349569;373104350;15557762
1206;6.75087e-15;-221;1671;16038;13726;1;435;-2.14748e+09;-5.74411e+06;0;0;0;0;0;0;370576513;373343860;15605194
1207;6.75087e-15;-221;1671;16038;13726;1;435;-2.14748e+09;-5.72907e+06;-1;0;0;0;-1;0;370802895;373582829;15652617
1208;6.75087e-15;-222;1671;16038;13726;1;435;-2.14748e+09;-5.71408e+06;0;0;0;0;0;0;371028717;373821259;15700030
1209;6.75087e-15;-222;1671;16038;13726;1;435;-2.14748e+09;-5.69915e+06;-1;0;0;0;-1;0;371253981;374059151;15747434
1210;6.75087e-15;-222;1671;16038;13726;1;435;-2.14748e+09;-5.68438e+06;-1;0;0;0;-1;0;371478689;374296508;15794828
1211;6.75087e-15;-222;1671;16038;13726;1;435;-2.14748e+09;-5.66946e+06;-1;0;0;0;-1;0;371702842;374533332;15842212
1212;6.75087e-15;-222;1671;16038;13726;1;435;-2.14748e+09;-5.6547e+06;-1;0;0;0;-1;0;371926443;374769623;15889585
1213;6.75087e-15;-223;1671;16038;13726;1;435;-2.14748e+09;-5.63999e+06;0;0;0;0;0;0;372149493;375005383;15936948
1214;6.75087e-15;-223;1671;16038;13726;1;435;-2.14748e+09;-5.62534e+06;-1;0;0;0;-1;0;372371994;375240615;15984300
1215;6.75087e-15;-223;1671;16038;13726;1;435;-2.14748e+09;-5.61074e+06;-1;0;0;0;-1;0;372593947;375475319;16031640
1216;6.75087e-15;-224;1671;16038;13726;1;435;-2.14748e+09;-5.5962e+06;0;0;0;0;0;0;372815355;375709498;16078969
1217;6.75087e-15;-225;1671;16038;13726;1;435;-2.14748e+09;-5.58171e+06;0;0;0;0;0;0;373036219;375943153;16126287
1218;6.75087e-15;-226;1671;16038;13726;1;435;-2.14748e+09;-5.56728e+06;0;0;0;0;0;0;373256540;376176285;16173592
1219;6.75087e-15;-226;1671;16038;13726;1;435;-2.14748e+09;-5.5529e+06;-1;0;0;0;-1;0;373476321;376408897;16220885
1220;6.75087e-15;-227;1671;16038;13726;1;435;-2.14748e+09;-5.53857e+06;0;0;0;0;0;0;373695564;376640990;16268166
1221;6.75087e-15;-227;1671;16038;13726;1;435;-2.14748e+09;-5.5243e+06;-1;0;0;0;-1;0;373914269;376872565;16315434
1222;6.75087e-15;-227;1671;16038;13726;1;435;-2.14748e+09;-5.51017e+06;-1;0;0;0;-1;0;374132439;377103625;16362688
1223;6.75087e-15;-228;1671;16038;13726;1;435;-2.14748e+09;-5.4959e+06;0;0;0;0;0;0;374350075;377334170;16409929
1224;6.75087e-15;-229;1671;16038;13726;1;435;-2.14748e+09;-5.48189e+06;0;0;0;0;0;0;374567180;377564203;16457157
1225;6.75087e-15;-230;1671;16038;13726;1;435;-2.14748e+09;-5.46772e+06;0;0;0;0;0;0;374783754;377793724;16504371
1226;6.75087e-15;-231;1671;16038;13726;1;435;-2.14748e+09;-5.45371e+06;0;0;0;0;0;0;374999799;378022736;16551571
1227;6.75087e-15;-231;1671;16038;13726;1;435;-2.14748e+09;-5.43974e+06;-1;0;0;0;-1;0;375215317;378251240;16598756
1228;6.75087e-15;-232;1671;16038;13726;1;435;-2.14748e+09;-5.42593e+06;0;0;0;0;0;0;375430310;378479237;16645927
1229;6.75087e-15;-233;1671;16038;13726;1;435;-2.14748e+09;-5.41197e+06;0;0;0;0;0;0;375644779;378706730;16693083
1230;6.75087e-15;-233;1671;16038;13726;1;435;-2.14748e+09;-5.39816e+06;-1;0;0;0;-1;0;375858727;378933719;16740224
1231;6.75087e-15;-233;1671;16038;13726;1;435;-2.14748e+09;-5.3844e+06;-1;0;0;0;-1;0;376072153;379160207;16787349
1232;6.75087e-15;-233;1671;16038;13726;1;435;-2.14748e+09;-5.37079e+06;-1;0;0;0;-1;0;376285061;379386194;16834459
1233;6.75087e-15;-234;1671;16038;13726;1;435;-2.14748e+09;-5.35702e+06;0;0;0;0;0;0;376497452;379611683;16881553
1234;6.75087e-15;-235;1671;16038;13726;1;435;-2.14748e+09;-5.34341e+06;0;0;0;0;0;0;376709327;379836674;16928631
1235;6.75087e-15;-236;1671;16038;13726;1;435;-2.14748e+09;-5.32985e+06;0;0;0;0;0;0;376920689;380061170;16975693
1236;6.75087e-15;-237;1671;16038;13726;1;435;-2.14748e+09;-5.31634e+06;0;0;0;0;0;0;377131537;380285171;17022738
1237;6.75087e-15;-237;1671;16038;13726;1;435;-2.14748e+09;-5.30287e+06;-1;0;0;0;-1;0;377341875;380508680;17069767
1238;6.75087e-15;-238;1671;16038;13726;1;435;-2.14748e+09;-5.28945e+06;0;0;0;0;0;0;377551704;380731697;17116778
1239;6.75087e-15;-239;1671;16038;13726;1;435;-2.14748e+09;-5.27608e+06;0;0;0;0;0;0;377761025;380954225;17163772
1240;6.75087e-15;-239;1671;16038;13726;1;435;-2.14748e+09;-5.26276e+06;-1;0;0;0;-1;0;377969841;381176264;17210748
1241;6.75087e-15;-239;1671;16038;13726;1;435;-2.14748e+09;-5.24949e+06;-1;0;0;0;-1;0;378178151;381397817;17257707
1242;6.75087e-15;-239;1671;16038;13726;1;435;-2.14748e+09;-5.23626e+06;-1;0;0;0;-1;0;378385959;381618884;17304648
1243;6.75087e-15;-239;1671;16038;13726;1;435;-2.14748e+09;-5.22308e+06;-1;0;0;0;-1;0;378593265;381839467;17351570
1244;6.75087e-15;-239;1671;16038;13726;1;435;-2.14748e+09;-5.21005e+06;-1;0;0;0;-1;0;378800072;382059568;17398474
1245;6.75087e-15;-240;1671;16038;13726;1;435;-2.14748e+09;-5.19696e+06;0;0;0;0;0;0;379006380;382279188;17445360
1246;6.75087e-15;-241;1671;16038;13726;1;435;-2.14748e+09;-5.18382e+06;0;0;0;0;0;0;379212191;382498328;17492226
1247;6.75087e-15;-242;1671;16038;13726;1;435;-2.14748e+09;-5.17083e+06;0;0;0;0;0;0;379417507;382716991;17539074
1248;6.75087e-15;-243;1671;16038;13726;1;435;-2.14748e+09;-5.15788e+06;0;0;0;0;0;0;379622330;382935176;17585902
1249;6.75087e-15;-243;1671;16038;13726;1;435;-2.14748e+09;-5.14498e+06;-1;0;0;0;-1;0;379826660;383152886;17632711
1250;6.75087e-15;-243;1671;16038;13726;1;435;-2.14748e+09;-5.13212e+06;-1;0;0;0;-1;0;380030499;383370122;17679500
1251;6.75087e-15;-243;1671;16038;13726;1;435;-2.14748e+09;-5.11931e+06;-1;0;0;0;-1;0;380233849;383586886;17726268
1252;6.75087e-15;-243;1671;16038;13726;1;435;-2.14748e+09;-5.10655e+06;-1;0;0;0;-1;0;380436712;383803179;17773017
1253;6.75087e-15;-244;1671;16038;13726;1;435;-2.14748e+09;-5.09382e+06;0;0;0;0;0;0;380639088;384019002;17819745
1254;6.75087e-15;-244;1671;16038;13726;1;435;-2.14748e+09;-5.08115e+06;-1;0;0;0;-1;0;380840979;384234356;17866453
1255;6.75087e-15;-245;1671;16038;13726;1;435;-2.14748e+09;-5.06861e+06;0;0;0;0;0;0;381042388;384449244;17913139
1256;6.75087e-15;-246;1671;16038;13726;1;435;-2.14748e+09;-5.05592e+06;0;0;0;0;0;0;381243314;384663666;17959805
1257;6.75087e-15;-247;1671;16038;13726;1;435;-2.14748e+09;-5.04338e+06;0;0;0;0;0;0;381443760;384877624;18006449
1258;6.75087e-15;-248;1671;16038;13726;1;435;-2.14748e+09;-5.03098e+06;0;0;0;0;0;0;381643727;385091119;18053072
1259;6.75087e-15;-249;1671;16038;13726;1;435;-2.14748e+09;-5.01842e+06;0;0;0;0;0;0;381843216;385304152;18099674
1260;6.75087e-15;-249;1671;16038;13726;1;435;-2.14748e+09;-5.0061e+06;-1;0;0;0;-1;0;382042230;385516726;18146253
1261;6.75087e-15;-249;1671;16038;13726;1;435;-2.14748e+09;-4.99363e+06;-1;0;0;0;-1;0;382240769;385728840;18192810
1262;6.75087e-15;-249;1671;16038;13726;1;435;-2.14748e+09;-4.9813e+06;-1;0;0;0;-1;0;382438834;385940497;18239345
1263;6.75087e-15;-249;1671;16038;13726;1;435;-2.14748e+09;-4.96901e+06;-1;0;0;0;-1;0;382636428;386151698;18285857
1264;6.75087e-15;-249;1671;16038;13726;1;435;-2.14748e+09;-4.95677e+06;-1;0;0;0;-1;0;382833552;386362445;18332347
1265;6.75087e-15;-249;1671;16038;13726;1;435;-2.14748e+09;-4.94456e+06;-1;0;0;0;-1;0;383030207;386572737;18378814
1266;6.75087e-15;-249;1671;16038;13726;1;435;-2.14748e+09;-4.9324e+06;-1;0;0;0;-1;0;383226394;386782578;18425257
1267;6.75087e-15;-250;1671;16038;13726;1;435;-2.14748e+09;-4.92028e+06;0;0;0;0;0;0;383422116;386991967;18471678
1268;6.75087e-15;-250;1671;16038;13726;1;435;-2.14748e+09;-4.9082e+06;-1;0;0;0;-1;0;383617372;387200908;18518074
1269;6.75087e-15;-251;1671;16038;13726;1;435;-2.14748e+09;-4.89617e+06;0;0;0;0;0;0;383812166;387409399;18564448
1270;6.75087e-15;-251;1671;16038;13726;1;435;-2.14748e+09;-4.88417e+06;-1;0;0;0;-1;0;384006497;387617444;18610797
1271;6.75087e-15;-252;1671;16038;13726;1;435;-2.14748e+09;-4.87222e+06;0;0;0;0;0;0;384200368;387825043;18657122
1272;6.75087e-15;-253;1671;16038;13726;1;435;-2.14748e+09;-4.8603e+06;0;0;0;0;0;0;384393780;388032198;18703423
1273;6.75087e-15;-254;1671;16038;13726;1;435;-2.14748e+09;-4.84843e+06;0;0;0;0;0;0;384586734;388238910;18749699
1274;6.75087e-15;-255;1671;16038;13726;1;435;-2.14748e+09;-4.83659e+06;0;0;0;0;0;0;384779231;388445179;18795951
1275;6.75087e-15;-256;1671;16038;13726;1;435;-2.14748e+09;-4.8248e+06;0;0;0;0;0;0;384971273;388651008;18842178
1276;6.75087e-15;-257;1671;16038;13726;1;435;-2.14748e+09;-4.81304e+06;0;0;0;0;0;0;385162862;388856398;18888380
1277;6.75087e-15;-257;1671;16038;13726;1;435;-2.14748e+09;-4.80133e+06;-1;0;0;0;-1;0;385353998;389061350;18934557
1278;6.75087e-15;-257;1671;16038;13726;1;435;-2.14748e+09;-4.78965e+06;-1;0;0;0;-1;0;385544684;389265865;18980708
1279;6.75087e-15;-258;1671;16038;13726;1;435;-2.14748e+09;-4.77802e+06;0;0;0;0;0;0;385734919;389469944;19026834
1280;6.75087e-15;-259;1671;16038;13726;1;435;-2.14748e+09;-4.76642e+06;0;0;0;0;0;0;385924707;389673589;19072933
1281;6.75087e-15;-259;1671;16038;13726;1;435;-2.14748e+09;-4.75486e+06;-1;0;0;0;-1;0;386114047;389876800;19119007
1282;6.75087e-15;-259;1671;16038;13726;1;435;-2.14748e+09;-4.74334e+06;-1;0;0;0;-1;0;386302942;390079580;19165055
1283;6.75087e-15;-260;1671;16038;13726;1;435;-2.14748e+09;-4.73186e+06;0;0;0;0;0;0;386491392;390281929;19211077
1284;6.75087e-15;-260;1671;16038;13726;1;435;-2.14748e+09;-4.72042e+06;-1;0;0;0;-1;0;386679399;390483849;19257072
1285;6.75087e-15;-260;1671;16038;13726;1;435;-2.14748e+09;-4.70901e+06;-1;0;0;0;-1;0;386866964;390685340;19303041
1286;6.75087e-15;-261;1671;16038;13726;1;435;-2.14748e+09;-4.69764e+06;0;0;0;0;0;0;387054089;390886404;19348982
1287;6.75087e-15;-262;1671;16038;13726;1;435;-2.14748e+09;-4.68631e+06;0;0;0;0;0;0;387240775;391087043;19394897
1288;6.75087e-15;-263;1671;16038;13726;1;435;-2.14748e+09;-4.67512e+06;0;0;0;0;0;0;387427022;391287257;19440784
1289;6.75087e-15;-263;1671;16038;13726;1;435;-2.14748e+09;-4.66377e+06;-1;0;0;0;-1;0;387612833;391487047;19486644
1290;6.75087e-15;-263;1671;16038;13726;1;435;-2.14748e+09;-4.65255e+06;-1;0;0;0;-1;0;387798209;391686415;19532477
1291;6.75087e-15;-263;1671;16038;13726;1;435;-2.14748e+09;-4.64137e+06;-1;0;0;0;-1;0;387983151;391885362;19578282
1292;6.75087e-15;-263;1671;16038;13726;1;435;-2.14748e+09;-4.63022e+06;-1;0;0;0;-1;0;388167660;392083889;19624059
1293;6.75087e-15;-264;1671;16038;13726;1;435;-2.14748e+09;-4.61922e+06;0;0;0;0;0;0;388351737;392281997;19669808
1294;6.75087e-15;-265;1671;16038;13726;1;435;-2.14748e+09;-4.60805e+06;0;0;0;0;0;0;388535384;392479688;19715529
1295;6.75087e-15;-265;1671;16038;13726;1;435;-2.14748e+09;-4.59701e+06;-1;0;0;0;-1;0;388718602;392676962;19761222
1296;6.75087e-15;-266;1671;16038;13726;1;435;-2.14748e+09;-4.58601e+06;0;0;0;0;0;0;388901393;392873821;19806886
1297;6.75087e-15;-266;1671;16038;13726;1;435;-2.14748e+09;-4.57505e+06;-1;0;0;0;-1;0;389083757;393070266;19852521
1298;6.75087e-15;-266;1671;16038;13726;1;435;-2.14748e+09;-4.56412e+06;-1;0;0;0;-1;0;389265695;393266298;19898128
1299;6.75087e-15;-267;1671;16038;13726;1;435;-2.14748e+09;-4.55323e+06;0;0;0;0;0;0;389447210;393461918;19943706
1300;6.75087e-15;-267;1671;16038;13726;1;435;-2.14748e+09;-4.54238e+06;-1;0;0;0;-1;0;389628301;393657127;19989254
1301;6.75087e-15;-267;1671;16038;13726;1;435;-2.14748e+09;-4.53156e+06;-1;0;0;0;-1;0;389808971;393851927;20034774
1302;6.75087e-15;-267;1671;16038;13726;1;435;-2.14748e+09;-4.52077e+06;-1;0;0;0;-1;0;389989221;394046318;20080263
1303;6.75087e-15;-268;1671;16038;13726;1;435;-2.14748e+09;-4.51002e+06;0;0;0;0;0;0;390169052;394240303;20125724
1304;6.75087e-15;-268;1671;16038;13726;1;435;-2.14748e+09;-4.4993e+06;-1;0;0;0;-1;0;390348464;394433880;20171154
1305;6.75087e-15;-269;1671;16038;13726;1;435;-2.14748e+09;-4.48862e+06;0;0;0;0;0;0;390527460;394627053;20216554
1306;6.75087e-15;-269;1671;16038;13726;1;435;-2.14748e+09;-4.47798e+06;-1;0;0;0;-1;0;390706040;394819822;20261925
1307;6.75087e-15;-269;1671;16038;13726;1;435;-2.14748e+09;-4.46736e+06;-1;0;0;0;-1;0;390884206;395012188;20307265
1308;6.75087e-15;-269;1671;16038;13726;1;435;-2.14748e+09;-4.45678e+06;-1;0;0;0;-1;0;391061959;395204152;20352575
1309;6.75087e-15;-270;1671;16038;13726;1;435;-2.14748e+09;-4.44624e+06;0;0;0;0;0;0;391239300;395395716;20397855
1310;6.75087e-15;-271;1671;16038;13726;1;435;-2.14748e+09;-4.43573e+06;0;0;0;0;0;0;391416230;395586880;20443103
1311;6.75087e-15;-271;1671;16038;13726;1;435;-2.14748e+09;-4.42525e+06;-1;0;0;0;-1;0;391592750;395777646;20488321
1312;6.75087e-15;-272;1671;16038;13726;1;435;-2.14748e+09;-4.41481e+06;0;0;0;0;0;0;391768862;395968014;20533508
1313;6.75087e-15;-273;1671;16038;13726;1;435;-2.14748e+09;-4.4044e+06;0;0;0;0;0;0;391944567;396157985;20578664
1314;6.75087e-15;-274;1671;16038;13726;1;435;-2.14748e+09;-4.39412e+06;0;0;0;0;0;0;392119866;396347562;20623789
1315;6.75087e-15;-275;1671;16038;13726;1;435;-2.14748e+09;-4.38368e+06;0;0;0;0;0;0;392294759;396536744;20668882
1316;6.75087e-15;-275;1671;16038;13726;1;435;-2.14748e+09;-4.37336e+06;-1;0;0;0;-1;0;392469249;396725534;20713944
1317;6.75087e-15;-275;1671;16038;13726;1;435;-2.14748e+09;-4.36308e+06;-1;0;0;0;-1;0;392643337;396913931;20758974
1318;6.75087e-15;-275;1671;16038;13726;1;435;-2.14748e+09;-4.35284e+06;-1;0;0;0;-1;0;392817023;397101937;20803972
1319;6.75087e-15;-276;1671;16038;13726;1;435;-2.14748e+09;-4.34262e+06;0;0;0;0;0;0;392990308;397289553;20848939
1320;6.75087e-15;-276;1671;16038;13726;1;435;-2.14748e+09;-4.33244e+06;-1;0;0;0;-1;0;393163194;397476781;20893873
1321;6.75087e-15;-277;1671;16038;13726;1;435;-2.14748e+09;-4.32229e+06;0;0;0;0;0;0;393335683;397663620;20938775
1322;6.75087e-15;-277;1671;16038;13726;1;435;-2.14748e+09;-4.31218e+06;-1;0;0;0;-1;0;393507774;397850073;20983645
1323;6.75087e-15;-278;1671;16038;13726;1;435;-2.14748e+09;-4.30209e+06;0;0;0;0;0;0;393679469;398036140;21028482
1324;6.75087e-15;-278;1671;16038;13726;1;435;-2.14748e+09;-4.29204e+06;-1;0;0;0;-1;0;393850770;398221823;21073287
1325;6.75087e-15;-278;1671;16038;13726;1;435;-2.14748e+09;-4.28201e+06;-1;0;0;0;-1;0;394021677;398407121;21118059
1326;6.75087e-15;-278;1671;16038;13726;1;435;-2.14748e+09;-4.27202e+06;-1;0;0;0;-1;0;394192192;398592037;21162798
1327;6.75087e-15;-279;1671;16038;13726;1;435;-2.14748e+09;-4.26206e+06;0;0;0;0;0;0;394362315;398776571;21207504
1328;6.75087e-15;-279;1671;16038;13726;1;435;-2.14748e+09;-4.25213e+06;-1;0;0;0;-1;0;394532048;398960725;21252178
1329;6.75087e-15;-280;1671;16038;13726;1;435;-2.14748e+09;-4.24224e+06;0;0;0;0;0;0;394701392;399144499;21296817
1330;6.75087e-15;-280;1671;16038;13726;1;435;-2.14748e+09;-4.23237e+06;-1;0;0;0;-1;0;394870348;399327894;21341424
1331;6.75087e-15;-280;1671;16038;13726;1;435;-2.14748e+09;-4.22253e+06;-1;0;0;0;-1;0;395038917;399510912;21385997
1332;6.75087e-15;-280;1671;16038;13726;1;435;-2.14748e+09;-4.21272e+06;-1;0;0;0;-1;0;395207100;399693553;21430536
1333;6.75087e-15;-281;1671;16038;13726;1;435;-2.14748e+09;-4.20295e+06;0;0;0;0;0;0;395374899;399875819;21475041
1334;6.75087e-15;-281;1671;16038;13726;1;435;-2.14748e+09;-4.1932e+06;-1;0;0;0;-1;0;395542313;400057709;21519513
1335;6.75087e-15;-281;1671;16038;13726;1;435;-2.14748e+09;-4.18349e+06;-1;0;0;0;-1;0;395709345;400239226;21563951
1336;6.75087e-15;-281;1671;16038;13726;1;435;-2.14748e+09;-4.1739e+06;-1;0;0;0;-1;0;395875996;400420371;21608354
1337;6.75087e-15;-281;1671;16038;13726;1;435;-2.14748e+09;-4.16415e+06;-1;0;0;0;-1;0;396042265;400601144;21652724
1338;6.75087e-15;-282;1671;16038;13726;1;435;-2.14748e+09;-4.15452e+06;0;0;0;0;0;0;396208156;400781546;21697059
1339;6.75087e-15;-282;1671;16038;13726;1;435;-2.14748e+09;-4.14502e+06;-1;0;0;0;-1;0;396373668;400961579;21741359
1340;6.75087e-15;-283;1671;16038;13726;1;435;-2.14748e+09;-4.13536e+06;0;0;0;0;0;0;396538803;401141242;21785625
1341;6.75087e-15;-283;1671;16038;13726;1;435;-2.14748e+09;-4.12582e+06;-1;0;0;0;-1;0;396703561;401320538;21829856
1342;6.75087e-15;-283;1671;16038;13726;1;435;-2.14748e+09;-4.11631e+06;-1;0;0;0;-1;0;396867944;401499467;21874053
1343;6.75087e-15;-284;1671;16038;13726;1;435;-2.14748e+09;-4.10693e+06;0;0;0;0;0;0;397031954;401678030;21918214
1344;6.75087e-15;-285;1671;16038;13726;1;435;-2.14748e+09;-4.09738e+06;0;0;0;0;0;0;397195590;401856229;21962340
1345;6.75087e-15;-285;1671;16038;13726;1;435;-2.14748e+09;-4.08796e+06;-1;0;0;0;-1;0;397358853;402034063;22006432
1346;6.75087e-15;-286;1671;16038;13726;1;435;-2.14748e+09;-4.07857e+06;0;0;0;0;0;0;397521746;402211534;22050488
1347;6.75087e-15;-287;1671;16038;13726;1;435;-2.14748e+09;-4.0692e+06;0;0;0;0;0;0;397684269;402388643;22094508
1348;6.75087e-15;-288;1671;16038;13726;1;435;-2.14748e+09;-4.05997e+06;0;0;0;0;0;0;397846423;402565391;22138493
1349;6.75087e-15;-289;1671;16038;13726;1;435;-2.14748e+09;-4.05056e+06;0;0;0;0;0;0;398008209;402741779;22182443
1350;6.75087e-15;-290;1671;16038;13726;1;435;-2.14748e+09;-4.04128e+06;0;0;0;0;0;0;398169628;402917808;22226356
1351;6.75087e-15;-290;1671;16038;13726;1;435;-2.14748e+09;-4.03203e+06;-1;0;0;0;-1;0;398330681;403093478;22270234
1352;6.75087e-15;-290;1671;16038;13726;1;435;-2.14748e+09;-4.02281e+06;-1;0;0;0;-1;0;398491369;403268791;22314076
1353;6.75087e-15;-291;1671;16038;13726;1;435;-2.14748e+09;-4.01361e+06;0;0;0;0;0;0;398651693;403443747;22357882
1354;6.75087e-15;-291;1671;16038;13726;1;435;-2.14748e+09;-4.00444e+06;-1;0;0;0;-1;0;398811654;403618348;22401652
1355;6.75087e-15;-291;1671;16038;13726;1;435;-2.14748e+09;-3.9953e+06;-1;0;0;0;-1;0;398971253;403792594;22445386
1356;6.75087e-15;-292;1671;16038;13726;1;435;-2.14748e+09;-3.98619e+06;0;0;0;0;0;0;399130491;403966486;22489083
1357;6.75087e-15;-292;1671;16038;13726;1;435;-2.14748e+09;-3.9772e+06;-1;0;0;0;-1;0;399289370;404140026;22532744
1358;6.75087e-15;-292;1671;16038;13726;1;435;-2.14748e+09;-3.96815e+06;-1;0;0;0;-1;0;399447889;404313214;22576368
1359;6.75087e-15;-293;1671;16038;13726;1;435;-2.14748e+09;-3.95912e+06;0;0;0;0;0;0;399606050;404486050;22619956
1360;6.75087e-15;-293;1671;16038;13726;1;435;-2.14748e+09;-3.95001e+06;-1;0;0;0;-1;0;399763855;404658537;22663507
1361;6.75087e-15;-293;1671;16038;13726;1;435;-2.14748e+09;-3.94103e+06;-1;0;0;0;-1;0;399921303;404830674;22707021
1362;6.75087e-15;-294;1671;16038;13726;1;435;-2.14748e+09;-3.93218e+06;0;0;0;0;0;0;400078397;405002463;22750498
1363;6.75087e-15;-295;1671;16038;13726;1;435;-2.14748e+09;-3.92316e+06;0;0;0;0;0;0;400235136;405173904;22793938
1364;6.75087e-15;-296;1671;16038;13726;1;435;-2.14748e+09;-3.91426e+06;0;0;0;0;0;0;400391522;405344999;22837341
1365;6.75087e-15;-296;1671;16038;13726;1;435;-2.14748e+09;-3.90539e+06;-1;0;0;0;-1;0;400547556;405515748;22880707
1366;6.75087e-15;-296;1671;16038;13726;1;435;-2.14748e+09;-3.89665e+06;-1;0;0;0;-1;0;400703239;405686152;22924036
1367;6.75087e-15;-296;1671;16038;13726;1;435;-2.14748e+09;-3.88783e+06;-1;0;0;0;-1;0;400858572;405856213;22967327
1368;6.75087e-15;-296;1671;16038;13726;1;435;-2.14748e+09;-3.87893e+06;-1;0;0;0;-1;0;401013555;406025930;23010580
1369;6.75087e-15;-297;1671;16038;13726;1;435;-2.14748e+09;-3.87017e+06;0;0;0;0;0;0;401168190;406195305;23053796
1370;6.75087e-15;-297;1671;16038;13726;1;435;-2.14748e+09;-3.86153e+06;-1;0;0;0;-1;0;401322478;406364339;23096974
1371;6.75087e-15;-297;1671;16038;13726;1;435;-2.14748e+09;-3.85271e+06;-1;0;0;0;-1;0;401476419;406533032;23140115
1372;6.75087e-15;-297;1671;16038;13726;1;435;-2.14748e+09;-3.84402e+06;-1;0;0;0;-1;0;401630015;406701386;23183217
1373;6.75087e-15;-297;1671;16038;13726;1;435;-2.14748e+09;-3.83536e+06;-1;0;0;0;-1;0;401783267;406869401;23226282
1374;6.75087e-15;-297;1671;16038;13726;1;435;-2.14748e+09;-3.82672e+06;-1;0;0;0;-1;0;401936174;407037078;23269309
1375;6.75087e-15;-297;1671;16038;13726;1;435;-2.14748e+09;-3.81811e+06;-1;0;0;0;-1;0;402088739;407204418;23312297
1376;6.75087e-15;-297;1671;16038;13726;1;435;-2.14748e+09;-3.80952e+06;-1;0;0;0;-1;0;402240963;407371421;23355247
1377;6.75087e-15;-298;1671;16038;13726;1;435;-2.14748e+09;-3.80096e+06;0;0;0;0;0;0;402392845;407538090;23398159
1378;6.75087e-15;-298;1671;16038;13726;1;435;-2.14748e+09;-3.79242e+06;-1;0;0;0;-1;0;402544388;407704424;23441033
1379;6.75087e-15;-298;1671;16038;13726;1;435;-2.14748e+09;-3.7839e+06;-1;0;0;0;-1;0;402695591;407870424;23483868
1380;6.75087e-15;-299;1671;16038;13726;1;435;-2.14748e+09;-3.77542e+06;0;0;0;0;0;0;402846457;408036091;23526664
1381;6.75087e-15;-300;1671;16038;13726;1;435;-2.14748e+09;-3.76695e+06;0;0;0;0;0;0;402996985;408201426;23569422
1382;6.75087e-15;-300;1671;16038;13726;1;435;-2.14748e+09;-3.75851e+06;-1;0;0;0;-1;0;403147177;408366431;23612141
1383;6.75087e-15;-300;1671;16038;13726;1;435;-2.14748e+09;-3.7501e+06;-1;0;0;0;-1;0;403297034;408531104;23654822
1384;6.75087e-15;-300;1671;16038;13726;1;435;-2.14748e+09;-3.74171e+06;-1;0;0;0;-1;0;403446556;408695448;23697463
1385;6.75087e-15;-300;1671;16038;13726;1;435;-2.14748e+09;-3.73334e+06;-1;0;0;0;-1;0;403595745;408859464;23740065
1386;6.75087e-15;-300;1671;16038;13726;1;435;-2.14748e+09;-3.725e+06;-1;0;0;0;-1;0;403744601;409023151;23782629
1387;6.75087e-15;-300;1671;16038;13726;1;435;-2.14748e+09;-3.71668e+06;-1;0;0;0;-1;0;403893125;409186512;23825153
1388;6.75087e-15;-301;1671;16038;13726;1;435;-2.14748e+09;-3.70839e+06;0;0;0;0;0;0;404041318;409349546;23867638
1389;6.75087e-15;-302;1671;16038;13726;1;435;-2.14748e+09;-3.70012e+06;0;0;0;0;0;0;404189181;409512255;23910084
1390;6.75087e-15;-302;1671;16038;13726;1;435;-2.14748e+09;-3.69197e+06;-1;0;0;0;-1;0;404336716;409674639;23952491
1391;6.75087e-15;-303;1671;16038;13726;1;435;-2.14748e+09;-3.68365e+06;0;0;0;0;0;0;404483922;409836699;23994858
1392;6.75087e-15;-303;1671;16038;13726;1;435;-2.14748e+09;-3.67545e+06;-1;0;0;0;-1;0;404630800;409998436;24037185
1393;6.75087e-15;-303;1671;16038;13726;1;435;-2.14748e+09;-3.66738e+06;-1;0;0;0;-1;0;404777352;410159850;24079473
1394;6.75087e-15;-303;1671;16038;13726;1;435;-2.14748e+09;-3.65922e+06;-1;0;0;0;-1;0;404923579;410320944;24121722
1395;6.75087e-15;-304;1671;16038;13726;1;435;-2.14748e+09;-3.651e+06;0;0;0;0;0;0;405069481;410481716;24163930
1396;6.75087e-15;-305;1671;16038;13726;1;435;-2.14748e+09;-3.64299e+06;0;0;0;0;0;0;405215059;410642169;24206099
1397;6.75087e-15;-305;1671;16038;13726;1;435;-2.14748e+09;-3.63481e+06;-1;0;0;0;-1;0;405360313;410802302;24248228
1398;6.75087e-15;-305;1671;16038;13726;1;435;-2.14748e+09;-3.62675e+06;-1;0;0;0;-1;0;405505246;410962117;24290317
1399;6.75087e-15;-305;1671;16038;13726;1;435;-2.14748e+09;-3.61871e+06;-1;0;0;0;-1;0;405649858;411121615;24332366
1400;6.75087e-15;-306;1671;16038;13726;1;435;-2.14748e+09;-3.6107e+06;0;0;0;0;0;0;405794149;411280795;24374376
1401;6.75087e-15;-307;1671;16038;13726;1;435;-2.14748e+09;-3.60271e+06;0;0;0;0;0;0;405938120;411439660;24416344
1402;6.75087e-15;-308;1671;16038;13726;1;435;-2.14748e+09;-3.59474e+06;0;0;0;0;0;0;406081772;411598210;24458273
1403;6.75087e-15;-309;1671;16038;13726;1;435;-2.14748e+09;-3.58689e+06;0;0;0;0;0;0;406225107;411756444;24500161
1404;6.75087e-15;-310;1671;16038;13726;1;435;-2.14748e+09;-3.57887e+06;0;0;0;0;0;0;406368125;411914366;24542010
1405;6.75087e-15;-311;1671;16038;13726;1;435;-2.14748e+09;-3.57097e+06;0;0;0;0;0;0;406510826;412071974;24583817
1406;6.75087e-15;-311;1671;16038;13726;1;435;-2.14748e+09;-3.56309e+06;-1;0;0;0;-1;0;406653212;412229270;24625584
1407;6.75087e-15;-312;1671;16038;13726;1;435;-2.14748e+09;-3.55533e+06;0;0;0;0;0;0;406795283;412386255;24667311
1408;6.75087e-15;-313;1671;16038;13726;1;435;-2.14748e+09;-3.5474e+06;0;0;0;0;0;0;406937041;412542929;24708997
1409;6.75087e-15;-313;1671;16038;13726;1;435;-2.14748e+09;-3.53959e+06;-1;0;0;0;-1;0;407078485;412699293;24750643
1410;6.75087e-15;-314;1671;16038;13726;1;435;-2.14748e+09;-3.5318e+06;0;0;0;0;0;0;407219618;412855348;24792247
1411;6.75087e-15;-314;1671;16038;13726;1;435;-2.14748e+09;-3.52403e+06;-1;0;0;0;-1;0;407360439;413011094;24833811
1412;6.75087e-15;-315;1671;16038;13726;1;435;-2.14748e+09;-3.51628e+06;0;0;0;0;0;0;407500950;413166533;24875334
1413;6.75087e-15;-316;1671;16038;13726;1;435;-2.14748e+09;-3.50856e+06;0;0;0;0;0;0;407641151;413321665;24916816
1414;6.75087e-15;-316;1671;16038;13726;1;435;-2.14748e+09;-3.50085e+06;-1;0;0;0;-1;0;407781044;413476490;24958258
1415;6.75087e-15;-317;1671;16038;13726;1;435;-2.14748e+09;-3.49317e+06;0;0;0;0;0;0;407920628;413631010;24999658
1416;6.75087e-15;-318;1671;16038;13726;1;435;-2.14748e+09;-3.48551e+06;0;0;0;0;0;0;408059905;413785226;25041017
1417;6.75087e-15;-319;1671;16038;13726;1;435;-2.14748e+09;-3.47797e+06;0;0;0;0;0;0;408198876;413939137;25082335
1418;6.75087e-15;-319;1671;16038;13726;1;435;-2.14748e+09;-3.47025e+06;-1;0;0;0;-1;0;408337541;414092745;25123612
1419;6.75087e-15;-320;1671;16038;13726;1;435;-2.14748e+09;-3.46265e+06;0;0;0;0;0;0;408475901;414246050;25164847
1420;6.75087e-15;-320;1671;16038;13726;1;435;-2.14748e+09;-3.45508e+06;-1;0;0;0;-1;0;408613957;414399054;25206042
1421;6.75087e-15;-320;1671;16038;13726;1;435;-2.14748e+09;-3.44752e+06;-1;0;0;0;-1;0;408751711;414551757;25247195
1422;6.75087e-15;-320;1671;16038;13726;1;435;-2.14748e+09;-3.43999e+06;-1;0;0;0;-1;0;408889161;414704159;25288306
1423;6.75087e-15;-321;1671;16038;13726;1;435;-2.14748e+09;-3.43258e+06;0;0;0;0;0;0;409026310;414856261;25329376
1424;6.75087e-15;-322;1671;16038;13726;1;435;-2.14748e+09;-3.42508e+06;0;0;0;0;0;0;409163158;415008065;25370405
1425;6.75087e-15;-323;1671;16038;13726;1;435;-2.14748e+09;-3.41751e+06;0;0;0;0;0;0;409299706;415159570;25411392
1426;6.75087e-15;-323;1671;16038;13726;1;435;-2.14748e+09;-3.41016e+06;-1;0;0;0;-1;0;409435955;415310778;25452337
1427;6.75087e-15;-323;1671;16038;13726;1;435;-2.14748e+09;-3.40273e+06;-1;0;0;0;-1;0;409571905;415461689;25493241
1428;6.75087e-15;-323;1671;16038;13726;1;435;-2.14748e+09;-3.39522e+06;-1;0;0;0;-1;0;409707558;415612303;25534103
1429;6.75087e-15;-323;1671;16038;13726;1;435;-2.14748e+09;-3.38783e+06;-1;0;0;0;-1;0;409842913;415762623;25574923
1430;6.75087e-15;-324;1671;16038;13726;1;435;-2.14748e+09;-3.38046e+06;0;0;0;0;0;0;409977973;415912647;25615701
1431;6.75087e-15;-324;1671;16038;13726;1;435;-2.14748e+09;-3.37321e+06;-1;0;0;0;-1;0;410112737;416062378;25656437
1432;6.75087e-15;-324;1671;16038;13726;1;435;-2.14748e+09;-3.36578e+06;-1;0;0;0;-1;0;410247206;416211815;25697132
1433;6.75087e-15;-325;1671;16038;13726;1;435;-2.14748e+09;-3.35847e+06;0;0;0;0;0;0;410381381;416360960;25737785
1434;6.75087e-15;-325;1671;16038;13726;1;435;-2.14748e+09;-3.35118e+06;-1;0;0;0;-1;0;410515263;416509812;25778395
1435;6.75087e-15;-326;1671;16038;13726;1;435;-2.14748e+09;-3.34391e+06;0;0;0;0;0;0;410648853;416658373;25818964
1436;6.75087e-15;-327;1671;16038;13726;1;435;-2.14748e+09;-3.33666e+06;0;0;0;0;0;0;410782151;416806644;25859490
1437;6.75087e-15;-328;1671;16038;13726;1;435;-2.14748e+09;-3.32943e+06;0;0;0;0;0;0;410915159;416954625;25899974
1438;6.75087e-15;-328;1671;16038;13726;1;435;-2.14748e+09;-3.32222e+06;-1;0;0;0;-1;0;411047876;417102317;25940416
1439;6.75087e-15;-328;1671;16038;13726;1;435;-2.14748e+09;-3.31503e+06;-1;0;0;0;-1;0;411180304;417249720;25980816
1440;6.75087e-15;-328;1671;16038;13726;1;435;-2.14748e+09;-3.30786e+06;-1;0;0;0;-1;0;411312443;417396835;26021174
1441;6.75087e-15;-329;1671;16038;13726;1;435;-2.14748e+09;-3.3007e+06;0;0;0;0;0;0;411444294;417543663;26061489
1442;6.75087e-15;-329;1671;16038;13726;1;435;-2.14748e+09;-3.29357e+06;-1;0;0;0;-1;0;411575858;417690204;26101762
1443;6.75087e-15;-329;1671;16038;13726;1;435;-2.14748e+09;-3.28656e+06;-1;0;0;0;-1;0;411707136;417836460;26141992
1444;6.75087e-15;-330;1671;16038;13726;1;435;-2.14748e+09;-3.27936e+06;0;0;0;0;0;0;411838128;417982431;26182180
1445;6.75087e-15;-330;1671;16038;13726;1;435;-2.14748e+09;-3.27229e+06;-1;0;0;0;-1;0;411968835;418128116;26222325
1446;6.75087e-15;-330;1671;16038;13726;1;435;-2.14748e+09;-3.26523e+06;-1;0;0;0;-1;0;412099258;418273519;26262428
1447;6.75087e-15;-330;1671;16038;13726;1;435;-2.14748e+09;-3.2582e+06;-1;0;0;0;-1;0;412229397;418418638;26302488
1448;6.75087e-15;-330;1671;16038;13726;1;435;-2.14748e+09;-3.25118e+06;-1;0;0;0;-1;0;412359254;418563474;26342506
1449;6.75087e-15;-330;1671;16038;13726;1;435;-2.14748e+09;-3.24418e+06;-1;0;0;0;-1;0;412488828;418708028;26382481
1450;6.75087e-15;-331;1671;16038;13726;1;435;-2.14748e+09;-3.2372e+06;0;0;0;0;0;0;412618121;418852302;26422414
1451;6.75087e-15;-331;1671;16038;13726;1;435;-2.14748e+09;-3.23024e+06;-1;0;0;0;-1;0;412747134;418996294;26462303
1452;6.75087e-15;-331;1671;16038;13726;1;435;-2.14748e+09;-3.22329e+06;-1;0;0;0;-1;0;412875867;419140007;26502150
1453;6.75087e-15;-332;1671;16038;13726;1;435;-2.14748e+09;-3.21647e+06;0;0;0;0;0;0;413004320;419283441;26541954
1454;6.75087e-15;-333;1671;16038;13726;1;435;-2.14748e+09;-3.20946e+06;0;0;0;0;0;0;413132495;419426595;26581715
1455;6.75087e-15;-333;1671;16038;13726;1;435;-2.14748e+09;-3.20257e+06;-1;0;0;0;-1;0;413260392;419569472;26621434
1456;6.75087e-15;-334;1671;16038;13726;1;435;-2.14748e+09;-3.1957e+06;0;0;0;0;0;0;413388013;419712072;26661109
1457;6.75087e-15;-335;1671;16038;13726;1;435;-2.14748e+09;-3.18885e+06;0;0;0;0;0;0;413515357;419854395;26700742
1458;6.75087e-15;-336;1671;16038;13726;1;435;-2.14748e+09;-3.18202e+06;0;0;0;0;0;0;413642425;419996441;26740331
1459;6.75087e-15;-337;1671;16038;13726;1;435;-2.14748e+09;-3.1752e+06;0;0;0;0;0;0;413769218;420138213;26779878
1460;6.75087e-15;-338;1671;16038;13726;1;435;-2.14748e+09;-3.16841e+06;0;0;0;0;0;0;413895737;420279709;26819381
1461;6.75087e-15;-339;1671;16038;13726;1;435;-2.14748e+09;-3.16163e+06;0;0;0;0;0;0;414021983;420420932;26858841
1462;6.75087e-15;-340;1671;16038;13726;1;435;-2.14748e+09;-3.15487e+06;0;0;0;0;0;0;414147955;420561880;26898259
1463;6.75087e-15;-341;1671;16038;13726;1;435;-2.14748e+09;-3.14812e+06;0;0;0;0;0;0;414273656;420702556;26937633
1464;6.75087e-15;-342;1671;16038;13726;1;435;-2.14748e+09;-3.1414e+06;0;0;0;0;0;0;414399085;420842960;26976964
1465;6.75087e-15;-342;1671;16038;13726;1;435;-2.14748e+09;-3.13479e+06;-1;0;0;0;-1;0;414524243;420983092;27016252
1466;6.75087e-15;-343;1671;16038;13726;1;435;-2.14748e+09;-3.128e+06;0;0;0;0;0;0;414649131;421122953;27055496
1467;6.75087e-15;-343;1671;16038;13726;1;435;-2.14748e+09;-3.12133e+06;-1;0;0;0;-1;0;414773750;421262543;27094697
1468;6.75087e-15;-344;1671;16038;13726;1;435;-2.14748e+09;-3.11468e+06;0;0;0;0;0;0;414898099;421401864;27133855
1469;6.75087e-15;-345;1671;16038;13726;1;435;-2.14748e+09;-3.10804e+06;0;0;0;0;0;0;415022181;421540916;27172970
1470;6.75087e-15;-345;1671;16038;13726;1;435;-2.14748e+09;-3.10142e+06;-1;0;0;0;-1;0;415145996;421679699;27212041
1471;6.75087e-15;-346;1671;16038;13726;1;435;-2.14748e+09;-3.09482e+06;0;0;0;0;0;0;415269543;421818214;27251069
1472;6.75087e-15;-347;1671;16038;13726;1;435;-2.14748e+09;-3.08833e+06;0;0;0;0;0;0;415392825;421956461;27290054
1473;6.75087e-15;-347;1671;16038;13726;1;435;-2.14748e+09;-3.08176e+06;-1;0;0;0;-1;0;415515841;422094442;27328995
1474;6.75087e-15;-348;1671;16038;13726;1;435;-2.14748e+09;-3.07511e+06;0;0;0;0;0;0;415638593;422232157;27367892
1475;6.75087e-15;-348;1671;16038;13726;1;435;-2.14748e+09;-3.06858e+06;-1;0;0;0;-1;0;415761080;422369606;27406746
1476;6.75087e-15;-349;1671;16038;13726;1;435;-2.14748e+09;-3.06206e+06;0;0;0;0;0;0;415883305;422506790;27445557
1477;6.75087e-15;-349;1671;16038;13726;1;435;-2.14748e+09;-3.05556e+06;-1;0;0;0;-1;0;416005266;422643710;27484324
1478;6.75087e-15;-350;1671;16038;13726;1;435;-2.14748e+09;-3.04918e+06;0;0;0;0;0;0;416126965;422780366;27523048
1479;6.75087e-15;-351;1671;16038;13726;1;435;-2.14748e+09;-3.04262e+06;0;0;0;0;0;0;416248403;422916759;27561728
1480;6.75087e-15;-352;1671;16038;13726;1;435;-2.14748e+09;-3.03627e+06;0;0;0;0;0;0;416369581;423052890;27600364
1481;6.75087e-15;-352;1671;16038;13726;1;435;-2.14748e+09;-3.02974e+06;-1;0;0;0;-1;0;416490498;423188758;27638957
1482;6.75087e-15;-353;1671;16038;13726;1;435;-2.14748e+09;-3.02332e+06;0;0;0;0;0;0;416611155;423324366;27677506
1483;6.75087e-15;-353;1671;16038;13726;1;435;-2.14748e+09;-3.01702e+06;-1;0;0;0;-1;0;416731554;423459712;27716011
1484;6.75087e-15;-353;1671;16038;13726;1;435;-2.14748e+09;-3.01054e+06;-1;0;0;0;-1;0;416851695;423594798;27754473
1485;6.75087e-15;-353;1671;16038;13726;1;435;-2.14748e+09;-3.00427e+06;-1;0;0;0;-1;0;416971578;423729625;27792891
1486;6.75087e-15;-354;1671;16038;13726;1;435;-2.14748e+09;-2.99792e+06;0;0;0;0;0;0;417091204;423864192;27831265
1487;6.75087e-15;-354;1671;16038;13726;1;435;-2.14748e+09;-2.99149e+06;-1;0;0;0;-1;0;417210574;423998501;27869596
1488;6.75087e-15;-354;1671;16038;13726;1;435;-2.14748e+09;-2.98518e+06;-1;0;0;0;-1;0;417329689;424132552;27907882
1489;6.75087e-15;-355;1671;16038;13726;1;435;-2.14748e+09;-2.97888e+06;0;0;0;0;0;0;417448548;424266346;27946125
1490;6.75087e-15;-355;1671;16038;13726;1;435;-2.14748e+09;-2.97259e+06;-1;0;0;0;-1;0;417567153;424399884;27984324
1491;6.75087e-15;-355;1671;16038;13726;1;435;-2.14748e+09;-2.96632e+06;-1;0;0;0;-1;0;417685505;424533165;28022480
1492;6.75087e-15;-356;1671;16038;13726;1;435;-2.14748e+09;-2.96007e+06;0;0;0;0;0;0;417803603;424666190;28060591
1493;6.75087e-15;-356;1671;16038;13726;1;435;-2.14748e+09;-2.95384e+06;-1;0;0;0;-1;0;417921449;424798961;28098659
1494;6.75087e-15;-356;1671;16038;13726;1;435;-2.14748e+09;-2.94772e+06;-1;0;0;0;-1;0;418039043;424931477;28136682
1495;6.75087e-15;-356;1671;16038;13726;1;435;-2.14748e+09;-2.94141e+06;-1;0;0;0;-1;0;418156386;425063739;28174662
1496;6.75087e-15;-356;1671;16038;13726;1;435;-2.14748e+09;-2.93522e+06;-1;0;0;0;-1;0;418273479;425195748;28212598
1497;6.75087e-15;-356;1671;16038;13726;1;435;-2.14748e+09;-2.92905e+06;-1;0;0;0;-1;0;418390321;425327505;28250490
1498;6.75087e-15;-357;1671;16038;13726;1;435;-2.14748e+09;-2.9229e+06;0;0;0;0;0;0;418506914;425459009;28288338
1499;6.75087e-15;-357;1671;16038;13726;1;435;-2.14748e+09;-2.91676e+06;-1;0;0;0;-1;0;418623259;425590261;28326142
1500;6.75087e-15;-358;1671;16038;13726;1;435;-2.14748e+09;-2.91073e+06;0;0;0;0;0;0;418739355;425721262;28363902
1501;6.75087e-15;-358;1671;16038;13726;1;435;-2.14748e+09;-2.90452e+06;-1;0;0;0;-1;0;418855204;425852013;28401618
1502;6.75087e-15;-358;1671;16038;13726;1;435;-2.14748e+09;-2.89843e+06;-1;0;0;0;-1;0;418970806;425982514;28439290
1503;6.75087e-15;-358;1671;16038;13726;1;435;-2.14748e+09;-2.89235e+06;-1;0;0;0;-1;0;419086162;426112766;28476918
1504;6.75087e-15;-359;1671;16038;13726;1;435;-2.14748e+09;-2.88629e+06;0;0;0;0;0;0;419201272;426242769;28514502
1505;6.75087e-15;-360;1671;16038;13726;1;435;-2.14748e+09;-2.88024e+06;0;0;0;0;0;0;419316137;426372523;28552042
1506;6.75087e-15;-360;1671;16038;13726;1;435;-2.14748e+09;-2.87431e+06;-1;0;0;0;-1;0;419430758;426502030;28589538
1507;6.75087e-15;-360;1671;16038;13726;1;435;-2.14748e+09;-2.86829e+06;-1;0;0;0;-1;0;419545134;426631290;28626989
1508;6.75087e-15;-360;1671;16038;13726;1;435;-2.14748e+09;-2.86219e+06;-1;0;0;0;-1;0;419659268;426760303;28664397
1509;6.75087e-15;-361;1671;16038;13726;1;435;-2.14748e+09;-2.8562e+06;0;0;0;0;0;0;419773159;426889069;28701761
1510;6.75087e-15;-361;1671;16038;13726;1;435;-2.14748e+09;-2.85023e+06;-1;0;0;0;-1;0;419886808;427017591;28739080
1511;6.75087e-15;-362;1671;16038;13726;1;435;-2.14748e+09;-2.84427e+06;0;0;0;0;0;0;420000215;427145867;28776355
1512;6.75087e-15;-363;1671;16038;13726;1;435;-2.14748e+09;-2.83843e+06;0;0;0;0;0;0;420113382;427273899;28813587
1513;6.75087e-15;-364;1671;16038;13726;1;435;-2.14748e+09;-2.8324e+06;0;0;0;0;0;0;420226308;427401687;28850774
1514;6.75087e-15;-365;1671;16038;13726;1;435;-2.14748e+09;-2.82659e+06;0;0;0;0;0;0;420338994;427529231;28887917
1515;6.75087e-15;-365;1671;16038;13726;1;435;-2.14748e+09;-2.8207e+06;-1;0;0;0;-1;0;420451442;427656533;28925015
1516;6.75087e-15;-366;1671;16038;13726;1;435;-2.14748e+09;-2.81472e+06;0;0;0;0;0;0;420563651;427783592;28962070
1517;6.75087e-15;-366;1671;16038;13726;1;435;-2.14748e+09;-2.80885e+06;-1;0;0;0;-1;0;420675622;427910409;28999081
1518;6.75087e-15;-366;1671;16038;13726;1;435;-2.14748e+09;-2.803e+06;-1;0;0;0;-1;0;420787355;428036985;29036047
1519;6.75087e-15;-367;1671;16038;13726;1;435;-2.14748e+09;-2.79716e+06;0;0;0;0;0;0;420898852;428163321;29072969
1520;6.75087e-15;-367;1671;16038;13726;1;435;-2.14748e+09;-2.79134e+06;-1;0;0;0;-1;0;421010113;428289416;29109847
1521;6.75087e-15;-368;1671;16038;13726;1;435;-2.14748e+09;-2.78553e+06;0;0;0;0;0;0;421121138;428415271;29146680
1522;6.75087e-15;-369;1671;16038;13726;1;435;-2.14748e+09;-2.77983e+06;0;0;0;0;0;0;421231928;428540887;29183470
1523;6.75087e-15;-370;1671;16038;13726;1;435;-2.14748e+09;-2.77395e+06;0;0;0;0;0;0;421342484;428666265;29220215
1524;6.75087e-15;-371;1671;16038;13726;1;435;-2.14748e+09;-2.76819e+06;0;0;0;0;0;0;421452805;428791404;29256916
1525;6.75087e-15;-371;1671;16038;13726;1;435;-2.14748e+09;-2.76244e+06;-1;0;0;0;-1;0;421562894;428916306;29293573
1526;6.75087e-15;-372;1671;16038;13726;1;435;-2.14748e+09;-2.7567e+06;0;0;0;0;0;0;421672750;429040971;29330186
1527;6.75087e-15;-372;1671;16038;13726;1;435;-2.14748e+09;-2.75098e+06;-1;0;0;0;-1;0;421782373;429165399;29366754
1528;6.75087e-15;-373;1671;16038;13726;1;435;-2.14748e+09;-2.74527e+06;0;0;0;0;0;0;421891765;429289591;29403278
1529;6.75087e-15;-374;1671;16038;13726;1;435;-2.14748e+09;-2.73958e+06;0;0;0;0;0;0;422000926;429413548;29439758
1530;6.75087e-15;-375;1671;16038;13726;1;435;-2.14748e+09;-2.7339e+06;0;0;0;0;0;0;422109856;429537269;29476193
1531;6.75087e-15;-375;1671;16038;13726;1;435;-2.14748e+09;-2.72833e+06;-1;0;0;0;-1;0;422218556;429660756;29512585
1532;6.75087e-15;-375;1671;16038;13726;1;435;-2.14748e+09;-2.72268e+06;-1;0;0;0;-1;0;422327027;429784009;29548932
1533;6.75087e-15;-376;1671;16038;13726;1;435;-2.14748e+09;-2.71704e+06;0;0;0;0;0;0;422435269;429907028;29585235
1534;6.75087e-15;-376;1671;16038;13726;1;435;-2.14748e+09;-2.71132e+06;-1;0;0;0;-1;0;422543283;430029814;29621493
1535;6.75087e-15;-376;1670;16038;13726;1;435;-2.14748e+09;-2.70571e+06;0;0;0;0;0;0;422651069;430152368;29657707
1536;6.75087e-15;-377;1670;16038;13726;1;435;-2.14748e+09;-2.70011e+06;0;0;0;0;0;0;422758628;430274690;29693877
1537;6.75087e-15;-377;1670;16038;13726;1;435;-2.14748e+09;-2.69453e+06;-1;0;0;0;-1;0;422865960;430396780;29730003
1538;6.75087e-15;-377;1670;16038;13726;1;435;-2.14748e+09;-2.68896e+06;-1;0;0;0;-1;0;422973066;430518639;29766085
1539;6.75087e-15;-377;1670;16038;13726;1;435;-2.14748e+09;-2.68351e+06;-1;0;0;0;-1;0;423079947;430640268;29802122
1540;6.75087e-15;-378;1670;16038;13726;1;435;-2.14748e+09;-2.67786e+06;0;0;0;0;0;0;423186602;430761666;29838115
1541;6.75087e-15;-378;1670;16038;13726;1;435;-2.14748e+09;-2.67234e+06;-1;0;0;0;-1;0;423293034;430882835;29874064
1542;6.75087e-15;-379;1670;16038;13726;1;435;-2.14748e+09;-2.66682e+06;0;0;0;0;0;0;423399241;431003776;29909968
1543;6.75087e-15;-379;1670;16038;13726;1;435;-2.14748e+09;-2.66132e+06;-1;0;0;0;-1;0;423505225;431124487;29945828
1544;6.75087e-15;-380;1670;16038;13726;1;435;-2.14748e+09;-2.65584e+06;0;0;0;0;0;0;423610986;431244970;29981644
1545;6.75087e-15;-380;1670;16038;13726;1;435;-2.14748e+09;-2.65036e+06;-1;0;0;0;-1;0;423716525;431365226;30017416
1546;6.75087e-15;-380;1670;16038;13726;1;435;-2.14748e+09;-2.6449e+06;-1;0;0;0;-1;0;423821842;431485255;30053143
1547;6.75087e-15;-380;1670;16038;13726;1;435;-2.14748e+09;-2.63946e+06;-1;0;0;0;-1;0;423926938;431605057;30088826
1548;6.75087e-15;-380;1670;16038;13726;1;435;-2.14748e+09;-2.63402e+06;-1;0;0;0;-1;0;424031813;431724633;30124465
1549;6.75087e-15;-381;1670;16038;13726;1;435;-2.14748e+09;-2.6286e+06;0;0;0;0;0;0;424136468;431843983;30160060
1550;6.75087e-15;-381;1670;16038;13726;1;435;-2.14748e+09;-2.62319e+06;-1;0;0;0;-1;0;424240903;431963109;30195610
1551;6.75087e-15;-382;1670;16038;13726;1;435;-2.14748e+09;-2.6178e+06;0;0;0;0;0;0;424345119;432082009;30231116
1552;6.75087e-15;-383;1670;16038;13726;1;435;-2.14748e+09;-2.61242e+06;0;0;0;0;0;0;424449117;432200685;30266578
1553;6.75087e-15;-383;1670;16038;13726;1;435;-2.14748e+09;-2.60705e+06;-1;0;0;0;-1;0;424552897;432319138;30301995
1554;6.75087e-15;-383;1670;16038;13726;1;435;-2.14748e+09;-2.6017e+06;-1;0;0;0;-1;0;424656459;432437367;30337369
1555;6.75087e-15;-384;1670;16038;13726;1;435;-2.14748e+09;-2.59636e+06;0;0;0;0;0;0;424759804;432555374;30372698
1556;6.75087e-15;-385;1670;16038;13726;1;435;-2.14748e+09;-2.59103e+06;0;0;0;0;0;0;424862932;432673158;30407983
1557;6.75087e-15;-386;1670;16038;13726;1;435;-2.14748e+09;-2.58571e+06;0;0;0;0;0;0;424965845;432790721;30443223
1558;6.75087e-15;-386;1670;16038;13726;1;435;-2.14748e+09;-2.58041e+06;-1;0;0;0;-1;0;425068542;432908062;30478420
1559;6.75087e-15;-387;1670;16038;13726;1;435;-2.14748e+09;-2.57512e+06;0;0;0;0;0;0;425171024;433025182;30513572
1560;6.75087e-15;-387;1670;16038;13726;1;435;-2.14748e+09;-2.56984e+06;-1;0;0;0;-1;0;425273291;433142082;30548680
1561;6.75087e-15;-387;1670;16038;13726;1;435;-2.14748e+09;-2.56458e+06;-1;0;0;0;-1;0;425375345;433258762;30583744
1562;6.75087e-15;-388;1670;16038;13726;1;435;-2.14748e+09;-2.55932e+06;0;0;0;0;0;0;425477185;433375222;30618763
1563;6.75087e-15;-389;1670;16038;13726;1;435;-2.14748e+09;-2.55408e+06;0;0;0;0;0;0;425578813;433491464;30653739
1564;6.75087e-15;-389;1670;16038;13726;1;435;-2.14748e+09;-2.54886e+06;-1;0;0;0;-1;0;425680228;433607487;30688670
1565;6.75087e-15;-390;1670;16038;13726;1;435;-2.14748e+09;-2.54374e+06;0;0;0;0;0;0;425781431;433723292;30723557
1566;6.75087e-15;-390;1670;16038;13726;1;435;-2.14748e+09;-2.53854e+06;-1;0;0;0;-1;0;425882423;433838879;30758400
1567;6.75087e-15;-391;1670;16038;13726;1;435;-2.14748e+09;-2.53325e+06;0;0;0;0;0;0;425983204;433954249;30793199
1568;6.75087e-15;-391;1670;16038;13726;1;435;-2.14748e+09;-2.52808e+06;-1;0;0;0;-1;0;426083774;434069402;30827953
1569;6.75087e-15;-391;1670;16038;13726;1;435;-2.14748e+09;-2.52291e+06;-1;0;0;0;-1;0;426184134;434184339;30862664
1570;6.75087e-15;-391;1670;16038;13726;1;435;-2.14748e+09;-2.51776e+06;-1;0;0;0;-1;0;426284286;434299060;30897330
1571;6.75087e-15;-391;1670;16038;13726;1;435;-2.14748e+09;-2.51262e+06;-1;0;0;0;-1;0;426384228;434413566;30931952
1572;6.75087e-15;-391;1670;16038;13726;1;435;-2.14748e+09;-2.5075e+06;-1;0;0;0;-1;0;426483962;434527857;30966530
1573;6.75087e-15;-392;1670;16038;13726;1;435;-2.14748e+09;-2.50248e+06;0;0;0;0;0;0;426583488;434641934;31001064
1574;6.75087e-15;-393;1670;16038;13726;1;435;-2.14748e+09;-2.49728e+06;0;0;0;0;0;0;426682806;434755796;31035554
1575;6.75087e-15;-393;1670;16038;13726;1;435;-2.14748e+09;-2.49219e+06;-1;0;0;0;-1;0;426781918;434869445;31070000
1576;6.75087e-15;-393;1670;16038;13726;1;435;-2.14748e+09;-2.48711e+06;-1;0;0;0;-1;0;426880823;434982881;31104401
1577;6.75087e-15;-393;1670;16038;13726;1;435;-2.14748e+09;-2.48204e+06;-1;0;0;0;-1;0;426979522;435096104;31138759
1578;6.75087e-15;-393;1670;16038;13726;1;435;-2.14748e+09;-2.47699e+06;-1;0;0;0;-1;0;427078016;435209115;31173072
1579;6.75087e-15;-394;1670;16038;13726;1;435;-2.14748e+09;-2.47195e+06;0;0;0;0;0;0;427176305;435321915;31207342
1580;6.75087e-15;-395;1670;16038;13726;1;435;-2.14748e+09;-2.46692e+06;0;0;0;0;0;0;427274389;435434503;31241567
1581;6.75087e-15;-396;1670;16038;13726;1;435;-2.14748e+09;-2.4619e+06;0;0;0;0;0;0;427372269;435546880;31275748
1582;6.75087e-15;-396;1670;16038;13726;1;435;-2.14748e+09;-2.45689e+06;-1;0;0;0;-1;0;427469946;435659046;31309886
1583;6.75087e-15;-397;1670;16038;13726;1;435;-2.14748e+09;-2.452e+06;0;0;0;0;0;0;427567419;435771003;31343979
1584;6.75087e-15;-398;1670;16038;13726;1;435;-2.14748e+09;-2.44692e+06;0;0;0;0;0;0;427664690;435882750;31378029
1585;6.75087e-15;-399;1670;16038;13726;1;435;-2.14748e+09;-2.44204e+06;0;0;0;0;0;0;427761759;435994288;31412034
1586;6.75087e-15;-400;1670;16038;13726;1;435;-2.14748e+09;-2.43699e+06;0;0;0;0;0;0;427858627;436105618;31445995
1587;6.75087e-15;-400;1670;16038;13726;1;435;-2.14748e+09;-2.43204e+06;-1;0;0;0;-1;0;427955293;436216739;31479913
1588;6.75087e-15;-401;1670;16038;13726;1;435;-2.14748e+09;-2.4271e+06;0;0;0;0;0;0;428051759;436327652;31513786
1589;6.75087e-15;-402;1670;16038;13726;1;435;-2.14748e+09;-2.42218e+06;0;0;0;0;0;0;428148024;436438358;31547616
1590;6.75087e-15;-403;1670;16038;13726;1;435;-2.14748e+09;-2.41727e+06;0;0;0;0;0;0;428244090;436548857;31581402
1591;6.75087e-15;-403;1670;16038;13726;1;435;-2.14748e+09;-2.41237e+06;-1;0;0;0;-1;0;428339956;436659149;31615143
1592;6.75087e-15;-403;1670;16038;13726;1;435;-2.14748e+09;-2.40748e+06;-1;0;0;0;-1;0;428435623;436769235;31648841
1593;6.75087e-15;-403;1670;16038;13726;1;435;-2.14748e+09;-2.4026e+06;-1;0;0;0;-1;0;428531093;436879116;31682495
1594;6.75087e-15;-404;1670;16038;13726;1;435;-2.14748e+09;-2.39774e+06;0;0;0;0;0;0;428626364;436988791;31716105
1595;6.75087e-15;-404;1670;16038;13726;1;435;-2.14748e+09;-2.39288e+06;-1;0;0;0;-1;0;428721438;437098262;31749672
1596;6.75087e-15;-405;1670;16038;13726;1;435;-2.14748e+09;-2.38804e+06;0;0;0;0;0;0;428816315;437207528;31783194
1597;6.75087e-15;-405;1670;16038;13726;1;435;-2.14748e+09;-2.38331e+06;-1;0;0;0;-1;0;428910996;437316590;31816673
1598;6.75087e-15;-405;1670;16038;13726;1;435;-2.14748e+09;-2.37838e+06;-1;0;0;0;-1;0;429005480;437425449;31850108
1599;6.75087e-15;-406;1670;16038;13726;1;435;-2.14748e+09;-2.37358e+06;0;0;0;0;0;0;429099769;437534105;31883499
1600;6.75087e-15;-406;1670;16038;13726;1;435;-2.14748e+09;-2.36878e+06;-1;0;0;0;-1;0;429193863;437642557;31916846
1601;6.75087e-15;-406;1670;16038;13726;1;435;-2.14748e+09;-2.36399e+06;-1;0;0;0;-1;0;429287762;437750808;31950150
1602;6.75087e-15;-407;1670;16038;13726;1;435;-2.14748e+09;-2.35922e+06;0;0;0;0;0;0;429381467;437858857;31983409
1603;6.75087e-15;-408;1670;16038;13726;1;435;-2.14748e+09;-2.35445e+06;0;0;0;0;0;0;429474978;437966704;32016626
1604;6.75087e-15;-408;1670;16038;13726;1;435;-2.14748e+09;-2.3497e+06;-1;0;0;0;-1;0;429568296;438074350;32049798
1605;6.75087e-15;-409;1670;16038;13726;1;435;-2.14748e+09;-2.34496e+06;0;0;0;0;0;0;429661421;438181796;32082927
1606;6.75087e-15;-409;1670;16038;13726;1;435;-2.14748e+09;-2.34023e+06;-1;0;0;0;-1;0;429754354;438289041;32116012
1607;6.75087e-15;-409;1670;16038;13726;1;435;-2.14748e+09;-2.33551e+06;-1;0;0;0;-1;0;429847095;438396087;32149053
1608;6.75087e-15;-409;1670;16038;13726;1;435;-2.14748e+09;-2.3308e+06;-1;0;0;0;-1;0;429939644;438502933;32182051
1609;6.75087e-15;-409;1670;16038;13726;1;435;-2.14748e+09;-2.3261e+06;-1;0;0;0;-1;0;430032002;438609580;32215005
1610;6.75087e-15;-410;1670;16038;13726;1;435;-2.14748e+09;-2.32141e+06;0;0;0;0;0;0;430124170;438716028;32247916
1611;6.75087e-15;-411;1670;16038;13726;1;435;-2.14748e+09;-2.31674e+06;0;0;0;0;0;0;430216148;438822279;32280783
1612;6.75087e-15;-411;1670;16038;13726;1;435;-2.14748e+09;-2.31207e+06;-1;0;0;0;-1;0;430307935;438928331;32313606
1613;6.75087e-15;-412;1670;16038;13726;1;435;-2.14748e+09;-2.30742e+06;0;0;0;0;0;0;430399534;439034187;32346386
1614;6.75087e-15;-413;1670;16038;13726;1;435;-2.14748e+09;-2.30277e+06;0;0;0;0;0;0;430490943;439139845;32379122
1615;6.75087e-15;-414;1670;16038;13726;1;435;-2.14748e+09;-2.29814e+06;0;0;0;0;0;0;430582165;439245307;32411815
1616;6.75087e-15;-414;1670;16038;13726;1;435;-2.14748e+09;-2.29352e+06;-1;0;0;0;-1;0;430673198;439350573;32444464
1617;6.75087e-15;-415;1670;16038;13726;1;435;-2.14748e+09;-2.28891e+06;0;0;0;0;0;0;430764044;439455643;32477070
1618;6.75087e-15;-415;1670;16038;13726;1;435;-2.14748e+09;-2.28431e+06;-1;0;0;0;-1;0;430854702;439560517;32509633
1619;6.75087e-15;-415;1670;16038;13726;1;435;-2.14748e+09;-2.27972e+06;-1;0;0;0;-1;0;430945174;439665197;32542152
1620;6.75087e-15;-416;1670;16038;13726;1;435;-2.14748e+09;-2.27514e+06;0;0;0;0;0;0;431035460;439769682;32574627
1621;6.75087e-15;-416;1670;16038;13726;1;435;-2.14748e+09;-2.27057e+06;-1;0;0;0;-1;0;431125560;439873973;32607059
1622;6.75087e-15;-417;1670;16038;13726;1;435;-2.14748e+09;-2.26601e+06;0;0;0;0;0;0;431215475;439978071;32639448
1623;6.75087e-15;-418;1670;16038;13726;1;435;-2.14748e+09;-2.26146e+06;0;0;0;0;0;0;431305204;440081974;32671794
1624;6.75087e-15;-419;1670;16038;13726;1;435;-2.14748e+09;-2.25692e+06;0;0;0;0;0;0;431394749;440185685;32704096
1625;6.75087e-15;-420;1670;16038;13726;1;435;-2.14748e+09;-2.2524e+06;0;0;0;0;0;0;431484110;440289204;32736355
1626;6.75087e-15;-421;1670;16038;13726;1;435;-2.14748e+09;-2.24788e+06;0;0;0;0;0;0;431573288;440392530;32768570
1627;6.75087e-15;-422;1670;16038;13726;1;435;-2.14748e+09;-2.24347e+06;0;0;0;0;0;0;431662282;440495664;32800743
1628;6.75087e-15;-423;1670;16038;13726;1;435;-2.14748e+09;-2.23888e+06;0;0;0;0;0;0;431751093;440598607;32832872
1629;6.75087e-15;-424;1670;16038;13726;1;435;-2.14748e+09;-2.23449e+06;0;0;0;0;0;0;431839722;440701359;32864958
1630;6.75087e-15;-424;1670;16038;13726;1;435;-2.14748e+09;-2.22992e+06;-1;0;0;0;-1;0;431928169;440803921;32897000
1631;6.75087e-15;-424;1670;16038;13726;1;435;-2.14748e+09;-2.22545e+06;-1;0;0;0;-1;0;432016434;440906292;32929000
1632;6.75087e-15;-425;1670;16038;13726;1;435;-2.14748e+09;-2.221e+06;0;0;0;0;0;0;432104518;441008473;32960956
1633;6.75087e-15;-425;1670;16038;13726;1;435;-2.14748e+09;-2.21655e+06;-1;0;0;0;-1;0;432192422;441110465;32992869
1634;6.75087e-15;-425;1670;16038;13726;1;435;-2.14748e+09;-2.21212e+06;-1;0;0;0;-1;0;432280145;441212268;33024740
1635;6.75087e-15;-426;1670;16038;13726;1;435;-2.14748e+09;-2.2077e+06;0;0;0;0;0;0;432367688;441313882;33056567
1636;6.75087e-15;-426;1670;16038;13726;1;435;-2.14748e+09;-2.20328e+06;-1;0;0;0;-1;0;432455052;441415307;33088351
1637;6.75087e-15;-427;1670;16038;13726;1;435;-2.14748e+09;-2.19888e+06;0;0;0;0;0;0;432542236;441516545;33120091
1638;6.75087e-15;-428;1670;16038;13726;1;435;-2.14748e+09;-2.19448e+06;0;0;0;0;0;0;432629242;441617595;33151789
1639;6.75087e-15;-429;1670;16038;13726;1;435;-2.14748e+09;-2.1901e+06;0;0;0;0;0;0;432716070;441718458;33183444
1640;6.75087e-15;-429;1670;16038;13726;1;435;-2.14748e+09;-2.18572e+06;-1;0;0;0;-1;0;432802720;441819135;33215056
1641;6.75087e-15;-430;1670;16038;13726;1;435;-2.14748e+09;-2.18136e+06;0;0;0;0;0;0;432889192;441919625;33246625
1642;6.75087e-15;-430;1670;16038;13726;1;435;-2.14748e+09;-2.17701e+06;-1;0;0;0;-1;0;432975488;442019928;33278151
1643;6.75087e-15;-431;1670;16038;13726;1;435;-2.14748e+09;-2.17266e+06;0;0;0;0;0;0;433061607;442120047;33309634
1644;6.75087e-15;-431;1670;16038;13726;1;435;-2.14748e+09;-2.16833e+06;-1;0;0;0;-1;0;433147549;442219979;33341075
1645;6.75087e-15;-432;1670;16038;13726;1;435;-2.14748e+09;-2.164e+06;0;0;0;0;0;0;433233316;442319727;33372472
1646;6.75087e-15;-433;1670;16038;13726;1;435;-2.14748e+09;-2.15969e+06;0;0;0;0;0;0;433318907;442419291;33403827
1647;6.75087e-15;-434;1670;16038;13726;1;435;-2.14748e+09;-2.15548e+06;0;0;0;0;0;0;433404324;442518670;33435139
1648;6.75087e-15;-434;1670;16038;13726;1;435;-2.14748e+09;-2.15109e+06;-1;0;0;0;-1;0;433489565;442617865;33466408
1649;6.75087e-15;-435;1670;16038;13726;1;435;-2.14748e+09;-2.1468e+06;0;0;0;0;0;0;433574633;442716877;33497634
1650;6.75087e-15;-435;1670;16038;13726;1;435;-2.14748e+09;-2.14263e+06;-1;0;0;0;-1;0;433659527;442815706;33528818
1651;6.75087e-15;-435;1670;16038;13726;1;435;-2.14748e+09;-2.13836e+06;-1;0;0;0;-1;0;433744247;442914352;33559959
1652;6.75087e-15;-435;1670;16038;13726;1;435;-2.14748e+09;-2.13401e+06;-1;0;0;0;-1;0;433828794;443012816;33591057
1653;6.75087e-15;-436;1670;16038;13726;1;435;-2.14748e+09;-2.12976e+06;0;0;0;0;0;0;433913168;443111098;33622112
1654;6.75087e-15;-437;1670;16038;13726;1;435;-2.14748e+09;-2.12552e+06;0;0;0;0;0;0;433997371;443209198;33653125
1655;6.75087e-15;-438;1670;16038;13726;1;435;-2.14748e+09;-2.1213e+06;0;0;0;0;0;0;434081401;443307117;33684096
1656;6.75087e-15;-438;1670;16038;13726;1;435;-2.14748e+09;-2.11708e+06;-1;0;0;0;-1;0;434165260;443404855;33715023
1657;6.75087e-15;-438;1670;16038;13726;1;435;-2.14748e+09;-2.11287e+06;-1;0;0;0;-1;0;434248948;443502413;33745909
1658;6.75087e-15;-438;1670;16038;13726;1;435;-2.14748e+09;-2.10877e+06;-1;0;0;0;-1;0;434332466;443599791;33776751
1659;6.75087e-15;-438;1670;16038;13726;1;435;-2.14748e+09;-2.10448e+06;-1;0;0;0;-1;0;434415813;443696988;33807552
1660;6.75087e-15;-439;1670;16038;13726;1;435;-2.14748e+09;-2.1004e+06;0;0;0;0;0;0;434498990;443794007;33838309
1661;6.75087e-15;-440;1670;16038;13726;1;435;-2.14748e+09;-2.09623e+06;0;0;0;0;0;0;434581997;443890846;33869025
1662;6.75087e-15;-441;1670;16038;13726;1;435;-2.14748e+09;-2.09197e+06;0;0;0;0;0;0;434664835;443987506;33899698
1663;6.75087e-15;-441;1670;16038;13726;1;435;-2.14748e+09;-2.08782e+06;-1;0;0;0;-1;0;434747505;444083988;33930328
1664;6.75087e-15;-441;1670;16038;13726;1;435;-2.14748e+09;-2.08367e+06;-1;0;0;0;-1;0;434830006;444180292;33960916
1665;6.75087e-15;-441;1670;16038;13726;1;435;-2.14748e+09;-2.07954e+06;-1;0;0;0;-1;0;434912340;444276419;33991462
1666;6.75087e-15;-441;1670;16038;13726;1;435;-2.14748e+09;-2.07542e+06;-1;0;0;0;-1;0;434994505;444372368;34021966
1667;6.75087e-15;-441;1670;16038;13726;1;435;-2.14748e+09;-2.0713e+06;-1;0;0;0;-1;0;435076504;444468140;34052427
1668;6.75087e-15;-441;1670;16038;13726;1;435;-2.14748e+09;-2.0672e+06;-1;0;0;0;-1;0;435158335;444563736;34082846
1669;6.75087e-15;-441;1670;16038;13726;1;435;-2.14748e+09;-2.0632e+06;-1;0;0;0;-1;0;435240001;444659155;34113223
1670;6.75087e-15;-442;1670;16038;13726;1;435;-2.14748e+09;-2.05901e+06;0;0;0;0;0;0;435321499;444754399;34143558
1671;6.75087e-15;-443;1670;16038;13726;1;435;-2.14748e+09;-2.05503e+06;0;0;0;0;0;0;435402833;444849467;34173850
1672;6.75087e-15;-443;1670;16038;13726;1;435;-2.14748e+09;-2.05086e+06;-1;0;0;0;-1;0;435484001;444944359;34204101
1673;6.75087e-15;-444;1670;16038;13726;1;435;-2.14748e+09;-2.0468e+06;0;0;0;0;0;0;435565004;445039077;34234309
1674;6.75087e-15;-444;1670;16038;13726;1;435;-2.14748e+09;-2.04275e+06;-1;0;0;0;-1;0;435645842;445133621;34264475
1675;6.75087e-15;-445;1670;16038;13726;1;435;-2.14748e+09;-2.03881e+06;0;0;0;0;0;0;435726516;445227990;34294599
1676;6.75087e-15;-445;1670;16038;13726;1;435;-2.14748e+09;-2.03468e+06;-1;0;0;0;-1;0;435807027;445322185;34324681
1677;6.75087e-15;-446;1670;16038;13726;1;435;-2.14748e+09;-2.03066e+06;0;0;0;0;0;0;435887373;445416207;34354721
1678;6.75087e-15;-447;1670;16038;13726;1;435;-2.14748e+09;-2.02674e+06;0;0;0;0;0;0;435967557;445510056;34384720
1679;6.75087e-15;-447;1670;16038;13726;1;435;-2.14748e+09;-2.02273e+06;-1;0;0;0;-1;0;436047578;445603732;34414676
1680;6.75087e-15;-447;1670;16038;13726;1;435;-2.14748e+09;-2.01864e+06;-1;0;0;0;-1;0;436127436;445697236;34444590
1681;6.75087e-15;-447;1670;16038;13726;1;435;-2.14748e+09;-2.01465e+06;-1;0;0;0;-1;0;436207133;445790568;34474463
1682;6.75087e-15;-448;1670;16038;13726;1;435;-2.14748e+09;-2.01067e+06;0;0;0;0;0;0;436286668;445883728;34504293
1683;6.75087e-15;-449;1670;16038;13726;1;435;-2.14748e+09;-2.0067e+06;0;0;0;0;0;0;436366041;445976716;34534082
1684;6.75087e-15;-450;1670;16038;13726;1;435;-2.14748e+09;-2.00274e+06;0;0;0;0;0;0;436445254;446069533;34563829
1685;6.75087e-15;-451;1670;16038;13726;1;435;-2.14748e+09;-1.99878e+06;0;0;0;0;0;0;436524306;446162180;34593535
1686;6.75087e-15;-452;1670;16038;13726;1;435;-2.14748e+09;-1.99484e+06;0;0;0;0;0;0;436603198;446254656;34623198
1687;6.75087e-15;-452;1670;16038;13726;1;435;-2.14748e+09;-1.9909e+06;-1;0;0;0;-1;0;436681930;446346962;34652820
1688;6.75087e-15;-453;1670;16038;13726;1;435;-2.14748e+09;-1.98698e+06;0;0;0;0;0;0;436760502;446439099;34682400
1689;6.75087e-15;-453;1670;16038;13726;1;435;-2.14748e+09;-1.98306e+06;-1;0;0;0;-1;0;436838916;446531066;34711939
1690;6.75087e-15;-454;1670;16038;13726;1;435;-2.14748e+09;-1.97915e+06;0;0;0;0;0;0;436917170;446622864;34741436
1691;6.75087e-15;-454;1670;16038;13726;1;435;-2.14748e+09;-1.97525e+06;-1;0;0;0;-1;0;436995267;446714493;34770892
1692;6.75087e-15;-454;1670;16038;13726;1;435;-2.14748e+09;-1.97136e+06;-1;0;0;0;-1;0;437073205;446805954;34800305
1693;6.75087e-15;-455;1670;16038;13726;1;435;-2.14748e+09;-1.96747e+06;0;0;0;0;0;0;437150985;446897247;34829678
1694;6.75087e-15;-455;1670;16038;13726;1;435;-2.14748e+09;-1.9636e+06;-1;0;0;0;-1;0;437228608;446988372;34859009
1695;6.75087e-15;-456;1670;16038;13726;1;435;-2.14748e+09;-1.95973e+06;0;0;0;0;0;0;437306074;447079330;34888298
1696;6.75087e-15;-456;1670;16038;13726;1;435;-2.14748e+09;-1.95588e+06;-1;0;0;0;-1;0;437383383;447170120;34917547
1697;6.75087e-15;-457;1670;16038;13726;1;435;-2.14748e+09;-1.95203e+06;0;0;0;0;0;0;437460536;447260744;34946753
1698;6.75087e-15;-457;1670;16038;13726;1;435;-2.14748e+09;-1.94828e+06;-1;0;0;0;-1;0;437537534;447351202;34975919
1699;6.75087e-15;-458;1670;16038;13726;1;435;-2.14748e+09;-1.94445e+06;0;0;0;0;0;0;437614375;447441493;35005043
1700;6.75087e-15;-459;1670;16038;13726;1;435;-2.14748e+09;-1.94053e+06;0;0;0;0;0;0;437691061;447531619;35034126
1701;6.75087e-15;-460;1670;16038;13726;1;435;-2.14748e+09;-1.93671e+06;0;0;0;0;0;0;437767593;447621579;35063167
1702;6.75087e-15;-460;1670;16038;13726;1;435;-2.14748e+09;-1.9329e+06;-1;0;0;0;-1;0;437843969;447711374;35092167
1703;6.75087e-15;-461;1670;16038;13726;1;435;-2.14748e+09;-1.92911e+06;0;0;0;0;0;0;437920192;447801005;35121127
1704;6.75087e-15;-461;1670;16038;13726;1;435;-2.14748e+09;-1.92532e+06;-1;0;0;0;-1;0;437996261;447890470;35150045
1705;6.75087e-15;-462;1670;16038;13726;1;435;-2.14748e+09;-1.92153e+06;0;0;0;0;0;0;438072176;447979772;35178921
1706;6.75087e-15;-463;1670;16038;13726;1;435;-2.14748e+09;-1.91776e+06;0;0;0;0;0;0;438147938;448068910;35207757
1707;6.75087e-15;-464;1670;16038;13726;1;435;-2.14748e+09;-1.91409e+06;0;0;0;0;0;0;438223547;448157884;35236552
1708;6.75087e-15;-465;1670;16038;13726;1;435;-2.14748e+09;-1.91024e+06;0;0;0;0;0;0;438299003;448246696;35265306
1709;6.75087e-15;-465;1670;16038;13726;1;435;-2.14748e+09;-1.90649e+06;-1;0;0;0;-1;0;438374308;448335344;35294018
1710;6.75087e-15;-465;1670;16038;13726;1;435;-2.14748e+09;-1.90274e+06;-1;0;0;0;-1;0;438449460;448423830;35322690
1711;6.75087e-15;-466;1670;16038;13726;1;435;-2.14748e+09;-1.89901e+06;0;0;0;0;0;0;438524461;448512153;35351321
1712;6.75087e-15;-467;1670;16038;13726;1;435;-2.14748e+09;-1.89529e+06;0;0;0;0;0;0;438599311;448600315;35379911
1713;6.75087e-15;-468;1670;16038;13726;1;435;-2.14748e+09;-1.89167e+06;0;0;0;0;0;0;438674010;448688315;35408460
1714;6.75087e-15;-469;1670;16038;13726;1;435;-2.14748e+09;-1.88786e+06;0;0;0;0;0;0;438748559;448776154;35436968
1715;6.75087e-15;-470;1670;16038;13726;1;435;-2.14748e+09;-1.88426e+06;0;0;0;0;0;0;438822957;448863832;35465436
1716;6.75087e-15;-470;1670;16038;13726;1;435;-2.14748e+09;-1.88047e+06;-1;0;0;0;-1;0;438897206;448951349;35493863
1717;6.75087e-15;-471;1670;16038;13726;1;435;-2.14748e+09;-1.87678e+06;0;0;0;0;0;0;438971305;449038706;35522249
1718;6.75087e-15;-471;1670;16038;13726;1;435;-2.14748e+09;-1.87311e+06;-1;0;0;0;-1;0;439045255;449125903;35550594
1719;6.75087e-15;-471;1670;16038;13726;1;435;-2.14748e+09;-1.86944e+06;-1;0;0;0;-1;0;439119056;449212940;35578899
1720;6.75087e-15;-472;1670;16038;13726;1;435;-2.14748e+09;-1.86588e+06;0;0;0;0;0;0;439192709;449299818;35607163
1721;6.75087e-15;-473;1670;16038;13726;1;435;-2.14748e+09;-1.86213e+06;0;0;0;0;0;0;439266213;449386536;35635386
1722;6.75087e-15;-474;1670;16038;13726;1;435;-2.14748e+09;-1.85848e+06;0;0;0;0;0;0;439339570;449473096;35663569
1723;6.75087e-15;-475;1670;16038;13726;1;435;-2.14748e+09;-1.85495e+06;0;0;0;0;0;0;439412779;449559498;35691711
1724;6.75087e-15;-475;1670;16038;13726;1;435;-2.14748e+09;-1.85122e+06;-1;0;0;0;-1;0;439485841;449645741;35719813
1725;6.75087e-15;-476;1670;16038;13726;1;435;-2.14748e+09;-1.8476e+06;0;0;0;0;0;0;439558756;449731826;35747875
1726;6.75087e-15;-477;1670;16038;13726;1;435;-2.14748e+09;-1.84398e+06;0;0;0;0;0;0;439631524;449817754;35775896
1727;6.75087e-15;-478;1670;16038;13726;1;435;-2.14748e+09;-1.84038e+06;0;0;0;0;0;0;439704146;449903525;35803876
1728;6.75087e-15;-478;1670;16038;13726;1;435;-2.14748e+09;-1.83678e+06;-1;0;0;0;-1;0;439776623;449989138;35831817
1729;6.75087e-15;-478;1670;16038;13726;1;435;-2.14748e+09;-1.83319e+06;-1;0;0;0;-1;0;439848954;450074595;35859717
1730;6.75087e-15;-479;1670;16038;13726;1;435;-2.14748e+09;-1.82971e+06;0;0;0;0;0;0;439921139;450159896;35887576
1731;6.75087e-15;-479;1670;16038;13726;1;435;-2.14748e+09;-1.82604e+06;-1;0;0;0;-1;0;439993180;450245041;35915396
1732;6.75087e-15;-480;1670;16038;13726;1;435;-2.14748e+09;-1.82247e+06;0;0;0;0;0;0;440065076;450330030;35943175
1733;6.75087e-15;-481;1670;16038;13726;1;435;-2.14748e+09;-1.81891e+06;0;0;0;0;0;0;440136828;450414863;35970914
1734;6.75087e-15;-482;1670;16038;13726;1;435;-2.14748e+09;-1.81536e+06;0;0;0;0;0;0;440208435;450499542;35998613
1735;6.75087e-15;-482;1670;16038;13726;1;435;-2.14748e+09;-1.81182e+06;-1;0;0;0;-1;0;440279899;450584065;36026272
1736;6.75087e-15;-483;1670;16038;13726;1;435;-2.14748e+09;-1.80828e+06;0;0;0;0;0;0;440351220;450668434;36053891
1737;6.75087e-15;-484;1670;16038;13726;1;435;-2.14748e+09;-1.80476e+06;0;0;0;0;0;0;440422398;450752649;36081469
1738;6.75087e-15;-485;1670;16038;13726;1;435;-2.14748e+09;-1.80123e+06;0;0;0;0;0;0;440493433;450836710;36109008
1739;6.75087e-15;-485;1670;16038;13726;1;435;-2.14748e+09;-1.79772e+06;-1;0;0;0;-1;0;440564326;450920617;36136507
1740;6.75087e-15;-486;1670;16038;13726;1;435;-2.14748e+09;-1.79422e+06;0;0;0;0;0;0;440635076;451004371;36163966
1741;6.75087e-15;-486;1670;16038;13726;1;435;-2.14748e+09;-1.79072e+06;-1;0;0;0;-1;0;440705685;451087972;36191385
1742;6.75087e-15;-487;1670;16038;13726;1;435;-2.14748e+09;-1.78723e+06;0;0;0;0;0;0;440776152;451171421;36218764
1743;6.75087e-15;-487;1670;16038;13726;1;435;-2.14748e+09;-1.78375e+06;-1;0;0;0;-1;0;440846479;451254716;36246103
1744;6.75087e-15;-488;1670;16038;13726;1;435;-2.14748e+09;-1.78037e+06;0;0;0;0;0;0;440916664;451337860;36273402
1745;6.75087e-15;-488;1670;16038;13726;1;435;-2.14748e+09;-1.7768e+06;-1;0;0;0;-1;0;440986709;451420852;36300662
1746;6.75087e-15;-488;1670;16038;13726;1;435;-2.14748e+09;-1.77334e+06;-1;0;0;0;-1;0;441056613;451503692;36327882
1747;6.75087e-15;-488;1670;16038;13726;1;435;-2.14748e+09;-1.76989e+06;-1;0;0;0;-1;0;441126378;451586381;36355063
1748;6.75087e-15;-488;1670;16038;13726;1;435;-2.14748e+09;-1.76644e+06;-1;0;0;0;-1;0;441196003;451668919;36382203
1749;6.75087e-15;-489;1670;16038;13726;1;435;-2.14748e+09;-1.76301e+06;0;0;0;0;0;0;441265489;451751306;36409304
1750;6.75087e-15;-490;1670;16038;13726;1;435;-2.14748e+09;-1.75958e+06;0;0;0;0;0;0;441334836;451833543;36436366
1751;6.75087e-15;-490;1670;16038;13726;1;435;-2.14748e+09;-1.75615e+06;-1;0;0;0;-1;0;441404044;451915629;36463388
1752;6.75087e-15;-491;1670;16038;13726;1;435;-2.14748e+09;-1.75274e+06;0;0;0;0;0;0;441473114;451997566;36490371
1753;6.75087e-15;-492;1670;16038;13726;1;435;-2.14748e+09;-1.74933e+06;0;0;0;0;0;0;441542045;452079354;36517314
1754;6.75087e-15;-493;1670;16038;13726;1;435;-2.14748e+09;-1.74593e+06;0;0;0;0;0;0;441610839;452160992;36544217
1755;6.75087e-15;-493;1670;16038;13726;1;435;-2.14748e+09;-1.74253e+06;-1;0;0;0;-1;0;441679496;452242481;36571082
1756;6.75087e-15;-493;1670;16038;13726;1;435;-2.14748e+09;-1.73914e+06;-1;0;0;0;-1;0;441748015;452323821;36597907
1757;6.75087e-15;-493;1670;16038;13726;1;435;-2.14748e+09;-1.73576e+06;-1;0;0;0;-1;0;441816397;452405014;36624692
1758;6.75087e-15;-494;1670;16038;13726;1;435;-2.14748e+09;-1.73239e+06;0;0;0;0;0;0;441884643;452486058;36651439
1759;6.75087e-15;-494;1670;16038;13726;1;435;-2.14748e+09;-1.72903e+06;-1;0;0;0;-1;0;441952752;452566954;36678146
1760;6.75087e-15;-495;1670;16038;13726;1;435;-2.14748e+09;-1.72567e+06;0;0;0;0;0;0;442020726;452647702;36704814
1761;6.75087e-15;-496;1670;16038;13726;1;435;-2.14748e+09;-1.72232e+06;0;0;0;0;0;0;442088564;452728304;36731442
1762;6.75087e-15;-496;1670;16038;13726;1;435;-2.14748e+09;-1.71898e+06;-1;0;0;0;-1;0;442156266;452808758;36758032
1763;6.75087e-15;-497;1670;16038;13726;1;435;-2.14748e+09;-1.71564e+06;0;0;0;0;0;0;442223833;452889066;36784583
1764;6.75087e-15;-498;1670;16038;13726;1;435;-2.14748e+09;-1.71231e+06;0;0;0;0;0;0;442291266;452969227;36811094
1765;6.75087e-15;-499;1670;16038;13726;1;435;-2.14748e+09;-1.70909e+06;0;0;0;0;0;0;442358564;453049243;36837567
1766;6.75087e-15;-499;1670;16038;13726;1;435;-2.14748e+09;-1.70567e+06;-1;0;0;0;-1;0;442425728;453129112;36864000
1767;6.75087e-15;-500;1670;16038;13726;1;435;-2.14748e+09;-1.70246e+06;0;0;0;0;0;0;442492758;453208836;36890395
1768;6.75087e-15;-501;1670;16038;13726;1;435;-2.14748e+09;-1.69906e+06;0;0;0;0;0;0;442559654;453288414;36916750
1769;6.75087e-15;-501;1670;16038;13726;1;435;-2.14748e+09;-1.69577e+06;-1;0;0;0;-1;0;442626417;453367848;36943067
1770;6.75087e-15;-502;1670;16038;13726;1;435;-2.14748e+09;-1.69248e+06;0;0;0;0;0;0;442693046;453447137;36969345
1771;6.75087e-15;-503;1670;16038;13726;1;435;-2.14748e+09;-1.6892e+06;0;0;0;0;0;0;442759543;453526281;36995584
1772;6.75087e-15;-504;1670;16038;13726;1;435;-2.14748e+09;-1.68592e+06;0;0;0;0;0;0;442825908;453605281;37021785
1773;6.75087e-15;-505;1670;16038;13726;1;435;-2.14748e+09;-1.68266e+06;0;0;0;0;0;0;442892140;453684138;37047947
1774;6.75087e-15;-505;1670;16038;13726;1;435;-2.14748e+09;-1.6794e+06;-1;0;0;0;-1;0;442958241;453762850;37074070
1775;6.75087e-15;-506;1670;16038;13726;1;435;-2.14748e+09;-1.67625e+06;0;0;0;0;0;0;443024210;453841420;37100154
1776;6.75087e-15;-506;1670;16038;13726;1;435;-2.14748e+09;-1.6729e+06;-1;0;0;0;-1;0;443090047;453919846;37126200
1777;6.75087e-15;-506;1670;16038;13726;1;435;-2.14748e+09;-1.66976e+06;-1;0;0;0;-1;0;443155754;453998129;37152207
1778;6.75087e-15;-506;1670;16038;13726;1;435;-2.14748e+09;-1.66643e+06;-1;0;0;0;-1;0;443221330;454076270;37178176
1779;6.75087e-15;-507;1670;16038;13726;1;435;-2.14748e+09;-1.6633e+06;0;0;0;0;0;0;443286775;454154269;37204106
1780;6.75087e-15;-507;1670;16038;13726;1;435;-2.14748e+09;-1.66009e+06;-1;0;0;0;-1;0;443352090;454232125;37229998
1781;6.75087e-15;-507;1670;16038;13726;1;435;-2.14748e+09;-1.65677e+06;-1;0;0;0;-1;0;443417275;454309840;37255851
1782;6.75087e-15;-507;1670;16038;13726;1;435;-2.14748e+09;-1.65367e+06;-1;0;0;0;-1;0;443482331;454387414;37281666
1783;6.75087e-15;-507;1670;16038;13726;1;435;-2.14748e+09;-1.65037e+06;-1;0;0;0;-1;0;443547257;454464846;37307443
1784;6.75087e-15;-508;1670;16038;13726;1;435;-2.14748e+09;-1.64718e+06;0;0;0;0;0;0;443612054;454542137;37333182
1785;6.75087e-15;-508;1670;16038;13726;1;435;-2.14748e+09;-1.644e+06;-1;0;0;0;-1;0;443676723;454619288;37358882
1786;6.75087e-15;-508;1670;16038;13726;1;435;-2.14748e+09;-1.64082e+06;-1;0;0;0;-1;0;443741263;454696298;37384544
1787;6.75087e-15;-509;1670;16038;13726;1;435;-2.14748e+09;-1.63765e+06;0;0;0;0;0;0;443805674;454773168;37410167
1788;6.75087e-15;-510;1670;16038;13726;1;435;-2.14748e+09;-1.63448e+06;0;0;0;0;0;0;443869958;454849899;37435753
1789;6.75087e-15;-510;1670;16038;13726;1;435;-2.14748e+09;-1.63132e+06;-1;0;0;0;-1;0;443934114;454926490;37461301
1790;6.75087e-15;-511;1670;16038;13726;1;435;-2.14748e+09;-1.62817e+06;0;0;0;0;0;0;443998142;455002941;37486810
1791;6.75087e-15;-512;1670;16038;13726;1;435;-2.14748e+09;-1.62503e+06;0;0;0;0;0;0;444062044;455079253;37512282
1792;6.75087e-15;-513;1670;16038;13726;1;435;-2.14748e+09;-1.62189e+06;0;0;0;0;0;0;444125819;455155427;37537715
1793;6.75087e-15;-514;1670;16038;13726;1;435;-2.14748e+09;-1.61876e+06;0;0;0;0;0;0;444189467;455231462;37563111
1794;6.75087e-15;-515;1670;16038;13726;1;435;-2.14748e+09;-1.61563e+06;0;0;0;0;0;0;444252988;455307359;37588468
1795;6.75087e-15;-515;1670;16038;13726;1;435;-2.14748e+09;-1.61252e+06;-1;0;0;0;-1;0;444316384;455383118;37613788
1796;6.75087e-15;-515;1670;16038;13726;1;435;-2.14748e+09;-1.6094e+06;-1;0;0;0;-1;0;444379654;455458739;37639070
1797;6.75087e-15;-516;1670;16038;13726;1;435;-2.14748e+09;-1.6063e+06;0;0;0;0;0;0;444442799;455534223;37664314
1798;6.75087e-15;-516;1670;16038;13726;1;435;-2.14748e+09;-1.6032e+06;-1;0;0;0;-1;0;444505818;455609569;37689520
1799;6.75087e-15;-516;1670;16038;13726;1;435;-2.14748e+09;-1.60011e+06;-1;0;0;0;-1;0;444568712;455684779;37714689
1800;6.75087e-15;-516;1670;16038;13726;1;435;-2.14748e+09;-1.59702e+06;-1;0;0;0;-1;0;444631482;455759852;37739820
1801;6.75087e-15;-516;1670;16038;13726;1;435;-2.14748e+09;-1.59404e+06;-1;0;0;0;-1;0;444694127;455834788;37764913
1802;6.75087e-15;-517;1670;16038;13726;1;435;-2.14748e+09;-1.59087e+06;0;0;0;0;0;0;444756648;455909588;37789969
1803;6.75087e-15;-518;1670;16038;13726;1;435;-2.14748e+09;-1.5879e+06;0;0;0;0;0;0;444819045;455984253;37814987
1804;6.75087e-15;-518;1670;16038;13726;1;435;-2.14748e+09;-1.58474e+06;-1;0;0;0;-1;0;444881319;456058781;37839968
1805;6.75087e-15;-519;1670;16038;13726;1;435;-2.14748e+09;-1.58179e+06;0;0;0;0;0;0;444943469;456133175;37864911
1806;6.75087e-15;-520;1670;16038;13726;1;435;-2.14748e+09;-1.57864e+06;0;0;0;0;0;0;445005496;456207433;37889817
1807;6.75087e-15;-521;1670;16038;13726;1;435;-2.14748e+09;-1.5757e+06;0;0;0;0;0;0;445067400;456281556;37914685
1808;6.75087e-15;-522;1670;16038;13726;1;435;-2.14748e+09;-1.57257e+06;0;0;0;0;0;0;445129182;456355544;37939516
1809;6.75087e-15;-523;1670;16038;13726;1;435;-2.14748e+09;-1.56954e+06;0;0;0;0;0;0;445190842;456429399;37964310
1810;6.75087e-15;-524;1670;16038;13726;1;435;-2.14748e+09;-1.56662e+06;0;0;0;0;0;0;445252379;456503119;37989067
1811;6.75087e-15;-524;1670;16038;13726;1;435;-2.14748e+09;-1.5635e+06;-1;0;0;0;-1;0;445313795;456576705;38013786
1812;6.75087e-15;-524;1670;16038;13726;1;435;-2.14748e+09;-1.56049e+06;-1;0;0;0;-1;0;445375089;456650158;38038468
1813;6.75087e-15;-525;1670;16038;13726;1;435;-2.14748e+09;-1.55759e+06;0;0;0;0;0;0;445436262;456723477;38063113
1814;6.75087e-15;-526;1670;16038;13726;1;435;-2.14748e+09;-1.55459e+06;0;0;0;0;0;0;445497314;456796663;38087720
1815;6.75087e-15;-527;1670;16038;13726;1;435;-2.14748e+09;-1.5515e+06;0;0;0;0;0;0;445558245;456869716;38112291
1816;6.75087e-15;-527;1670;16038;13726;1;435;-2.14748e+09;-1.54852e+06;-1;0;0;0;-1;0;445619056;456942637;38136825
1817;6.75087e-15;-527;1670;16038;13726;1;435;-2.14748e+09;-1.54564e+06;-1;0;0;0;-1;0;445679747;457015425;38161321
1818;6.75087e-15;-528;1670;16038;13726;1;435;-2.14748e+09;-1.54267e+06;0;0;0;0;0;0;445740318;457088081;38185781
1819;6.75087e-15;-528;1670;16038;13726;1;435;-2.14748e+09;-1.5396e+06;-1;0;0;0;-1;0;445800768;457160605;38210203
1820;6.75087e-15;-529;1670;16038;13726;1;435;-2.14748e+09;-1.53664e+06;0;0;0;0;0;0;445861100;457232998;38234589
1821;6.75087e-15;-530;1670;16038;13726;1;435;-2.14748e+09;-1.53379e+06;0;0;0;0;0;0;445921312;457305259;38258938
1822;6.75087e-15;-530;1670;16038;13726;1;435;-2.14748e+09;-1.53084e+06;-1;0;0;0;-1;0;445981406;457377390;38283250
1823;6.75087e-15;-530;1670;16038;13726;1;435;-2.14748e+09;-1.5278e+06;-1;0;0;0;-1;0;446041381;457449389;38307526
1824;6.75087e-15;-531;1670;16038;13726;1;435;-2.14748e+09;-1.52497e+06;0;0;0;0;0;0;446101237;457521258;38331764
1825;6.75087e-15;-532;1670;16038;13726;1;435;-2.14748e+09;-1.52204e+06;0;0;0;0;0;0;446160975;457592996;38355966
1826;6.75087e-15;-533;1670;16038;13726;1;435;-2.14748e+09;-1.51902e+06;0;0;0;0;0;0;446220595;457664604;38380132
1827;6.75087e-15;-533;1670;16038;13726;1;435;-2.14748e+09;-1.5161e+06;-1;0;0;0;-1;0;446280098;457736082;38404261
1828;6.75087e-15;-533;1670;16038;13726;1;435;-2.14748e+09;-1.51319e+06;-1;0;0;0;-1;0;446339483;457807431;38428353
1829;6.75087e-15;-534;1670;16038;13726;1;435;-2.14748e+09;-1.51028e+06;0;0;0;0;0;0;446398751;457878650;38452408
1830;6.75087e-15;-535;1670;16038;13726;1;435;-2.14748e+09;-1.50738e+06;0;0;0;0;0;0;446457902;457949740;38476428
1831;6.75087e-15;-536;1670;16038;13726;1;435;-2.14748e+09;-1.50449e+06;0;0;0;0;0;0;446516937;458020702;38500410
1832;6.75087e-15;-537;1670;16038;13726;1;435;-2.14748e+09;-1.5016e+06;0;0;0;0;0;0;446575855;458091534;38524357
1833;6.75087e-15;-538;1670;16038;13726;1;435;-2.14748e+09;-1.49872e+06;0;0;0;0;0;0;446634657;458162238;38548267
1834;6.75087e-15;-539;1670;16038;13726;1;435;-2.14748e+09;-1.49585e+06;0;0;0;0;0;0;446693343;458232814;38572140
1835;6.75087e-15;-540;1670;16038;13726;1;435;-2.14748e+09;-1.49298e+06;0;0;0;0;0;0;446751913;458303262;38595978
1836;6.75087e-15;-541;1670;16038;13726;1;435;-2.14748e+09;-1.49022e+06;0;0;0;0;0;0;446810368;458373582;38619779
1837;6.75087e-15;-541;1670;16038;13726;1;435;-2.14748e+09;-1.48726e+06;-1;0;0;0;-1;0;446868708;458443775;38643544
1838;6.75087e-15;-541;1670;16038;13726;1;435;-2.14748e+09;-1.48441e+06;-1;0;0;0;-1;0;446926932;458513840;38667272
1839;6.75087e-15;-541;1670;16038;13726;1;435;-2.14748e+09;-1.48156e+06;-1;0;0;0;-1;0;446985042;458583779;38690965
1840;6.75087e-15;-542;1670;16038;13726;1;435;-2.14748e+09;-1.47872e+06;0;0;0;0;0;0;447043038;458653591;38714622
1841;6.75087e-15;-543;1670;16038;13726;1;435;-2.14748e+09;-1.47589e+06;0;0;0;0;0;0;447100919;458723276;38738242
1842;6.75087e-15;-543;1670;16038;13726;1;435;-2.14748e+09;-1.47306e+06;-1;0;0;0;-1;0;447158687;458792835;38761827
1843;6.75087e-15;-544;1670;16038;13726;1;435;-2.14748e+09;-1.47024e+06;0;0;0;0;0;0;447216341;458862268;38785375
1844;6.75087e-15;-544;1670;16038;13726;1;435;-2.14748e+09;-1.46752e+06;-1;0;0;0;-1;0;447273881;458931575;38808888
1845;6.75087e-15;-544;1670;16038;13726;1;435;-2.14748e+09;-1.46462e+06;-1;0;0;0;-1;0;447331308;459000756;38832365
1846;6.75087e-15;-545;1670;16038;13726;1;435;-2.14748e+09;-1.46181e+06;0;0;0;0;0;0;447388622;459069813;38855806
1847;6.75087e-15;-546;1670;16038;13726;1;435;-2.14748e+09;-1.45901e+06;0;0;0;0;0;0;447445823;459138744;38879211
1848;6.75087e-15;-547;1670;16038;13726;1;435;-2.14748e+09;-1.45622e+06;0;0;0;0;0;0;447502912;459207550;38902580
1849;6.75087e-15;-548;1670;16038;13726;1;435;-2.14748e+09;-1.45353e+06;0;0;0;0;0;0;447559889;459276232;38925914
1850;6.75087e-15;-548;1670;16038;13726;1;435;-2.14748e+09;-1.45065e+06;-1;0;0;0;-1;0;447616753;459344789;38949212
1851;6.75087e-15;-549;1670;16038;13726;1;435;-2.14748e+09;-1.44787e+06;0;0;0;0;0;0;447673506;459413222;38972474
1852;6.75087e-15;-549;1670;16038;13726;1;435;-2.14748e+09;-1.4451e+06;-1;0;0;0;-1;0;447730147;459481531;38995701
1853;6.75087e-15;-550;1670;16038;13726;1;435;-2.14748e+09;-1.44234e+06;0;0;0;0;0;0;447786677;459549716;39018892
1854;6.75087e-15;-551;1670;16038;13726;1;435;-2.14748e+09;-1.43958e+06;0;0;0;0;0;0;447843096;459617778;39042048
1855;6.75087e-15;-551;1670;16038;13726;1;435;-2.14748e+09;-1.43683e+06;-1;0;0;0;-1;0;447899404;459685717;39065168
1856;6.75087e-15;-552;1670;16038;13726;1;435;-2.14748e+09;-1.43408e+06;0;0;0;0;0;0;447955601;459753533;39088253
1857;6.75087e-15;-553;1670;16038;13726;1;435;-2.14748e+09;-1.43134e+06;0;0;0;0;0;0;448011688;459821226;39111302
1858;6.75087e-15;-554;1670;16038;13726;1;435;-2.14748e+09;-1.4286e+06;0;0;0;0;0;0;448067664;459888796;39134316
1859;6.75087e-15;-555;1670;16038;13726;1;435;-2.14748e+09;-1.42597e+06;0;0;0;0;0;0;448123531;459956244;39157295
1860;6.75087e-15;-555;1670;16038;13726;1;435;-2.14748e+09;-1.42325e+06;-1;0;0;0;-1;0;448179288;460023570;39180238
1861;6.75087e-15;-555;1670;16038;13726;1;435;-2.14748e+09;-1.42043e+06;-1;0;0;0;-1;0;448234936;460090774;39203146
1862;6.75087e-15;-555;1670;16038;13726;1;435;-2.14748e+09;-1.41771e+06;-1;0;0;0;-1;0;448290474;460157857;39226019
1863;6.75087e-15;-556;1670;16038;13726;1;435;-2.14748e+09;-1.41501e+06;0;0;0;0;0;0;448345904;460224818;39248857
1864;6.75087e-15;-556;1670;16038;13726;1;435;-2.14748e+09;-1.4123e+06;-1;0;0;0;-1;0;448401224;460291657;39271660
1865;6.75087e-15;-556;1670;16038;13726;1;435;-2.14748e+09;-1.40961e+06;-1;0;0;0;-1;0;448456437;460358376;39294428
1866;6.75087e-15;-557;1670;16038;13726;1;435;-2.14748e+09;-1.40691e+06;0;0;0;0;0;0;448511540;460424974;39317160
1867;6.75087e-15;-558;1670;16038;13726;1;435;-2.14748e+09;-1.40423e+06;0;0;0;0;0;0;448566536;460491452;39339858
1868;6.75087e-15;-559;1670;16038;13726;1;435;-2.14748e+09;-1.40165e+06;0;0;0;0;0;0;448621424;460557810;39362521
1869;6.75087e-15;-559;1670;16038;13726;1;435;-2.14748e+09;-1.39887e+06;-1;0;0;0;-1;0;448676204;460624047;39385149
1870;6.75087e-15;-559;1670;16038;13726;1;435;-2.14748e+09;-1.3962e+06;-1;0;0;0;-1;0;448730877;460690164;39407742
1871;6.75087e-15;-559;1670;16038;13726;1;435;-2.14748e+09;-1.39354e+06;-1;0;0;0;-1;0;448785443;460756162;39430300
1872;6.75087e-15;-559;1670;16038;13726;1;435;-2.14748e+09;-1.39088e+06;-1;0;0;0;-1;0;448839902;460822041;39452823
1873;6.75087e-15;-559;1670;16038;13726;1;435;-2.14748e+09;-1.38823e+06;-1;0;0;0;-1;0;448894254;460887800;39475312
1874;6.75087e-15;-559;1670;16038;13726;1;435;-2.14748e+09;-1.38558e+06;-1;0;0;0;-1;0;448948499;460953440;39497766
1875;6.75087e-15;-560;1670;16038;13726;1;435;-2.14748e+09;-1.38294e+06;0;0;0;0;0;0;449002638;461018962;39520185
1876;6.75087e-15;-561;1670;16038;13726;1;435;-2.14748e+09;-1.3803e+06;0;0;0;0;0;0;449056672;461084365;39542570
1877;6.75087e-15;-561;1670;16038;13726;1;435;-2.14748e+09;-1.37767e+06;-1;0;0;0;-1;0;449110599;461149650;39564920
1878;6.75087e-15;-561;1670;16038;13726;1;435;-2.14748e+09;-1.37514e+06;-1;0;0;0;-1;0;449164421;461214817;39587235
1879;6.75087e-15;-561;1670;16038;13726;1;435;-2.14748e+09;-1.37242e+06;-1;0;0;0;-1;0;449218137;461279866;39609516
1880;6.75087e-15;-562;1670;16038;13726;1;435;-2.14748e+09;-1.3698e+06;0;0;0;0;0;0;449271749;461344797;39631763
1881;6.75087e-15;-562;1670;16038;13726;1;435;-2.14748e+09;-1.36729e+06;-1;0;0;0;-1;0;449325255;461409611;39653975
1882;6.75087e-15;-562;1670;16038;13726;1;435;-2.14748e+09;-1.36469e+06;-1;0;0;0;-1;0;449378657;461474307;39676153
1883;6.75087e-15;-563;1670;16038;13726;1;435;-2.14748e+09;-1.36209e+06;0;0;0;0;0;0;449431954;461538887;39698296
1884;6.75087e-15;-563;1670;16038;13726;1;435;-2.14748e+09;-1.35939e+06;-1;0;0;0;-1;0;449485147;461603350;39720406
1885;6.75087e-15;-563;1670;16038;13726;1;435;-2.14748e+09;-1.3569e+06;-1;0;0;0;-1;0;449538236;461667697;39742481
1886;6.75087e-15;-563;1670;16038;13726;1;435;-2.14748e+09;-1.35422e+06;-1;0;0;0;-1;0;449591221;461731927;39764521
1887;6.75087e-15;-564;1670;16038;13726;1;435;-2.14748e+09;-1.35174e+06;0;0;0;0;0;0;449644102;461796041;39786528
1888;6.75087e-15;-564;1670;16038;13726;1;435;-2.14748e+09;-1.34907e+06;-1;0;0;0;-1;0;449696880;461860039;39808500
1889;6.75087e-15;-565;1670;16038;13726;1;435;-2.14748e+09;-1.3466e+06;0;0;0;0;0;0;449749555;461923921;39830439
1890;6.75087e-15;-565;1670;16038;13726;1;435;-2.14748e+09;-1.34393e+06;-1;0;0;0;-1;0;449802126;461987688;39852343
1891;6.75087e-15;-565;1670;16038;13726;1;435;-2.14748e+09;-1.34138e+06;-1;0;0;0;-1;0;449854596;462051340;39874213
1892;6.75087e-15;-566;1670;16038;13726;1;435;-2.14748e+09;-1.33882e+06;0;0;0;0;0;0;449906962;462114877;39896050
1893;6.75087e-15;-567;1670;16038;13726;1;435;-2.14748e+09;-1.33628e+06;0;0;0;0;0;0;449959226;462178299;39917852
1894;6.75087e-15;-567;1670;16038;13726;1;435;-2.14748e+09;-1.33373e+06;-1;0;0;0;-1;0;450011388;462241606;39939621
1895;6.75087e-15;-568;1670;16038;13726;1;435;-2.14748e+09;-1.3313e+06;0;0;0;0;0;0;450063449;462304799;39961355
1896;6.75087e-15;-569;1670;16038;13726;1;435;-2.14748e+09;-1.32866e+06;0;0;0;0;0;0;450115407;462367878;39983056
1897;6.75087e-15;-570;1670;16038;13726;1;435;-2.14748e+09;-1.32614e+06;0;0;0;0;0;0;450167264;462430843;40004723
1898;6.75087e-15;-571;1670;16038;13726;1;435;-2.14748e+09;-1.32361e+06;0;0;0;0;0;0;450219020;462493694;40026357
1899;6.75087e-15;-572;1670;16038;13726;1;435;-2.14748e+09;-1.3211e+06;0;0;0;0;0;0;450270675;462556431;40047957
1900;6.75087e-15;-572;1670;16038;13726;1;435;-2.14748e+09;-1.31858e+06;-1;0;0;0;-1;0;450322229;462619055;40069523
1901;6.75087e-15;-572;1670;16038;13726;1;435;-2.14748e+09;-1.31608e+06;-1;0;0;0;-1;0;450373682;462681566;40091055
1902;6.75087e-15;-573;1670;16038;13726;1;435;-2.14748e+09;-1.31358e+06;0;0;0;0;0;0;450425035;462743964;40112554
1903;6.75087e-15;-573;1670;16038;13726;1;435;-2.14748e+09;-1.31108e+06;-1;0;0;0;-1;0;450476288;462806250;40134020
1904;6.75087e-15;-574;1670;16038;13726;1;435;-2.14748e+09;-1.30869e+06;0;0;0;0;0;0;450527440;462868423;40155452
1905;6.75087e-15;-575;1670;16038;13726;1;435;-2.14748e+09;-1.3061e+06;0;0;0;0;0;0;450578493;462930483;40176850
1906;6.75087e-15;-575;1670;16038;13726;1;435;-2.14748e+09;-1.30372e+06;-1;0;0;0;-1;0;450629447;462992432;40198215
1907;6.75087e-15;-576;1670;16038;13726;1;435;-2.14748e+09;-1.30114e+06;0;0;0;0;0;0;450680300;463054268;40219547
1908;6.75087e-15;-576;1670;16038;13726;1;435;-2.14748e+09;-1.29867e+06;-1;0;0;0;-1;0;450731055;463115993;40240846
1909;6.75087e-15;-577;1670;16038;13726;1;435;-2.14748e+09;-1.2963e+06;0;0;0;0;0;0;450781711;463177607;40262111
1910;6.75087e-15;-578;1670;16038;13726;1;435;-2.14748e+09;-1.29374e+06;0;0;0;0;0;0;450832268;463239109;40283343
1911;6.75087e-15;-578;1670;16038;13726;1;435;-2.14748e+09;-1.29139e+06;-1;0;0;0;-1;0;450882727;463300501;40304542
1912;6.75087e-15;-579;1670;16038;13726;1;435;-2.14748e+09;-1.28884e+06;0;0;0;0;0;0;450933087;463361781;40325707
1913;6.75087e-15;-579;1670;16038;13726;1;435;-2.14748e+09;-1.28639e+06;-1;0;0;0;-1;0;450983349;463422951;40346840
1914;6.75087e-15;-579;1670;16038;13726;1;435;-2.14748e+09;-1.28395e+06;-1;0;0;0;-1;0;451033513;463484010;40367940
1915;6.75087e-15;-579;1670;16038;13726;1;435;-2.14748e+09;-1.28151e+06;-1;0;0;0;-1;0;451083580;463544959;40389006
1916;6.75087e-15;-579;1670;16038;13726;1;435;-2.14748e+09;-1.27908e+06;-1;0;0;0;-1;0;451133549;463605798;40410040
1917;6.75087e-15;-579;1670;16038;13726;1;435;-2.14748e+09;-1.27665e+06;-1;0;0;0;-1;0;451183420;463666527;40431040
1918;6.75087e-15;-579;1670;16038;13726;1;435;-2.14748e+09;-1.27433e+06;-1;0;0;0;-1;0;451233195;463727147;40452008
1919;6.75087e-15;-579;1670;16038;13726;1;435;-2.14748e+09;-1.27181e+06;-1;0;0;0;-1;0;451282873;463787657;40472943
1920;6.75087e-15;-580;1670;16038;13726;1;435;-2.14748e+09;-1.2694e+06;0;0;0;0;0;0;451332453;463848058;40493845
1921;6.75087e-15;-581;1670;16038;13726;1;435;-2.14748e+09;-1.26699e+06;0;0;0;0;0;0;451381938;463908350;40514714
1922;6.75087e-15;-581;1670;16038;13726;1;435;-2.14748e+09;-1.26459e+06;-1;0;0;0;-1;0;451431326;463968533;40535551
1923;6.75087e-15;-581;1670;16038;13726;1;435;-2.14748e+09;-1.26219e+06;-1;0;0;0;-1;0;451480618;464028608;40556354
1924;6.75087e-15;-582;1670;16038;13726;1;435;-2.14748e+09;-1.2598e+06;0;0;0;0;0;0;451529814;464088574;40577126
1925;6.75087e-15;-583;1670;16038;13726;1;435;-2.14748e+09;-1.25741e+06;0;0;0;0;0;0;451578914;464148432;40597864
1926;6.75087e-15;-583;1670;16038;13726;1;435;-2.14748e+09;-1.25502e+06;-1;0;0;0;-1;0;451627919;464208181;40618570
1927;6.75087e-15;-583;1670;16038;13726;1;435;-2.14748e+09;-1.25265e+06;-1;0;0;0;-1;0;451676829;464267823;40639244
1928;6.75087e-15;-583;1670;16038;13726;1;435;-2.14748e+09;-1.25027e+06;-1;0;0;0;-1;0;451725643;464327358;40659885
1929;6.75087e-15;-584;1670;16038;13726;1;435;-2.14748e+09;-1.2479e+06;0;0;0;0;0;0;451774362;464386785;40680493
1930;6.75087e-15;-585;1670;16038;13726;1;435;-2.14748e+09;-1.24554e+06;0;0;0;0;0;0;451822987;464446105;40701069
1931;6.75087e-15;-585;1670;16038;13726;1;435;-2.14748e+09;-1.24318e+06;-1;0;0;0;-1;0;451871517;464505317;40721613
1932;6.75087e-15;-586;1670;16038;13726;1;435;-2.14748e+09;-1.24082e+06;0;0;0;0;0;0;451919953;464564423;40742125
1933;6.75087e-15;-587;1670;16038;13726;1;435;-2.14748e+09;-1.23847e+06;0;0;0;0;0;0;451968295;464623423;40762604
1934;6.75087e-15;-588;1670;16038;13726;1;435;-2.14748e+09;-1.23623e+06;0;0;0;0;0;0;452016543;464682316;40783051
1935;6.75087e-15;-589;1670;16038;13726;1;435;-2.14748e+09;-1.23378e+06;0;0;0;0;0;0;452064697;464741102;40803465
1936;6.75087e-15;-589;1670;16038;13726;1;435;-2.14748e+09;-1.23145e+06;-1;0;0;0;-1;0;452112758;464799783;40823848
1937;6.75087e-15;-589;1670;16038;13726;1;435;-2.14748e+09;-1.22912e+06;-1;0;0;0;-1;0;452160725;464858358;40844198
1938;6.75087e-15;-590;1670;16038;13726;1;435;-2.14748e+09;-1.22679e+06;0;0;0;0;0;0;452208599;464916827;40864517
1939;6.75087e-15;-590;1670;16038;13726;1;435;-2.14748e+09;-1.22447e+06;-1;0;0;0;-1;0;452256380;464975190;40884803
1940;6.75087e-15;-590;1670;16038;13726;1;435;-2.14748e+09;-1.22215e+06;-1;0;0;0;-1;0;452304068;465033449;40905057
1941;6.75087e-15;-590;1670;16038;13726;1;435;-2.14748e+09;-1.21994e+06;-1;0;0;0;-1;0;452351664;465091602;40925280
1942;6.75087e-15;-590;1670;16038;13726;1;435;-2.14748e+09;-1.21753e+06;-1;0;0;0;-1;0;452399167;465149650;40945470
1943;6.75087e-15;-591;1670;16038;13726;1;435;-2.14748e+09;-1.21522e+06;0;0;0;0;0;0;452446578;465207594;40965629
1944;6.75087e-15;-591;1670;16038;13726;1;435;-2.14748e+09;-1.21293e+06;-1;0;0;0;-1;0;452493897;465265434;40985755
1945;6.75087e-15;-591;1670;16038;13726;1;435;-2.14748e+09;-1.21063e+06;-1;0;0;0;-1;0;452541125;465323168;41005850
1946;6.75087e-15;-592;1670;16038;13726;1;435;-2.14748e+09;-1.20834e+06;0;0;0;0;0;0;452588260;465380799;41025914
1947;6.75087e-15;-593;1670;16038;13726;1;435;-2.14748e+09;-1.20606e+06;0;0;0;0;0;0;452635305;465438326;41045945
1948;6.75087e-15;-593;1670;16038;13726;1;435;-2.14748e+09;-1.20377e+06;-1;0;0;0;-1;0;452682258;465495749;41065945
1949;6.75087e-15;-593;1670;16038;13726;1;435;-2.14748e+09;-1.2015e+06;-1;0;0;0;-1;0;452729119;465553069;41085913
1950;6.75087e-15;-593;1670;16038;13726;1;435;-2.14748e+09;-1.19923e+06;-1;0;0;0;-1;0;452775890;465610286;41105850
1951;6.75087e-15;-593;1670;16038;13726;1;435;-2.14748e+09;-1.19696e+06;-1;0;0;0;-1;0;452822571;465667399;41125755
1952;6.75087e-15;-594;1670;16038;13726;1;435;-2.14748e+09;-1.1947e+06;0;0;0;0;0;0;452869161;465724409;41145628
1953;6.75087e-15;-594;1670;16038;13726;1;435;-2.14748e+09;-1.19244e+06;-1;0;0;0;-1;0;452915660;465781316;41165470
1954;6.75087e-15;-594;1670;16038;13726;1;435;-2.14748e+09;-1.19018e+06;-1;0;0;0;-1;0;452962069;465838121;41185281
1955;6.75087e-15;-595;1670;16038;13726;1;435;-2.14748e+09;-1.18793e+06;0;0;0;0;0;0;453008389;465894824;41205060
1956;6.75087e-15;-595;1670;16038;13726;1;435;-2.14748e+09;-1.18579e+06;-1;0;0;0;-1;0;453054619;465951424;41224808
1957;6.75087e-15;-595;1670;16038;13726;1;435;-2.14748e+09;-1.18345e+06;-1;0;0;0;-1;0;453100759;466007922;41244525
1958;6.75087e-15;-595;1670;16038;13726;1;435;-2.14748e+09;-1.18121e+06;-1;0;0;0;-1;0;453146809;466064319;41264210
1959;6.75087e-15;-596;1670;16038;13726;1;435;-2.14748e+09;-1.17898e+06;0;0;0;0;0;0;453192771;466120613;41283864
1960;6.75087e-15;-597;1670;16038;13726;1;435;-2.14748e+09;-1.17675e+06;0;0;0;0;0;0;453238644;466176807;41303487
1961;6.75087e-15;-598;1670;16038;13726;1;435;-2.14748e+09;-1.17453e+06;0;0;0;0;0;0;453284427;466232899;41323079
1962;6.75087e-15;-599;1670;16038;13726;1;435;-2.14748e+09;-1.17241e+06;0;0;0;0;0;0;453330122;466288890;41342639
1963;6.75087e-15;-600;1670;16038;13726;1;435;-2.14748e+09;-1.1701e+06;0;0;0;0;0;0;453375729;466344779;41362169
1964;6.75087e-15;-600;1670;16038;13726;1;435;-2.14748e+09;-1.16789e+06;-1;0;0;0;-1;0;453421247;466400569;41381668
1965;6.75087e-15;-600;1670;16038;13726;1;435;-2.14748e+09;-1.16568e+06;-1;0;0;0;-1;0;453466677;466456258;41401135
1966;6.75087e-15;-601;1670;16038;13726;1;435;-2.14748e+09;-1.16348e+06;0;0;0;0;0;0;453512020;466511846;41420572
1967;6.75087e-15;-602;1670;16038;13726;1;435;-2.14748e+09;-1.16139e+06;0;0;0;0;0;0;453557274;466567334;41439978
1968;6.75087e-15;-602;1670;16038;13726;1;435;-2.14748e+09;-1.1591e+06;-1;0;0;0;-1;0;453602441;466622722;41459353
1969;6.75087e-15;-603;1670;16038;13726;1;435;-2.14748e+09;-1.15691e+06;0;0;0;0;0;0;453647521;466678011;41478697
1970;6.75087e-15;-604;1670;16038;13726;1;435;-2.14748e+09;-1.15472e+06;0;0;0;0;0;0;453692513;466733200;41498010
1971;6.75087e-15;-605;1670;16038;13726;1;435;-2.14748e+09;-1.15255e+06;0;0;0;0;0;0;453737418;466788289;41517292
1972;6.75087e-15;-605;1670;16038;13726;1;435;-2.14748e+09;-1.15047e+06;-1;0;0;0;-1;0;453782237;466843279;41536544
1973;6.75087e-15;-606;1670;16038;13726;1;435;-2.14748e+09;-1.1482e+06;0;0;0;0;0;0;453826968;466898170;41555766
1974;6.75087e-15;-606;1670;16038;13726;1;435;-2.14748e+09;-1.14604e+06;-1;0;0;0;-1;0;453871614;466952962;41574956
1975;6.75087e-15;-606;1670;16038;13726;1;435;-2.14748e+09;-1.14387e+06;-1;0;0;0;-1;0;453916173;467007656;41594116
1976;6.75087e-15;-607;1670;16038;13726;1;435;-2.14748e+09;-1.14172e+06;0;0;0;0;0;0;453960646;467062251;41613246
1977;6.75087e-15;-608;1670;16038;13726;1;435;-2.14748e+09;-1.13956e+06;0;0;0;0;0;0;454005033;467116747;41632345
1978;6.75087e-15;-608;1670;16038;13726;1;435;-2.14748e+09;-1.13751e+06;-1;0;0;0;-1;0;454049334;467171146;41651413
1979;6.75087e-15;-608;1670;16038;13726;1;435;-2.14748e+09;-1.13527e+06;-1;0;0;0;-1;0;454093549;467225446;41670451
1980;6.75087e-15;-608;1670;16038;13726;1;435;-2.14748e+09;-1.13313e+06;-1;0;0;0;-1;0;454137679;467279649;41689459
1981;6.75087e-15;-608;1670;16038;13726;1;435;-2.14748e+09;-1.13099e+06;-1;0;0;0;-1;0;454181724;467333754;41708436
1982;6.75087e-15;-608;1670;16038;13726;1;435;-2.14748e+09;-1.12886e+06;-1;0;0;0;-1;0;454225684;467387761;41727384
1983;6.75087e-15;-609;1670;16038;13726;1;435;-2.14748e+09;-1.12673e+06;0;0;0;0;0;0;454269559;467441672;41746300
1984;6.75087e-15;-609;1670;16038;13726;1;435;-2.14748e+09;-1.12461e+06;-1;0;0;0;-1;0;454313349;467495485;41765187
1985;6.75087e-15;-609;1670;16038;13726;1;435;-2.14748e+09;-1.12249e+06;-1;0;0;0;-1;0;454357054;467549201;41784044
1986;6.75087e-15;-610;1670;16038;13726;1;435;-2.14748e+09;-1.12037e+06;0;0;0;0;0;0;454400675;467602821;41802870
1987;6.75087e-15;-611;1670;16038;13726;1;435;-2.14748e+09;-1.11826e+06;0;0;0;0;0;0;454444212;467656343;41821666
1988;6.75087e-15;-612;1670;16038;13726;1;435;-2.14748e+09;-1.11616e+06;0;0;0;0;0;0;454487665;467709770;41840432
1989;6.75087e-15;-613;1670;16038;13726;1;435;-2.14748e+09;-1.11405e+06;0;0;0;0;0;0;454531034;467763100;41859169
1990;6.75087e-15;-614;1670;16038;13726;1;435;-2.14748e+09;-1.11196e+06;0;0;0;0;0;0;454574320;467816335;41877875
1991;6.75087e-15;-615;1670;16038;13726;1;435;-2.14748e+09;-1.10986e+06;0;0;0;0;0;0;454617521;467869473;41896551
1992;6.75087e-15;-615;1670;16038;13726;1;435;-2.14748e+09;-1.10777e+06;-1;0;0;0;-1;0;454660640;467922516;41915197
1993;6.75087e-15;-616;1670;16038;13726;1;435;-2.14748e+09;-1.10568e+06;0;0;0;0;0;0;454703675;467975463;41933814
1994;6.75087e-15;-616;1670;16038;13726;1;435;-2.14748e+09;-1.1036e+06;-1;0;0;0;-1;0;454746627;468028315;41952401
1995;6.75087e-15;-617;1670;16038;13726;1;435;-2.14748e+09;-1.10162e+06;0;0;0;0;0;0;454789497;468081072;41970957
1996;6.75087e-15;-617;1670;16038;13726;1;435;-2.14748e+09;-1.09945e+06;-1;0;0;0;-1;0;454832283;468133734;41989485
1997;6.75087e-15;-618;1670;16038;13726;1;435;-2.14748e+09;-1.09748e+06;0;0;0;0;0;0;454874988;468186301;42007982
1998;6.75087e-15;-619;1670;16038;13726;1;435;-2.14748e+09;-1.09532e+06;0;0;0;0;0;0;454917609;468238773;42026450
1999;6.75087e-15;-619;1670;16038;13726;1;435;-2.14748e+09;-1.09325e+06;-1;0;0;0;-1;0;454960149;468291151;42044888
