step;volume;A_0;B_0;C;L;p;Compl;Aext;Bext;A_ingresso;A_uscita;B_ingresso;B_uscita;A_netto;B_netto;Avicino;Amedio;Alontano
402;4.18816e-15;77;555;13217;10035;1;2;782;3499;508;126;474;131;382;343;98;94;3
402;4.18816e-15;77;555;13217;10035;1;0;748;3499;493;127;496;130;366;366;98;93;3
403;4.21091e-15;204;1298;13119;10091;1;109;708;3499;368;64;1744;485;304;1259;98;94;3
403;4.21091e-15;193;1305;13113;10117;1;110;681;3499;390;78;1715;490;312;1225;98;94;3
404;4.24638e-15;197;1610;13028;10175;1;232;685;3500;336;112;1720;733;224;987;98;92;3
404;4.26225e-15;188;1557;13019;10207;1;235;673;3500;319;81;1687;718;238;969;98;92;3
405;4.29978e-15;191;1673;12995;10242;1;316;669;3500;346;102;1705;841;244;864;97;93;3
405;4.32018e-15;164;1667;12976;10293;1;330;646;3500;325;95;1743;796;230;947;97;93;3
406;4.34253e-15;210;1691;12984;10320;1;398;608;3401;342;97;1794;811;245;983;98;93;3
406;4.37517e-15;201;1659;12976;10370;1;392;595;3401;309;54;1707;793;255;914;98;93;3
407;4.39248e-15;187;1665;13010;10389;1;456;649;3501;285;82;1664;814;203;850;97;92;3
407;4.4246e-15;192;1572;12975;10454;1;463;639;3501;287;87;1676;822;200;854;97;92;3
408;4.43683e-15;185;1545;13007;10450;1;535;691;3502;348;93;1732;837;255;895;96;93;3
408;4.47874e-15;183;1674;13054;10526;1;485;656;3502;320;89;1742;822;231;920;96;91;3
409;4.47615e-15;206;1652;13075;10523;1;572;682;3502;341;105;1790;789;236;1001;96;92;3
409;4.52531e-15;192;1691;13079;10608;1;542;647;3502;306;100;1716;827;206;889;96;91;3
410;4.52337e-15;214;1693;13126;10602;1;621;634;3502;351;129;1730;767;222;963;96;92;3
410;4.57855e-15;206;1638;13176;10686;1;558;574;3502;329;100;1785;855;229;930;96;92;3
411;4.57465e-15;191;1694;13227;10666;1;647;585;3503;307;120;1771;826;187;945;95;91;3
411;4.62939e-15;174;1602;13270;10763;1;568;565;3503;274;90;1723;811;184;912;95;91;3
412;4.61634e-15;192;1657;13367;10736;1;643;607;3503;291;102;1792;800;189;992;95;92;3
412;4.67911e-15;174;1617;13357;10828;1;588;598;3503;262;92;1749;838;170;911;95;92;3
413;4.66208e-15;168;1580;13477;10822;1;651;566;3504;300;107;1735;777;193;958;95;90;3
413;4.72243e-15;167;1613;13443;10904;1;608;527;3504;271;87;1793;810;184;983;95;90;3
414;4.71848e-15;162;1695;13597;10902;1;641;589;3504;311;82;1787;837;229;950;95;91;3
414;4.77247e-15;158;1663;13523;10971;1;618;580;3504;260;98;1723;846;162;877;95;91;3
415;4.77115e-15;181;1690;13666;10971;1;681;562;3505;312;80;1813;813;232;1000;95;91;3
415;4.81674e-15;164;1655;13603;11043;1;637;513;3505;287;74;1828;837;213;991;95;90;3
416;4.81674e-15;185;1698;13774;11042;1;693;575;3505;278;72;1788;833;206;955;94;90;3
416;4.86446e-15;158;1607;13716;11129;1;643;555;3505;245;66;1764;826;179;938;94;90;3
417;4.8638e-15;172;1641;13918;11118;1;677;509;3505;297;81;1728;873;216;855;94;89;3
417;4.92167e-15;184;1707;13808;11195;1;651;500;3505;264;71;1778;784;193;994;94;89;3
418;4.91434e-15;154;1588;14067;11186;1;655;565;3506;262;71;1716;791;191;925;93;90;3
418;4.96572e-15;128;1637;13890;11262;1;677;533;3506;247;63;1745;831;184;914;93;90;3
419;4.95971e-15;147;1632;14168;11263;1;661;557;3506;276;70;1775;803;206;972;93;90;3
419;5.01058e-15;162;1685;14033;11333;1;651;489;3506;243;76;1726;782;167;944;93;89;3
420;5.01125e-15;153;1630;14314;11333;1;645;553;3507;293;74;1700;781;219;919;93;90;3
420;5.05826e-15;161;1698;14137;11394;1;651;538;3507;203;87;1825;867;116;958;93;90;3
421;5.05826e-15;143;1669;14410;11384;1;656;545;3507;265;83;1770;801;182;969;93;90;3
421;5.09935e-15;171;1713;14242;11469;1;654;507;3507;262;79;1712;831;183;881;93;88;3
422;5.09261e-15;173;1633;14503;11455;1;662;500;3507;260;75;1818;820;185;998;94;89;3
422;5.15002e-15;169;1726;14324;11542;1;660;493;3507;228;73;1741;867;155;874;94;89;3
423;5.14055e-15;139;1588;14588;11523;1;673;552;3508;240;91;1809;812;149;997;93;90;3
423;5.1995e-15;144;1691;14417;11606;1;665;532;3508;254;80;1805;895;174;910;93;90;3
424;5.1866e-15;163;1712;14698;11587;1;659;551;3508;265;81;1681;791;184;890;94;90;3
424;5.24301e-15;142;1722;14523;11664;1;676;521;3508;272;77;1749;850;195;899;94;89;3
425;5.23008e-15;165;1717;14784;11663;1;667;543;3509;293;97;1721;834;196;887;93;90;3
425;5.28254e-15;168;1766;14614;11733;1;683;522;3509;286;76;1721;827;210;894;93;90;3
426;5.28186e-15;161;1642;14876;11737;1;672;546;3509;279;99;1760;839;180;921;93;91;3
426;5.3297e-15;168;1712;14720;11804;1;683;537;3509;244;74;1789;874;170;915;93;91;3
427;5.33244e-15;174;1635;14991;11807;1;670;438;3409;268;75;1711;762;193;949;94;90;3
427;5.37838e-15;153;1631;14835;11866;1;681;420;3409;267;81;1771;846;186;925;94;90;3
428;5.38044e-15;141;1696;15074;11875;1;682;547;3510;226;74;1725;796;152;929;93;90;3
428;5.421e-15;113;1608;14987;11947;1;646;532;3510;204;77;1722;789;127;933;93;90;3
429;5.4272e-15;168;1731;15162;11944;1;685;497;3510;295;70;1749;850;225;899;92;88;3
429;5.47686e-15;126;1616;15068;12011;1;651;488;3510;256;65;1779;830;191;949;92;88;3
430;5.47479e-15;143;1729;15266;12009;1;691;553;3511;255;87;1688;864;168;824;91;89;3
430;5.52113e-15;135;1614;15193;12079;1;638;523;3511;224;71;1784;841;153;943;91;88;3
431;5.51975e-15;152;1711;15365;12077;1;693;527;3511;295;83;1813;811;212;1002;91;89;3
431;5.5683e-15;150;1717;15280;12161;1;641;485;3511;235;72;1796;785;163;1011;91;87;3
432;5.56691e-15;166;1612;15459;12161;1;703;517;3511;266;79;1773;879;187;894;91;87;3
432;5.62536e-15;164;1787;15399;12240;1;630;482;3511;222;70;1668;805;152;863;91;87;3
433;5.62536e-15;156;1590;15535;12225;1;721;440;3412;275;79;1765;789;196;976;92;88;3
433;5.68051e-15;154;1742;15468;12318;1;657;483;3512;235;58;1728;899;177;829;91;87;3
434;5.67003e-15;119;1649;15661;12299;1;705;527;3512;197;74;1664;809;123;855;91;87;4
434;5.73515e-15;166;1692;15562;12382;1;656;509;3512;249;70;1793;828;179;965;91;87;4
435;5.72182e-15;137;1677;15812;12378;1;668;556;3513;276;76;1790;839;200;951;91;88;4
435;5.7801e-15;137;1718;15637;12436;1;677;539;3513;259;93;1801;844;166;957;91;86;4
436;5.77729e-15;164;1681;15939;12450;1;655;550;3513;284;82;1762;850;202;912;90;87;4
436;5.81813e-15;162;1638;15765;12501;1;665;529;3513;294;63;1804;822;231;982;90;87;4
437;5.828e-15;162;1671;16017;12519;1;668;546;3513;277;78;1833;815;199;1018;91;87;4
437;5.86401e-15;147;1668;15852;12571;1;672;525;3513;251;63;1715;825;188;890;91;87;4
438;5.87673e-15;170;1641;16114;12580;1;673;537;3514;264;77;1720;843;187;877;90;87;4
438;5.91355e-15;134;1591;15967;12639;1;665;502;3514;260;73;1731;831;187;900;90;85;4
439;5.91993e-15;170;1612;16203;12650;1;685;549;3514;262;88;1806;848;174;958;90;86;4
439;5.96181e-15;158;1631;16073;12709;1;660;529;3514;249;77;1823;826;172;997;90;86;4
440;5.96963e-15;152;1666;16256;12721;1;719;528;3514;281;80;1818;802;201;1016;90;84;4
440;6.01163e-15;161;1645;16133;12781;1;685;501;3514;273;95;1775;854;178;921;90;84;4
441;6.02018e-15;158;1691;16312;12786;1;756;543;3515;263;69;1777;819;194;958;89;85;4
441;6.06302e-15;137;1693;16219;12855;1;698;519;3515;228;70;1731;843;158;888;89;85;4
442;6.06659e-15;134;1644;16434;12848;1;747;553;3515;258;90;1774;886;168;888;90;85;4
442;6.11598e-15;143;1648;16316;12912;1;697;526;3515;216;72;1801;858;144;943;90;84;4
443;6.11097e-15;185;1569;16540;12924;1;745;551;3516;290;64;1786;795;226;991;90;85;4
443;6.15689e-15;150;1658;16407;12995;1;708;531;3516;252;79;1697;844;173;853;90;85;4
444;6.16551e-15;180;1619;16626;12998;1;758;503;3516;290;82;1722;808;208;914;90;84;4
444;6.21661e-15;169;1708;16452;13057;1;745;485;3516;278;71;1760;847;207;913;90;84;4
445;6.21877e-15;169;1605;16708;13075;1;766;551;3516;236;99;1868;842;137;1026;90;85;4
445;6.26135e-15;151;1748;16534;13119;1;755;514;3516;227;79;1731;805;148;926;90;83;4
446;6.27436e-15;186;1662;16777;13145;1;791;512;3517;258;88;1766;853;170;913;89;83;4
446;6.3062e-15;136;1696;16648;13185;1;756;493;3517;274;77;1700;882;197;818;89;83;4
447;6.32503e-15;149;1630;16842;13212;1;812;548;3517;255;80;1753;855;175;898;89;84;4
447;6.35405e-15;160;1677;16750;13258;1;750;532;3517;208;70;1665;894;138;771;89;84;4
448;6.37366e-15;145;1662;16944;13287;1;811;542;3517;280;75;1824;803;205;1021;89;84;4
448;6.40713e-15;159;1636;16841;13327;1;757;506;3517;268;89;1716;833;179;883;89;82;4
449;6.42825e-15;173;1675;17037;13350;1;822;515;3518;271;84;1619;784;187;835;88;81;4
449;6.45743e-15;139;1681;16931;13392;1;760;496;3518;239;72;1729;841;167;888;88;81;4
450;6.47422e-15;173;1633;17157;13426;1;811;553;3518;233;71;1823;852;162;971;88;82;4
450;6.50493e-15;149;1640;17036;13462;1;751;526;3518;242;77;1777;831;165;946;88;82;4
451;6.52983e-15;172;1633;17244;13488;1;826;522;3519;295;78;1797;807;217;990;88;82;4
451;6.55622e-15;162;1624;17064;13515;1;787;513;3519;264;79;1690;852;185;838;88;82;4
452;6.57531e-15;155;1638;17306;13555;1;850;547;3519;256;71;1806;889;185;917;87;81;4
452;6.59515e-15;141;1606;17169;13580;1;791;530;3519;236;84;1717;804;152;913;87;81;4
453;6.62457e-15;142;1661;17435;13629;1;834;548;3519;251;66;1710;820;185;890;86;81;4
453;6.64299e-15;164;1615;17267;13656;1;799;504;3519;258;73;1727;785;185;942;86;80;4
454;6.67913e-15;161;1693;17552;13692;1;832;496;3520;274;76;1792;818;198;974;86;80;4
454;6.69907e-15;145;1648;17325;13731;1;825;487;3520;271;80;1805;805;191;1000;86;80;4
455;6.72569e-15;156;1713;17644;13757;1;832;550;3520;253;78;1673;872;175;801;87;80;4
455;6.75457e-15;145;1675;17474;13783;1;793;494;3520;247;77;1770;835;170;935;87;79;4
456;6.77385e-15;178;1595;17782;13815;1;802;510;3520;280;87;1772;873;193;899;86;79;4
456;6.79314e-15;162;1679;17576;13862;1;787;494;3520;246;73;1773;834;173;939;86;79;4
457;6.81691e-15;167;1636;17881;13875;1;804;535;3521;258;91;1867;812;167;1055;85;80;4
457;6.85188e-15;156;1747;17680;13929;1;785;517;3521;260;94;1778;813;166;965;85;80;4
458;6.86156e-15;164;1639;17956;13936;1;823;521;3521;257;76;1684;819;181;865;84;81;4
458;6.90183e-15;160;1644;17809;13985;1;775;486;3521;290;70;1711;824;220;887;84;80;4
459;6.90705e-15;125;1609;18040;14010;1;825;512;3521;283;81;1794;791;202;1003;85;79;4
459;6.94367e-15;167;1647;17893;14052;1;786;494;3521;258;81;1760;847;177;913;85;79;4
460;6.96238e-15;173;1646;18201;14070;1;789;549;3522;277;68;1751;743;209;1008;85;80;4
460;6.99384e-15;179;1710;17969;14120;1;801;520;3522;239;70;1681;826;169;855;85;79;4
461;7.00734e-15;175;1597;18268;14140;1;817;548;3522;235;81;1676;822;154;854;85;80;4
461;7.04488e-15;149;1622;18050;14174;1;813;531;3522;250;102;1795;879;148;916;85;78;4
462;7.05992e-15;198;1617;18332;14214;1;841;548;3523;298;81;1693;799;217;894;85;79;4
462;7.08551e-15;169;1616;18159;14231;1;810;532;3523;273;94;1777;795;179;982;85;79;4
463;7.11565e-15;172;1627;18396;14270;1;876;542;3523;292;98;1808;813;194;995;84;79;4
463;7.12847e-15;177;1630;18230;14299;1;824;532;3523;279;82;1775;827;197;948;84;79;4
464;7.15792e-15;162;1751;18506;14331;1;874;552;3523;254;93;1792;815;161;977;84;79;4
464;7.17984e-15;184;1664;18301;14363;1;847;514;3523;262;60;1821;836;202;985;84;79;4
465;7.20406e-15;167;1717;18596;14387;1;883;541;3524;267;93;1694;837;174;857;84;79;4
465;7.2283e-15;180;1607;18381;14437;1;863;505;3524;238;76;1754;858;162;896;84;79;4
466;7.2465e-15;160;1682;18694;14450;1;888;552;3524;251;75;1741;834;176;907;83;79;4
466;7.28447e-15;137;1729;18505;14486;1;855;524;3524;270;74;1752;811;196;941;83;78;4
467;7.29435e-15;171;1678;18764;14497;1;904;541;3524;271;77;1787;810;194;977;83;78;4
467;7.32174e-15;153;1705;18634;14543;1;835;513;3524;256;60;1861;839;196;1022;83;78;4
468;7.33011e-15;171;1638;18890;14563;1;889;495;3525;240;80;1768;823;160;945;83;77;4
468;7.36518e-15;155;1657;18750;14601;1;824;487;3525;248;76;1698;848;172;850;83;77;4
469;7.38044e-15;150;1625;18960;14626;1;909;524;3525;274;76;1809;823;198;986;83;77;4
469;7.40946e-15;151;1673;18846;14665;1;826;490;3525;237;74;1802;776;163;1026;83;77;4
470;7.42858e-15;167;1687;19065;14686;1;906;544;3525;276;75;1758;799;201;959;82;78;4
470;7.45844e-15;156;1663;18936;14732;1;832;528;3525;235;77;1717;861;158;856;82;78;4
471;7.47453e-15;146;1683;19150;14744;1;915;517;3526;260;94;1799;859;166;940;83;78;4
471;7.50905e-15;147;1702;19028;14780;1;837;507;3526;252;65;1773;796;187;977;83;78;4
472;7.51903e-15;161;1693;19253;14799;1;908;507;3526;247;82;1736;845;165;891;83;77;4
472;7.5467e-15;159;1657;19119;14850;1;842;490;3526;256;81;1752;832;175;920;83;77;4
473;7.56132e-15;174;1724;19337;14854;1;913;526;3526;255;84;1712;854;171;858;83;78;4
473;7.6006e-15;163;1672;19218;14915;1;836;490;3526;227;69;1664;849;158;815;83;76;4
474;7.60369e-15;154;1678;19423;14925;1;925;554;3527;232;70;1804;836;162;968;83;77;4
474;7.65076e-15;159;1698;19334;14975;1;823;536;3527;228;63;1782;749;165;1033;83;77;4
475;7.65849e-15;148;1616;19523;14998;1;924;502;3527;281;99;1776;848;182;928;83;76;4
475;7.69717e-15;168;1664;19413;15046;1;839;492;3527;282;91;1783;862;191;921;83;76;4
476;7.71498e-15;161;1597;19581;15062;1;948;533;3527;253;66;1725;863;187;862;83;76;4
476;7.7522e-15;157;1673;19472;15109;1;860;490;3527;220;70;1751;837;150;914;83;76;4
477;7.76462e-15;169;1650;19723;15128;1;926;535;3528;255;81;1712;751;174;961;82;77;4
477;7.80114e-15;146;1660;19556;15176;1;871;509;3528;269;79;1789;827;190;962;82;75;4
478;7.81592e-15;168;1662;19823;15190;1;925;535;3528;249;85;1739;781;164;958;82;76;4
478;7.8533e-15;177;1628;19668;15246;1;860;490;3528;242;90;1812;822;152;990;82;75;4
479;7.86421e-15;160;1698;19930;15245;1;925;526;3528;249;81;1754;823;168;931;81;75;4
479;7.90792e-15;152;1612;19793;15305;1;838;519;3528;238;104;1805;845;134;960;81;75;4
480;7.90714e-15;181;1688;20020;15310;1;925;498;3529;283;82;1780;847;201;933;81;76;4
480;7.95405e-15;145;1738;19854;15347;1;855;491;3529;226;84;1825;786;142;1039;81;75;4
481;7.95796e-15;176;1683;20102;15382;1;936;515;3529;244;99;1713;865;145;848;80;74;4
481;7.98695e-15;129;1663;19910;15404;1;881;488;3529;264;64;1716;854;200;862;80;74;4
482;8.0144e-15;143;1695;20238;15440;1;911;536;3529;283;93;1843;820;190;1023;80;75;4
482;8.03167e-15;155;1705;19997;15464;1;879;529;3529;227;82;1738;808;145;930;80;75;4
483;8.05995e-15;142;1661;20348;15507;1;904;524;3530;258;81;1833;883;177;950;80;75;4
483;8.07883e-15;164;1622;20108;15523;1;868;489;3530;269;73;1836;856;196;980;80;74;4
484;8.11268e-15;169;1622;20460;15578;1;887;512;3530;280;87;1760;878;193;882;80;75;5
484;8.12529e-15;168;1650;20173;15584;1;884;463;3530;251;83;1780;818;168;962;80;73;5
485;8.16869e-15;184;1572;20536;15644;1;899;522;3530;265;75;1782;792;190;990;79;74;5
485;8.17343e-15;145;1682;20261;15656;1;883;513;3530;259;72;1759;852;187;907;79;74;5
486;8.22086e-15;153;1623;20570;15725;1;944;451;3531;262;76;1758;828;186;930;80;73;5
486;8.23036e-15;155;1638;20376;15714;1;868;442;3531;250;84;1807;807;166;1000;80;73;5
487;8.28505e-15;127;1605;20686;15793;1;937;421;3531;251;81;1693;828;170;865;80;73;5
487;8.27632e-15;137;1649;20465;15764;1;862;413;3531;228;75;1730;861;153;869;80;73;5
488;8.33906e-15;134;1687;20778;15859;1;933;441;3531;206;59;1785;769;147;1016;80;72;5
488;8.31601e-15;134;1682;20537;15840;1;865;412;3531;201;66;1817;843;135;974;80;72;5
489;8.3916e-15;126;1664;20886;15917;1;920;361;3432;223;65;1685;868;158;817;81;73;5
489;8.37647e-15;135;1768;20600;15910;1;876;429;3532;216;65;1699;838;151;861;79;73;5
490;8.43786e-15;120;1673;20971;15990;1;921;428;3532;157;65;1700;830;92;870;79;73;5
490;8.43148e-15;136;1736;20686;15969;1;873;414;3532;217;84;1779;877;133;902;79;73;5
491;8.49621e-15;135;1747;21041;16058;1;925;419;3532;200;66;1773;812;134;961;79;72;5
491;8.47941e-15;133;1677;20780;16033;1;864;411;3532;211;52;1760;864;159;896;79;72;5
492;8.55068e-15;126;1688;21128;16116;1;918;412;3533;223;70;1670;852;153;818;79;72;5
492;8.53064e-15;132;1680;20876;16099;1;861;403;3533;240;51;1735;842;189;893;79;72;5
493;8.59723e-15;127;1677;21278;16185;1;881;421;3533;176;70;1797;792;106;1005;78;72;5
493;8.58358e-15;121;1667;21001;16149;1;832;415;3533;189;69;1811;855;120;956;78;72;5
494;8.65272e-15;134;1629;21371;16231;1;875;417;3533;198;61;1818;864;137;954;78;71;5
494;8.62375e-15;124;1726;21110;16223;1;809;408;3533;232;58;1727;818;174;909;78;71;5
495;8.68978e-15;110;1576;21420;16286;1;891;420;3534;205;75;1835;848;130;987;78;71;5
495;8.68333e-15;126;1731;21201;16290;1;797;413;3534;198;57;1686;850;141;836;78;71;5
496;8.73416e-15;121;1705;21530;16331;1;872;424;3534;184;52;1830;763;132;1067;78;71;5
496;8.73739e-15;162;1727;21303;16367;1;783;417;3534;187;55;1789;833;132;956;78;71;5
497;8.77053e-15;115;1703;21621;16381;1;867;464;3534;202;61;1778;832;141;946;78;71;5
497;8.79885e-15;138;1718;21370;16415;1;795;451;3534;202;74;1768;851;128;917;78;71;5
498;8.81099e-15;125;1737;21710;16448;1;862;462;3535;217;60;1779;811;157;968;78;70;5
498;8.83855e-15;131;1727;21462;16479;1;792;439;3535;221;72;1829;853;149;976;78;70;5
499;8.86532e-15;113;1728;21775;16505;1;871;416;3535;239;68;1770;925;171;845;78;70;5
499;8.89049e-15;142;1754;21546;16537;1;794;409;3535;213;81;1807;785;132;1022;78;70;5
500;8.91162e-15;149;1746;21862;16569;1;867;414;3535;212;58;1810;841;154;969;78;69;5
500;8.93765e-15;137;1714;21619;16593;1;799;409;3535;186;71;1778;854;115;924;78;69;5
501;8.96371e-15;121;1740;21928;16626;1;878;412;3536;223;67;1805;846;156;959;77;68;5
501;8.98327e-15;128;1766;21673;16648;1;811;404;3536;208;53;1757;865;155;892;77;68;5
502;9.01018e-15;136;1693;22035;16678;1;867;406;3536;217;66;1701;845;151;856;77;68;5
502;9.02814e-15;136;1707;21772;16707;1;797;400;3536;200;73;1819;899;127;920;77;68;5
503;9.05265e-15;128;1643;22123;16742;1;862;413;3536;210;56;1818;866;154;952;77;69;5
503;9.07636e-15;123;1699;21850;16777;1;796;407;3536;175;67;1822;826;108;996;77;69;5
504;9.10501e-15;133;1663;22170;16808;1;886;426;3537;209;72;1741;820;137;921;77;68;5
504;9.13369e-15;133;1701;21908;16842;1;808;419;3537;209;59;1819;832;150;987;77;68;5
505;9.15911e-15;148;1654;22262;16864;1;869;442;3537;237;59;1698;869;178;829;77;69;5
505;9.18703e-15;132;1675;21991;16902;1;804;426;3537;212;62;1748;894;150;854;77;69;5
506;9.2051e-15;139;1702;22332;16929;1;879;421;3537;209;55;1734;837;154;897;77;68;5
506;9.23635e-15;133;1653;22058;16965;1;805;408;3537;220;61;1768;820;159;948;77;68;5
507;9.25858e-15;129;1671;22414;16970;1;878;406;3537;216;63;1831;876;153;955;77;68;5
507;9.28824e-15;124;1692;22103;17043;1;826;398;3537;203;52;1790;799;151;991;77;68;5
508;9.29236e-15;119;1773;22498;17014;1;875;383;3538;193;71;1652;835;122;817;76;68;5
508;9.35262e-15;132;1740;22188;17104;1;822;378;3538;178;68;1772;811;110;961;76;68;5
509;9.32867e-15;114;1687;22532;17072;1;895;361;3538;193;54;1815;882;139;933;75;68;5
509;9.40307e-15;127;1700;22245;17159;1;832;354;3538;191;44;1710;848;147;862;75;68;5
510;9.37659e-15;105;1678;22625;17138;1;882;376;3538;182;51;1777;871;131;906;74;67;5
510;9.44863e-15;119;1670;22349;17218;1;815;370;3538;167;49;1788;834;118;954;74;67;5
511;9.43123e-15;116;1723;22694;17206;1;881;380;3539;164;63;1813;860;101;953;74;67;5
511;9.49759e-15;124;1728;22400;17289;1;827;360;3539;179;65;1759;816;114;943;74;67;5
512;9.48763e-15;130;1708;22774;17266;1;877;358;3539;193;62;1788;849;131;939;74;68;5
512;9.55663e-15;109;1746;22482;17346;1;818;352;3539;180;59;1845;869;121;976;74;68;5
513;9.53749e-15;108;1694;22838;17315;1;884;359;3539;167;66;1778;868;101;910;74;68;5
513;9.60411e-15;98;1735;22544;17402;1;817;347;3539;182;54;1789;802;128;987;74;68;5
514;9.57827e-15;91;1692;22944;17380;1;864;353;3540;200;61;1768;845;139;923;74;69;5
514;9.65083e-15;121;1661;22621;17464;1;805;346;3540;170;43;1707;851;127;856;74;69;5
515;9.63246e-15;108;1724;23029;17438;1;855;320;3540;158;47;1743;850;111;893;74;69;5
515;9.70265e-15;117;1737;22693;17539;1;803;315;3540;163;53;1794;849;110;945;74;69;5
516;9.68091e-15;107;1764;23143;17497;1;823;314;3540;153;52;1755;802;101;953;73;69;5
516;9.76545e-15;114;1764;22772;17593;1;800;308;3540;165;45;1754;860;120;894;73;69;5
517;9.73027e-15;108;1743;23208;17557;1;825;377;3541;138;47;1710;865;91;845;73;70;5
517;9.81076e-15;92;1787;22863;17638;1;785;362;3541;141;56;1765;863;85;902;73;70;5
518;9.78055e-15;117;1724;23258;17624;1;834;347;3541;196;61;1796;861;135;935;73;70;5
518;9.84857e-15;114;1643;22963;17696;1;766;319;3541;180;54;1822;859;126;963;73;70;5
519;9.8368e-15;126;1735;23307;17670;1;846;362;3541;177;59;1682;860;118;822;73;70;5
519;9.89737e-15;101;1731;23026;17760;1;768;336;3541;184;37;1755;858;147;897;73;70;5
520;9.87548e-15;126;1651;23364;17718;1;855;372;3541;201;68;1695;827;133;868;73;70;5
520;9.95131e-15;105;1730;23134;17813;1;743;359;3541;180;50;1752;863;130;889;73;70;5
521;9.9159e-15;129;1711;23423;17782;1;855;353;3542;186;66;1844;847;120;997;73;69;5
521;9.99606e-15;95;1707;23209;17863;1;736;333;3542;202;52;1758;893;150;865;73;69;5
522;9.96988e-15;117;1723;23459;17836;1;879;317;3542;162;53;1733;845;109;888;73;69;5
522;1.00383e-14;108;1626;23265;17922;1;734;305;3542;171;52;1843;916;119;927;73;69;5
523;1.00155e-14;92;1640;23540;17890;1;867;372;3542;172;52;1688;846;120;842;73;68;5
523;1.00883e-14;99;1604;23329;17981;1;729;361;3542;158;49;1816;859;109;957;73;68;5
524;1.00612e-14;109;1744;23639;17946;1;848;327;3543;185;41;1703;823;144;880;73;68;5
524;1.01383e-14;116;1617;23398;18027;1;718;304;3543;194;60;1870;803;134;1067;73;68;5
525;1.01086e-14;89;1728;23727;18007;1;837;314;3543;159;42;1735;839;117;896;73;69;5
525;1.01774e-14;106;1616;23440;18083;1;727;304;3543;154;52;1861;851;102;1010;73;69;5
526;1.01604e-14;90;1710;23802;18072;1;830;309;3543;155;51;1786;896;104;890;72;69;5
526;1.02251e-14;98;1692;23490;18134;1;727;306;3543;139;63;1771;834;76;937;72;69;5
527;1.02157e-14;78;1706;23875;18134;1;822;263;3444;152;49;1793;849;103;944;73;69;5
527;1.02685e-14;102;1725;23527;18178;1;737;358;3544;142;53;1686;805;89;881;72;69;5
528;1.02685e-14;71;1705;23973;18183;1;800;337;3544;115;38;1705;803;77;902;72;68;5
528;1.0306e-14;113;1719;23562;18253;1;754;332;3544;172;60;1793;907;112;886;72;68;5
529;1.03103e-14;97;1678;24035;18231;1;798;326;3544;153;48;1811;864;105;947;72;68;5
529;1.03701e-14;94;1702;23630;18313;1;749;314;3544;178;57;1741;870;121;871;72;68;5
530;1.03513e-14;98;1696;24100;18280;1;798;312;3544;157;43;1781;824;114;957;72;67;5
530;1.04215e-14;97;1691;23694;18376;1;745;307;3544;145;48;1806;830;97;976;72;67;5
531;1.03932e-14;100;1759;24169;18340;1;792;369;3545;153;56;1799;916;97;883;70;67;5
531;1.04755e-14;86;1670;23772;18434;1;734;359;3545;152;59;1727;824;93;903;70;67;5
532;1.04446e-14;130;1666;24255;18400;1;778;368;3545;162;51;1757;884;111;873;71;66;5
532;1.05253e-14;116;1642;23833;18484;1;730;357;3545;182;49;1749;817;133;932;71;66;5
533;1.04961e-14;120;1721;24315;18462;1;780;283;3545;179;61;1783;880;118;903;70;67;5
533;1.05683e-14;96;1710;23862;18553;1;748;270;3545;169;56;1739;834;113;905;70;67;5
534;1.05494e-14;92;1703;24383;18517;1;778;326;3546;137;50;1760;886;87;874;70;67;5
534;1.06278e-14;83;1744;23931;18610;1;741;311;3546;128;47;1815;893;81;922;70;67;5
535;1.05968e-14;92;1697;24449;18575;1;776;291;3546;158;43;1809;845;115;964;70;66;5
535;1.0677e-14;88;1767;24019;18669;1;719;273;3546;189;55;1761;855;134;906;70;66;5
536;1.06468e-14;93;1727;24516;18634;1;768;266;3546;121;51;1811;834;70;977;70;67;5
536;1.0728e-14;98;1782;24096;18725;1;706;262;3546;131;58;1829;863;73;966;70;67;5
537;1.06977e-14;87;1730;24606;18687;1;749;271;3546;137;41;1734;828;96;906;69;67;5
537;1.07765e-14;95;1779;24172;18777;1;692;267;3546;124;42;1730;866;82;864;69;67;5
538;1.07436e-14;88;1761;24690;18744;1;730;314;3547;123;40;1716;917;83;799;69;68;6
538;1.08215e-14;75;1857;24254;18840;1;674;288;3547;130;46;1721;888;84;833;69;68;6
539;1.07929e-14;82;1679;24757;18795;1;723;325;3547;173;55;1853;886;118;967;69;68;6
539;1.08763e-14;83;1771;24325;18895;1;654;315;3547;138;55;1787;940;83;847;69;68;6
540;1.08372e-14;82;1741;24804;18844;1;730;301;3547;175;54;1697;840;121;857;69;68;6
540;1.09241e-14;95;1777;24384;18939;1;645;270;3547;168;47;1779;895;121;884;69;68;6
541;1.08797e-14;91;1744;24879;18891;1;718;314;3548;167;48;1742;865;119;877;69;68;6
541;1.09624e-14;87;1753;24449;18997;1;637;304;3548;144;48;1755;885;96;870;69;68;6
542;1.09206e-14;113;1762;24921;18942;1;726;265;3548;161;46;1788;898;115;890;70;68;6
542;1.1013e-14;108;1748;24508;19054;1;637;260;3548;137;43;1870;817;94;1053;70;68;6
543;1.0965e-14;106;1740;24979;19010;1;729;293;3548;122;46;1740;860;76;880;69;68;6
543;1.10628e-14;78;1780;24575;19115;1;631;284;3548;132;45;1864;885;87;979;69;68;6
544;1.10243e-14;97;1773;25026;19077;1;733;307;3548;149;52;1803;844;97;959;69;68;6
544;1.11161e-14;99;1834;24643;19179;1;619;286;3548;145;37;1699;873;108;826;69;68;6
545;1.10829e-14;95;1739;25092;19129;1;726;337;3549;162;50;1702;896;112;806;69;69;6
545;1.11722e-14;101;1673;24698;19236;1;613;326;3549;146;36;1741;925;110;816;69;69;6
546;1.11284e-14;103;1763;25142;19181;1;733;300;3549;172;56;1739;867;116;872;68;67;6
546;1.12222e-14;105;1782;24739;19290;1;620;294;3549;174;67;1820;800;107;1020;68;67;6
547;1.1174e-14;109;1755;25201;19231;1;726;315;3549;134;50;1840;902;84;938;68;68;6
547;1.12697e-14;110;1771;24790;19352;1;620;299;3549;157;49;1729;901;108;828;68;68;6
548;1.12178e-14;110;1757;25271;19277;1;722;213;3450;147;55;1792;857;92;935;69;67;6
548;1.13243e-14;108;1746;24842;19412;1;624;302;3550;164;40;1777;877;124;900;69;67;6
549;1.12583e-14;68;1673;25336;19337;1;719;312;3550;110;48;1712;837;62;875;68;68;6
549;1.13772e-14;98;1786;24875;19481;1;641;301;3550;142;41;1840;856;101;984;68;68;6
550;1.13111e-14;81;1701;25399;19402;1;703;292;3550;167;46;1699;789;121;910;68;66;6
550;1.14381e-14;94;1750;24902;19531;1;656;281;3550;142;51;1746;902;91;844;68;66;6
551;1.13683e-14;94;1759;25456;19460;1;694;198;3450;139;41;1807;824;98;983;69;67;6
551;1.14823e-14;93;1713;24954;19567;1;653;277;3550;144;47;1722;865;97;857;68;67;6
552;1.14195e-14;73;1666;25492;19517;1;700;298;3551;88;38;1636;863;50;773;67;66;6
552;1.15142e-14;97;1673;24986;19623;1;668;290;3551;137;43;1804;885;94;919;67;66;6
553;1.14699e-14;84;1689;25538;19580;1;702;308;3551;150;37;1794;843;113;951;67;66;6
553;1.15638e-14;87;1742;25006;19679;1;688;299;3551;130;43;1792;849;87;943;67;66;6
554;1.15257e-14;93;1754;25600;19623;1;694;232;3451;134;55;1781;865;79;916;68;66;6
554;1.16135e-14;94;1671;25062;19735;1;687;222;3451;142;44;1766;866;98;900;68;66;6
555;1.15638e-14;83;1757;25679;19681;1;677;310;3551;120;34;1851;852;86;999;67;65;6
555;1.16633e-14;85;1714;25100;19796;1;692;305;3551;126;32;1748;844;94;904;67;65;6
556;1.16153e-14;102;1768;25724;19740;1;674;340;3552;166;48;1804;903;118;901;67;66;6
556;1.17176e-14;115;1738;25165;19841;1;680;328;3552;173;52;1772;856;121;916;67;66;6
557;1.16678e-14;109;1713;25773;19791;1;680;328;3552;171;61;1745;849;110;896;67;65;6
557;1.17578e-14;100;1740;25180;19901;1;701;308;3552;180;64;1726;845;116;881;67;64;6
558;1.17132e-14;105;1702;25812;19842;1;692;303;3552;168;52;1765;856;116;909;66;64;6
558;1.18113e-14;100;1708;25239;19963;1;696;287;3552;175;52;1723;887;123;836;66;64;6
559;1.17587e-14;119;1715;25854;19885;1;703;228;3453;161;46;1747;840;115;907;67;65;6
559;1.18668e-14;107;1700;25298;20020;1;692;211;3453;139;45;1801;910;94;891;67;65;6
560;1.1797e-14;100;1660;25910;19932;1;699;333;3553;121;43;1780;840;78;940;66;64;6
560;4.1951e-15;53;1364;9079;10057;1;642;319;3553;108;26;1744;458;82;1286;66;64;6
561;1.1839e-14;107;1786;25945;19979;1;709;1.07374e+08;-2.14748e+09;164;54;1808;860;110;948;66;64;6
561;4.22483e-15;81;1624;9258;10117;1;575;2.14749e+08;-2.14748e+09;151;42;1773;754;109;1019;66;63;6
562;1.18811e-14;107;1786;25945;19979;1;709;4.21148e+08;-2.06399e+09;0;0;-1;0;0;-1;65;63;6
562;4.26289e-15;81;1621;9258;10117;1;575;4.21148e+08;-2.06399e+09;0;0;-1;0;0;-1;65;63;6
563;1.18811e-14;108;1782;25945;19979;1;709;6.19576e+08;-1.98428e+09;0;0;-1;0;0;-1;65;63;6
563;4.26289e-15;81;1620;9258;10117;1;575;6.19576e+08;-1.98428e+09;0;0;-1;0;0;-1;65;63;6
564;1.18811e-14;108;1781;25945;19979;1;709;7.03019e+08;-1.90817e+09;0;0;-1;0;0;-1;416;414;6
564;4.26289e-15;81;1620;9258;10117;1;575;7.03019e+08;-1.90817e+09;0;0;-1;0;0;-1;416;414;6
565;1.18811e-14;109;1779;25945;19979;1;709;8.86568e+08;-1.83548e+09;0;0;-1;0;0;-1;1764;1761;6
565;4.26289e-15;81;1620;9258;10117;1;575;8.86568e+08;-1.83548e+09;0;0;-1;0;0;-1;1764;1761;6
566;1.18811e-14;110;1777;25945;19979;1;709;9.55798e+08;-1.76604e+09;1;0;-1;0;1;-1;5004;5001;6
566;4.26289e-15;81;1620;9258;10117;1;575;9.55798e+08;-1.76604e+09;0;0;-1;0;0;-1;5004;5001;6
567;1.18811e-14;111;1776;25945;19979;1;709;1.34052e+09;-1.69969e+09;2;0;-1;0;2;-1;11232;11230;6
567;4.26289e-15;83;1620;9258;10117;1;575;1.34052e+09;-1.69969e+09;1;0;-1;0;1;-1;11232;11230;6
568;1.18811e-14;111;1776;25945;19979;1;709;1.28939e+09;-1.63627e+09;1;0;-1;0;1;-1;21712;21710;6
568;4.26289e-15;83;1619;9258;10117;1;575;1.28939e+09;-1.63627e+09;0;0;-1;0;0;-1;21712;21710;6
569;1.18811e-14;111;1775;25945;19979;1;709;1.66171e+09;-1.57565e+09;0;0;-1;0;0;-1;37837;37834;6
569;4.26289e-15;84;1617;9258;10117;1;575;1.66171e+09;-1.57565e+09;1;0;-1;0;1;-1;37837;37834;6
570;1.18811e-14;112;1775;25945;19979;1;709;1.81348e+09;-1.51768e+09;1;0;-1;0;1;-1;61099;61096;6
570;4.26289e-15;84;1615;9258;10117;1;575;1.81348e+09;-1.51768e+09;0;0;-1;0;0;-1;61099;61096;6
571;1.18811e-14;115;1772;25945;19979;1;709;1.74495e+09;-1.46224e+09;7;0;-1;0;7;-1;93064;93061;6
571;4.26289e-15;84;1614;9258;10117;1;575;1.74495e+09;-1.46224e+09;2;0;-1;0;2;-1;93064;93061;6
572;1.18811e-14;115;1772;25945;19979;1;709;1.88587e+09;-1.40921e+09;1;0;-1;0;1;-1;135348;135345;6
572;4.26289e-15;94;1612;9258;10117;1;575;1.88587e+09;-1.40921e+09;3;0;-1;0;3;-1;135348;135345;6
573;1.18811e-14;121;1770;25945;19979;1;709;2.02172e+09;-1.35846e+09;4;0;-1;0;4;-1;189593;189590;6
573;4.26289e-15;100;1611;9258;10117;1;575;2.02172e+09;-1.35846e+09;2;0;-1;0;2;-1;189593;189590;6
574;1.18811e-14;123;1768;25945;19979;1;709;-2.14748e+09;-1.30989e+09;4;0;-1;0;4;-1;257453;257450;6
574;4.26289e-15;100;1611;9258;10117;1;575;-2.14748e+09;-1.30989e+09;1;0;-1;0;1;-1;257453;257450;6
575;1.18811e-14;122;1767;25945;19979;1;709;-2.14748e+09;-1.2634e+09;-1;0;0;0;-1;0;340574;340572;6
575;4.26289e-15;100;1611;9258;10117;1;575;-2.14748e+09;-1.2634e+09;0;0;-1;0;0;-1;340574;340572;6
576;1.18811e-14;119;1767;25945;19979;1;709;-2.14748e+09;-1.21888e+09;-1;0;0;0;-1;0;440587;440584;6
576;4.26289e-15;98;1608;9258;10117;1;575;-2.14748e+09;-1.21888e+09;-1;0;0;0;-1;0;440587;440584;6
577;1.18811e-14;118;1767;25945;19979;1;709;-2.14748e+09;-1.17625e+09;-1;0;0;0;-1;0;559086;559083;6
577;4.26289e-15;97;1608;9258;10117;1;575;-2.14748e+09;-1.17625e+09;0;0;-1;0;0;-1;559086;559083;6
578;1.18811e-14;118;1766;25945;19979;1;709;-2.14748e+09;-1.13541e+09;-1;0;0;0;-1;0;697627;697624;6
578;4.26289e-15;97;1608;9258;10117;1;575;-2.14748e+09;-1.13541e+09;0;0;-1;0;0;-1;697627;697624;6
579;1.18811e-14;118;1766;25945;19979;1;709;-2.14748e+09;-1.09627e+09;-1;0;0;0;-1;0;857717;857715;6
579;4.26289e-15;97;1607;9258;10117;1;575;-2.14748e+09;-1.09627e+09;-1;0;0;0;-1;0;857717;857715;6
580;1.18811e-14;118;1766;25945;19979;1;709;-2.14748e+09;-1.05877e+09;-1;0;0;0;-1;0;1040806;1040803;6
580;4.26289e-15;97;1607;9258;10117;1;575;-2.14748e+09;-1.05877e+09;0;0;-1;0;0;-1;1040806;1040803;6
581;1.18811e-14;117;1766;25945;19979;1;709;-2.14748e+09;-1.02281e+09;-1;0;0;0;-1;0;1248279;1248276;6
581;4.26289e-15;97;1607;9258;10117;1;575;-2.14748e+09;-1.02281e+09;0;0;-1;0;0;-1;1248279;1248276;6
582;1.18811e-14;117;1765;25945;19979;1;709;-2.14748e+09;-9.88342e+08;-1;0;0;0;-1;0;1481457;1481455;6
582;4.26289e-15;97;1607;9258;10117;1;575;-2.14748e+09;-9.88342e+08;0;0;-1;0;0;-1;1481457;1481455;6
583;1.18811e-14;117;1764;25945;19979;1;709;-2.14748e+09;-9.5528e+08;-1;0;0;0;-1;0;1741590;1741587;6
583;4.26289e-15;96;1606;9258;10117;1;575;-2.14748e+09;-9.5528e+08;-1;0;0;0;-1;0;1741590;1741587;6
584;1.18811e-14;117;1764;25945;19979;1;709;-2.14748e+09;-9.23566e+08;-1;0;0;0;-1;0;2029853;2029850;6
584;4.26289e-15;96;1606;9258;10117;1;575;-2.14748e+09;-9.23566e+08;-1;0;0;0;-1;0;2029853;2029850;6
585;1.18811e-14;116;1764;25945;19979;1;709;-2.14748e+09;-8.93136e+08;-1;0;0;0;-1;0;2347347;2347344;6
585;4.26289e-15;96;1606;9258;10117;1;575;-2.14748e+09;-8.93136e+08;0;0;-1;0;0;-1;2347347;2347344;6
586;1.18811e-14;114;1764;25945;19979;1;709;-2.14748e+09;-8.63933e+08;-1;0;0;0;-1;0;2695095;2695092;6
586;4.26289e-15;94;1606;9258;10117;1;575;-2.14748e+09;-8.63933e+08;-1;0;0;0;-1;0;2695095;2695092;6
587;1.18811e-14;114;1764;25945;19979;1;709;-2.14748e+09;-8.359e+08;0;0;-1;0;0;-1;3074045;3074042;6
587;4.26289e-15;93;1606;9258;10117;1;575;-2.14748e+09;-8.359e+08;0;0;-1;0;0;-1;3074045;3074042;6
588;1.18811e-14;114;1764;25945;19979;1;709;-2.14748e+09;-8.08984e+08;0;0;-1;0;0;-1;3485065;3485062;6
588;4.26289e-15;92;1605;9258;10117;1;575;-2.14748e+09;-8.08984e+08;-1;0;0;0;-1;0;3485065;3485062;6
589;1.18811e-14;114;1764;25945;19979;1;709;-2.14748e+09;-7.83135e+08;0;0;-1;0;0;-1;3928947;3928944;6
589;4.26289e-15;92;1604;9258;10117;1;575;-2.14748e+09;-7.83135e+08;-1;0;0;0;-1;0;3928947;3928944;6
590;1.18811e-14;114;1764;25945;19979;1;709;-2.14748e+09;-7.58305e+08;0;0;-1;0;0;-1;4406407;4406404;6
590;4.26289e-15;92;1603;9258;10117;1;575;-2.14748e+09;-7.58305e+08;0;0;-1;0;0;-1;4406407;4406404;6
591;1.18811e-14;113;1764;25945;19979;1;709;-2.14748e+09;-7.34449e+08;-1;0;0;0;-1;0;4918086;4918083;6
591;4.26289e-15;92;1603;9258;10117;1;575;-2.14748e+09;-7.34449e+08;-1;0;0;0;-1;0;4918086;4918083;6
592;1.18811e-14;113;1764;25945;19979;1;709;-2.14748e+09;-7.11523e+08;-1;0;0;0;-1;0;5464550;5464547;7
592;4.26289e-15;89;1599;9258;10117;1;575;-2.14748e+09;-7.11523e+08;0;0;-1;0;0;-1;5464550;5464547;7
593;1.18811e-14;110;1764;25945;19979;1;709;-2.14748e+09;-6.89486e+08;0;0;-1;0;0;-1;6046293;6046291;7
593;4.26289e-15;88;1599;9258;10117;1;575;-2.14748e+09;-6.89486e+08;-1;0;0;0;-1;0;6046293;6046291;7
594;1.18811e-14;108;1764;25945;19979;1;709;-2.14748e+09;-6.68298e+08;-1;0;0;0;-1;0;6663741;6663738;7
594;4.26289e-15;88;1599;9258;10117;1;575;-2.14748e+09;-6.68298e+08;-1;0;0;0;-1;0;6663741;6663738;7
595;1.18811e-14;108;1763;25945;19979;1;709;-2.14748e+09;-6.47923e+08;0;0;-1;0;0;-1;7317248;7317245;7
595;4.26289e-15;88;1599;9258;10117;1;575;-2.14748e+09;-6.47923e+08;-1;0;0;0;-1;0;7317248;7317245;7
596;1.18811e-14;108;1763;25945;19979;1;709;-2.14748e+09;-6.28325e+08;-1;0;0;0;-1;0;8007105;8007102;7
596;4.26289e-15;88;1599;9258;10117;1;575;-2.14748e+09;-6.28325e+08;-1;0;0;0;-1;0;8007105;8007102;7
597;1.18811e-14;106;1763;25945;19979;1;709;-2.14748e+09;-6.0947e+08;-1;0;0;0;-1;0;8733537;8733534;7
597;4.26289e-15;87;1598;9258;10117;1;575;-2.14748e+09;-6.0947e+08;-1;0;0;0;-1;0;8733537;8733534;7
598;1.18811e-14;105;1763;25945;19979;1;709;-2.14748e+09;-5.91326e+08;-1;0;0;0;-1;0;9496710;9496707;8
598;4.26289e-15;87;1598;9258;10117;1;575;-2.14748e+09;-5.91326e+08;0;0;-1;0;0;-1;9496710;9496707;8
599;1.18811e-14;105;1763;25945;19979;1;709;-2.14748e+09;-5.73862e+08;-1;0;0;0;-1;0;10296729;10296727;8
599;4.26289e-15;85;1597;9258;10117;1;575;-2.14748e+09;-5.73862e+08;-1;0;0;0;-1;0;10296729;10296727;8
600;1.18811e-14;105;1763;25945;19979;1;709;-2.14748e+09;-5.57049e+08;0;0;-1;0;0;-1;11133645;11133642;9
600;4.26289e-15;85;1597;9258;10117;1;575;-2.14748e+09;-5.57049e+08;-1;0;0;0;-1;0;11133645;11133642;9
601;1.18811e-14;105;1762;25945;19979;1;709;-2.14748e+09;-5.40859e+08;-1;0;0;0;-1;0;12007452;12007450;9
601;4.26289e-15;85;1597;9258;10117;1;575;-2.14748e+09;-5.40859e+08;-1;0;0;0;-1;0;12007452;12007450;9
602;1.18811e-14;105;1762;25945;19979;1;709;-2.14748e+09;-5.25266e+08;-1;0;0;0;-1;0;12918097;12918094;10
602;4.26289e-15;84;1597;9258;10117;1;575;-2.14748e+09;-5.25266e+08;-1;0;0;0;-1;0;12918097;12918094;10
603;1.18811e-14;102;1761;25945;19979;1;709;-2.14748e+09;-5.10244e+08;0;0;-1;0;0;-1;13865473;13865471;11
603;4.26289e-15;82;1597;9258;10117;1;575;-2.14748e+09;-5.10244e+08;0;0;-1;0;0;-1;13865473;13865471;11
604;1.18811e-14;100;1761;25945;19979;1;709;-2.14748e+09;-4.95769e+08;0;0;-1;0;0;-1;14849432;14849430;12
604;4.26289e-15;82;1597;9258;10117;1;575;-2.14748e+09;-4.95769e+08;-1;0;0;0;-1;0;14849432;14849430;12
605;1.18811e-14;98;1761;25945;19979;1;709;-2.14748e+09;-4.81819e+08;-1;0;0;0;-1;0;15869779;15869777;13
605;4.26289e-15;81;1597;9258;10117;1;575;-2.14748e+09;-4.81819e+08;-1;0;0;0;-1;0;15869779;15869777;13
606;1.18811e-14;98;1761;25945;19979;1;709;-2.14748e+09;-4.68371e+08;-1;0;0;0;-1;0;16926279;16926277;15
606;4.26289e-15;80;1597;9258;10117;1;575;-2.14748e+09;-4.68371e+08;-1;0;0;0;-1;0;16926279;16926277;15
607;1.18811e-14;98;1761;25945;19979;1;709;-2.14748e+09;-4.55404e+08;-1;0;0;0;-1;0;18018659;18018657;17
607;4.26289e-15;79;1597;9258;10117;1;575;-2.14748e+09;-4.55404e+08;-1;0;0;0;-1;0;18018659;18018657;17
608;1.18811e-14;98;1761;25945;19979;1;709;-2.14748e+09;-4.429e+08;-1;0;0;0;-1;0;19146609;19146607;19
608;4.26289e-15;77;1596;9258;10117;1;575;-2.14748e+09;-4.429e+08;0;0;-1;0;0;-1;19146609;19146607;19
609;1.18811e-14;98;1761;25945;19979;1;709;-2.14748e+09;-4.30837e+08;0;0;-1;0;0;-1;20309784;20309782;22
609;4.26289e-15;74;1596;9258;10117;1;575;-2.14748e+09;-4.30837e+08;-1;0;0;0;-1;0;20309784;20309782;22
610;1.18811e-14;98;1761;25945;19979;1;709;-2.14748e+09;-4.192e+08;-1;0;0;0;-1;0;21507808;21507806;25
610;4.26289e-15;74;1596;9258;10117;1;575;-2.14748e+09;-4.192e+08;-1;0;0;0;-1;0;21507808;21507806;25
611;1.18811e-14;98;1760;25945;19979;1;709;-2.14748e+09;-4.07969e+08;-1;0;0;0;-1;0;22740277;22740275;29
611;4.26289e-15;74;1596;9258;10117;1;575;-2.14748e+09;-4.07969e+08;-1;0;0;0;-1;0;22740277;22740275;29
612;1.18811e-14;98;1760;25945;19979;1;709;-2.14748e+09;-3.97129e+08;0;0;-1;0;0;-1;24006757;24006756;33
612;4.26289e-15;70;1596;9258;10117;1;575;-2.14748e+09;-3.97129e+08;-1;0;0;0;-1;0;24006757;24006756;33
613;1.18811e-14;98;1759;25945;19979;1;709;-2.14748e+09;-3.86664e+08;-1;0;0;0;-1;0;25306792;25306791;39
613;4.26289e-15;67;1596;9258;10117;1;575;-2.14748e+09;-3.86664e+08;-1;0;0;0;-1;0;25306792;25306791;39
614;1.18811e-14;97;1758;25945;19979;1;709;-2.14748e+09;-3.76558e+08;0;0;-1;0;0;-1;26639899;26639898;45
614;4.26289e-15;67;1596;9258;10117;1;575;-2.14748e+09;-3.76558e+08;-1;0;0;0;-1;0;26639899;26639898;45
615;1.18811e-14;97;1757;25945;19979;1;709;-2.14748e+09;-3.66798e+08;-1;0;0;0;-1;0;28005576;28005576;52
615;4.26289e-15;66;1595;9258;10117;1;575;-2.14748e+09;-3.66798e+08;-1;0;0;0;-1;0;28005576;28005576;52
616;1.18811e-14;97;1757;25945;19979;1;709;-2.14748e+09;-3.57369e+08;-1;0;0;0;-1;0;29403302;29403302;60
616;4.26289e-15;66;1595;9258;10117;1;575;-2.14748e+09;-3.57369e+08;0;0;-1;0;0;-1;29403302;29403302;60
617;1.18811e-14;95;1757;25945;19979;1;709;-2.14748e+09;-3.48258e+08;-1;0;0;0;-1;0;30832536;30832537;69
617;4.26289e-15;63;1595;9258;10117;1;575;-2.14748e+09;-3.48258e+08;-1;0;0;0;-1;0;30832536;30832537;69
618;1.18811e-14;93;1757;25945;19979;1;709;-2.14748e+09;-3.39454e+08;0;0;-1;0;0;-1;32292724;32292725;79
618;4.26289e-15;63;1595;9258;10117;1;575;-2.14748e+09;-3.39454e+08;-1;0;0;0;-1;0;32292724;32292725;79
619;1.18811e-14;93;1757;25945;19979;1;709;-2.14748e+09;-3.30943e+08;-1;0;0;0;-1;0;33783295;33783296;91
619;4.26289e-15;62;1595;9258;10117;1;575;-2.14748e+09;-3.30943e+08;-1;0;0;0;-1;0;33783295;33783296;91
620;1.18811e-14;93;1757;25945;19979;1;709;-2.14748e+09;-3.22714e+08;-1;0;0;0;-1;0;35303667;35303669;105
620;4.26289e-15;62;1595;9258;10117;1;575;-2.14748e+09;-3.22714e+08;-1;0;0;0;-1;0;35303667;35303669;105
621;1.18811e-14;93;1757;25945;19979;1;709;-2.14748e+09;-3.14757e+08;-1;0;0;0;-1;0;36853245;36853247;121
621;4.26289e-15;62;1595;9258;10117;1;575;-2.14748e+09;-3.14757e+08;-1;0;0;0;-1;0;36853245;36853247;121
622;1.18811e-14;93;1757;25945;19979;1;709;-2.14748e+09;-3.07061e+08;0;0;-1;0;0;-1;38431426;38431429;138
622;4.26289e-15;62;1595;9258;10117;1;575;-2.14748e+09;-3.07061e+08;0;0;-1;0;0;-1;38431426;38431429;138
623;1.18811e-14;93;1757;25945;19979;1;709;-2.14748e+09;-2.99615e+08;-1;0;0;0;-1;0;40037598;40037603;158
623;4.26289e-15;62;1595;9258;10117;1;575;-2.14748e+09;-2.99615e+08;-1;0;0;0;-1;0;40037598;40037603;158
624;1.18811e-14;91;1757;25945;19979;1;709;-2.14748e+09;-2.92411e+08;-1;0;0;0;-1;0;41671142;41671148;180
624;4.26289e-15;62;1595;9258;10117;1;575;-2.14748e+09;-2.92411e+08;-1;0;0;0;-1;0;41671142;41671148;180
625;1.18811e-14;89;1757;25945;19979;1;709;-2.14748e+09;-2.85438e+08;-1;0;0;0;-1;0;43331432;43331439;205
625;4.26289e-15;60;1595;9258;10117;1;575;-2.14748e+09;-2.85438e+08;-1;0;0;0;-1;0;43331432;43331439;205
626;1.18811e-14;89;1757;25945;19979;1;709;-2.14748e+09;-2.78689e+08;-1;0;0;0;-1;0;45017839;45017848;233
626;4.26289e-15;60;1595;9258;10117;1;575;-2.14748e+09;-2.78689e+08;-1;0;0;0;-1;0;45017839;45017848;233
627;1.18811e-14;89;1757;25945;19979;1;709;-2.14748e+09;-2.72154e+08;-1;0;0;0;-1;0;46729729;46729739;264
627;4.26289e-15;56;1595;9258;10117;1;575;-2.14748e+09;-2.72154e+08;-1;0;0;0;-1;0;46729729;46729739;264
628;1.18811e-14;89;1757;25945;19979;1;709;-2.14748e+09;-2.65826e+08;-1;0;0;0;-1;0;48466466;48466476;299
628;4.26289e-15;56;1595;9258;10117;1;575;-2.14748e+09;-2.65826e+08;-1;0;0;0;-1;0;48466466;48466476;299
629;1.18811e-14;86;1757;25945;19979;1;709;-2.14748e+09;-2.59697e+08;-1;0;0;0;-1;0;50227410;50227423;338
629;4.26289e-15;55;1595;9258;10117;1;575;-2.14748e+09;-2.59697e+08;-1;0;0;0;-1;0;50227410;50227423;338
630;1.18811e-14;86;1757;25945;19979;1;709;-2.14748e+09;-2.53759e+08;-1;0;0;0;-1;0;52011925;52011940;381
630;4.26289e-15;55;1595;9258;10117;1;575;-2.14748e+09;-2.53759e+08;-1;0;0;0;-1;0;52011925;52011940;381
631;1.18811e-14;86;1757;25945;19979;1;709;-2.14748e+09;-2.48005e+08;-1;0;0;0;-1;0;53819371;53819388;429
631;4.26289e-15;53;1595;9258;10117;1;575;-2.14748e+09;-2.48005e+08;-1;0;0;0;-1;0;53819371;53819388;429
632;1.18811e-14;85;1757;25945;19979;1;709;-2.14748e+09;-2.42429e+08;-1;0;0;0;-1;0;55649111;55649131;481
632;4.26289e-15;53;1595;9258;10117;1;575;-2.14748e+09;-2.42429e+08;-1;0;0;0;-1;0;55649111;55649131;481
633;1.18811e-14;85;1757;25945;19979;1;709;-2.14748e+09;-2.37024e+08;-1;0;0;0;-1;0;57500510;57500531;539
633;4.26289e-15;53;1595;9258;10117;1;575;-2.14748e+09;-2.37024e+08;-1;0;0;0;-1;0;57500510;57500531;539
634;1.18811e-14;84;1757;25945;19979;1;709;-2.14748e+09;-2.31784e+08;-1;0;0;0;-1;0;59372932;59372957;603
634;4.26289e-15;52;1595;9258;10117;1;575;-2.14748e+09;-2.31784e+08;-1;0;0;0;-1;0;59372932;59372957;603
635;1.18811e-14;82;1757;25945;19979;1;709;-2.14748e+09;-2.26703e+08;-1;0;0;0;-1;0;61265750;61265777;674
635;4.26289e-15;52;1595;9258;10117;1;575;-2.14748e+09;-2.26703e+08;-1;0;0;0;-1;0;61265750;61265777;674
636;1.18811e-14;77;1757;25945;19979;1;709;-2.14748e+09;-2.21775e+08;-1;0;0;0;-1;0;63178335;63178365;751
636;4.26289e-15;52;1595;9258;10117;1;575;-2.14748e+09;-2.21775e+08;0;0;-1;0;0;-1;63178335;63178365;751
637;1.18811e-14;77;1757;25945;19979;1;709;-2.14748e+09;-2.16994e+08;-1;0;0;0;-1;0;65110065;65110100;835
637;4.26289e-15;52;1595;9258;10117;1;575;-2.14748e+09;-2.16994e+08;-1;0;0;0;-1;0;65110065;65110100;835
638;1.18811e-14;76;1757;25945;19979;1;709;-2.14748e+09;-2.12356e+08;-1;0;0;0;-1;0;67060324;67060363;927
638;4.26289e-15;52;1595;9258;10117;1;575;-2.14748e+09;-2.12356e+08;-1;0;0;0;-1;0;67060324;67060363;927
639;1.18811e-14;75;1757;25945;19979;1;709;-2.14748e+09;-2.07855e+08;-1;0;0;0;-1;0;69028499;69028543;1028
639;4.26289e-15;51;1595;9258;10117;1;575;-2.14748e+09;-2.07855e+08;-1;0;0;0;-1;0;69028499;69028543;1028
640;1.18811e-14;75;1757;25945;19979;1;709;-2.14748e+09;-2.03486e+08;0;0;-1;0;0;-1;71013983;71014033;1137
640;4.26289e-15;51;1595;9258;10117;1;575;-2.14748e+09;-2.03486e+08;-1;0;0;0;-1;0;71013983;71014033;1137
641;1.18811e-14;75;1757;25945;19979;1;709;-2.14748e+09;-1.99245e+08;-1;0;0;0;-1;0;73016177;73016233;1257
641;4.26289e-15;51;1595;9258;10117;1;575;-2.14748e+09;-1.99245e+08;-1;0;0;0;-1;0;73016177;73016233;1257
642;1.18811e-14;73;1757;25945;19979;1;709;-2.14748e+09;-1.95127e+08;-1;0;0;0;-1;0;75034487;75034549;1386
642;4.26289e-15;51;1595;9258;10117;1;575;-2.14748e+09;-1.95127e+08;-1;0;0;0;-1;0;75034487;75034549;1386
643;1.18811e-14;71;1757;25945;19979;1;709;-2.14748e+09;-1.91128e+08;-1;0;0;0;-1;0;77068327;77068396;1527
643;4.26289e-15;48;1595;9258;10117;1;575;-2.14748e+09;-1.91128e+08;-1;0;0;0;-1;0;77068327;77068396;1527
644;1.18811e-14;71;1757;25945;19979;1;709;-2.14748e+09;-1.87243e+08;-1;0;0;0;-1;0;79117118;79117193;1680
644;4.26289e-15;47;1594;9258;10117;1;575;-2.14748e+09;-1.87243e+08;-1;0;0;0;-1;0;79117118;79117193;1680
645;1.18811e-14;70;1757;25945;19979;1;709;-2.14748e+09;-1.8347e+08;-1;0;0;0;-1;0;81180287;81180369;1844
645;4.26289e-15;47;1594;9258;10117;1;575;-2.14748e+09;-1.8347e+08;0;0;-1;0;0;-1;81180287;81180369;1844
646;1.18811e-14;68;1756;25945;19979;1;709;-2.14748e+09;-1.79803e+08;-1;0;0;0;-1;0;83257270;83257361;2022
646;4.26289e-15;45;1594;9258;10117;1;575;-2.14748e+09;-1.79803e+08;-1;0;0;0;-1;0;83257270;83257361;2022
647;1.18811e-14;68;1756;25945;19979;1;709;-2.14748e+09;-1.76239e+08;-1;0;0;0;-1;0;85347512;85347612;2215
647;4.26289e-15;44;1594;9258;10117;1;575;-2.14748e+09;-1.76239e+08;-1;0;0;0;-1;0;85347512;85347612;2215
648;1.18811e-14;68;1756;25945;19979;1;709;-2.14748e+09;-1.72776e+08;-1;0;0;0;-1;0;87450466;87450575;2422
648;4.26289e-15;43;1594;9258;10117;1;575;-2.14748e+09;-1.72776e+08;-1;0;0;0;-1;0;87450466;87450575;2422
649;1.18811e-14;67;1756;25945;19979;1;709;-2.14748e+09;-1.69408e+08;-1;0;0;0;-1;0;89565591;89565711;2644
649;4.26289e-15;42;1594;9258;10117;1;575;-2.14748e+09;-1.69408e+08;-1;0;0;0;-1;0;89565591;89565711;2644
650;1.18811e-14;65;1756;25945;19979;1;709;-2.14748e+09;-1.66134e+08;0;0;-1;0;0;-1;91692358;91692490;2884
650;4.26289e-15;40;1593;9258;10117;1;575;-2.14748e+09;-1.66134e+08;-1;0;0;0;-1;0;91692358;91692490;2884
651;1.18811e-14;65;1756;25945;19979;1;709;-2.14748e+09;-1.6295e+08;-1;0;0;0;-1;0;93830245;93830389;3141
651;4.26289e-15;38;1593;9258;10117;1;575;-2.14748e+09;-1.6295e+08;-1;0;0;0;-1;0;93830245;93830389;3141
652;1.18811e-14;65;1756;25945;19979;1;709;-2.14748e+09;-1.59852e+08;0;0;-1;0;0;-1;95978738;95978895;3417
652;4.26289e-15;38;1593;9258;10117;1;575;-2.14748e+09;-1.59852e+08;-1;0;0;0;-1;0;95978738;95978895;3417
653;1.18811e-14;65;1756;25945;19979;1;709;-2.14748e+09;-1.56839e+08;-1;0;0;0;-1;0;98137335;98137505;3712
653;4.26289e-15;38;1593;9258;10117;1;575;-2.14748e+09;-1.56839e+08;-1;0;0;0;-1;0;98137335;98137505;3712
654;1.18811e-14;65;1755;25945;19979;1;709;-2.14748e+09;-1.53907e+08;-1;0;0;0;-1;0;100305538;100305725;4028
654;4.26289e-15;38;1593;9258;10117;1;575;-2.14748e+09;-1.53907e+08;-1;0;0;0;-1;0;100305538;100305725;4028
655;1.18811e-14;65;1755;25945;19979;1;709;-2.14748e+09;-1.51054e+08;-1;0;0;0;-1;0;102482865;102483067;4366
655;4.26289e-15;37;1593;9258;10117;1;575;-2.14748e+09;-1.51054e+08;-1;0;0;0;-1;0;102482865;102483067;4366
656;1.18811e-14;65;1755;25945;19979;1;709;-2.14748e+09;-1.48277e+08;-1;0;0;0;-1;0;104668836;104669056;4726
656;4.26289e-15;36;1592;9258;10117;1;575;-2.14748e+09;-1.48277e+08;-1;0;0;0;-1;0;104668836;104669056;4726
657;1.18811e-14;65;1755;25945;19979;1;709;-2.14748e+09;-1.45573e+08;-1;0;0;0;-1;0;106862986;106863224;5111
657;4.26289e-15;35;1592;9258;10117;1;575;-2.14748e+09;-1.45573e+08;-1;0;0;0;-1;0;106862986;106863224;5111
658;1.18811e-14;61;1755;25945;19979;1;709;-2.14748e+09;-1.42941e+08;-1;0;0;0;-1;0;109064855;109065113;5521
658;4.26289e-15;35;1592;9258;10117;1;575;-2.14748e+09;-1.42941e+08;-1;0;0;0;-1;0;109064855;109065113;5521
659;1.18811e-14;60;1755;25945;19979;1;709;-2.14748e+09;-1.40378e+08;-1;0;0;0;-1;0;111273995;111274274;5957
659;4.26289e-15;34;1592;9258;10117;1;575;-2.14748e+09;-1.40378e+08;-1;0;0;0;-1;0;111273995;111274274;5957
660;1.18811e-14;60;1755;25945;19979;1;709;-2.14748e+09;-1.37881e+08;-1;0;0;0;-1;0;113489966;113490268;6421
660;4.26289e-15;34;1592;9258;10117;1;575;-2.14748e+09;-1.37881e+08;-1;0;0;0;-1;0;113489966;113490268;6421
661;1.18811e-14;60;1755;25945;19979;1;709;-2.14748e+09;-1.35448e+08;-1;0;0;0;-1;0;115712338;115712664;6914
661;4.26289e-15;34;1592;9258;10117;1;575;-2.14748e+09;-1.35448e+08;-1;0;0;0;-1;0;115712338;115712664;6914
662;1.18811e-14;60;1755;25945;19979;1;709;-2.14748e+09;-1.33079e+08;-1;0;0;0;-1;0;117940689;117941040;7438
662;4.26289e-15;34;1592;9258;10117;1;575;-2.14748e+09;-1.33079e+08;-1;0;0;0;-1;0;117940689;117941040;7438
663;1.18811e-14;60;1755;25945;19979;1;709;-2.14748e+09;-1.30769e+08;-1;0;0;0;-1;0;120174607;120174985;7993
663;4.26289e-15;33;1592;9258;10117;1;575;-2.14748e+09;-1.30769e+08;-1;0;0;0;-1;0;120174607;120174985;7993
664;1.18811e-14;59;1755;25945;19979;1;709;-2.14748e+09;-1.28518e+08;-1;0;0;0;-1;0;122413688;122414095;8581
664;4.26289e-15;33;1592;9258;10117;1;575;-2.14748e+09;-1.28518e+08;-1;0;0;0;-1;0;122413688;122414095;8581
665;1.18811e-14;58;1755;25945;19979;1;709;-2.14748e+09;-1.26325e+08;0;0;-1;0;0;-1;124657539;124657977;9204
665;4.26289e-15;33;1592;9258;10117;1;575;-2.14748e+09;-1.26325e+08;-1;0;0;0;-1;0;124657539;124657977;9204
666;1.18811e-14;58;1755;25945;19979;1;709;-2.14748e+09;-1.24186e+08;-1;0;0;0;-1;0;126905775;126906246;9862
666;4.26289e-15;33;1592;9258;10117;1;575;-2.14748e+09;-1.24186e+08;-1;0;0;0;-1;0;126905775;126906246;9862
667;1.18811e-14;58;1754;25945;19979;1;709;-2.14748e+09;-1.221e+08;-1;0;0;0;-1;0;129158019;129158524;10559
667;4.26289e-15;33;1592;9258;10117;1;575;-2.14748e+09;-1.221e+08;0;0;-1;0;0;-1;129158019;129158524;10559
668;1.18811e-14;58;1754;25945;19979;1;709;-2.14748e+09;-1.20066e+08;-1;0;0;0;-1;0;131413903;131414446;11294
668;4.26289e-15;32;1592;9258;10117;1;575;-2.14748e+09;-1.20066e+08;-1;0;0;0;-1;0;131413903;131414446;11294
669;1.18811e-14;58;1754;25945;19979;1;709;-2.14748e+09;-1.18082e+08;-1;0;0;0;-1;0;133673070;133673651;12070
669;4.26289e-15;28;1590;9258;10117;1;575;-2.14748e+09;-1.18082e+08;-1;0;0;0;-1;0;133673070;133673651;12070
670;1.18811e-14;58;1754;25945;19979;1;709;-2.14748e+09;-1.16147e+08;-1;0;0;0;-1;0;135935169;135935792;12889
670;4.26289e-15;28;1590;9258;10117;1;575;-2.14748e+09;-1.16147e+08;0;0;-1;0;0;-1;135935169;135935792;12889
671;1.18811e-14;55;1754;25945;19979;1;709;-2.14748e+09;-1.14258e+08;0;0;-1;0;0;-1;138199859;138200525;13751
671;4.26289e-15;23;1590;9258;10117;1;575;-2.14748e+09;-1.14258e+08;-1;0;0;0;-1;0;138199859;138200525;13751
672;1.18811e-14;54;1754;25945;19979;1;709;-2.14748e+09;-1.12416e+08;-1;0;0;0;-1;0;140466807;140467519;14659
672;4.26289e-15;23;1590;9258;10117;1;575;-2.14748e+09;-1.12415e+08;-1;0;0;0;-1;0;140466807;140467519;14659
673;1.18811e-14;54;1754;25945;19979;1;709;-2.14748e+09;-1.10617e+08;-1;0;0;0;-1;0;142735689;142736449;15614
673;4.26289e-15;15;1590;9258;10117;1;575;-2.14748e+09;-1.10617e+08;-1;0;0;0;-1;0;142735689;142736449;15614
674;1.18811e-14;49;1754;25945;19979;1;709;-2.14748e+09;-1.08861e+08;-1;0;0;0;-1;0;145006187;145006998;16619
674;4.26289e-15;15;1590;9258;10117;1;575;-2.14748e+09;-1.08861e+08;0;0;-1;0;0;-1;145006187;145006998;16619
675;1.18811e-14;48;1754;25945;19979;1;709;-2.14748e+09;-1.07148e+08;-1;0;0;0;-1;0;147277994;147278859;17674
675;4.26289e-15;15;1590;9258;10117;1;575;-2.14748e+09;-1.07148e+08;-1;0;0;0;-1;0;147277994;147278859;17674
676;1.18811e-14;46;1754;25945;19979;1;709;-2.14748e+09;-1.05474e+08;-1;0;0;0;-1;0;149550810;149551731;18782
676;4.26289e-15;15;1590;9258;10117;1;575;-2.14748e+09;-1.05474e+08;-1;0;0;0;-1;0;149550810;149551731;18782
677;1.18811e-14;45;1754;25945;19979;1;709;-2.14748e+09;-1.0384e+08;-1;0;0;0;-1;0;151824342;151825322;19944
677;4.26289e-15;14;1590;9258;10117;1;575;-2.14748e+09;-1.0384e+08;-1;0;0;0;-1;0;151824342;151825322;19944
678;1.18811e-14;45;1754;25945;19979;1;709;-2.14748e+09;-1.02244e+08;-1;0;0;0;-1;0;154098306;154099348;21163
678;4.26289e-15;10;1590;9258;10117;1;575;-2.14748e+09;-1.02244e+08;-1;0;0;0;-1;0;154098306;154099348;21163
679;1.18811e-14;45;1754;25945;19979;1;709;-2.14748e+09;-1.00684e+08;-1;0;0;0;-1;0;156372424;156373533;22441
679;4.26289e-15;10;1590;9258;10117;1;575;-2.14748e+09;-1.00684e+08;-1;0;0;0;-1;0;156372424;156373533;22441
680;1.18811e-14;44;1754;25945;19979;1;709;-2.14748e+09;-9.9161e+07;-1;0;0;0;-1;0;158646429;158647607;23779
680;4.26289e-15;9;1590;9258;10117;1;575;-2.14748e+09;-9.9161e+07;-1;0;0;0;-1;0;158646429;158647607;23779
681;1.18811e-14;44;1754;25945;19979;1;709;-2.14748e+09;-9.76726e+07;-1;0;0;0;-1;0;160920057;160921308;25179
681;4.26289e-15;9;1590;9258;10117;1;575;-2.14748e+09;-9.76726e+07;-1;0;0;0;-1;0;160920057;160921308;25179
682;1.18811e-14;41;1754;25945;19979;1;709;-2.14748e+09;-9.62179e+07;-1;0;0;0;-1;0;163193056;163194382;26643
682;4.26289e-15;9;1590;9258;10117;1;575;-2.14748e+09;-9.62178e+07;-1;0;0;0;-1;0;163193056;163194382;26643
683;1.18811e-14;41;1754;25945;19979;1;709;-2.14748e+09;-9.4796e+07;-1;0;0;0;-1;0;165465176;165466582;28174
683;4.26289e-15;9;1590;9258;10117;1;575;-2.14748e+09;-9.4796e+07;-1;0;0;0;-1;0;165465176;165466582;28174
684;1.18811e-14;40;1754;25945;19979;1;709;-2.14748e+09;-9.34062e+07;-1;0;0;0;-1;0;167736178;167737668;29773
684;4.26289e-15;8;1590;9258;10117;1;575;-2.14748e+09;-9.34062e+07;-1;0;0;0;-1;0;167736178;167737668;29773
685;1.18811e-14;40;1754;25945;19979;1;709;-2.14748e+09;-9.20473e+07;-1;0;0;0;-1;0;170005829;170007407;31443
685;4.26289e-15;5;1590;9258;10117;1;575;-2.14748e+09;-9.20473e+07;-1;0;0;0;-1;0;170005829;170007407;31443
686;1.18811e-14;39;1754;25945;19979;1;709;-2.14748e+09;-9.07186e+07;-1;0;0;0;-1;0;172273901;172275571;33185
686;4.26289e-15;5;1590;9258;10117;1;575;-2.14748e+09;-9.07186e+07;-1;0;0;0;-1;0;172273901;172275571;33185
687;1.18811e-14;39;1754;25945;19979;1;709;-2.14748e+09;-8.94192e+07;-1;0;0;0;-1;0;174540177;174541941;35002
687;4.26289e-15;5;1590;9258;10117;1;575;-2.14748e+09;-8.94192e+07;-1;0;0;0;-1;0;174540177;174541941;35002
688;1.18811e-14;37;1754;25945;19979;1;709;-2.14748e+09;-8.81484e+07;-1;0;0;0;-1;0;176804441;176806306;36896
688;4.26289e-15;5;1590;9258;10117;1;575;-2.14748e+09;-8.81484e+07;-1;0;0;0;-1;0;176804441;176806306;36896
689;1.18811e-14;37;1754;25945;19979;1;709;-2.14748e+09;-8.69051e+07;-1;0;0;0;-1;0;179066487;179068456;38870
689;4.26289e-15;5;1590;9258;10117;1;575;-2.14748e+09;-8.69051e+07;-1;0;0;0;-1;0;179066487;179068456;38870
690;1.18811e-14;36;1754;25945;19979;1;709;-2.14748e+09;-8.56888e+07;-1;0;0;0;-1;0;181326114;181328193;40924
690;4.26289e-15;3;1590;9258;10117;1;575;-2.14748e+09;-8.56888e+07;-1;0;0;0;-1;0;181326114;181328193;40924
691;1.18811e-14;36;1754;25945;19979;1;709;-2.14748e+09;-8.44987e+07;-1;0;0;0;-1;0;183583128;183585322;43063
691;4.26289e-15;3;1590;9258;10117;1;575;-2.14748e+09;-8.44987e+07;-1;0;0;0;-1;0;183583128;183585322;43063
692;1.18811e-14;36;1754;25945;19979;1;709;-2.14748e+09;-8.33341e+07;-1;0;0;0;-1;0;185837342;185839654;45287
692;4.26289e-15;3;1590;9258;10117;1;575;-2.14748e+09;-8.33341e+07;-1;0;0;0;-1;0;185837342;185839654;45287
693;1.18811e-14;34;1754;25945;19979;1;709;-2.14748e+09;-8.21942e+07;-1;0;0;0;-1;0;188088571;188091007;47600
693;4.26289e-15;3;1590;9258;10117;1;575;-2.14748e+09;-8.21942e+07;-1;0;0;0;-1;0;188088571;188091007;47600
694;1.18811e-14;34;1754;25945;19979;1;709;-2.14748e+09;-8.10785e+07;-1;0;0;0;-1;0;190336640;190339206;50003
694;4.26289e-15;3;1590;9258;10117;1;575;-2.14748e+09;-8.10785e+07;-1;0;0;0;-1;0;190336640;190339206;50003
695;1.18811e-14;32;1754;25945;19979;1;709;-2.14748e+09;-7.99862e+07;-1;0;0;0;-1;0;192581378;192584079;52499
695;4.26289e-15;3;1590;9258;10117;1;575;-2.14748e+09;-7.99862e+07;-1;0;0;0;-1;0;192581378;192584079;52499
696;1.18811e-14;30;1754;25945;19979;1;709;-2.14748e+09;-7.89167e+07;0;0;-1;0;0;-1;194822618;194825460;55091
696;4.26289e-15;3;1590;9258;10117;1;575;-2.14748e+09;-7.89167e+07;-1;0;0;0;-1;0;194822618;194825460;55091
697;1.18811e-14;27;1754;25945;19979;1;709;-2.14748e+09;-7.78695e+07;-1;0;0;0;-1;0;197060203;197063191;57780
697;4.26289e-15;1;1590;9258;10117;1;575;-2.14748e+09;-7.78694e+07;-1;0;0;0;-1;0;197060202;197063191;57780
698;1.18811e-14;25;1754;25945;19979;1;709;-2.14748e+09;-7.68437e+07;-1;0;0;0;-1;0;199293975;199297115;60569
698;4.26289e-15;-1;1589;9258;10117;1;575;-2.14748e+09;-7.68437e+07;0;0;0;0;0;0;199293975;199297115;60569
699;1.18811e-14;24;1754;25945;19979;1;709;-2.14748e+09;-7.58392e+07;-1;0;0;0;-1;0;201523786;201527085;63461
699;4.26289e-15;-1;1589;9258;10117;1;575;-2.14748e+09;-7.58391e+07;-1;0;0;0;-1;0;201523786;201527085;63461
700;1.18811e-14;24;1754;25945;19979;1;709;-2.14748e+09;-7.48551e+07;-1;0;0;0;-1;0;203749493;203752956;66458
700;4.26289e-15;-2;1589;9258;10117;1;575;-2.14748e+09;-7.48551e+07;0;0;0;0;0;0;203749493;203752956;66458
701;1.18811e-14;23;1754;25945;19979;1;709;-2.14748e+09;-7.38909e+07;-1;0;0;0;-1;0;205970953;205974588;69562
701;4.26289e-15;-2;1589;9258;10117;1;575;-2.14748e+09;-7.38909e+07;-1;0;0;0;-1;0;205970953;205974588;69562
702;1.18811e-14;23;1754;25945;19979;1;709;-2.14748e+09;-7.2946e+07;-1;0;0;0;-1;0;208188036;208191848;72776
702;4.26289e-15;-2;1589;9258;10117;1;575;-2.14748e+09;-7.2946e+07;-1;0;0;0;-1;0;208188036;208191848;72776
703;1.18811e-14;22;1754;25945;19979;1;709;-2.14748e+09;-7.20202e+07;-1;0;0;0;-1;0;210400609;210404606;76103
703;4.26289e-15;-3;1589;9258;10117;1;575;-2.14748e+09;-7.20202e+07;0;0;0;0;0;0;210400609;210404606;76103
704;1.18811e-14;22;1754;25945;19979;1;709;-2.14748e+09;-7.11128e+07;-1;0;0;0;-1;0;212608547;212612736;79544
704;4.26289e-15;-3;1589;9258;10117;1;575;-2.14748e+09;-7.11128e+07;-1;0;0;0;-1;0;212608547;212612736;79544
705;1.18811e-14;22;1754;25945;19979;1;709;-2.14748e+09;-7.02234e+07;-1;0;0;0;-1;0;214811731;214816119;83103
705;4.26289e-15;-3;1589;9258;10117;1;575;-2.14748e+09;-7.02234e+07;-1;0;0;0;-1;0;214811731;214816119;83103
706;1.18811e-14;21;1754;25945;19979;1;709;-2.14748e+09;-6.93516e+07;-1;0;0;0;-1;0;217010043;217014638;86781
706;4.26289e-15;-4;1589;9258;10117;1;575;-2.14748e+09;-6.93516e+07;0;0;0;0;0;0;217010043;217014638;86781
707;1.18811e-14;21;1754;25945;19979;1;709;-2.14748e+09;-6.84966e+07;-1;0;0;0;-1;0;219203372;219208180;90583
707;4.26289e-15;-4;1589;9258;10117;1;575;-2.14748e+09;-6.84966e+07;-1;0;0;0;-1;0;219203372;219208180;90583
708;1.18811e-14;21;1754;25945;19979;1;709;-2.14748e+09;-6.76585e+07;-1;0;0;0;-1;0;221391610;221396640;94509
708;4.26289e-15;-4;1589;9258;10117;1;575;-2.14748e+09;-6.76584e+07;-1;0;0;0;-1;0;221391609;221396640;94509
709;1.18811e-14;21;1754;25945;19979;1;709;-2.14748e+09;-6.68363e+07;-1;0;0;0;-1;0;223574652;223579912;98563
709;4.26289e-15;-5;1589;9258;10117;1;575;-2.14748e+09;-6.68363e+07;0;0;0;0;0;0;223574652;223579912;98563
710;1.18811e-14;20;1754;25945;19979;1;709;-2.14748e+09;-6.60302e+07;0;0;-1;0;0;-1;225752401;225757899;102747
710;4.26289e-15;-5;1589;9258;10117;1;575;-2.14748e+09;-6.60302e+07;-1;0;0;0;-1;0;225752401;225757899;102747
711;1.18811e-14;18;1754;25945;19979;1;709;-2.14748e+09;-6.52393e+07;0;0;-1;0;0;-1;227924759;227930504;107063
711;4.26289e-15;-5;1589;9258;10117;1;575;-2.14748e+09;-6.52393e+07;-1;0;0;0;-1;0;227924759;227930504;107063
712;1.18811e-14;12;1754;25945;19979;1;709;-2.14748e+09;-6.44635e+07;-1;0;0;0;-1;0;230091635;230097635;111516
712;4.26289e-15;-6;1589;9258;10117;1;575;-2.14748e+09;-6.44635e+07;0;0;0;0;0;0;230091635;230097635;111516
713;1.18811e-14;12;1754;25945;19979;1;709;-2.14748e+09;-6.37023e+07;-1;0;0;0;-1;0;232252940;232259205;116106
713;4.26289e-15;-6;1589;9258;10117;1;575;-2.14748e+09;-6.37023e+07;-1;0;0;0;-1;0;232252940;232259205;116106
714;1.18811e-14;9;1754;25945;19979;1;709;-2.14748e+09;-6.29556e+07;-1;0;0;0;-1;0;234408591;234415128;120836
714;4.26289e-15;-6;1589;9258;10117;1;575;-2.14748e+09;-6.29556e+07;-1;0;0;0;-1;0;234408591;234415128;120836
715;1.18811e-14;8;1754;25945;19979;1;709;-2.14748e+09;-6.22227e+07;-1;0;0;0;-1;0;236558503;236565325;125710
715;4.26289e-15;-7;1589;9258;10117;1;575;-2.14748e+09;-6.22226e+07;0;0;0;0;0;0;236558502;236565325;125710
716;1.18811e-14;6;1754;25945;19979;1;709;-2.14748e+09;-6.15033e+07;-1;0;0;0;-1;0;238702603;238709718;130730
716;4.26289e-15;-8;1589;9258;10117;1;575;-2.14748e+09;-6.15032e+07;0;0;0;0;0;0;238702602;238709717;130730
717;1.18811e-14;5;1754;25945;19979;1;709;-2.14748e+09;-6.07973e+07;-1;0;0;0;-1;0;240840814;240848231;135898
717;4.26289e-15;-8;1589;9258;10117;1;575;-2.14748e+09;-6.07973e+07;-1;0;0;0;-1;0;240840814;240848231;135898
718;1.18811e-14;5;1754;25945;19979;1;709;-2.14748e+09;-6.01041e+07;-1;0;0;0;-1;0;242973066;242980795;141217
718;4.26289e-15;-9;1589;9258;10117;1;575;-2.14748e+09;-6.01041e+07;0;0;0;0;0;0;242973066;242980795;141217
719;1.18811e-14;5;1754;25945;19979;1;709;-2.14748e+09;-5.94236e+07;-1;0;0;0;-1;0;245099291;245107340;146689
719;4.26289e-15;-9;1589;9258;10117;1;575;-2.14748e+09;-5.94236e+07;-1;0;0;0;-1;0;245099291;245107340;146689
720;1.18811e-14;0;1754;25945;19979;1;709;-2.14748e+09;-5.87555e+07;-1;0;0;0;-1;0;247219423;247227805;152318
720;4.26289e-15;-9;1589;9258;10117;1;575;-2.14748e+09;-5.87555e+07;-1;0;0;0;-1;0;247219423;247227805;152318
721;1.18811e-14;-1;1754;25945;19979;1;709;-2.14748e+09;-5.80994e+07;0;0;0;0;0;0;249333401;249342125;158106
721;4.26289e-15;-10;1589;9258;10117;1;575;-2.14748e+09;-5.80994e+07;0;0;0;0;0;0;249333401;249342125;158106
722;1.18811e-14;-2;1754;25945;19979;1;709;-2.14748e+09;-5.74552e+07;0;0;0;0;0;0;251441167;251450244;164055
722;4.26289e-15;-11;1589;9258;10117;1;575;-2.14748e+09;-5.74551e+07;0;0;0;0;0;0;251441166;251450244;164055
723;1.18811e-14;-2;1754;25945;19979;1;709;-2.14748e+09;-5.68223e+07;-1;0;0;0;-1;0;253542662;253552105;170168
723;4.26289e-15;-12;1589;9258;10117;1;575;-2.14748e+09;-5.68223e+07;0;0;0;0;0;0;253542662;253552105;170168
724;1.18811e-14;-3;1754;25945;19979;1;709;-2.14748e+09;-5.62007e+07;0;0;0;0;0;0;255637835;255647654;176448
724;4.26289e-15;-13;1589;9258;10117;1;575;-2.14748e+09;-5.62006e+07;0;0;0;0;0;0;255637835;255647654;176448
725;1.18811e-14;-3;1754;25945;19979;1;709;-2.14748e+09;-5.559e+07;-1;0;0;0;-1;0;257726633;257736841;182897
725;4.26289e-15;-13;1589;9258;10117;1;575;-2.14748e+09;-5.559e+07;-1;0;0;0;-1;0;257726633;257736841;182897
726;1.18811e-14;-3;1754;25945;19979;1;709;-2.14748e+09;-5.49901e+07;-1;0;0;0;-1;0;259809012;259819619;189519
726;4.26289e-15;-13;1589;9258;10117;1;575;-2.14748e+09;-5.499e+07;-1;0;0;0;-1;0;259809009;259819619;189519
727;1.18811e-14;-3;1754;25945;19979;1;709;-2.14748e+09;-5.44004e+07;-1;0;0;0;-1;0;261884921;261895942;196315
727;4.26289e-15;-14;1589;9258;10117;1;575;-2.14748e+09;-5.44004e+07;0;0;0;0;0;0;261884921;261895942;196315
728;1.18811e-14;-3;1754;25945;19979;1;709;-2.14748e+09;-5.38211e+07;-1;0;0;0;-1;0;263954323;263965767;203288
728;4.26289e-15;-14;1589;9258;10117;1;575;-2.14748e+09;-5.38211e+07;-1;0;0;0;-1;0;263954323;263965767;203288
729;1.18811e-14;-4;1754;25945;19979;1;709;-2.14748e+09;-5.32517e+07;0;0;0;0;0;0;266017174;266029054;210440
729;4.26289e-15;-14;1589;9258;10117;1;575;-2.14748e+09;-5.32517e+07;-1;0;0;0;-1;0;266017174;266029054;210440
730;1.18811e-14;-5;1754;25945;19979;1;709;-2.14748e+09;-5.26922e+07;0;0;0;0;0;0;268073437;268085764;217776
730;4.26289e-15;-14;1589;9258;10117;1;575;-2.14748e+09;-5.26922e+07;-1;0;0;0;-1;0;268073437;268085764;217776
731;1.18811e-14;-5;1754;25945;19979;1;709;-2.14748e+09;-5.2142e+07;-1;0;0;0;-1;0;270123074;270135864;225296
731;4.26289e-15;-14;1589;9258;10117;1;575;-2.14748e+09;-5.2142e+07;-1;0;0;0;-1;0;270123074;270135864;225296
732;1.18811e-14;-5;1754;25945;19979;1;709;-2.14748e+09;-5.16013e+07;-1;0;0;0;-1;0;272166054;272179319;233003
732;4.26289e-15;-15;1589;9258;10117;1;575;-2.14748e+09;-5.16013e+07;0;0;0;0;0;0;272166054;272179319;233003
733;1.18811e-14;-6;1754;25945;19979;1;709;-2.14748e+09;-5.10696e+07;0;0;0;0;0;0;274202342;274216097;240901
733;4.26289e-15;-15;1589;9258;10117;1;575;-2.14748e+09;-5.10696e+07;-1;0;0;0;-1;0;274202342;274216097;240901
734;1.18811e-14;-7;1754;25945;19979;1;709;-2.14748e+09;-5.05469e+07;0;0;0;0;0;0;276231912;276246169;248991
734;4.26289e-15;-15;1589;9258;10117;1;575;-2.14748e+09;-5.05469e+07;-1;0;0;0;-1;0;276231911;276246169;248991
735;1.18811e-14;-8;1754;25945;19979;1;709;-2.14748e+09;-5.00327e+07;0;0;0;0;0;0;278254734;278269508;257276
735;4.26289e-15;-16;1589;9258;10117;1;575;-2.14748e+09;-5.00327e+07;0;0;0;0;0;0;278254734;278269508;257276
736;1.18811e-14;-8;1754;25945;19979;1;709;-2.14748e+09;-4.95272e+07;-1;0;0;0;-1;0;280270783;280286089;265760
736;4.26289e-15;-16;1589;9258;10117;1;575;-2.14748e+09;-4.95272e+07;-1;0;0;0;-1;0;280270783;280286089;265760
737;1.18811e-14;-9;1754;25945;19979;1;709;-2.14748e+09;-4.903e+07;0;0;0;0;0;0;282280035;282295887;274443
737;4.26289e-15;-16;1589;9258;10117;1;575;-2.14748e+09;-4.903e+07;-1;0;0;0;-1;0;282280035;282295887;274443
738;1.18811e-14;-9;1754;25945;19979;1;709;-2.14748e+09;-4.85409e+07;-1;0;0;0;-1;0;284282468;284298879;283329
738;4.26289e-15;-16;1589;9258;10117;1;575;-2.14748e+09;-4.85409e+07;-1;0;0;0;-1;0;284282468;284298879;283329
739;1.18811e-14;-9;1754;25945;19979;1;709;-2.14748e+09;-4.80597e+07;-1;0;0;0;-1;0;286278063;286295049;292420
739;4.26289e-15;-17;1589;9258;10117;1;575;-2.14748e+09;-4.80597e+07;0;0;0;0;0;0;286278063;286295049;292420
740;1.18811e-14;-10;1754;25945;19979;1;709;-2.14748e+09;-4.75863e+07;0;0;0;0;0;0;288266801;288284379;301719
740;4.26289e-15;-17;1589;9258;10117;1;575;-2.14748e+09;-4.75863e+07;-1;0;0;0;-1;0;288266801;288284379;301719
741;1.18811e-14;-11;1754;25945;19979;1;709;-2.14748e+09;-4.71205e+07;0;0;0;0;0;0;290248665;290266850;311229
741;4.26289e-15;-17;1589;9258;10117;1;575;-2.14748e+09;-4.71205e+07;-1;0;0;0;-1;0;290248665;290266850;311229
742;1.18811e-14;-12;1754;25945;19979;1;709;-2.14748e+09;-4.66623e+07;0;0;0;0;0;0;292223641;292242449;320950
742;4.26289e-15;-17;1589;9258;10117;1;575;-2.14748e+09;-4.66623e+07;-1;0;0;0;-1;0;292223641;292242449;320950
743;1.18811e-14;-13;1754;25945;19979;1;709;-2.14748e+09;-4.62113e+07;0;0;0;0;0;0;294191715;294211162;330887
743;4.26289e-15;-17;1589;9258;10117;1;575;-2.14748e+09;-4.62113e+07;-1;0;0;0;-1;0;294191715;294211162;330887
744;1.18811e-14;-14;1754;25945;19979;1;709;-2.14748e+09;-4.57675e+07;0;0;0;0;0;0;296152873;296172978;341042
744;4.26289e-15;-18;1589;9258;10117;1;575;-2.14748e+09;-4.57675e+07;0;0;0;0;0;0;296152873;296172978;341042
745;1.18811e-14;-15;1754;25945;19979;1;709;-2.14748e+09;-4.53306e+07;0;0;0;0;0;0;298107108;298127886;351416
745;4.26289e-15;-19;1589;9258;10117;1;575;-2.14748e+09;-4.53305e+07;0;0;0;0;0;0;298107108;298127886;351416
746;1.18811e-14;-15;1754;25945;19979;1;709;-2.14748e+09;-4.49005e+07;-1;0;0;0;-1;0;300054410;300075878;362013
746;4.26289e-15;-19;1589;9258;10117;1;575;-2.14748e+09;-4.49005e+07;-1;0;0;0;-1;0;300054410;300075878;362013
747;1.18811e-14;-15;1754;25945;19979;1;709;-2.14748e+09;-4.44771e+07;-1;0;0;0;-1;0;301994764;302016944;372834
747;4.26289e-15;-19;1589;9258;10117;1;575;-2.14748e+09;-4.44771e+07;-1;0;0;0;-1;0;301994764;302016944;372834
748;1.18811e-14;-16;1754;25945;19979;1;709;-2.14748e+09;-4.40604e+07;0;0;0;0;0;0;303928179;303951083;383883
748;4.26289e-15;-19;1589;9258;10117;1;575;-2.14748e+09;-4.40603e+07;-1;0;0;0;-1;0;303928179;303951083;383883
749;1.18811e-14;-16;1754;25945;19979;1;709;-2.14748e+09;-4.365e+07;-1;0;0;0;-1;0;305854641;305878287;395161
749;4.26289e-15;-19;1589;9258;10117;1;575;-2.14748e+09;-4.36499e+07;-1;0;0;0;-1;0;305854640;305878287;395161
750;1.18811e-14;-16;1754;25945;19979;1;709;-2.14748e+09;-4.32458e+07;-1;0;0;0;-1;0;307774146;307798553;406670
750;4.26289e-15;-20;1589;9258;10117;1;575;-2.14748e+09;-4.32458e+07;0;0;0;0;0;0;307774146;307798553;406670
751;1.18811e-14;-16;1754;25945;19979;1;709;-2.14748e+09;-4.28479e+07;-1;0;0;0;-1;0;309686695;309711881;418414
751;4.26289e-15;-21;1589;9258;10117;1;575;-2.14748e+09;-4.28479e+07;0;0;0;0;0;0;309686695;309711881;418414
752;1.18811e-14;-17;1754;25945;19979;1;709;-2.14748e+09;-4.2456e+07;0;0;0;0;0;0;311592283;311618267;430393
752;4.26289e-15;-21;1589;9258;10117;1;575;-2.14748e+09;-4.2456e+07;-1;0;0;0;-1;0;311592283;311618267;430393
753;1.18811e-14;-17;1754;25945;19979;1;709;-2.14748e+09;-4.207e+07;-1;0;0;0;-1;0;313490914;313517714;442612
753;4.26289e-15;-22;1589;9258;10117;1;575;-2.14748e+09;-4.207e+07;0;0;0;0;0;0;313490914;313517714;442612
754;1.18811e-14;-18;1754;25945;19979;1;709;-2.14748e+09;-4.16897e+07;0;0;0;0;0;0;315382586;315410223;455071
754;4.26289e-15;-23;1589;9258;10117;1;575;-2.14748e+09;-4.16897e+07;0;0;0;0;0;0;315382586;315410223;455071
755;1.18811e-14;-19;1754;25945;19979;1;709;-2.14748e+09;-4.13153e+07;0;0;0;0;0;0;317267302;317295789;467773
755;4.26289e-15;-24;1589;9258;10117;1;575;-2.14748e+09;-4.13153e+07;0;0;0;0;0;0;317267302;317295789;467773
756;1.18811e-14;-19;1754;25945;19979;1;709;-2.14748e+09;-4.09462e+07;-1;0;0;0;-1;0;319145063;319174428;480720
756;4.26289e-15;-24;1589;9258;10117;1;575;-2.14748e+09;-4.09462e+07;-1;0;0;0;-1;0;319145063;319174428;480720
757;1.18811e-14;-19;1754;25945;19979;1;709;-2.14748e+09;-4.05827e+07;-1;0;0;0;-1;0;321015878;321046139;493915
757;4.26289e-15;-24;1589;9258;10117;1;575;-2.14748e+09;-4.05827e+07;-1;0;0;0;-1;0;321015878;321046139;493915
758;1.18811e-14;-19;1754;25945;19979;1;709;-2.14748e+09;-4.02245e+07;-1;0;0;0;-1;0;322879748;322910924;507359
758;4.26289e-15;-25;1589;9258;10117;1;575;-2.14748e+09;-4.02244e+07;0;0;0;0;0;0;322879747;322910924;507359
759;1.18811e-14;-19;1754;25945;19979;1;709;-2.14748e+09;-3.98714e+07;-1;0;0;0;-1;0;324736679;324768794;521055
759;4.26289e-15;-26;1589;9258;10117;1;575;-2.14748e+09;-3.98714e+07;0;0;0;0;0;0;324736679;324768794;521055
760;1.18811e-14;-20;1754;25945;19979;1;709;-2.14748e+09;-3.95235e+07;0;0;0;0;0;0;326586680;326619755;535005
760;4.26289e-15;-27;1589;9258;10117;1;575;-2.14748e+09;-3.95235e+07;0;0;0;0;0;0;326586680;326619755;535005
761;1.18811e-14;-20;1754;25945;19979;1;709;-2.14748e+09;-3.91807e+07;-1;0;0;0;-1;0;328429759;328463815;549210
761;4.26289e-15;-28;1589;9258;10117;1;575;-2.14748e+09;-3.91807e+07;0;0;0;0;0;0;328429759;328463815;549210
762;1.18811e-14;-21;1754;25945;19979;1;709;-2.14748e+09;-3.88428e+07;0;0;0;0;0;0;330265925;330300983;563674
762;4.26289e-15;-28;1589;9258;10117;1;575;-2.14748e+09;-3.88428e+07;-1;0;0;0;-1;0;330265925;330300982;563674
763;1.18811e-14;-21;1754;25945;19979;1;709;-2.14748e+09;-3.85098e+07;-1;0;0;0;-1;0;332095186;332131267;578397
763;4.26289e-15;-29;1589;9258;10117;1;575;-2.14748e+09;-3.85097e+07;0;0;0;0;0;0;332095186;332131267;578397
764;1.18811e-14;-22;1754;25945;19979;1;709;-2.14748e+09;-3.81813e+07;0;0;0;0;0;0;333917553;333954680;593382
764;4.26289e-15;-30;1589;9258;10117;1;575;-2.14748e+09;-3.81813e+07;0;0;0;0;0;0;333917553;333954680;593382
765;1.18811e-14;-22;1754;25945;19979;1;709;-2.14748e+09;-3.78576e+07;-1;0;0;0;-1;0;335733037;335771229;608631
765;4.26289e-15;-30;1589;9258;10117;1;575;-2.14748e+09;-3.78576e+07;-1;0;0;0;-1;0;335733037;335771229;608631
766;1.18811e-14;-22;1754;25945;19979;1;709;-2.14748e+09;-3.75384e+07;-1;0;0;0;-1;0;337541650;337580933;624146
766;4.26289e-15;-30;1589;9258;10117;1;575;-2.14748e+09;-3.75384e+07;-1;0;0;0;-1;0;337541650;337580933;624146
767;1.18811e-14;-23;1754;25945;19979;1;709;-2.14748e+09;-3.72237e+07;0;0;0;0;0;0;339343403;339383802;639929
767;4.26289e-15;-31;1589;9258;10117;1;575;-2.14748e+09;-3.72237e+07;0;0;0;0;0;0;339343403;339383802;639929
768;1.18811e-14;-23;1754;25945;19979;1;709;-2.14748e+09;-3.69134e+07;-1;0;0;0;-1;0;341138311;341179849;655982
768;4.26289e-15;-31;1589;9258;10117;1;575;-2.14748e+09;-3.69134e+07;-1;0;0;0;-1;0;341138311;341179849;655982
769;1.18811e-14;-24;1754;25945;19979;1;709;-2.14748e+09;-3.66073e+07;0;0;0;0;0;0;342926388;342969088;672306
769;4.26289e-15;-32;1589;9258;10117;1;575;-2.14748e+09;-3.66073e+07;0;0;0;0;0;0;342926388;342969088;672306
770;1.18811e-14;-24;1754;25945;19979;1;709;-2.14748e+09;-3.63056e+07;-1;0;0;0;-1;0;344707647;344751533;688904
770;4.26289e-15;-32;1589;9258;10117;1;575;-2.14748e+09;-3.63056e+07;-1;0;0;0;-1;0;344707647;344751533;688904
771;1.18811e-14;-25;1754;25945;19979;1;709;-2.14748e+09;-3.60078e+07;0;0;0;0;0;0;346482103;346527201;705776
771;4.26289e-15;-32;1589;9258;10117;1;575;-2.14748e+09;-3.60078e+07;-1;0;0;0;-1;0;346482103;346527201;705776
772;1.18811e-14;-26;1754;25945;19979;1;709;-2.14748e+09;-3.57143e+07;0;0;0;0;0;0;348249773;348296107;722926
772;4.26289e-15;-33;1589;9258;10117;1;575;-2.14748e+09;-3.57142e+07;0;0;0;0;0;0;348249773;348296107;722926
773;1.18811e-14;-26;1754;25945;19979;1;709;-2.14748e+09;-3.54246e+07;-1;0;0;0;-1;0;350010673;350058267;740355
773;4.26289e-15;-33;1589;9258;10117;1;575;-2.14748e+09;-3.54246e+07;-1;0;0;0;-1;0;350010673;350058267;740355
774;1.18811e-14;-26;1754;25945;19979;1;709;-2.14748e+09;-3.51389e+07;-1;0;0;0;-1;0;351764818;351813700;758065
774;4.26289e-15;-33;1589;9258;10117;1;575;-2.14748e+09;-3.51389e+07;-1;0;0;0;-1;0;351764818;351813700;758065
775;1.18811e-14;-26;1754;25945;19979;1;709;-2.14748e+09;-3.4857e+07;-1;0;0;0;-1;0;353512228;353562421;776057
775;4.26289e-15;-33;1589;9258;10117;1;575;-2.14748e+09;-3.4857e+07;-1;0;0;0;-1;0;353512228;353562420;776057
776;1.18811e-14;-26;1754;25945;19979;1;709;-2.14748e+09;-3.45789e+07;-1;0;0;0;-1;0;355252919;355304449;794333
776;4.26289e-15;-34;1589;9258;10117;1;575;-2.14748e+09;-3.45789e+07;0;0;0;0;0;0;355252919;355304449;794333
777;1.18811e-14;-26;1754;25945;19979;1;709;-2.14748e+09;-3.43044e+07;-1;0;0;0;-1;0;356986909;357039801;812894
777;4.26289e-15;-35;1589;9258;10117;1;575;-2.14748e+09;-3.43044e+07;0;0;0;0;0;0;356986909;357039801;812894
778;1.18811e-14;-27;1754;25945;19979;1;709;-2.14748e+09;-3.40336e+07;0;0;0;0;0;0;358714217;358768499;831743
778;4.26289e-15;-36;1589;9258;10117;1;575;-2.14748e+09;-3.40336e+07;0;0;0;0;0;0;358714217;358768499;831743
779;1.18811e-14;-27;1754;25945;19979;1;709;-2.14748e+09;-3.37664e+07;-1;0;0;0;-1;0;360434863;360490563;850881
779;4.26289e-15;-36;1589;9258;10117;1;575;-2.14748e+09;-3.37664e+07;-1;0;0;0;-1;0;360434863;360490563;850881
780;1.18811e-14;-28;1754;25945;19979;1;709;-2.14748e+09;-3.35027e+07;0;0;0;0;0;0;362148866;362206011;870309
780;4.26289e-15;-37;1589;9258;10117;1;575;-2.14748e+09;-3.35027e+07;0;0;0;0;0;0;362148866;362206011;870309
781;1.18811e-14;-29;1754;25945;19979;1;709;-2.14748e+09;-3.32423e+07;0;0;0;0;0;0;363856245;363914861;890030
781;4.26289e-15;-38;1589;9258;10117;1;575;-2.14748e+09;-3.32423e+07;0;0;0;0;0;0;363856245;363914861;890030
782;1.18811e-14;-30;1754;25945;19979;1;709;-2.14748e+09;-3.29854e+07;0;0;0;0;0;0;365557022;365617139;910044
782;4.26289e-15;-38;1589;9258;10117;1;575;-2.14748e+09;-3.29854e+07;-1;0;0;0;-1;0;365557022;365617139;910044
783;1.18811e-14;-30;1754;25945;19979;1;709;-2.14748e+09;-3.27318e+07;-1;0;0;0;-1;0;367251217;367312864;930353
783;4.26289e-15;-39;1589;9258;10117;1;575;-2.14748e+09;-3.27318e+07;0;0;0;0;0;0;367251217;367312864;930353
784;1.18811e-14;-30;1754;25945;19979;1;709;-2.14748e+09;-3.24814e+07;-1;0;0;0;-1;0;368938851;369002055;950959
784;4.26289e-15;-39;1589;9258;10117;1;575;-2.14748e+09;-3.24814e+07;-1;0;0;0;-1;0;368938851;369002055;950959
785;1.18811e-14;-30;1754;25945;19979;1;709;-2.14748e+09;-3.22342e+07;-1;0;0;0;-1;0;370619945;370684736;971863
785;4.26289e-15;-39;1589;9258;10117;1;575;-2.14748e+09;-3.22342e+07;-1;0;0;0;-1;0;370619945;370684736;971863
786;1.18811e-14;-31;1754;25945;19979;1;709;-2.14748e+09;-3.19903e+07;0;0;0;0;0;0;372294521;372360929;993066
786;4.26289e-15;-39;1589;9258;10117;1;575;-2.14748e+09;-3.19903e+07;-1;0;0;0;-1;0;372294521;372360929;993066
787;1.18811e-14;-31;1754;25945;19979;1;709;-2.14748e+09;-3.17492e+07;-1;0;0;0;-1;0;373962601;374030654;1014570
787;4.26289e-15;-39;1589;9258;10117;1;575;-2.14748e+09;-3.17492e+07;-1;0;0;0;-1;0;373962601;374030654;1014570
788;1.18811e-14;-32;1754;25945;19979;1;709;-2.14748e+09;-3.15113e+07;0;0;0;0;0;0;375624207;375693936;1036377
788;4.26289e-15;-40;1589;9258;10117;1;575;-2.14748e+09;-3.15113e+07;0;0;0;0;0;0;375624207;375693936;1036377
789;1.18811e-14;-33;1754;25945;19979;1;709;-2.14748e+09;-3.12765e+07;0;0;0;0;0;0;377279363;377350797;1058486
789;4.26289e-15;-40;1589;9258;10117;1;575;-2.14748e+09;-3.12765e+07;-1;0;0;0;-1;0;377279363;377350797;1058486
790;1.18811e-14;-33;1754;25945;19979;1;709;-2.14748e+09;-3.10445e+07;-1;0;0;0;-1;0;378928090;379001260;1080901
790;4.26289e-15;-41;1589;9258;10117;1;575;-2.14748e+09;-3.10444e+07;0;0;0;0;0;0;378928090;379001260;1080901
791;1.18811e-14;-33;1754;25945;19979;1;709;-2.14748e+09;-3.08153e+07;-1;0;0;0;-1;0;380570412;380645349;1103622
791;4.26289e-15;-41;1589;9258;10117;1;575;-2.14748e+09;-3.08153e+07;-1;0;0;0;-1;0;380570412;380645349;1103622
792;1.18811e-14;-33;1754;25945;19979;1;709;-2.14748e+09;-3.05891e+07;-1;0;0;0;-1;0;382206352;382283086;1126650
792;4.26289e-15;-41;1589;9258;10117;1;575;-2.14748e+09;-3.05891e+07;-1;0;0;0;-1;0;382206352;382283086;1126650
793;1.18811e-14;-34;1754;25945;19979;1;709;-2.14748e+09;-3.03654e+07;0;0;0;0;0;0;383835934;383914497;1149986
793;4.26289e-15;-42;1589;9258;10117;1;575;-2.14748e+09;-3.03654e+07;0;0;0;0;0;0;383835934;383914497;1149986
794;1.18811e-14;-34;1754;25945;19979;1;709;-2.14748e+09;-3.01448e+07;-1;0;0;0;-1;0;385459182;385539605;1173632
794;4.26289e-15;-42;1589;9258;10117;1;575;-2.14748e+09;-3.01448e+07;-1;0;0;0;-1;0;385459182;385539605;1173632
795;1.18811e-14;-35;1754;25945;19979;1;709;-2.14748e+09;-2.99265e+07;0;0;0;0;0;0;387076119;387158435;1197589
795;4.26289e-15;-42;1589;9258;10117;1;575;-2.14748e+09;-2.99265e+07;-1;0;0;0;-1;0;387076119;387158435;1197589
796;1.18811e-14;-35;1754;25945;19979;1;709;-2.14748e+09;-2.97112e+07;-1;0;0;0;-1;0;388686769;388771010;1221858
796;4.26289e-15;-42;1589;9258;10117;1;575;-2.14748e+09;-2.97112e+07;-1;0;0;0;-1;0;388686769;388771010;1221858
797;1.18811e-14;-35;1754;25945;19979;1;709;-2.14748e+09;-2.94982e+07;-1;0;0;0;-1;0;390291158;390377356;1246440
797;4.26289e-15;-43;1589;9258;10117;1;575;-2.14748e+09;-2.94982e+07;0;0;0;0;0;0;390291158;390377356;1246440
798;1.18811e-14;-35;1754;25945;19979;1;709;-2.14748e+09;-2.92879e+07;-1;0;0;0;-1;0;391889309;391977498;1271336
798;4.26289e-15;-44;1589;9258;10117;1;575;-2.14748e+09;-2.92879e+07;0;0;0;0;0;0;391889309;391977498;1271336
799;1.18811e-14;-36;1754;25945;19979;1;709;-2.14748e+09;-2.90801e+07;0;0;0;0;0;0;393481247;393571459;1296548
799;4.26289e-15;-44;1589;9258;10117;1;575;-2.14748e+09;-2.90801e+07;-1;0;0;0;-1;0;393481247;393571459;1296548
800;1.18811e-14;-37;1754;25945;19979;1;709;-2.14748e+09;-2.88748e+07;0;0;0;0;0;0;395066997;395159266;1322075
800;4.26289e-15;-44;1589;9258;10117;1;575;-2.14748e+09;-2.88747e+07;-1;0;0;0;-1;0;395066997;395159266;1322075
801;1.18811e-14;-38;1754;25945;19979;1;709;-2.14748e+09;-2.86718e+07;0;0;0;0;0;0;396646584;396740944;1347920
801;4.26289e-15;-44;1589;9258;10117;1;575;-2.14748e+09;-2.86718e+07;-1;0;0;0;-1;0;396646584;396740944;1347920
802;1.18811e-14;-39;1754;25945;19979;1;709;-2.14748e+09;-2.84713e+07;0;0;0;0;0;0;398220032;398316518;1374083
802;4.26289e-15;-45;1589;9258;10117;1;575;-2.14748e+09;-2.84713e+07;0;0;0;0;0;0;398220032;398316518;1374083
803;1.18811e-14;-40;1754;25945;19979;1;709;-2.14748e+09;-2.82731e+07;0;0;0;0;0;0;399787368;399886013;1400565
803;4.26289e-15;-46;1589;9258;10117;1;575;-2.14748e+09;-2.82731e+07;0;0;0;0;0;0;399787368;399886013;1400565
804;1.18811e-14;-41;1754;25945;19979;1;709;-2.14748e+09;-2.80773e+07;0;0;0;0;0;0;401348616;401449456;1427367
804;4.26289e-15;-46;1589;9258;10117;1;575;-2.14748e+09;-2.80773e+07;-1;0;0;0;-1;0;401348616;401449456;1427367
805;1.18811e-14;-41;1754;25945;19979;1;709;-2.14748e+09;-2.78837e+07;-1;0;0;0;-1;0;402903802;403006871;1454489
805;4.26289e-15;-46;1589;9258;10117;1;575;-2.14748e+09;-2.78837e+07;-1;0;0;0;-1;0;402903802;403006871;1454489
806;1.18811e-14;-42;1754;25945;19979;1;709;-2.14748e+09;-2.76924e+07;0;0;0;0;0;0;404452951;404558285;1481934
806;4.26289e-15;-47;1589;9258;10117;1;575;-2.14748e+09;-2.76924e+07;0;0;0;0;0;0;404452951;404558285;1481934
807;1.18811e-14;-43;1754;25945;19979;1;709;-2.14748e+09;-2.75033e+07;0;0;0;0;0;0;405996089;406103724;1509700
807;4.26289e-15;-48;1589;9258;10117;1;575;-2.14748e+09;-2.75033e+07;0;0;0;0;0;0;405996089;406103724;1509700
808;1.18811e-14;-43;1754;25945;19979;1;709;-2.14748e+09;-2.73163e+07;-1;0;0;0;-1;0;407533241;407643213;1537790
808;4.26289e-15;-48;1589;9258;10117;1;575;-2.14748e+09;-2.73163e+07;-1;0;0;0;-1;0;407533241;407643213;1537790
809;1.18811e-14;-43;1754;25945;19979;1;709;-2.14748e+09;-2.71313e+07;-1;0;0;0;-1;0;409064433;409176778;1566204
809;4.26289e-15;-48;1589;9258;10117;1;575;-2.14748e+09;-2.71313e+07;-1;0;0;0;-1;0;409064433;409176778;1566204
810;1.18811e-14;-43;1754;25945;19979;1;709;-2.14748e+09;-2.69485e+07;-1;0;0;0;-1;0;410589692;410704447;1594943
810;4.26289e-15;-49;1589;9258;10117;1;575;-2.14748e+09;-2.69485e+07;0;0;0;0;0;0;410589692;410704447;1594943
811;1.18811e-14;-44;1754;25945;19979;1;709;-2.14748e+09;-2.67678e+07;0;0;0;0;0;0;412109042;412226243;1624007
811;4.26289e-15;-49;1589;9258;10117;1;575;-2.14748e+09;-2.67678e+07;-1;0;0;0;-1;0;412109042;412226243;1624007
812;1.18811e-14;-44;1754;25945;19979;1;709;-2.14748e+09;-2.65893e+07;-1;0;0;0;-1;0;413622509;413742195;1653397
812;4.26289e-15;-49;1589;9258;10117;1;575;-2.14748e+09;-2.65892e+07;-1;0;0;0;-1;0;413622509;413742195;1653397
813;1.18811e-14;-45;1754;25945;19979;1;709;-2.14748e+09;-2.64125e+07;0;0;0;0;0;0;415130121;415252328;1683114
813;4.26289e-15;-49;1589;9258;10117;1;575;-2.14748e+09;-2.64125e+07;-1;0;0;0;-1;0;415130121;415252328;1683114
814;1.18811e-14;-45;1754;25945;19979;1;709;-2.14748e+09;-2.62379e+07;-1;0;0;0;-1;0;416631901;416756668;1713158
814;4.26289e-15;-49;1588;9258;10117;1;575;-2.14748e+09;-2.62379e+07;0;0;0;0;0;0;416631901;416756668;1713158
815;1.18811e-14;-46;1754;25945;19979;1;709;-2.14748e+09;-2.60651e+07;0;0;0;0;0;0;418127878;418255242;1743530
815;4.26289e-15;-49;1588;9258;10117;1;575;-2.14748e+09;-2.60651e+07;-1;0;0;0;-1;0;418127878;418255242;1743530
816;1.18811e-14;-47;1754;25945;19979;1;709;-2.14748e+09;-2.58941e+07;0;0;0;0;0;0;419618075;419748076;1774231
816;4.26289e-15;-50;1588;9258;10117;1;575;-2.14748e+09;-2.58941e+07;0;0;0;0;0;0;419618075;419748076;1774231
817;1.18811e-14;-47;1754;25945;19979;1;709;-2.14748e+09;-2.57251e+07;-1;0;0;0;-1;0;421102521;421235197;1805260
817;4.26289e-15;-51;1588;9258;10117;1;575;-2.14748e+09;-2.57251e+07;0;0;0;0;0;0;421102521;421235197;1805260
818;1.18811e-14;-48;1754;25945;19979;1;709;-2.14748e+09;-2.5558e+07;0;0;0;0;0;0;422581239;422716630;1836619
818;4.26289e-15;-51;1588;9258;10117;1;575;-2.14748e+09;-2.5558e+07;-1;0;0;0;-1;0;422581239;422716630;1836619
819;1.18811e-14;-48;1754;25945;19979;1;709;-2.14748e+09;-2.53927e+07;-1;0;0;0;-1;0;424054258;424192402;1868308
819;4.26289e-15;-52;1588;9258;10117;1;575;-2.14748e+09;-2.53927e+07;0;0;0;0;0;0;424054258;424192402;1868308
820;1.18811e-14;-48;1754;25945;19979;1;709;-2.14748e+09;-2.52293e+07;-1;0;0;0;-1;0;425521602;425662539;1900328
820;4.26289e-15;-53;1588;9258;10117;1;575;-2.14748e+09;-2.52293e+07;0;0;0;0;0;0;425521602;425662539;1900328
821;1.18811e-14;-49;1754;25945;19979;1;709;-2.14748e+09;-2.50674e+07;0;0;0;0;0;0;426983297;427127068;1932678
821;4.26289e-15;-53;1588;9258;10117;1;575;-2.14748e+09;-2.50674e+07;-1;0;0;0;-1;0;426983297;427127068;1932678
822;1.18811e-14;-50;1754;25945;19979;1;709;-2.14748e+09;-2.49075e+07;0;0;0;0;0;0;428439370;428586015;1965360
822;4.26289e-15;-54;1588;9258;10117;1;575;-2.14748e+09;-2.49075e+07;0;0;0;0;0;0;428439370;428586015;1965360
823;1.18811e-14;-51;1754;25945;19979;1;709;-2.14748e+09;-2.47491e+07;0;0;0;0;0;0;429889847;430039407;1998373
823;4.26289e-15;-54;1588;9258;10117;1;575;-2.14748e+09;-2.47491e+07;-1;0;0;0;-1;0;429889847;430039407;1998373
824;1.18811e-14;-52;1754;25945;19979;1;709;-2.14748e+09;-2.45925e+07;0;0;0;0;0;0;431334754;431487269;2031719
824;4.26289e-15;-55;1588;9258;10117;1;575;-2.14748e+09;-2.45925e+07;0;0;0;0;0;0;431334754;431487269;2031719
825;1.18811e-14;-52;1754;25945;19979;1;709;-2.14748e+09;-2.44375e+07;-1;0;0;0;-1;0;432774116;432929628;2065396
825;4.26289e-15;-55;1588;9258;10117;1;575;-2.14748e+09;-2.44375e+07;-1;0;0;0;-1;0;432774116;432929628;2065396
826;1.18811e-14;-53;1754;25945;19979;1;709;-2.14748e+09;-2.42841e+07;0;0;0;0;0;0;434207960;434366510;2099407
826;4.26289e-15;-56;1588;9258;10117;1;575;-2.14748e+09;-2.42841e+07;0;0;0;0;0;0;434207960;434366510;2099407
827;1.18811e-14;-54;1754;25945;19979;1;709;-2.14748e+09;-2.41325e+07;0;0;0;0;0;0;435636312;435797942;2133750
827;4.26289e-15;-56;1588;9258;10117;1;575;-2.14748e+09;-2.41324e+07;-1;0;0;0;-1;0;435636312;435797942;2133750
828;1.18811e-14;-55;1754;25945;19979;1;709;-2.14748e+09;-2.39824e+07;0;0;0;0;0;0;437059197;437223949;2168426
828;4.26289e-15;-57;1588;9258;10117;1;575;-2.14748e+09;-2.39824e+07;0;0;0;0;0;0;437059197;437223949;2168426
829;1.18811e-14;-55;1754;25945;19979;1;709;-2.14748e+09;-2.38338e+07;-1;0;0;0;-1;0;438476641;438644557;2203436
829;4.26289e-15;-57;1588;9258;10117;1;575;-2.14748e+09;-2.38337e+07;-1;0;0;0;-1;0;438476641;438644557;2203436
830;1.18811e-14;-55;1754;25945;19979;1;709;-2.14748e+09;-2.36867e+07;-1;0;0;0;-1;0;439888670;440059794;2238779
830;4.26289e-15;-57;1588;9258;10117;1;575;-2.14748e+09;-2.36867e+07;-1;0;0;0;-1;0;439888670;440059794;2238779
831;1.18811e-14;-56;1754;25945;19979;1;709;-2.14748e+09;-2.35412e+07;0;0;0;0;0;0;441295310;441469684;2274456
831;4.26289e-15;-58;1588;9258;10117;1;575;-2.14748e+09;-2.35412e+07;0;0;0;0;0;0;441295310;441469684;2274456
832;1.18811e-14;-57;1754;25945;19979;1;709;-2.14748e+09;-2.33972e+07;0;0;0;0;0;0;442696587;442874255;2310467
832;4.26289e-15;-58;1588;9258;10117;1;575;-2.14748e+09;-2.33972e+07;-1;0;0;0;-1;0;442696587;442874255;2310467
833;1.18811e-14;-58;1754;25945;19979;1;709;-2.14748e+09;-2.32547e+07;0;0;0;0;0;0;444092525;444273531;2346812
833;4.26289e-15;-58;1588;9258;10117;1;575;-2.14748e+09;-2.32547e+07;-1;0;0;0;-1;0;444092525;444273531;2346812
834;1.18811e-14;-58;1754;25945;19979;1;709;-2.14748e+09;-2.31136e+07;-1;0;0;0;-1;0;445483152;445667538;2383491
834;4.26289e-15;-59;1588;9258;10117;1;575;-2.14748e+09;-2.31136e+07;0;0;0;0;0;0;445483152;445667538;2383491
835;1.18811e-14;-59;1754;25945;19979;1;709;-2.14748e+09;-2.29739e+07;0;0;0;0;0;0;446868492;447056303;2420504
835;4.26289e-15;-59;1588;9258;10117;1;575;-2.14748e+09;-2.29739e+07;-1;0;0;0;-1;0;446868492;447056303;2420504
836;1.18811e-14;-59;1754;25945;19979;1;709;-2.14748e+09;-2.28357e+07;-1;0;0;0;-1;0;448248570;448439852;2457851
836;4.26289e-15;-60;1588;9258;10117;1;575;-2.14748e+09;-2.28357e+07;0;0;0;0;0;0;448248570;448439852;2457851
837;1.18811e-14;-60;1754;25945;19979;1;709;-2.14748e+09;-2.2699e+07;0;0;0;0;0;0;449623413;449818209;2495533
837;4.26289e-15;-60;1588;9258;10117;1;575;-2.14748e+09;-2.26989e+07;-1;0;0;0;-1;0;449623413;449818209;2495533
838;1.18811e-14;-60;1754;25945;19979;1;709;-2.14748e+09;-2.25634e+07;-1;0;0;0;-1;0;450993045;451191401;2533549
838;4.26289e-15;-60;1588;9258;10117;1;575;-2.14748e+09;-2.25634e+07;-1;0;0;0;-1;0;450993045;451191401;2533549
839;1.18811e-14;-60;1754;25945;19979;1;709;-2.14748e+09;-2.24293e+07;-1;0;0;0;-1;0;452357493;452559453;2571899
839;4.26289e-15;-60;1588;9258;10117;1;575;-2.14748e+09;-2.24293e+07;-1;0;0;0;-1;0;452357493;452559453;2571899
840;1.18811e-14;-60;1754;25945;19979;1;709;-2.14748e+09;-2.22965e+07;-1;0;0;0;-1;0;453716780;453922391;2610583
840;4.26289e-15;-61;1588;9258;10117;1;575;-2.14748e+09;-2.22965e+07;0;0;0;0;0;0;453716780;453922391;2610583
841;1.18811e-14;-61;1754;25945;19979;1;709;-2.14748e+09;-2.21651e+07;0;0;0;0;0;0;455070933;455280240;2649602
841;4.26289e-15;-62;1588;9258;10117;1;575;-2.14748e+09;-2.21651e+07;0;0;0;0;0;0;455070933;455280240;2649602
842;1.18811e-14;-61;1754;25945;19979;1;709;-2.14748e+09;-2.20349e+07;-1;0;0;0;-1;0;456419975;456633025;2688954
842;4.26289e-15;-62;1588;9258;10117;1;575;-2.14748e+09;-2.20349e+07;-1;0;0;0;-1;0;456419975;456633025;2688954
843;1.18811e-14;-61;1754;25945;19979;1;709;-2.14748e+09;-2.1906e+07;-1;0;0;0;-1;0;457763934;457980772;2728641
843;4.26289e-15;-63;1588;9258;10117;1;575;-2.14748e+09;-2.1906e+07;0;0;0;0;0;0;457763934;457980772;2728641
844;1.18811e-14;-61;1754;25945;19979;1;709;-2.14748e+09;-2.17784e+07;-1;0;0;0;-1;0;459102832;459323506;2768661
844;4.26289e-15;-63;1588;9258;10117;1;575;-2.14748e+09;-2.17784e+07;-1;0;0;0;-1;0;459102832;459323506;2768661
845;1.18811e-14;-62;1754;25945;19979;1;709;-2.14748e+09;-2.16521e+07;0;0;0;0;0;0;460436695;460661252;2809015
845;4.26289e-15;-64;1588;9258;10117;1;575;-2.14748e+09;-2.16521e+07;0;0;0;0;0;0;460436695;460661252;2809015
846;1.18811e-14;-63;1754;25945;19979;1;709;-2.14748e+09;-2.1527e+07;0;0;0;0;0;0;461765548;461994034;2849703
846;4.26289e-15;-64;1588;9258;10117;1;575;-2.14748e+09;-2.15269e+07;-1;0;0;0;-1;0;461765548;461994034;2849703
847;1.18811e-14;-63;1754;25945;19979;1;709;-2.14748e+09;-2.14031e+07;-1;0;0;0;-1;0;463089415;463321879;2890723
847;4.26289e-15;-65;1588;9258;10117;1;575;-2.14748e+09;-2.14031e+07;0;0;0;0;0;0;463089415;463321879;2890723
848;1.18811e-14;-64;1754;25945;19979;1;709;-2.14748e+09;-2.12802e+07;0;0;0;0;0;0;464408321;464644810;2932077
848;4.26289e-15;-65;1588;9258;10117;1;575;-2.14748e+09;-2.12802e+07;-1;0;0;0;-1;0;464408321;464644810;2932077
849;1.18811e-14;-64;1754;25945;19979;1;709;-2.14748e+09;-2.11587e+07;-1;0;0;0;-1;0;465722291;465962853;2973764
849;4.26289e-15;-66;1588;9258;10117;1;575;-2.14748e+09;-2.11587e+07;0;0;0;0;0;0;465722291;465962853;2973764
850;1.18811e-14;-64;1754;25945;19979;1;709;-2.14748e+09;-2.10384e+07;-1;0;0;0;-1;0;467031348;467276032;3015783
850;4.26289e-15;-66;1588;9258;10117;1;575;-2.14748e+09;-2.10384e+07;-1;0;0;0;-1;0;467031348;467276032;3015783
851;1.18811e-14;-65;1754;25945;19979;1;709;-2.14748e+09;-2.09191e+07;0;0;0;0;0;0;468335518;468584372;3058135
851;4.26289e-15;-67;1588;9258;10117;1;575;-2.14748e+09;-2.0919e+07;0;0;0;0;0;0;468335518;468584372;3058135
852;1.18811e-14;-66;1754;25945;19979;1;709;-2.14748e+09;-2.08009e+07;0;0;0;0;0;0;469634823;469887897;3100818
852;4.26289e-15;-68;1588;9258;10117;1;575;-2.14748e+09;-2.08009e+07;0;0;0;0;0;0;469634823;469887897;3100818
853;1.18811e-14;-66;1754;25945;19979;1;709;-2.14748e+09;-2.06839e+07;-1;0;0;0;-1;0;470929289;471186631;3143833
853;4.26289e-15;-68;1588;9258;10117;1;575;-2.14748e+09;-2.06839e+07;-1;0;0;0;-1;0;470929289;471186631;3143833
854;1.18811e-14;-67;1754;25945;19979;1;709;-2.14748e+09;-2.05679e+07;0;0;0;0;0;0;472218940;472480599;3187180
854;4.26289e-15;-68;1588;9258;10117;1;575;-2.14748e+09;-2.05679e+07;-1;0;0;0;-1;0;472218940;472480599;3187180
855;1.18811e-14;-67;1754;25945;19979;1;709;-2.14748e+09;-2.04531e+07;-1;0;0;0;-1;0;473503799;473769825;3230858
855;4.26289e-15;-69;1588;9258;10117;1;575;-2.14748e+09;-2.04531e+07;0;0;0;0;0;0;473503799;473769825;3230858
856;1.18811e-14;-68;1754;25945;19979;1;709;-2.14748e+09;-2.03394e+07;0;0;0;0;0;0;474783890;475054334;3274866
856;4.26289e-15;-70;1588;9258;10117;1;575;-2.14748e+09;-2.03394e+07;0;0;0;0;0;0;474783890;475054334;3274866
857;1.18811e-14;-68;1754;25945;19979;1;709;-2.14748e+09;-2.02267e+07;-1;0;0;0;-1;0;476059236;476334148;3319204
857;4.26289e-15;-71;1588;9258;10117;1;575;-2.14748e+09;-2.02267e+07;0;0;0;0;0;0;476059236;476334148;3319204
858;1.18811e-14;-68;1754;25945;19979;1;709;-2.14748e+09;-2.0115e+07;-1;0;0;0;-1;0;477329862;477609292;3363873
858;4.26289e-15;-71;1588;9258;10117;1;575;-2.14748e+09;-2.0115e+07;-1;0;0;0;-1;0;477329862;477609292;3363873
859;1.18811e-14;-68;1754;25945;19979;1;709;-2.14748e+09;-2.00045e+07;-1;0;0;0;-1;0;478595792;478879789;3408870
859;4.26289e-15;-71;1588;9258;10117;1;575;-2.14748e+09;-2.00045e+07;-1;0;0;0;-1;0;478595792;478879789;3408870
860;1.18811e-14;-68;1754;25945;19979;1;709;-2.14748e+09;-1.98948e+07;-1;0;0;0;-1;0;479857047;480145664;3454197
860;4.26289e-15;-71;1588;9258;10117;1;575;-2.14748e+09;-1.98948e+07;-1;0;0;0;-1;0;479857047;480145664;3454197
861;1.18811e-14;-68;1754;25945;19979;1;709;-2.14748e+09;-1.97862e+07;-1;0;0;0;-1;0;481113652;481406940;3499852
861;4.26289e-15;-72;1588;9258;10117;1;575;-2.14748e+09;-1.97862e+07;0;0;0;0;0;0;481113652;481406940;3499852
862;1.18811e-14;-68;1754;25945;19979;1;709;-2.14748e+09;-1.96786e+07;-1;0;0;0;-1;0;482365630;482663640;3545835
862;4.26289e-15;-73;1588;9258;10117;1;575;-2.14748e+09;-1.96786e+07;0;0;0;0;0;0;482365630;482663640;3545835
863;1.18811e-14;-69;1754;25945;19979;1;709;-2.14748e+09;-1.9572e+07;0;0;0;0;0;0;483613004;483915788;3592145
863;4.26289e-15;-73;1588;9258;10117;1;575;-2.14748e+09;-1.9572e+07;-1;0;0;0;-1;0;483613004;483915788;3592145
864;1.18811e-14;-70;1754;25945;19979;1;709;-2.14748e+09;-1.94663e+07;0;0;0;0;0;0;484855796;485163407;3638783
864;4.26289e-15;-74;1588;9258;10117;1;575;-2.14748e+09;-1.94663e+07;0;0;0;0;0;0;484855796;485163407;3638783
865;1.18811e-14;-70;1754;25945;19979;1;709;-2.14748e+09;-1.93616e+07;-1;0;0;0;-1;0;486094031;486406520;3685746
865;4.26289e-15;-74;1588;9258;10117;1;575;-2.14748e+09;-1.93616e+07;-1;0;0;0;-1;0;486094031;486406520;3685746
866;1.18811e-14;-71;1754;25945;19979;1;709;-2.14748e+09;-1.92579e+07;0;0;0;0;0;0;487327730;487645149;3733036
866;4.26289e-15;-75;1588;9258;10117;1;575;-2.14748e+09;-1.92578e+07;0;0;0;0;0;0;487327730;487645149;3733036
867;1.18811e-14;-72;1754;25945;19979;1;709;-2.14748e+09;-1.9155e+07;0;0;0;0;0;0;488556917;488879319;3780651
867;4.26289e-15;-76;1588;9258;10117;1;575;-2.14748e+09;-1.9155e+07;0;0;0;0;0;0;488556917;488879319;3780651
868;1.18811e-14;-72;1754;25945;19979;1;709;-2.14748e+09;-1.90531e+07;-1;0;0;0;-1;0;489781613;490109051;3828591
868;4.26289e-15;-76;1587;9258;10117;1;575;-2.14748e+09;-1.90531e+07;0;0;0;0;0;0;489781613;490109051;3828591
869;1.18811e-14;-73;1754;25945;19979;1;709;-2.14748e+09;-1.8952e+07;0;0;0;0;0;0;491001841;491334369;3876854
869;4.26289e-15;-76;1587;9258;10117;1;575;-2.14748e+09;-1.89519e+07;-1;0;0;0;-1;0;491001841;491334369;3876854
870;1.18811e-14;-74;1754;25945;19979;1;709;-2.14748e+09;-1.88518e+07;0;0;0;0;0;0;492217624;492555295;3925441
870;4.26289e-15;-76;1587;9258;10117;1;575;-2.14748e+09;-1.88518e+07;-1;0;0;0;-1;0;492217624;492555295;3925441
871;1.18811e-14;-74;1754;25945;19979;1;709;-2.14748e+09;-1.87527e+07;-1;0;0;0;-1;0;493428984;493771851;3974351
871;4.26289e-15;-76;1587;9258;10117;1;575;-2.14748e+09;-1.87527e+07;-1;0;0;0;-1;0;493428984;493771851;3974351
872;1.18811e-14;-75;1754;25945;19979;1;709;-2.14748e+09;-1.86542e+07;0;0;0;0;0;0;494635943;494984060;4023583
872;4.26289e-15;-77;1587;9258;10117;1;575;-2.14748e+09;-1.86542e+07;0;0;0;0;0;0;494635943;494984060;4023583
873;1.18811e-14;-75;1754;25945;19979;1;709;-2.14748e+09;-1.85566e+07;-1;0;0;0;-1;0;495838523;496191944;4073137
873;4.26289e-15;-77;1587;9258;10117;1;575;-2.14748e+09;-1.85566e+07;-1;0;0;0;-1;0;495838523;496191944;4073137
874;1.18811e-14;-76;1754;25945;19979;1;709;-2.14748e+09;-1.846e+07;0;0;0;0;0;0;497036746;497395526;4123011
874;4.26289e-15;-78;1587;9258;10117;1;575;-2.14748e+09;-1.846e+07;0;0;0;0;0;0;497036746;497395526;4123011
875;1.18811e-14;-77;1754;25945;19979;1;709;-2.14748e+09;-1.83641e+07;0;0;0;0;0;0;498230633;498594826;4173206
875;4.26289e-15;-78;1587;9258;10117;1;575;-2.14748e+09;-1.83641e+07;-1;0;0;0;-1;0;498230633;498594826;4173206
876;1.18811e-14;-77;1754;25945;19979;1;709;-2.14748e+09;-1.82691e+07;-1;0;0;0;-1;0;499420207;499789868;4223720
876;4.26289e-15;-78;1587;9258;10117;1;575;-2.14748e+09;-1.82691e+07;-1;0;0;0;-1;0;499420207;499789868;4223720
877;1.18811e-14;-78;1754;25945;19979;1;709;-2.14748e+09;-1.81751e+07;0;0;0;0;0;0;500605489;500980672;4274552
877;4.26289e-15;-78;1587;9258;10117;1;575;-2.14748e+09;-1.81751e+07;-1;0;0;0;-1;0;500605489;500980672;4274552
878;1.18811e-14;-78;1754;25945;19979;1;709;-2.14748e+09;-1.80816e+07;-1;0;0;0;-1;0;501786500;502167262;4325703
878;4.26289e-15;-78;1587;9258;10117;1;575;-2.14748e+09;-1.80816e+07;-1;0;0;0;-1;0;501786500;502167262;4325703
879;1.18811e-14;-79;1754;25945;19979;1;709;-2.14748e+09;-1.7989e+07;0;0;0;0;0;0;502963261;503349657;4377170
879;4.26289e-15;-79;1587;9258;10117;1;575;-2.14748e+09;-1.7989e+07;0;0;0;0;0;0;502963261;503349657;4377170
880;1.18811e-14;-80;1754;25945;19979;1;709;-2.14748e+09;-1.78972e+07;0;0;0;0;0;0;504135795;504527880;4428954
880;4.26289e-15;-80;1587;9258;10117;1;575;-2.14748e+09;-1.78972e+07;0;0;0;0;0;0;504135795;504527880;4428954
881;1.18811e-14;-80;1754;25945;19979;1;709;-2.14748e+09;-1.78063e+07;-1;0;0;0;-1;0;505304122;505701952;4481054
881;4.26289e-15;-81;1587;9258;10117;1;575;-2.14748e+09;-1.78063e+07;0;0;0;0;0;0;505304122;505701952;4481054
882;1.18811e-14;-81;1754;25945;19979;1;709;-2.14748e+09;-1.77161e+07;0;0;0;0;0;0;506468262;506871894;4533468
882;4.26289e-15;-82;1587;9258;10117;1;575;-2.14748e+09;-1.77161e+07;0;0;0;0;0;0;506468262;506871894;4533468
883;1.18811e-14;-81;1754;25945;19979;1;709;-2.14748e+09;-1.76265e+07;-1;0;0;0;-1;0;507628238;508037727;4586197
883;4.26289e-15;-82;1587;9258;10117;1;575;-2.14748e+09;-1.76265e+07;-1;0;0;0;-1;0;507628238;508037727;4586197
884;1.18811e-14;-82;1754;25945;19979;1;709;-2.14748e+09;-1.75378e+07;0;0;0;0;0;0;508784069;509199473;4639238
884;4.26289e-15;-82;1587;9258;10117;1;575;-2.14748e+09;-1.75378e+07;-1;0;0;0;-1;0;508784069;509199473;4639238
885;1.18811e-14;-83;1754;25945;19979;1;709;-2.14748e+09;-1.74498e+07;0;0;0;0;0;0;509935777;510357152;4692592
885;4.26289e-15;-83;1587;9258;10117;1;575;-2.14748e+09;-1.74498e+07;0;0;0;0;0;0;509935777;510357152;4692592
886;1.18811e-14;-83;1754;25945;19979;1;709;-2.14748e+09;-1.73626e+07;-1;0;0;0;-1;0;511083382;511510785;4746258
886;4.26289e-15;-83;1587;9258;10117;1;575;-2.14748e+09;-1.73625e+07;-1;0;0;0;-1;0;511083382;511510785;4746258
887;1.18811e-14;-84;1754;25945;19979;1;709;-2.14748e+09;-1.7276e+07;0;0;0;0;0;0;512226905;512660392;4800234
887;4.26289e-15;-84;1587;9258;10117;1;575;-2.14748e+09;-1.7276e+07;0;0;0;0;0;0;512226905;512660392;4800234
888;1.18811e-14;-85;1754;25945;19979;1;709;-2.14748e+09;-1.71903e+07;0;0;0;0;0;0;513366365;513805994;4854519
888;4.26289e-15;-85;1587;9258;10117;1;575;-2.14748e+09;-1.71903e+07;0;0;0;0;0;0;513366365;513805994;4854519
889;1.18811e-14;-85;1754;25945;19979;1;709;-2.14748e+09;-1.71052e+07;-1;0;0;0;-1;0;514501783;514947613;4909114
889;4.26289e-15;-86;1587;9258;10117;1;575;-2.14748e+09;-1.71052e+07;0;0;0;0;0;0;514501783;514947613;4909114
890;1.18811e-14;-85;1754;25945;19979;1;709;-2.14748e+09;-1.70208e+07;-1;0;0;0;-1;0;515633179;516085266;4964016
890;4.26289e-15;-86;1587;9258;10117;1;575;-2.14748e+09;-1.70208e+07;-1;0;0;0;-1;0;515633179;516085266;4964016
891;1.18811e-14;-86;1754;25945;19979;1;709;-2.14748e+09;-1.6937e+07;0;0;0;0;0;0;516760573;517218976;5019226
891;4.26289e-15;-87;1587;9258;10117;1;575;-2.14748e+09;-1.6937e+07;0;0;0;0;0;0;516760573;517218976;5019226
892;1.18811e-14;-87;1754;25945;19979;1;709;-2.14748e+09;-1.68541e+07;0;0;0;0;0;0;517883986;518348763;5074741
892;4.26289e-15;-88;1587;9258;10117;1;575;-2.14748e+09;-1.68541e+07;0;0;0;0;0;0;517883986;518348763;5074741
893;1.18811e-14;-87;1754;25945;19979;1;709;-2.14748e+09;-1.67717e+07;-1;0;0;0;-1;0;519003436;519474645;5130562
893;4.26289e-15;-88;1587;9258;10117;1;575;-2.14748e+09;-1.67717e+07;-1;0;0;0;-1;0;519003436;519474645;5130562
894;1.18811e-14;-88;1754;25945;19979;1;709;-2.14748e+09;-1.66899e+07;0;0;0;0;0;0;520118944;520596644;5186687
894;4.26289e-15;-89;1587;9258;10117;1;575;-2.14748e+09;-1.66899e+07;0;0;0;0;0;0;520118944;520596644;5186687
895;1.18811e-14;-89;1754;25945;19979;1;709;-2.14748e+09;-1.66089e+07;0;0;0;0;0;0;521230528;521714778;5243115
895;4.26289e-15;-89;1587;9258;10117;1;575;-2.14748e+09;-1.66089e+07;-1;0;0;0;-1;0;521230528;521714778;5243115
896;1.18811e-14;-90;1754;25945;19979;1;709;-2.14748e+09;-1.65285e+07;0;0;0;0;0;0;522338210;522829068;5299846
896;4.26289e-15;-90;1587;9258;10117;1;575;-2.14748e+09;-1.65285e+07;0;0;0;0;0;0;522338210;522829068;5299846
897;1.18811e-14;-91;1754;25945;19979;1;709;-2.14748e+09;-1.64488e+07;0;0;0;0;0;0;523442007;523939532;5356878
897;4.26289e-15;-91;1587;9258;10117;1;575;-2.14748e+09;-1.64488e+07;0;0;0;0;0;0;523442007;523939532;5356878
898;1.18811e-14;-92;1754;25945;19979;1;709;-2.14748e+09;-1.63697e+07;0;0;0;0;0;0;524541939;525046191;5414210
898;4.26289e-15;-91;1587;9258;10117;1;575;-2.14748e+09;-1.63697e+07;-1;0;0;0;-1;0;524541939;525046191;5414210
899;1.18811e-14;-92;1754;25945;19979;1;709;-2.14748e+09;-1.62914e+07;-1;0;0;0;-1;0;525638025;526149064;5471842
899;4.26289e-15;-91;1587;9258;10117;1;575;-2.14748e+09;-1.62914e+07;-1;0;0;0;-1;0;525638025;526149064;5471842
900;1.18811e-14;-93;1754;25945;19979;1;709;-2.14748e+09;-1.62135e+07;0;0;0;0;0;0;526730285;527248169;5529772
900;4.26289e-15;-91;1587;9258;10117;1;575;-2.14748e+09;-1.62134e+07;-1;0;0;0;-1;0;526730284;527248169;5529772
901;1.18811e-14;-94;1754;25945;19979;1;709;-2.14748e+09;-1.61362e+07;0;0;0;0;0;0;527818736;528343527;5587999
901;4.26289e-15;-92;1587;9258;10117;1;575;-2.14748e+09;-1.61362e+07;0;0;0;0;0;0;527818736;528343527;5587999
902;1.18811e-14;-94;1754;25945;19979;1;709;-2.14748e+09;-1.60597e+07;-1;0;0;0;-1;0;528903399;529435155;5646523
902;4.26289e-15;-93;1587;9258;10117;1;575;-2.14748e+09;-1.60597e+07;0;0;0;0;0;0;528903399;529435155;5646523
903;1.18811e-14;-94;1754;25945;19979;1;709;-2.14748e+09;-1.59836e+07;-1;0;0;0;-1;0;529984291;530523073;5705342
903;4.26289e-15;-94;1587;9258;10117;1;575;-2.14748e+09;-1.59836e+07;0;0;0;0;0;0;529984291;530523073;5705342
904;1.18811e-14;-95;1754;25945;19979;1;709;-2.14748e+09;-1.59083e+07;0;0;0;0;0;0;531061431;531607300;5764455
904;4.26289e-15;-95;1587;9258;10117;1;575;-2.14748e+09;-1.59082e+07;0;0;0;0;0;0;531061431;531607300;5764455
905;1.18811e-14;-95;1754;25945;19979;1;709;-2.14748e+09;-1.58334e+07;-1;0;0;0;-1;0;532134838;532687854;5823861
905;4.26289e-15;-96;1587;9258;10117;1;575;-2.14748e+09;-1.58334e+07;0;0;0;0;0;0;532134838;532687854;5823861
906;1.18811e-14;-95;1754;25945;19979;1;709;-2.14748e+09;-1.57592e+07;0;0;-1;0;0;-1;533204529;533764753;5883559
906;4.26289e-15;-97;1587;9258;10117;1;575;-2.14748e+09;-1.57592e+07;0;0;0;0;0;0;533204529;533764753;5883559
907;1.18811e-14;-95;1754;25945;19979;1;709;-2.14748e+09;-1.56855e+07;-1;0;0;0;-1;0;534270524;534838017;5943548
907;4.26289e-15;-97;1587;9258;10117;1;575;-2.14748e+09;-1.56855e+07;-1;0;0;0;-1;0;534270524;534838017;5943548
908;1.18811e-14;-96;1754;25945;19979;1;709;-2.14748e+09;-1.56124e+07;0;0;0;0;0;0;535332841;535907663;6003828
908;4.26289e-15;-97;1587;9258;10117;1;575;-2.14748e+09;-1.56124e+07;-1;0;0;0;-1;0;535332841;535907663;6003828
909;1.18811e-14;-97;1754;25945;19979;1;709;-2.14748e+09;-1.554e+07;0;0;0;0;0;0;536391497;536973710;6064396
909;4.26289e-15;-97;1587;9258;10117;1;575;-2.14748e+09;-1.55399e+07;-1;0;0;0;-1;0;536391497;536973710;6064396
910;1.18811e-14;-97;1754;25945;19979;1;709;-2.14748e+09;-1.54679e+07;-1;0;0;0;-1;0;537446510;538036176;6125252
910;4.26289e-15;-97;1587;9258;10117;1;575;-2.14748e+09;-1.54679e+07;-1;0;0;0;-1;0;537446510;538036176;6125252
911;1.18811e-14;-98;1754;25945;19979;1;709;-2.14748e+09;-1.53966e+07;0;0;0;0;0;0;538497899;539095078;6186394
911;4.26289e-15;-98;1587;9258;10117;1;575;-2.14748e+09;-1.53966e+07;0;0;0;0;0;0;538497899;539095078;6186394
912;1.18811e-14;-99;1754;25945;19979;1;709;-2.14748e+09;-1.53256e+07;0;0;0;0;0;0;539545680;540150435;6247822
912;4.26289e-15;-98;1587;9258;10117;1;575;-2.14748e+09;-1.53256e+07;-1;0;0;0;-1;0;539545680;540150435;6247822
913;1.18811e-14;-99;1754;25945;19979;1;709;-2.14748e+09;-1.52553e+07;-1;0;0;0;-1;0;540589872;541202265;6309535
913;4.26289e-15;-98;1587;9258;10117;1;575;-2.14748e+09;-1.52553e+07;-1;0;0;0;-1;0;540589872;541202265;6309535
914;1.18811e-14;-100;1754;25945;19979;1;709;-2.14748e+09;-1.51855e+07;0;0;0;0;0;0;541630493;542250584;6371531
914;4.26289e-15;-98;1587;9258;10117;1;575;-2.14748e+09;-1.51855e+07;-1;0;0;0;-1;0;541630493;542250584;6371531
915;1.18811e-14;-100;1754;25945;19979;1;709;-2.14748e+09;-1.51162e+07;-1;0;0;0;-1;0;542667558;543295411;6433809
915;4.26289e-15;-98;1587;9258;10117;1;575;-2.14748e+09;-1.51162e+07;-1;0;0;0;-1;0;542667558;543295411;6433809
916;1.18811e-14;-101;1754;25945;19979;1;709;-2.14748e+09;-1.50476e+07;0;0;0;0;0;0;543701087;544336764;6496368
916;4.26289e-15;-99;1587;9258;10117;1;575;-2.14748e+09;-1.50475e+07;0;0;0;0;0;0;543701087;544336764;6496368
917;1.18811e-14;-102;1754;25945;19979;1;709;-2.14748e+09;-1.49792e+07;0;0;0;0;0;0;544731095;545374658;6559206
917;4.26289e-15;-99;1587;9258;10117;1;575;-2.14748e+09;-1.49792e+07;-1;0;0;0;-1;0;544731095;545374658;6559206
918;1.18811e-14;-103;1754;25945;19979;1;709;-2.14748e+09;-1.49115e+07;0;0;0;0;0;0;545757601;546409113;6622324
918;4.26289e-15;-99;1587;9258;10117;1;575;-2.14748e+09;-1.49115e+07;-1;0;0;0;-1;0;545757601;546409113;6622324
919;1.18811e-14;-104;1754;25945;19979;1;709;-2.14748e+09;-1.48444e+07;0;0;0;0;0;0;546780621;547440144;6685719
919;4.26289e-15;-100;1587;9258;10117;1;575;-2.14748e+09;-1.48444e+07;0;0;0;0;0;0;546780621;547440144;6685719
920;1.18811e-14;-104;1754;25945;19979;1;709;-2.14748e+09;-1.47776e+07;-1;0;0;0;-1;0;547800172;548467770;6749391
920;4.26289e-15;-100;1587;9258;10117;1;575;-2.14748e+09;-1.47776e+07;-1;0;0;0;-1;0;547800172;548467770;6749391
921;1.18811e-14;-104;1754;25945;19979;1;709;-2.14748e+09;-1.47114e+07;-1;0;0;0;-1;0;548816270;549492006;6813337
921;4.26289e-15;-101;1587;9258;10117;1;575;-2.14748e+09;-1.47114e+07;0;0;0;0;0;0;548816270;549492006;6813337
922;1.18811e-14;-105;1754;25945;19979;1;709;-2.14748e+09;-1.46456e+07;0;0;0;0;0;0;549828934;550512870;6877558
922;4.26289e-15;-101;1587;9258;10117;1;575;-2.14748e+09;-1.46456e+07;-1;0;0;0;-1;0;549828934;550512870;6877558
923;1.18811e-14;-105;1754;25945;19979;1;709;-2.14748e+09;-1.45803e+07;-1;0;0;0;-1;0;550838178;551530379;6942052
923;4.26289e-15;-102;1587;9258;10117;1;575;-2.14748e+09;-1.45803e+07;0;0;0;0;0;0;550838178;551530379;6942052
924;1.18811e-14;-105;1754;25945;19979;1;709;-2.14748e+09;-1.45157e+07;-1;0;0;0;-1;0;551844020;552544548;7006817
924;4.26289e-15;-102;1587;9258;10117;1;575;-2.14748e+09;-1.45157e+07;-1;0;0;0;-1;0;551844020;552544548;7006817
925;1.18811e-14;-105;1754;25945;19979;1;709;-2.14748e+09;-1.44514e+07;-1;0;0;0;-1;0;552846477;553555395;7071853
925;4.26289e-15;-102;1587;9258;10117;1;575;-2.14748e+09;-1.44513e+07;-1;0;0;0;-1;0;552846477;553555395;7071853
926;1.18811e-14;-105;1754;25945;19979;1;709;-2.14748e+09;-1.43875e+07;-1;0;0;0;-1;0;553845563;554562937;7137158
926;4.26289e-15;-103;1587;9258;10117;1;575;-2.14748e+09;-1.43875e+07;0;0;0;0;0;0;553845563;554562937;7137158
927;1.18811e-14;-105;1754;25945;19979;1;709;-2.14748e+09;-1.43241e+07;-1;0;0;0;-1;0;554841296;555567188;7202731
927;4.26289e-15;-104;1587;9258;10117;1;575;-2.14748e+09;-1.43241e+07;0;0;0;0;0;0;554841296;555567188;7202731
928;1.18811e-14;-106;1754;25945;19979;1;709;-2.14748e+09;-1.42612e+07;0;0;0;0;0;0;555833692;556568167;7268571
928;4.26289e-15;-105;1587;9258;10117;1;575;-2.14748e+09;-1.42612e+07;0;0;0;0;0;0;555833692;556568167;7268571
929;1.18811e-14;-106;1754;25945;19979;1;709;-2.14748e+09;-1.41988e+07;-1;0;0;0;-1;0;556822767;557565888;7334676
929;4.26289e-15;-106;1587;9258;10117;1;575;-2.14748e+09;-1.41987e+07;0;0;0;0;0;0;556822767;557565888;7334676
930;1.18811e-14;-106;1754;25945;19979;1;709;-2.14748e+09;-1.41368e+07;-1;0;0;0;-1;0;557808536;558560368;7401046
930;4.26289e-15;-107;1587;9258;10117;1;575;-2.14748e+09;-1.41367e+07;0;0;0;0;0;0;557808536;558560368;7401046
931;1.18811e-14;-107;1754;25945;19979;1;709;-2.14748e+09;-1.40753e+07;0;0;0;0;0;0;558791016;559551622;7467679
931;4.26289e-15;-107;1587;9258;10117;1;575;-2.14748e+09;-1.40752e+07;-1;0;0;0;-1;0;558791016;559551622;7467679
932;1.18811e-14;-108;1754;25945;19979;1;709;-2.14748e+09;-1.40141e+07;0;0;0;0;0;0;559770222;560539668;7534574
932;4.26289e-15;-108;1587;9258;10117;1;575;-2.14748e+09;-1.40141e+07;0;0;0;0;0;0;559770222;560539668;7534574
933;1.18811e-14;-109;1754;25945;19979;1;709;-2.14748e+09;-1.39534e+07;0;0;0;0;0;0;560746169;561524519;7601730
933;4.26289e-15;-109;1587;9258;10117;1;575;-2.14748e+09;-1.39534e+07;0;0;0;0;0;0;560746169;561524519;7601730
934;1.18811e-14;-109;1754;25945;19979;1;709;-2.14748e+09;-1.38931e+07;-1;0;0;0;-1;0;561718874;562506193;7669145
934;4.26289e-15;-109;1587;9258;10117;1;575;-2.14748e+09;-1.38931e+07;-1;0;0;0;-1;0;561718874;562506193;7669145
935;1.18811e-14;-109;1754;25945;19979;1;709;-2.14748e+09;-1.38333e+07;-1;0;0;0;-1;0;562688352;563484704;7736819
935;4.26289e-15;-109;1587;9258;10117;1;575;-2.14748e+09;-1.38333e+07;-1;0;0;0;-1;0;562688352;563484704;7736819
936;1.18811e-14;-109;1754;25945;19979;1;709;-2.14748e+09;-1.37739e+07;-1;0;0;0;-1;0;563654618;564460069;7804749
936;4.26289e-15;-109;1587;9258;10117;1;575;-2.14748e+09;-1.37739e+07;-1;0;0;0;-1;0;563654618;564460069;7804749
937;1.18811e-14;-109;1754;25945;19979;1;709;-2.14748e+09;-1.3715e+07;-1;0;0;0;-1;0;564617688;565432301;7872935
937;4.26289e-15;-110;1587;9258;10117;1;575;-2.14748e+09;-1.3715e+07;0;0;0;0;0;0;564617688;565432301;7872935
938;1.18811e-14;-110;1754;25945;19979;1;709;-2.14748e+09;-1.36565e+07;0;0;0;0;0;0;565577576;566401418;7941376
938;4.26289e-15;-110;1587;9258;10117;1;575;-2.14748e+09;-1.36565e+07;-1;0;0;0;-1;0;565577576;566401418;7941376
939;1.18811e-14;-111;1754;25945;19979;1;709;-2.14748e+09;-1.35983e+07;0;0;0;0;0;0;566534297;567367433;8010070
939;4.26289e-15;-110;1587;9258;10117;1;575;-2.14748e+09;-1.35983e+07;-1;0;0;0;-1;0;566534297;567367433;8010070
940;1.18811e-14;-111;1754;25945;19979;1;709;-2.14748e+09;-1.35406e+07;-1;0;0;0;-1;0;567487868;568330362;8079015
940;4.26289e-15;-111;1587;9258;10117;1;575;-2.14748e+09;-1.35406e+07;0;0;0;0;0;0;567487868;568330362;8079015
941;1.18811e-14;-111;1754;25945;19979;1;709;-2.14748e+09;-1.34832e+07;-1;0;0;0;-1;0;568438301;569290220;8148212
941;4.26289e-15;-112;1587;9258;10117;1;575;-2.14748e+09;-1.34831e+07;0;0;0;0;0;0;568438301;569290220;8148212
942;1.18811e-14;-111;1754;25945;19979;1;709;-2.14748e+09;-1.34262e+07;-1;0;0;0;-1;0;569385614;570247022;8217657
942;4.26289e-15;-113;1587;9258;10117;1;575;-2.14748e+09;-1.34262e+07;0;0;0;0;0;0;569385614;570247022;8217657
943;1.18811e-14;-112;1754;25945;19979;1;709;-2.14748e+09;-1.33696e+07;0;0;0;0;0;0;570329819;571200782;8287351
943;4.26289e-15;-114;1587;9258;10117;1;575;-2.14748e+09;-1.33696e+07;0;0;0;0;0;0;570329819;571200782;8287351
944;1.18811e-14;-112;1754;25945;19979;1;709;-2.14748e+09;-1.33134e+07;-1;0;0;0;-1;0;571270932;572151516;8357292
944;4.26289e-15;-115;1587;9258;10117;1;575;-2.14748e+09;-1.33134e+07;0;0;0;0;0;0;571270932;572151516;8357292
945;1.18811e-14;-113;1754;25945;19979;1;709;-2.14748e+09;-1.32578e+07;0;0;0;0;0;0;572208967;573099238;8427478
945;4.26289e-15;-115;1587;9258;10117;1;575;-2.14748e+09;-1.32578e+07;-1;0;0;0;-1;0;572208967;573099238;8427478
946;1.18811e-14;-113;1754;25945;19979;1;709;-2.14748e+09;-1.32023e+07;-1;0;0;0;-1;0;573143938;574043962;8497909
946;4.26289e-15;-115;1587;9258;10117;1;575;-2.14748e+09;-1.32023e+07;-1;0;0;0;-1;0;573143938;574043962;8497909
947;1.18811e-14;-113;1754;25945;19979;1;709;-2.14748e+09;-1.31474e+07;-1;0;0;0;-1;0;574075861;574985703;8568583
947;4.26289e-15;-116;1587;9258;10117;1;575;-2.14748e+09;-1.31474e+07;0;0;0;0;0;0;574075861;574985703;8568583
948;1.18811e-14;-114;1754;25945;19979;1;709;-2.14748e+09;-1.30926e+07;0;0;0;0;0;0;575004748;575924476;8639498
948;4.26289e-15;-117;1587;9258;10117;1;575;-2.14748e+09;-1.30926e+07;0;0;0;0;0;0;575004748;575924476;8639498
949;1.18811e-14;-115;1754;25945;19979;1;709;-2.14748e+09;-1.30385e+07;0;0;0;0;0;0;575930616;576860294;8710654
949;4.26289e-15;-118;1587;9258;10117;1;575;-2.14748e+09;-1.30384e+07;0;0;0;0;0;0;575930616;576860294;8710654
950;1.18811e-14;-115;1754;25945;19979;1;709;-2.14748e+09;-1.29845e+07;-1;0;0;0;-1;0;576853477;577793172;8782049
950;4.26289e-15;-119;1587;9258;10117;1;575;-2.14748e+09;-1.29845e+07;0;0;0;0;0;0;576853477;577793172;8782049
951;1.18811e-14;-116;1754;25945;19979;1;709;-2.14748e+09;-1.29309e+07;0;0;0;0;0;0;577773345;578723123;8853681
951;4.26289e-15;-119;1587;9258;10117;1;575;-2.14748e+09;-1.29309e+07;-1;0;0;0;-1;0;577773345;578723123;8853681
952;1.18811e-14;-116;1754;25945;19979;1;709;-2.14748e+09;-1.28777e+07;-1;0;0;0;-1;0;578690235;579650163;8925551
952;4.26289e-15;-120;1587;9258;10117;1;575;-2.14748e+09;-1.28777e+07;0;0;0;0;0;0;578690235;579650163;8925551
953;1.18811e-14;-117;1754;25945;19979;1;709;-2.14748e+09;-1.2825e+07;0;0;0;0;0;0;579604160;580574304;8997655
953;4.26289e-15;-121;1587;9258;10117;1;575;-2.14748e+09;-1.2825e+07;0;0;0;0;0;0;579604160;580574304;8997655
954;1.18811e-14;-118;1754;25945;19979;1;709;-2.14748e+09;-1.27725e+07;0;0;0;0;0;0;580515134;581495561;9069994
954;4.26289e-15;-121;1587;9258;10117;1;575;-2.14748e+09;-1.27725e+07;-1;0;0;0;-1;0;580515134;581495561;9069994
955;1.18811e-14;-118;1754;25945;19979;1;709;-2.14748e+09;-1.27204e+07;-1;0;0;0;-1;0;581423171;582413947;9142565
955;4.26289e-15;-122;1587;9258;10117;1;575;-2.14748e+09;-1.27204e+07;0;0;0;0;0;0;581423171;582413947;9142565
956;1.18811e-14;-118;1754;25945;19979;1;709;-2.14748e+09;-1.26686e+07;-1;0;0;0;-1;0;582328285;583329476;9215367
956;4.26289e-15;-123;1587;9258;10117;1;575;-2.14748e+09;-1.26686e+07;0;0;0;0;0;0;582328285;583329476;9215367
957;1.18811e-14;-118;1754;25945;19979;1;709;-2.14748e+09;-1.26172e+07;-1;0;0;0;-1;0;583230488;584242162;9288400
957;4.26289e-15;-124;1587;9258;10117;1;575;-2.14748e+09;-1.26172e+07;0;0;0;0;0;0;583230488;584242162;9288400
958;1.18811e-14;-119;1754;25945;19979;1;709;-2.14748e+09;-1.25661e+07;0;0;0;0;0;0;584129794;585152017;9361661
958;4.26289e-15;-125;1587;9258;10117;1;575;-2.14748e+09;-1.25661e+07;0;0;0;0;0;0;584129794;585152017;9361661
959;1.18811e-14;-119;1754;25945;19979;1;709;-2.14748e+09;-1.25153e+07;-1;0;0;0;-1;0;585026217;586059057;9435149
959;4.26289e-15;-126;1587;9258;10117;1;575;-2.14748e+09;-1.25153e+07;0;0;0;0;0;0;585026217;586059057;9435149
960;1.18811e-14;-119;1754;25945;19979;1;709;-2.14748e+09;-1.24649e+07;-1;0;0;0;-1;0;585919770;586963293;9508864
960;4.26289e-15;-126;1587;9258;10117;1;575;-2.14748e+09;-1.24649e+07;-1;0;0;0;-1;0;585919770;586963293;9508864
961;1.18811e-14;-120;1754;25945;19979;1;709;-2.14748e+09;-1.24149e+07;0;0;0;0;0;0;586810467;587864739;9582804
961;4.26289e-15;-126;1587;9258;10117;1;575;-2.14748e+09;-1.24149e+07;-1;0;0;0;-1;0;586810467;587864739;9582804
962;1.18811e-14;-121;1754;25945;19979;1;709;-2.14748e+09;-1.23652e+07;0;0;0;0;0;0;587698319;588763408;9656967
962;4.26289e-15;-126;1587;9258;10117;1;575;-2.14748e+09;-1.23652e+07;-1;0;0;0;-1;0;587698319;588763408;9656967
963;1.18811e-14;-121;1754;25945;19979;1;709;-2.14748e+09;-1.23157e+07;-1;0;0;0;-1;0;588583340;589659314;9731352
963;4.26289e-15;-127;1587;9258;10117;1;575;-2.14748e+09;-1.23157e+07;0;0;0;0;0;0;588583340;589659314;9731352
964;1.18811e-14;-122;1754;25945;19979;1;709;-2.14748e+09;-1.22665e+07;0;0;0;0;0;0;589465544;590552469;9805958
964;4.26289e-15;-127;1587;9258;10117;1;575;-2.14748e+09;-1.22665e+07;-1;0;0;0;-1;0;589465544;590552469;9805958
965;1.18811e-14;-123;1754;25945;19979;1;709;-2.14748e+09;-1.22179e+07;0;0;0;0;0;0;590344943;591442886;9880784
965;4.26289e-15;-128;1587;9258;10117;1;575;-2.14748e+09;-1.22179e+07;0;0;0;0;0;0;590344943;591442886;9880784
966;1.18811e-14;-124;1754;25945;19979;1;709;-2.14748e+09;-1.21693e+07;0;0;0;0;0;0;591221549;592330578;9955828
966;4.26289e-15;-129;1587;9258;10117;1;575;-2.14748e+09;-1.21693e+07;0;0;0;0;0;0;591221549;592330578;9955828
967;1.18811e-14;-125;1754;25945;19979;1;709;-2.14748e+09;-1.21212e+07;0;0;0;0;0;0;592095376;593215558;10031088
967;4.26289e-15;-129;1587;9258;10117;1;575;-2.14748e+09;-1.21212e+07;-1;0;0;0;-1;0;592095376;593215558;10031088
968;1.18811e-14;-126;1754;25945;19979;1;709;-2.14748e+09;-1.20733e+07;0;0;0;0;0;0;592966436;594097838;10106565
968;4.26289e-15;-130;1587;9258;10117;1;575;-2.14748e+09;-1.20733e+07;0;0;0;0;0;0;592966436;594097838;10106565
969;1.18811e-14;-127;1754;25945;19979;1;709;-2.14748e+09;-1.20257e+07;0;0;0;0;0;0;593834742;594977432;10182256
969;4.26289e-15;-131;1587;9258;10117;1;575;-2.14748e+09;-1.20257e+07;0;0;0;0;0;0;593834742;594977432;10182256
970;1.18811e-14;-127;1754;25945;19979;1;709;-2.14748e+09;-1.19785e+07;-1;0;0;0;-1;0;594700306;595854351;10258159
970;4.26289e-15;-131;1587;9258;10117;1;575;-2.14748e+09;-1.19785e+07;-1;0;0;0;-1;0;594700306;595854351;10258159
971;1.18811e-14;-127;1754;25945;19979;1;709;-2.14748e+09;-1.19316e+07;-1;0;0;0;-1;0;595563141;596728608;10334275
971;4.26289e-15;-132;1587;9258;10117;1;575;-2.14748e+09;-1.19316e+07;0;0;0;0;0;0;595563141;596728608;10334275
972;1.18811e-14;-127;1754;25945;19979;1;709;-2.14748e+09;-1.1885e+07;-1;0;0;0;-1;0;596423258;597600216;10410600
972;4.26289e-15;-133;1587;9258;10117;1;575;-2.14748e+09;-1.18849e+07;0;0;0;0;0;0;596423258;597600216;10410600
973;1.18811e-14;-128;1754;25945;19979;1;709;-2.14748e+09;-1.18386e+07;0;0;0;0;0;0;597280671;598469187;10487135
973;4.26289e-15;-134;1587;9258;10117;1;575;-2.14748e+09;-1.18386e+07;0;0;0;0;0;0;597280671;598469187;10487135
974;1.18811e-14;-128;1754;25945;19979;1;709;-2.14748e+09;-1.17925e+07;-1;0;0;0;-1;0;598135391;599335532;10563878
974;4.26289e-15;-134;1587;9258;10117;1;575;-2.14748e+09;-1.17925e+07;-1;0;0;0;-1;0;598135391;599335532;10563878
975;1.18811e-14;-128;1754;25945;19979;1;709;-2.14748e+09;-1.17468e+07;-1;0;0;0;-1;0;598987431;600199265;10640827
975;4.26289e-15;-135;1587;9258;10117;1;575;-2.14748e+09;-1.17468e+07;0;0;0;0;0;0;598987431;600199265;10640827
976;1.18811e-14;-128;1754;25945;19979;1;709;-2.14748e+09;-1.17013e+07;-1;0;0;0;-1;0;599836802;601060396;10717981
976;4.26289e-15;-136;1587;9258;10117;1;575;-2.14748e+09;-1.17013e+07;0;0;0;0;0;0;599836802;601060396;10717981
977;1.18811e-14;-129;1754;25945;19979;1;709;-2.14748e+09;-1.16562e+07;0;0;0;0;0;0;600683517;601918939;10795338
977;4.26289e-15;-136;1587;9258;10117;1;575;-2.14748e+09;-1.16561e+07;-1;0;0;0;-1;0;600683517;601918939;10795338
978;1.18811e-14;-130;1754;25945;19979;1;709;-2.14748e+09;-1.16112e+07;0;0;0;0;0;0;601527587;602774905;10872898
978;4.26289e-15;-136;1587;9258;10117;1;575;-2.14748e+09;-1.16112e+07;-1;0;0;0;-1;0;601527587;602774905;10872898
979;1.18811e-14;-131;1754;25945;19979;1;709;-2.14748e+09;-1.15667e+07;0;0;0;0;0;0;602369025;603628306;10950660
979;4.26289e-15;-137;1587;9258;10117;1;575;-2.14748e+09;-1.15667e+07;0;0;0;0;0;0;602369025;603628306;10950660
980;1.18811e-14;-131;1754;25945;19979;1;709;-2.14748e+09;-1.15224e+07;-1;0;0;0;-1;0;603207841;604479154;11028621
980;4.26289e-15;-137;1587;9258;10117;1;575;-2.14748e+09;-1.15224e+07;-1;0;0;0;-1;0;603207841;604479154;11028621
981;1.18811e-14;-132;1754;25945;19979;1;709;-2.14748e+09;-1.14782e+07;0;0;0;0;0;0;604044048;605327460;11106781
981;4.26289e-15;-137;1587;9258;10117;1;575;-2.14748e+09;-1.14782e+07;-1;0;0;0;-1;0;604044048;605327460;11106781
982;1.18811e-14;-132;1754;25945;19979;1;709;-2.14748e+09;-1.14344e+07;-1;0;0;0;-1;0;604877658;606173237;11185138
982;4.26289e-15;-138;1587;9258;10117;1;575;-2.14748e+09;-1.14344e+07;0;0;0;0;0;0;604877658;606173237;11185138
983;1.18811e-14;-132;1754;25945;19979;1;709;-2.14748e+09;-1.13909e+07;-1;0;0;0;-1;0;605708681;607016495;11263690
983;4.26289e-15;-139;1587;9258;10117;1;575;-2.14748e+09;-1.13909e+07;0;0;0;0;0;0;605708681;607016495;11263690
984;1.18811e-14;-133;1754;25945;19979;1;709;-2.14748e+09;-1.13477e+07;0;0;0;0;0;0;606537130;607857246;11342438
984;4.26289e-15;-140;1587;9258;10117;1;575;-2.14748e+09;-1.13477e+07;0;0;0;0;0;0;606537130;607857246;11342438
985;1.18811e-14;-133;1754;25945;19979;1;709;-2.14748e+09;-1.13047e+07;-1;0;0;0;-1;0;607363015;608695501;11421378
985;4.26289e-15;-141;1587;9258;10117;1;575;-2.14748e+09;-1.13047e+07;0;0;0;0;0;0;607363015;608695501;11421378
986;1.18811e-14;-134;1754;25945;19979;1;709;-2.14748e+09;-1.1262e+07;0;0;0;0;0;0;608186348;609531273;11500511
986;4.26289e-15;-142;1587;9258;10117;1;575;-2.14748e+09;-1.1262e+07;0;0;0;0;0;0;608186348;609531273;11500511
987;1.18811e-14;-134;1754;25945;19979;1;709;-2.14748e+09;-1.12194e+07;-1;0;0;0;-1;0;609007140;610364571;11579834
987;4.26289e-15;-143;1587;9258;10117;1;575;-2.14748e+09;-1.12194e+07;0;0;0;0;0;0;609007140;610364571;11579834
988;1.18811e-14;-135;1754;25945;19979;1;709;-2.14748e+09;-1.11773e+07;0;0;0;0;0;0;609825403;611195408;11659347
988;4.26289e-15;-143;1587;9258;10117;1;575;-2.14748e+09;-1.11773e+07;-1;0;0;0;-1;0;609825403;611195408;11659347
989;1.18811e-14;-135;1754;25945;19979;1;709;-2.14748e+09;-1.11353e+07;-1;0;0;0;-1;0;610641148;612023795;11739047
989;4.26289e-15;-144;1587;9258;10117;1;575;-2.14748e+09;-1.11352e+07;0;0;0;0;0;0;610641148;612023795;11739047
990;1.18811e-14;-135;1754;25945;19979;1;709;-2.14748e+09;-1.10935e+07;-1;0;0;0;-1;0;611454385;612849742;11818935
990;4.26289e-15;-144;1587;9258;10117;1;575;-2.14748e+09;-1.10935e+07;-1;0;0;0;-1;0;611454385;612849742;11818935
991;1.18811e-14;-135;1754;25945;19979;1;709;-2.14748e+09;-1.10521e+07;-1;0;0;0;-1;0;612265126;613673261;11899008
991;4.26289e-15;-144;1587;9258;10117;1;575;-2.14748e+09;-1.10521e+07;-1;0;0;0;-1;0;612265126;613673261;11899008
992;1.18811e-14;-135;1754;25945;19979;1;709;-2.14748e+09;-1.10109e+07;-1;0;0;0;-1;0;613073382;614494362;11979265
992;4.26289e-15;-144;1587;9258;10117;1;575;-2.14748e+09;-1.10109e+07;-1;0;0;0;-1;0;613073382;614494362;11979265
993;1.18811e-14;-135;1754;25945;19979;1;709;-2.14748e+09;-1.09699e+07;-1;0;0;0;-1;0;613879163;615313057;12059704
993;4.26289e-15;-144;1587;9258;10117;1;575;-2.14748e+09;-1.09699e+07;-1;0;0;0;-1;0;613879163;615313057;12059704
994;1.18811e-14;-135;1754;25945;19979;1;709;-2.14748e+09;-1.09293e+07;-1;0;0;0;-1;0;614682481;616129356;12140326
994;4.26289e-15;-145;1587;9258;10117;1;575;-2.14748e+09;-1.09293e+07;0;0;0;0;0;0;614682481;616129356;12140326
995;1.18811e-14;-135;1754;25945;19979;1;709;-2.14748e+09;-1.08889e+07;-1;0;0;0;-1;0;615483345;616943270;12221127
995;4.26289e-15;-145;1587;9258;10117;1;575;-2.14748e+09;-1.08889e+07;-1;0;0;0;-1;0;615483345;616943270;12221127
996;1.18811e-14;-135;1754;25945;19979;1;709;-2.14748e+09;-1.08486e+07;-1;0;0;0;-1;0;616281768;617754809;12302108
996;4.26289e-15;-146;1587;9258;10117;1;575;-2.14748e+09;-1.08486e+07;0;0;0;0;0;0;616281768;617754809;12302108
997;1.18811e-14;-135;1754;25945;19979;1;709;-2.14748e+09;-1.08086e+07;-1;0;0;0;-1;0;617077758;618563985;12383266
997;4.26289e-15;-147;1587;9258;10117;1;575;-2.14748e+09;-1.08086e+07;0;0;0;0;0;0;617077758;618563985;12383266
998;1.18811e-14;-136;1754;25945;19979;1;709;-2.14748e+09;-1.07688e+07;0;0;0;0;0;0;617871328;619370807;12464600
998;4.26289e-15;-147;1587;9258;10117;1;575;-2.14748e+09;-1.07688e+07;-1;0;0;0;-1;0;617871328;619370807;12464600
999;1.18811e-14;-136;1754;25945;19979;1;709;-2.14748e+09;-1.07293e+07;-1;0;0;0;-1;0;618662487;620175287;12546110
999;4.26289e-15;-148;1587;9258;10117;1;575;-2.14748e+09;-1.07293e+07;0;0;0;0;0;0;618662487;620175287;12546110
1000;1.18811e-14;-136;1754;25945;19979;1;709;-2.14748e+09;-1.069e+07;-1;0;0;0;-1;0;619451246;620977435;12627793
1000;4.26289e-15;-148;1587;9258;10117;1;575;-2.14748e+09;-1.069e+07;-1;0;0;0;-1;0;619451246;620977435;12627793
1001;1.18811e-14;-136;1754;25945;19979;1;709;-2.14748e+09;-1.06511e+07;-1;0;0;0;-1;0;620237615;621777261;12709649
1001;4.26289e-15;-148;1587;9258;10117;1;575;-2.14748e+09;-1.06511e+07;-1;0;0;0;-1;0;620237615;621777261;12709649
1002;1.18811e-14;-137;1754;25945;19979;1;709;-2.14748e+09;-1.06123e+07;0;0;0;0;0;0;621021604;622574775;12791676
1002;4.26289e-15;-148;1587;9258;10117;1;575;-2.14748e+09;-1.06123e+07;-1;0;0;0;-1;0;621021604;622574775;12791676
1003;1.18811e-14;-138;1754;25945;19979;1;709;-2.14748e+09;-1.05736e+07;0;0;0;0;0;0;621803225;623369987;12873873
1003;4.26289e-15;-149;1587;9258;10117;1;575;-2.14748e+09;-1.05736e+07;0;0;0;0;0;0;621803225;623369987;12873873
1004;1.18811e-14;-139;1754;25945;19979;1;709;-2.14748e+09;-1.05353e+07;0;0;0;0;0;0;622582486;624162908;12956239
1004;4.26289e-15;-149;1587;9258;10117;1;575;-2.14748e+09;-1.05353e+07;-1;0;0;0;-1;0;622582486;624162908;12956239
1005;1.18811e-14;-139;1754;25945;19979;1;709;-2.14748e+09;-1.04971e+07;-1;0;0;0;-1;0;623359398;624953549;13038772
1005;4.26289e-15;-149;1587;9258;10117;1;575;-2.14748e+09;-1.04971e+07;-1;0;0;0;-1;0;623359398;624953549;13038772
1006;1.18811e-14;-140;1754;25945;19979;1;709;-2.14748e+09;-1.04593e+07;0;0;0;0;0;0;624133972;625741918;13121471
1006;4.26289e-15;-149;1587;9258;10117;1;575;-2.14748e+09;-1.04593e+07;-1;0;0;0;-1;0;624133972;625741918;13121471
1007;1.18811e-14;-141;1754;25945;19979;1;709;-2.14748e+09;-1.04215e+07;0;0;0;0;0;0;624906216;626528025;13204334
1007;4.26289e-15;-150;1587;9258;10117;1;575;-2.14748e+09;-1.04215e+07;0;0;0;0;0;0;624906216;626528025;13204334
1008;1.18811e-14;-142;1754;25945;19979;1;709;-2.14748e+09;-1.0384e+07;0;0;0;0;0;0;625676142;627311882;13287362
1008;4.26289e-15;-150;1587;9258;10117;1;575;-2.14748e+09;-1.0384e+07;-1;0;0;0;-1;0;625676142;627311882;13287362
1009;1.18811e-14;-143;1754;25945;19979;1;709;-2.14748e+09;-1.03467e+07;0;0;0;0;0;0;626443759;628093498;13370552
1009;4.26289e-15;-151;1587;9258;10117;1;575;-2.14748e+09;-1.03467e+07;0;0;0;0;0;0;626443759;628093498;13370552
1010;1.18811e-14;-143;1754;25945;19979;1;709;-2.14748e+09;-1.03097e+07;-1;0;0;0;-1;0;627209076;628872882;13453902
1010;4.26289e-15;-152;1587;9258;10117;1;575;-2.14748e+09;-1.03097e+07;0;0;0;0;0;0;627209076;628872882;13453902
1011;1.18811e-14;-143;1754;25945;19979;1;709;-2.14748e+09;-1.02729e+07;-1;0;0;0;-1;0;627972104;629650044;13537413
1011;4.26289e-15;-152;1587;9258;10117;1;575;-2.14748e+09;-1.02728e+07;-1;0;0;0;-1;0;627972104;629650044;13537413
1012;1.18811e-14;-143;1754;25945;19979;1;709;-2.14748e+09;-1.02363e+07;-1;0;0;0;-1;0;628732853;630424994;13621081
1012;4.26289e-15;-152;1587;9258;10117;1;575;-2.14748e+09;-1.02362e+07;-1;0;0;0;-1;0;628732853;630424994;13621081
1013;1.18811e-14;-143;1754;25945;19979;1;709;-2.14748e+09;-1.01998e+07;-1;0;0;0;-1;0;629491331;631197741;13704908
1013;4.26289e-15;-153;1587;9258;10117;1;575;-2.14748e+09;-1.01998e+07;0;0;0;0;0;0;629491331;631197741;13704908
1014;1.18811e-14;-143;1754;25945;19979;1;709;-2.14748e+09;-1.01636e+07;-1;0;0;0;-1;0;630247549;631968296;13788890
1014;4.26289e-15;-153;1587;9258;10117;1;575;-2.14748e+09;-1.01636e+07;-1;0;0;0;-1;0;630247549;631968296;13788890
1015;1.18811e-14;-143;1754;25945;19979;1;709;-2.14748e+09;-1.01276e+07;-1;0;0;0;-1;0;631001516;632736667;13873026
1015;4.26289e-15;-153;1587;9258;10117;1;575;-2.14748e+09;-1.01275e+07;-1;0;0;0;-1;0;631001516;632736667;13873026
1016;1.18811e-14;-144;1754;25945;19979;1;709;-2.14748e+09;-1.00918e+07;0;0;0;0;0;0;631753242;633502865;13957316
1016;4.26289e-15;-153;1587;9258;10117;1;575;-2.14748e+09;-1.00918e+07;-1;0;0;0;-1;0;631753242;633502865;13957316
1017;1.18811e-14;-145;1754;25945;19979;1;709;-2.14748e+09;-1.00561e+07;0;0;0;0;0;0;632502735;634266897;14041759
1017;4.26289e-15;-154;1587;9258;10117;1;575;-2.14748e+09;-1.00561e+07;0;0;0;0;0;0;632502735;634266897;14041759
1018;1.18811e-14;-145;1754;25945;19979;1;709;-2.14748e+09;-1.00207e+07;-1;0;0;0;-1;0;633250006;635028775;14126352
1018;4.26289e-15;-155;1587;9258;10117;1;575;-2.14748e+09;-1.00207e+07;0;0;0;0;0;0;633250006;635028775;14126352
1019;1.18811e-14;-145;1754;25945;19979;1;709;-2.14748e+09;-9.98552e+06;-1;0;0;0;-1;0;633995064;635788507;14211095
1019;4.26289e-15;-155;1587;9258;10117;1;575;-2.14748e+09;-9.98552e+06;-1;0;0;0;-1;0;633995064;635788507;14211095
1020;1.18811e-14;-145;1754;25945;19979;1;709;-2.14748e+09;-9.95061e+06;-1;0;0;0;-1;0;634737918;636546102;14295987
1020;4.26289e-15;-156;1587;9258;10117;1;575;-2.14748e+09;-9.95061e+06;0;0;0;0;0;0;634737918;636546102;14295987
1021;1.18811e-14;-146;1754;25945;19979;1;709;-2.14748e+09;-9.9158e+06;0;0;0;0;0;0;635478577;637301570;14381025
1021;4.26289e-15;-156;1587;9258;10117;1;575;-2.14748e+09;-9.9158e+06;-1;0;0;0;-1;0;635478577;637301570;14381025
1022;1.18811e-14;-146;1754;25945;19979;1;709;-2.14748e+09;-9.88108e+06;-1;0;0;0;-1;0;636217051;638054919;14466210
1022;4.26289e-15;-156;1587;9258;10117;1;575;-2.14748e+09;-9.88108e+06;-1;0;0;0;-1;0;636217051;638054919;14466210
1023;1.18811e-14;-146;1754;25945;19979;1;709;-2.14748e+09;-9.84676e+06;-1;0;0;0;-1;0;636953348;638806159;14551539
1023;4.26289e-15;-157;1587;9258;10117;1;575;-2.14748e+09;-9.84676e+06;0;0;0;0;0;0;636953348;638806159;14551539
1024;1.18811e-14;-147;1754;25945;19979;1;709;-2.14748e+09;-9.81242e+06;0;0;0;0;0;0;637687478;639555299;14637012
1024;4.26289e-15;-157;1587;9258;10117;1;575;-2.14748e+09;-9.81242e+06;-1;0;0;0;-1;0;637687478;639555299;14637012
1025;1.18811e-14;-148;1754;25945;19979;1;709;-2.14748e+09;-9.77848e+06;0;0;0;0;0;0;638419449;640302347;14722628
1025;4.26289e-15;-158;1587;9258;10117;1;575;-2.14748e+09;-9.77848e+06;0;0;0;0;0;0;638419449;640302347;14722628
1026;1.18811e-14;-148;1754;25945;19979;1;709;-2.14748e+09;-9.74452e+06;-1;0;0;0;-1;0;639149271;641047313;14808384
1026;4.26289e-15;-159;1587;9258;10117;1;575;-2.14748e+09;-9.74452e+06;0;0;0;0;0;0;639149271;641047313;14808384
1027;1.18811e-14;-149;1754;25945;19979;1;709;-2.14748e+09;-9.71095e+06;0;0;0;0;0;0;639876953;641790205;14894280
1027;4.26289e-15;-160;1587;9258;10117;1;575;-2.14748e+09;-9.71095e+06;0;0;0;0;0;0;639876953;641790205;14894280
1028;1.18811e-14;-150;1754;25945;19979;1;709;-2.14748e+09;-9.67746e+06;0;0;0;0;0;0;640602503;642531033;14980315
1028;4.26289e-15;-160;1587;9258;10117;1;575;-2.14748e+09;-9.67746e+06;-1;0;0;0;-1;0;640602503;642531033;14980315
1029;1.18811e-14;-151;1754;25945;19979;1;709;-2.14748e+09;-9.64406e+06;0;0;0;0;0;0;641325930;643269805;15066487
1029;4.26289e-15;-161;1587;9258;10117;1;575;-2.14748e+09;-9.64406e+06;0;0;0;0;0;0;641325930;643269805;15066487
1030;1.18811e-14;-152;1754;25945;19979;1;709;-2.14748e+09;-9.61094e+06;0;0;0;0;0;0;642047243;644006529;15152796
1030;4.26289e-15;-162;1587;9258;10117;1;575;-2.14748e+09;-9.61094e+06;0;0;0;0;0;0;642047243;644006529;15152796
1031;1.18811e-14;-153;1754;25945;19979;1;709;-2.14748e+09;-9.578e+06;0;0;0;0;0;0;642766450;644741215;15239239
1031;4.26289e-15;-163;1587;9258;10117;1;575;-2.14748e+09;-9.578e+06;0;0;0;0;0;0;642766450;644741215;15239239
1032;1.18811e-14;-154;1754;25945;19979;1;709;-2.14748e+09;-9.54524e+06;0;0;0;0;0;0;643483561;645473871;15325816
1032;4.26289e-15;-163;1587;9258;10117;1;575;-2.14748e+09;-9.54524e+06;-1;0;0;0;-1;0;643483561;645473871;15325816
1033;1.18811e-14;-155;1754;25945;19979;1;709;-2.14748e+09;-9.51266e+06;0;0;0;0;0;0;644198584;646204505;15412526
1033;4.26289e-15;-163;1587;9258;10117;1;575;-2.14748e+09;-9.51266e+06;-1;0;0;0;-1;0;644198584;646204505;15412526
1034;1.18811e-14;-156;1754;25945;19979;1;709;-2.14748e+09;-9.48025e+06;0;0;0;0;0;0;644911527;646933126;15499367
1034;4.26289e-15;-164;1587;9258;10117;1;575;-2.14748e+09;-9.48025e+06;0;0;0;0;0;0;644911527;646933126;15499367
1035;1.18811e-14;-157;1754;25945;19979;1;709;-2.14748e+09;-9.44802e+06;0;0;0;0;0;0;645622399;647659743;15586339
1035;4.26289e-15;-164;1587;9258;10117;1;575;-2.14748e+09;-9.44802e+06;-1;0;0;0;-1;0;645622399;647659743;15586339
1036;1.18811e-14;-158;1754;25945;19979;1;709;-2.14748e+09;-9.41606e+06;0;0;0;0;0;0;646331209;648384363;15673439
1036;4.26289e-15;-165;1587;9258;10117;1;575;-2.14748e+09;-9.41596e+06;0;0;0;0;0;0;646331209;648384363;15673439
1037;1.18811e-14;-158;1754;25945;19979;1;709;-2.14748e+09;-9.38407e+06;-1;0;0;0;-1;0;647037964;649106996;15760667
1037;4.26289e-15;-166;1587;9258;10117;1;575;-2.14748e+09;-9.38407e+06;0;0;0;0;0;0;647037964;649106996;15760667
1038;1.18811e-14;-159;1754;25945;19979;1;709;-2.14748e+09;-9.35236e+06;0;0;0;0;0;0;647742674;649827649;15848022
1038;4.26289e-15;-167;1587;9258;10117;1;575;-2.14748e+09;-9.35236e+06;0;0;0;0;0;0;647742674;649827649;15848022
1039;1.18811e-14;-160;1754;25945;19979;1;709;-2.14748e+09;-9.32091e+06;0;0;0;0;0;0;648445346;650546331;15935502
1039;4.26289e-15;-168;1587;9258;10117;1;575;-2.14748e+09;-9.32091e+06;0;0;0;0;0;0;648445346;650546331;15935502
1040;1.18811e-14;-161;1754;25945;19979;1;709;-2.14748e+09;-9.28943e+06;0;0;0;0;0;0;649145989;651263049;16023107
1040;4.26289e-15;-168;1587;9258;10117;1;575;-2.14748e+09;-9.28943e+06;-1;0;0;0;-1;0;649145989;651263049;16023107
1041;1.18811e-14;-162;1754;25945;19979;1;709;-2.14748e+09;-9.25832e+06;0;0;0;0;0;0;649844611;651977813;16110834
1041;4.26289e-15;-168;1587;9258;10117;1;575;-2.14748e+09;-9.25832e+06;-1;0;0;0;-1;0;649844611;651977813;16110834
1042;1.18811e-14;-163;1754;25945;19979;1;709;-2.14748e+09;-9.22718e+06;0;0;0;0;0;0;650541220;652690630;16198683
1042;4.26289e-15;-169;1587;9258;10117;1;575;-2.14748e+09;-9.22718e+06;0;0;0;0;0;0;650541220;652690630;16198683
1043;1.18811e-14;-163;1754;25945;19979;1;709;-2.14748e+09;-9.1963e+06;-1;0;0;0;-1;0;651235824;653401508;16286654
1043;4.26289e-15;-170;1587;9258;10117;1;575;-2.14748e+09;-9.1963e+06;0;0;0;0;0;0;651235824;653401508;16286654
1044;1.18811e-14;-163;1754;25945;19979;1;709;-2.14748e+09;-9.16568e+06;-1;0;0;0;-1;0;651928432;654110456;16374743
1044;4.26289e-15;-170;1587;9258;10117;1;575;-2.14748e+09;-9.16558e+06;-1;0;0;0;-1;0;651928432;654110456;16374743
1045;1.18811e-14;-164;1754;25945;19979;1;709;-2.14748e+09;-9.13502e+06;0;0;0;0;0;0;652619051;654817480;16462951
1045;4.26289e-15;-171;1587;9258;10117;1;575;-2.14748e+09;-9.13502e+06;0;0;0;0;0;0;652619051;654817480;16462951
1046;1.18811e-14;-165;1754;25945;19979;1;709;-2.14748e+09;-9.10463e+06;0;0;0;0;0;0;653307690;655522590;16551277
1046;4.26289e-15;-172;1587;9258;10117;1;575;-2.14748e+09;-9.10463e+06;0;0;0;0;0;0;653307690;655522590;16551277
1047;1.18811e-14;-165;1754;25945;19979;1;709;-2.14748e+09;-9.07449e+06;-1;0;0;0;-1;0;653994356;656225793;16639718
1047;4.26289e-15;-172;1587;9258;10117;1;575;-2.14748e+09;-9.07439e+06;-1;0;0;0;-1;0;653994356;656225793;16639718
1048;1.18811e-14;-166;1754;25945;19979;1;709;-2.14748e+09;-9.04431e+06;0;0;0;0;0;0;654679058;656927096;16728275
1048;4.26289e-15;-172;1587;9258;10117;1;575;-2.14748e+09;-9.04431e+06;-1;0;0;0;-1;0;654679058;656927096;16728275
1049;1.18811e-14;-166;1754;25945;19979;1;709;-2.14748e+09;-9.01439e+06;-1;0;0;0;-1;0;655361803;657626508;16816945
1049;4.26289e-15;-172;1587;9258;10117;1;575;-2.14748e+09;-9.01439e+06;-1;0;0;0;-1;0;655361803;657626508;16816945
1050;1.18811e-14;-166;1754;25945;19979;1;709;-2.14748e+09;-8.98462e+06;-1;0;0;0;-1;0;656042598;658324037;16905728
1050;4.26289e-15;-172;1587;9258;10117;1;575;-2.14748e+09;-8.98462e+06;-1;0;0;0;-1;0;656042598;658324037;16905728
1051;1.18811e-14;-167;1754;25945;19979;1;709;-2.14748e+09;-8.95511e+06;0;0;0;0;0;0;656721453;659019689;16994622
1051;4.26289e-15;-172;1587;9258;10117;1;575;-2.14748e+09;-8.95501e+06;-1;0;0;0;-1;0;656721453;659019689;16994622
1052;1.18811e-14;-167;1754;25945;19979;1;709;-2.14748e+09;-8.92556e+06;-1;0;0;0;-1;0;657398374;659713473;17083627
1052;4.26289e-15;-173;1587;9258;10117;1;575;-2.14748e+09;-8.92556e+06;0;0;0;0;0;0;657398374;659713473;17083627
1053;1.18811e-14;-167;1754;25945;19979;1;709;-2.14748e+09;-8.89625e+06;-1;0;0;0;-1;0;658073369;660405397;17172740
1053;4.26289e-15;-174;1587;9258;10117;1;575;-2.14748e+09;-8.89625e+06;0;0;0;0;0;0;658073369;660405397;17172740
1054;1.18811e-14;-168;1754;25945;19979;1;709;-2.14748e+09;-8.8671e+06;0;0;0;0;0;0;658746446;661095467;17261962
1054;4.26289e-15;-175;1587;9258;10117;1;575;-2.14748e+09;-8.8671e+06;0;0;0;0;0;0;658746446;661095467;17261962
1055;1.18811e-14;-168;1754;25945;19979;1;709;-2.14748e+09;-8.83809e+06;-1;0;0;0;-1;0;659417613;661783692;17351291
1055;4.26289e-15;-175;1587;9258;10117;1;575;-2.14748e+09;-8.83809e+06;-1;0;0;0;-1;0;659417613;661783692;17351291
1056;1.18811e-14;-168;1754;25945;19979;1;709;-2.14748e+09;-8.80934e+06;-1;0;0;0;-1;0;660086876;662470078;17440726
1056;4.26289e-15;-175;1587;9258;10117;1;575;-2.14748e+09;-8.80934e+06;-1;0;0;0;-1;0;660086876;662470078;17440726
1057;1.18811e-14;-168;1754;25945;19979;1;709;-2.14748e+09;-8.78053e+06;-1;0;0;0;-1;0;660754244;663154634;17530266
1057;4.26289e-15;-175;1587;9258;10117;1;575;-2.14748e+09;-8.78053e+06;-1;0;0;0;-1;0;660754244;663154634;17530266
1058;1.18811e-14;-169;1754;25945;19979;1;709;-2.14748e+09;-8.75197e+06;0;0;0;0;0;0;661419724;663837366;17619909
1058;4.26289e-15;-176;1587;9258;10117;1;575;-2.14748e+09;-8.75197e+06;0;0;0;0;0;0;661419724;663837366;17619909
1059;1.18811e-14;-170;1754;25945;19979;1;709;-2.14748e+09;-8.72355e+06;0;0;0;0;0;0;662083324;664518282;17709654
1059;4.26289e-15;-177;1587;9258;10117;1;575;-2.14748e+09;-8.72355e+06;0;0;0;0;0;0;662083324;664518282;17709654
1060;1.18811e-14;-170;1754;25945;19979;1;709;-2.14748e+09;-8.69538e+06;-1;0;0;0;-1;0;662745050;665197389;17799501
1060;4.26289e-15;-178;1587;9258;10117;1;575;-2.14748e+09;-8.69538e+06;0;0;0;0;0;0;662745050;665197389;17799501
1061;1.18811e-14;-171;1754;25945;19979;1;709;-2.14748e+09;-8.66725e+06;0;0;0;0;0;0;663404911;665874696;17889449
1061;4.26289e-15;-178;1587;9258;10117;1;575;-2.14748e+09;-8.66715e+06;-1;0;0;0;-1;0;663404911;665874696;17889449
1062;1.18811e-14;-171;1754;25945;19979;1;709;-2.14748e+09;-8.63927e+06;-1;0;0;0;-1;0;664062913;666550207;17979495
1062;4.26289e-15;-179;1587;9258;10117;1;575;-2.14748e+09;-8.63917e+06;0;0;0;0;0;0;664062913;666550207;17979495
1063;1.18811e-14;-171;1754;25945;19979;1;709;-2.14748e+09;-8.61132e+06;-1;0;0;0;-1;0;664719064;667223932;18069640
1063;4.26289e-15;-179;1587;9258;10117;1;575;-2.14748e+09;-8.61132e+06;-1;0;0;0;-1;0;664719064;667223932;18069640
1064;1.18811e-14;-171;1754;25945;19979;1;709;-2.14748e+09;-8.58362e+06;-1;0;0;0;-1;0;665373371;667895877;18159881
1064;4.26289e-15;-179;1587;9258;10117;1;575;-2.14748e+09;-8.58362e+06;-1;0;0;0;-1;0;665373371;667895877;18159881
1065;1.18811e-14;-171;1754;25945;19979;1;709;-2.14748e+09;-8.55606e+06;-1;0;0;0;-1;0;666025842;668566049;18250218
1065;4.26289e-15;-179;1587;9258;10117;1;575;-2.14748e+09;-8.55606e+06;0;0;-1;0;0;-1;666025842;668566049;18250218
1066;1.18811e-14;-171;1754;25945;19979;1;709;-2.14748e+09;-8.52863e+06;-1;0;0;0;-1;0;666676483;669234455;18340651
1066;4.26289e-15;-179;1587;9258;10117;1;575;-2.14748e+09;-8.52863e+06;-1;0;0;0;-1;0;666676483;669234455;18340651
1067;1.18811e-14;-171;1754;25945;19979;1;709;-2.14748e+09;-8.50134e+06;-1;0;0;0;-1;0;667325301;669901102;18431177
1067;4.26289e-15;-180;1587;9258;10117;1;575;-2.14748e+09;-8.50134e+06;0;0;0;0;0;0;667325301;669901102;18431177
1068;1.18811e-14;-172;1754;25945;19979;1;709;-2.14748e+09;-8.47419e+06;0;0;0;0;0;0;667972304;670565997;18521795
1068;4.26289e-15;-180;1587;9258;10117;1;575;-2.14748e+09;-8.47419e+06;-1;0;0;0;-1;0;667972304;670565997;18521795
1069;1.18811e-14;-172;1754;25945;19979;1;709;-2.14748e+09;-8.44727e+06;-1;0;0;0;-1;0;668617498;671229148;18612505
1069;4.26289e-15;-180;1587;9258;10117;1;575;-2.14748e+09;-8.44717e+06;-1;0;0;0;-1;0;668617498;671229148;18612505
1070;1.18811e-14;-172;1754;25945;19979;1;709;-2.14748e+09;-8.42038e+06;-1;0;0;0;-1;0;669260892;671890561;18703306
1070;4.26289e-15;-180;1587;9258;10117;1;575;-2.14748e+09;-8.42028e+06;-1;0;0;0;-1;0;669260892;671890561;18703306
1071;1.18811e-14;-173;1754;25945;19979;1;709;-2.14748e+09;-8.39354e+06;0;0;0;0;0;0;669902490;672550242;18794196
1071;4.26289e-15;-180;1587;9258;10117;1;575;-2.14748e+09;-8.39354e+06;-1;0;0;0;-1;0;669902490;672550242;18794196
1072;1.18811e-14;-174;1754;25945;19979;1;709;-2.14748e+09;-8.36702e+06;0;0;0;0;0;0;670542302;673208199;18885175
1072;4.26289e-15;-181;1587;9258;10117;1;575;-2.14748e+09;-8.36692e+06;0;0;0;0;0;0;670542302;673208199;18885175
1073;1.18811e-14;-175;1754;25945;19979;1;709;-2.14748e+09;-8.34043e+06;0;0;0;0;0;0;671180333;673864439;18976240
1073;4.26289e-15;-182;1587;9258;10117;1;575;-2.14748e+09;-8.34043e+06;0;0;0;0;0;0;671180333;673864439;18976240
1074;1.18811e-14;-175;1754;25945;19979;1;709;-2.14748e+09;-8.31417e+06;-1;0;0;0;-1;0;671816590;674518968;19067392
1074;4.26289e-15;-182;1587;9258;10117;1;575;-2.14748e+09;-8.31407e+06;-1;0;0;0;-1;0;671816590;674518968;19067392
1075;1.18811e-14;-175;1754;25945;19979;1;709;-2.14748e+09;-8.28795e+06;-1;0;0;0;-1;0;672451080;675171793;19158630
1075;4.26289e-15;-183;1587;9258;10117;1;575;-2.14748e+09;-8.28795e+06;0;0;0;0;0;0;672451080;675171793;19158630
1076;1.18811e-14;-176;1754;25945;19979;1;709;-2.14748e+09;-8.26185e+06;0;0;0;0;0;0;673083811;675822920;19249951
1076;4.26289e-15;-184;1587;9258;10117;1;575;-2.14748e+09;-8.26185e+06;0;0;0;0;0;0;673083811;675822920;19249951
1077;1.18811e-14;-176;1754;25945;19979;1;709;-2.14748e+09;-8.23588e+06;-1;0;0;0;-1;0;673714788;676472357;19341356
1077;4.26289e-15;-185;1587;9258;10117;1;575;-2.14748e+09;-8.23588e+06;0;0;0;0;0;0;673714788;676472357;19341356
1078;1.18811e-14;-176;1754;25945;19979;1;709;-2.14748e+09;-8.21003e+06;-1;0;0;0;-1;0;674344018;677120109;19432842
1078;4.26289e-15;-186;1587;9258;10117;1;575;-2.14748e+09;-8.21004e+06;0;0;0;0;0;0;674344018;677120109;19432842
1079;1.18811e-14;-177;1754;25945;19979;1;709;-2.14748e+09;-8.18422e+06;0;0;0;0;0;0;674971508;677766184;19524410
1079;4.26289e-15;-186;1587;9258;10117;1;575;-2.14748e+09;-8.18422e+06;-1;0;0;0;-1;0;674971508;677766184;19524410
1080;1.18811e-14;-178;1754;25945;19979;1;709;-2.14748e+09;-8.15862e+06;0;0;0;0;0;0;675597265;678410588;19616058
1080;4.26289e-15;-187;1587;9258;10117;1;575;-2.14748e+09;-8.15862e+06;0;0;0;0;0;0;675597265;678410588;19616058
1081;1.18811e-14;-179;1754;25945;19979;1;709;-2.14748e+09;-8.13316e+06;0;0;0;0;0;0;676221296;679053327;19707784
1081;4.26289e-15;-188;1587;9258;10117;1;575;-2.14748e+09;-8.13316e+06;0;0;0;0;0;0;676221296;679053327;19707784
1082;1.18811e-14;-180;1754;25945;19979;1;709;-2.14748e+09;-8.10781e+06;0;0;0;0;0;0;676843606;679694408;19799589
1082;4.26289e-15;-189;1587;9258;10117;1;575;-2.14748e+09;-8.10781e+06;0;0;0;0;0;0;676843606;679694408;19799589
1083;1.18811e-14;-181;1754;25945;19979;1;709;-2.14748e+09;-8.08259e+06;0;0;0;0;0;0;677464202;680333837;19891470
1083;4.26289e-15;-190;1587;9258;10117;1;575;-2.14748e+09;-8.08259e+06;0;0;0;0;0;0;677464202;680333837;19891470
1084;1.18811e-14;-181;1754;25945;19979;1;709;-2.14748e+09;-8.05748e+06;-1;0;0;0;-1;0;678083092;680971621;19983428
1084;4.26289e-15;-190;1587;9258;10117;1;575;-2.14748e+09;-8.05748e+06;-1;0;0;0;-1;0;678083092;680971621;19983428
1085;1.18811e-14;-182;1754;25945;19979;1;709;-2.14748e+09;-8.0326e+06;0;0;0;0;0;0;678700281;681607765;20075460
1085;4.26289e-15;-191;1587;9258;10117;1;575;-2.14748e+09;-8.0326e+06;0;0;0;0;0;0;678700281;681607765;20075460
1086;1.18811e-14;-182;1754;25945;19979;1;709;-2.14748e+09;-8.00774e+06;-1;0;0;0;-1;0;679315775;682242277;20167566
1086;4.26289e-15;-191;1587;9258;10117;1;575;-2.14748e+09;-8.00764e+06;-1;0;0;0;-1;0;679315775;682242277;20167566
1087;1.18811e-14;-182;1754;25945;19979;1;709;-2.14748e+09;-7.983e+06;-1;0;0;0;-1;0;679929582;682875162;20259745
1087;4.26289e-15;-191;1587;9258;10117;1;575;-2.14748e+09;-7.9829e+06;-1;0;0;0;-1;0;679929582;682875162;20259745
1088;1.18811e-14;-183;1754;25945;19979;1;709;-2.14748e+09;-7.95827e+06;0;0;0;0;0;0;680541707;683506427;20351996
1088;4.26289e-15;-191;1587;9258;10117;1;575;-2.14748e+09;-7.95827e+06;-1;0;0;0;-1;0;680541707;683506427;20351996
1089;1.18811e-14;-184;1754;25945;19979;1;709;-2.14748e+09;-7.93376e+06;0;0;0;0;0;0;681152157;684136078;20444318
1089;4.26289e-15;-191;1587;9258;10117;1;575;-2.14748e+09;-7.93376e+06;-1;0;0;0;-1;0;681152157;684136078;20444318
1090;1.18811e-14;-184;1754;25945;19979;1;709;-2.14748e+09;-7.90937e+06;-1;0;0;0;-1;0;681760939;684764121;20536710
1090;4.26289e-15;-191;1587;9258;10117;1;575;-2.14748e+09;-7.90937e+06;-1;0;0;0;-1;0;681760939;684764121;20536710
1091;1.18811e-14;-184;1754;25945;19979;1;709;-2.14748e+09;-7.8852e+06;-1;0;0;0;-1;0;682368057;685390563;20629171
1091;4.26289e-15;-192;1587;9258;10117;1;575;-2.14748e+09;-7.8852e+06;0;0;0;0;0;0;682368057;685390563;20629171
1092;1.18811e-14;-185;1754;25945;19979;1;709;-2.14748e+09;-7.86094e+06;0;0;0;0;0;0;682973520;686015408;20721700
1092;4.26289e-15;-192;1587;9258;10117;1;575;-2.14748e+09;-7.86094e+06;-1;0;0;0;-1;0;682973520;686015408;20721700
1093;1.18811e-14;-185;1754;25945;19979;1;709;-2.14748e+09;-7.83689e+06;-1;0;0;0;-1;0;683577332;686638664;20814295
1093;4.26289e-15;-192;1587;9258;10117;1;575;-2.14748e+09;-7.83689e+06;-1;0;0;0;-1;0;683577332;686638664;20814295
1094;1.18811e-14;-185;1754;25945;19979;1;709;-2.14748e+09;-7.81296e+06;-1;0;0;0;-1;0;684179500;687260337;20906957
1094;4.26289e-15;-193;1587;9258;10117;1;575;-2.14748e+09;-7.81296e+06;0;0;0;0;0;0;684179500;687260337;20906957
1095;1.18811e-14;-185;1754;25945;19979;1;709;-2.14748e+09;-7.78924e+06;-1;0;0;0;-1;0;684780030;687880432;20999684
1095;4.26289e-15;-194;1587;9258;10117;1;575;-2.14748e+09;-7.78914e+06;0;0;0;0;0;0;684780030;687880432;20999684
1096;1.18811e-14;-186;1754;25945;19979;1;709;-2.14748e+09;-7.76543e+06;0;0;0;0;0;0;685378929;688498955;21092474
1096;4.26289e-15;-194;1587;9258;10117;1;575;-2.14748e+09;-7.76543e+06;-1;0;0;0;-1;0;685378929;688498955;21092474
1097;1.18811e-14;-186;1754;25945;19979;1;709;-2.14748e+09;-7.74183e+06;-1;0;0;0;-1;0;685976202;689115912;21185328
1097;4.26289e-15;-195;1587;9258;10117;1;575;-2.14748e+09;-7.74183e+06;0;0;0;0;0;0;685976202;689115912;21185328
1098;1.18811e-14;-186;1754;25945;19979;1;709;-2.14748e+09;-7.71834e+06;-1;0;0;0;-1;0;686571855;689731310;21278244
1098;4.26289e-15;-195;1587;9258;10117;1;575;-2.14748e+09;-7.71834e+06;-1;0;0;0;-1;0;686571855;689731310;21278244
1099;1.18811e-14;-187;1754;25945;19979;1;709;-2.14748e+09;-7.69496e+06;0;0;0;0;0;0;687165894;690345154;21371221
1099;4.26289e-15;-196;1587;9258;10117;1;575;-2.14748e+09;-7.69496e+06;0;0;0;0;0;0;687165894;690345154;21371221
1100;1.18811e-14;-187;1754;25945;19979;1;709;-2.14748e+09;-7.67169e+06;-1;0;0;0;-1;0;687758326;690957450;21464258
1100;4.26289e-15;-196;1587;9258;10117;1;575;-2.14748e+09;-7.67169e+06;-1;0;0;0;-1;0;687758326;690957450;21464258
1101;1.18811e-14;-188;1754;25945;19979;1;709;-2.14748e+09;-7.64863e+06;0;0;0;0;0;0;688349156;691568203;21557354
1101;4.26289e-15;-196;1587;9258;10117;1;575;-2.14748e+09;-7.64863e+06;-1;0;0;0;-1;0;688349156;691568203;21557354
1102;1.18811e-14;-188;1754;25945;19979;1;709;-2.14748e+09;-7.62547e+06;-1;0;0;0;-1;0;688938391;692177420;21650509
1102;4.26289e-15;-197;1587;9258;10117;1;575;-2.14748e+09;-7.62547e+06;0;0;0;0;0;0;688938391;692177420;21650509
1103;1.18811e-14;-188;1754;25945;19979;1;709;-2.14748e+09;-7.60263e+06;-1;0;0;0;-1;0;689526035;692785106;21743721
1103;4.26289e-15;-198;1587;9258;10117;1;575;-2.14748e+09;-7.60252e+06;0;0;0;0;0;0;689526035;692785106;21743721
1104;1.18811e-14;-188;1754;25945;19979;1;709;-2.14748e+09;-7.57968e+06;-1;0;0;0;-1;0;690112095;693391267;21836990
1104;4.26289e-15;-198;1587;9258;10117;1;575;-2.14748e+09;-7.57968e+06;-1;0;0;0;-1;0;690112095;693391267;21836990
1105;1.18811e-14;-189;1754;25945;19979;1;709;-2.14748e+09;-7.55704e+06;0;0;0;0;0;0;690696577;693995908;21930314
1105;4.26289e-15;-198;1587;9258;10117;1;575;-2.14748e+09;-7.55704e+06;-1;0;0;0;-1;0;690696577;693995908;21930314
1106;1.18811e-14;-190;1754;25945;19979;1;709;-2.14748e+09;-7.53441e+06;0;0;0;0;0;0;691279487;694599036;22023692
1106;4.26289e-15;-199;1587;9258;10117;1;575;-2.14748e+09;-7.53441e+06;0;0;0;0;0;0;691279487;694599036;22023692
1107;1.18811e-14;-191;1754;25945;19979;1;709;-2.14748e+09;-7.51188e+06;0;0;0;0;0;0;691860829;695200656;22117124
1107;4.26289e-15;-200;1587;9258;10117;1;575;-2.14748e+09;-7.51178e+06;0;0;0;0;0;0;691860829;695200656;22117124
1108;1.18811e-14;-192;1754;25945;19979;1;709;-2.14748e+09;-7.48946e+06;0;0;0;0;0;0;692440611;695800773;22210609
1108;4.26289e-15;-200;1587;9258;10117;1;575;-2.14748e+09;-7.48936e+06;-1;0;0;0;-1;0;692440611;695800773;22210609
1109;1.18811e-14;-192;1754;25945;19979;1;709;-2.14748e+09;-7.46703e+06;-1;0;0;0;-1;0;693018837;696399393;22304146
1109;4.26289e-15;-201;1587;9258;10117;1;575;-2.14748e+09;-7.46703e+06;0;0;0;0;0;0;693018837;696399393;22304146
1110;1.18811e-14;-193;1754;25945;19979;1;709;-2.14748e+09;-7.44481e+06;0;0;0;0;0;0;693595514;696996522;22397734
1110;4.26289e-15;-202;1587;9258;10117;1;575;-2.14748e+09;-7.44481e+06;0;0;0;0;0;0;693595514;696996522;22397734
1111;1.18811e-14;-194;1754;25945;19979;1;709;-2.14748e+09;-7.42269e+06;0;0;0;0;0;0;694170647;697592165;22491371
1111;4.26289e-15;-202;1587;9258;10117;1;575;-2.14748e+09;-7.42269e+06;-1;0;0;0;-1;0;694170647;697592165;22491371
1112;1.18811e-14;-194;1754;25945;19979;1;709;-2.14748e+09;-7.40066e+06;-1;0;0;0;-1;0;694744242;698186327;22585058
1112;4.26289e-15;-202;1587;9258;10117;1;575;-2.14748e+09;-7.40066e+06;-1;0;0;0;-1;0;694744242;698186327;22585058
1113;1.18811e-14;-194;1754;25945;19979;1;709;-2.14748e+09;-7.37874e+06;-1;0;0;0;-1;0;695316303;698779014;22678793
1113;4.26289e-15;-203;1587;9258;10117;1;575;-2.14748e+09;-7.37874e+06;0;0;0;0;0;0;695316303;698779014;22678793
1114;1.18811e-14;-195;1754;25945;19979;1;709;-2.14748e+09;-7.35692e+06;0;0;0;0;0;0;695886838;699370232;22772575
1114;4.26289e-15;-203;1587;9258;10117;1;575;-2.14748e+09;-7.35692e+06;-1;0;0;0;-1;0;695886838;699370232;22772575
1115;1.18811e-14;-195;1754;25945;19979;1;709;-2.14748e+09;-7.33519e+06;-1;0;0;0;-1;0;696455851;699959985;22866404
1115;4.26289e-15;-204;1587;9258;10117;1;575;-2.14748e+09;-7.33519e+06;0;0;0;0;0;0;696455851;699959985;22866404
1116;1.18811e-14;-195;1754;25945;19979;1;709;-2.14748e+09;-7.31357e+06;-1;0;0;0;-1;0;697023348;700548279;22960278
1116;4.26289e-15;-205;1587;9258;10117;1;575;-2.14748e+09;-7.31357e+06;0;0;0;0;0;0;697023348;700548279;22960278
1117;1.18811e-14;-196;1754;25945;19979;1;709;-2.14748e+09;-7.29203e+06;0;0;0;0;0;0;697589334;701135120;23054196
1117;4.26289e-15;-205;1587;9258;10117;1;575;-2.14748e+09;-7.29204e+06;-1;0;0;0;-1;0;697589334;701135120;23054196
1118;1.18811e-14;-197;1754;25945;19979;1;709;-2.14748e+09;-7.2706e+06;0;0;0;0;0;0;698153814;701720512;23148159
1118;4.26289e-15;-206;1587;9258;10117;1;575;-2.14748e+09;-7.2706e+06;0;0;0;0;0;0;698153814;701720512;23148159
1119;1.18811e-14;-197;1754;25945;19979;1;709;-2.14748e+09;-7.24936e+06;-1;0;0;0;-1;0;698716795;702304462;23242164
1119;4.26289e-15;-207;1587;9258;10117;1;575;-2.14748e+09;-7.24936e+06;0;0;0;0;0;0;698716795;702304462;23242164
1120;1.18811e-14;-198;1754;25945;19979;1;709;-2.14748e+09;-7.22802e+06;0;0;0;0;0;0;699278282;702886973;23336211
1120;4.26289e-15;-207;1587;9258;10117;1;575;-2.14748e+09;-7.22802e+06;-1;0;0;0;-1;0;699278282;702886973;23336211
1121;1.18811e-14;-198;1754;25945;19979;1;709;-2.14748e+09;-7.20687e+06;-1;0;0;0;-1;0;699838279;703468052;23430300
1121;4.26289e-15;-208;1587;9258;10117;1;575;-2.14748e+09;-7.20687e+06;0;0;0;0;0;0;699838279;703468052;23430300
1122;1.18811e-14;-198;1754;25945;19979;1;709;-2.14748e+09;-7.18582e+06;-1;0;0;0;-1;0;700396793;704047704;23524428
1122;4.26289e-15;-208;1587;9258;10117;1;575;-2.14748e+09;-7.18582e+06;-1;0;0;0;-1;0;700396793;704047704;23524428
1123;1.18811e-14;-199;1754;25945;19979;1;709;-2.14748e+09;-7.16495e+06;0;0;0;0;0;0;700953828;704625933;23618596
1123;4.26289e-15;-209;1587;9258;10117;1;575;-2.14748e+09;-7.16485e+06;0;0;0;0;0;0;700953828;704625933;23618596
1124;1.18811e-14;-200;1754;25945;19979;1;709;-2.14748e+09;-7.14398e+06;0;0;0;0;0;0;701509390;705202745;23712803
1124;4.26289e-15;-209;1587;9258;10117;1;575;-2.14748e+09;-7.14398e+06;-1;0;0;0;-1;0;701509390;705202745;23712803
1125;1.18811e-14;-200;1754;25945;19979;1;709;-2.14748e+09;-7.12331e+06;-1;0;0;0;-1;0;702063484;705778145;23807047
1125;4.26289e-15;-210;1587;9258;10117;1;575;-2.14748e+09;-7.12321e+06;0;0;0;0;0;0;702063484;705778145;23807047
1126;1.18811e-14;-200;1754;25945;19979;1;709;-2.14748e+09;-7.10252e+06;-1;0;0;0;-1;0;702616116;706352139;23901328
1126;4.26289e-15;-211;1587;9258;10117;1;575;-2.14748e+09;-7.10252e+06;0;0;0;0;0;0;702616116;706352139;23901328
1127;1.18811e-14;-201;1754;25945;19979;1;709;-2.14748e+09;-7.08193e+06;0;0;0;0;0;0;703167290;706924730;23995645
1127;4.26289e-15;-211;1587;9258;10117;1;575;-2.14748e+09;-7.08193e+06;-1;0;0;0;-1;0;703167290;706924730;23995645
1128;1.18811e-14;-202;1754;25945;19979;1;709;-2.14748e+09;-7.06152e+06;0;0;0;0;0;0;703717012;707495924;24089997
1128;4.26289e-15;-211;1587;9258;10117;1;575;-2.14748e+09;-7.06152e+06;-1;0;0;0;-1;0;703717012;707495924;24089997
1129;1.18811e-14;-203;1754;25945;19979;1;709;-2.14748e+09;-7.04101e+06;0;0;0;0;0;0;704265286;708065727;24184383
1129;4.26289e-15;-212;1587;9258;10117;1;575;-2.14748e+09;-7.04101e+06;0;0;0;0;0;0;704265286;708065727;24184383
1130;1.18811e-14;-204;1754;25945;19979;1;709;-2.14748e+09;-7.02068e+06;0;0;0;0;0;0;704812119;708634142;24278803
1130;4.26289e-15;-213;1587;9258;10117;1;575;-2.14748e+09;-7.02068e+06;0;0;0;0;0;0;704812119;708634142;24278803
1131;1.18811e-14;-204;1754;25945;19979;1;709;-2.14748e+09;-7.00044e+06;-1;0;0;0;-1;0;705357515;709201176;24373256
1131;4.26289e-15;-214;1587;9258;10117;1;575;-2.14748e+09;-7.00044e+06;0;0;0;0;0;0;705357515;709201176;24373256
1132;1.18811e-14;-205;1754;25945;19979;1;709;-2.14748e+09;-6.98029e+06;0;0;0;0;0;0;705901479;709766832;24467740
1132;4.26289e-15;-214;1587;9258;10117;1;575;-2.14748e+09;-6.98029e+06;-1;0;0;0;-1;0;705901479;709766832;24467740
1133;1.18811e-14;-206;1754;25945;19979;1;709;-2.14748e+09;-6.96023e+06;0;0;0;0;0;0;706444016;710331117;24562255
1133;4.26289e-15;-215;1587;9258;10117;1;575;-2.14748e+09;-6.96023e+06;0;0;0;0;0;0;706444016;710331117;24562255
1134;1.18811e-14;-206;1754;25945;19979;1;709;-2.14748e+09;-6.94026e+06;-1;0;0;0;-1;0;706985132;710894033;24656801
1134;4.26289e-15;-215;1587;9258;10117;1;575;-2.14748e+09;-6.94026e+06;-1;0;0;0;-1;0;706985132;710894033;24656801
1135;1.18811e-14;-207;1754;25945;19979;1;709;-2.14748e+09;-6.92037e+06;0;0;0;0;0;0;707524831;711455588;24751375
1135;4.26289e-15;-215;1587;9258;10117;1;575;-2.14748e+09;-6.92037e+06;-1;0;0;0;-1;0;707524831;711455588;24751375
1136;1.18811e-14;-207;1754;25945;19979;1;709;-2.14748e+09;-6.90056e+06;-1;0;0;0;-1;0;708063118;712015785;24845979
1136;4.26289e-15;-215;1587;9258;10117;1;575;-2.14748e+09;-6.90056e+06;-1;0;0;0;-1;0;708063118;712015785;24845979
1137;1.18811e-14;-208;1754;25945;19979;1;709;-2.14748e+09;-6.88095e+06;0;0;0;0;0;0;708599998;712574629;24940610
1137;4.26289e-15;-215;1587;9258;10117;1;575;-2.14748e+09;-6.88095e+06;-1;0;0;0;-1;0;708599998;712574629;24940610
1138;1.18811e-14;-209;1754;25945;19979;1;709;-2.14748e+09;-6.86121e+06;0;0;0;0;0;0;709135477;713132124;25035268
1138;4.26289e-15;-216;1587;9258;10117;1;575;-2.14748e+09;-6.86121e+06;0;0;0;0;0;0;709135477;713132124;25035268
1139;1.18811e-14;-210;1754;25945;19979;1;709;-2.14748e+09;-6.84166e+06;0;0;0;0;0;0;709669559;713688277;25129952
1139;4.26289e-15;-216;1587;9258;10117;1;575;-2.14748e+09;-6.84166e+06;-1;0;0;0;-1;0;709669559;713688277;25129952
1140;1.18811e-14;-210;1754;25945;19979;1;709;-2.14748e+09;-6.8223e+06;-1;0;0;0;-1;0;710202248;714243091;25224661
1140;4.26289e-15;-217;1587;9258;10117;1;575;-2.14748e+09;-6.8223e+06;0;0;0;0;0;0;710202248;714243091;25224661
1141;1.18811e-14;-210;1754;25945;19979;1;709;-2.14748e+09;-6.80282e+06;-1;0;0;0;-1;0;710733550;714796570;25319395
1141;4.26289e-15;-217;1587;9258;10117;1;575;-2.14748e+09;-6.80282e+06;-1;0;0;0;-1;0;710733550;714796570;25319395
1142;1.18811e-14;-211;1754;25945;19979;1;709;-2.14748e+09;-6.78362e+06;0;0;0;0;0;0;711263470;715348721;25414153
1142;4.26289e-15;-218;1587;9258;10117;1;575;-2.14748e+09;-6.78362e+06;0;0;0;0;0;0;711263470;715348721;25414153
1143;1.18811e-14;-212;1754;25945;19979;1;709;-2.14748e+09;-6.7643e+06;0;0;0;0;0;0;711792013;715899547;25508934
1143;4.26289e-15;-218;1587;9258;10117;1;575;-2.14748e+09;-6.7643e+06;-1;0;0;0;-1;0;711792013;715899547;25508934
1144;1.18811e-14;-212;1754;25945;19979;1;709;-2.14748e+09;-6.74516e+06;-1;0;0;0;-1;0;712319182;716449053;25603737
1144;4.26289e-15;-219;1587;9258;10117;1;575;-2.14748e+09;-6.74516e+06;0;0;0;0;0;0;712319182;716449053;25603737
1145;1.18811e-14;-213;1754;25945;19979;1;709;-2.14748e+09;-6.72611e+06;0;0;0;0;0;0;712844984;716997243;25698561
1145;4.26289e-15;-220;1587;9258;10117;1;575;-2.14748e+09;-6.72611e+06;0;0;0;0;0;0;712844984;716997243;25698561
1146;1.18811e-14;-214;1754;25945;19979;1;709;-2.14748e+09;-6.70713e+06;0;0;0;0;0;0;713369423;717544123;25793406
1146;4.26289e-15;-221;1587;9258;10117;1;575;-2.14748e+09;-6.70713e+06;0;0;0;0;0;0;713369423;717544123;25793406
1147;1.18811e-14;-214;1754;25945;19979;1;709;-2.14748e+09;-6.68824e+06;-1;0;0;0;-1;0;713892502;718089696;25888271
1147;4.26289e-15;-222;1587;9258;10117;1;575;-2.14748e+09;-6.68824e+06;0;0;0;0;0;0;713892502;718089696;25888271
1148;1.18811e-14;-215;1754;25945;19979;1;709;-2.14748e+09;-6.66942e+06;0;0;0;0;0;0;714414229;718633967;25983155
1148;4.26289e-15;-222;1587;9258;10117;1;575;-2.14748e+09;-6.66942e+06;-1;0;0;0;-1;0;714414229;718633967;25983155
1149;1.18811e-14;-216;1754;25945;19979;1;709;-2.14748e+09;-6.65079e+06;0;0;0;0;0;0;714934605;719176941;26078057
1149;4.26289e-15;-223;1587;9258;10117;1;575;-2.14748e+09;-6.65069e+06;0;0;0;0;0;0;714934605;719176941;26078057
1150;1.18811e-14;-216;1754;25945;19979;1;709;-2.14748e+09;-6.63213e+06;-1;0;0;0;-1;0;715453638;719718623;26172977
1150;4.26289e-15;-223;1587;9258;10117;1;575;-2.14748e+09;-6.63213e+06;-1;0;0;0;-1;0;715453638;719718623;26172977
1151;1.18811e-14;-216;1754;25945;19979;1;709;-2.14748e+09;-6.61345e+06;-1;0;0;0;-1;0;715971330;720259016;26267914
1151;4.26289e-15;-224;1587;9258;10117;1;575;-2.14748e+09;-6.61345e+06;0;0;0;0;0;0;715971330;720259016;26267914
1152;1.18811e-14;-216;1754;25945;19979;1;709;-2.14748e+09;-6.59505e+06;-1;0;0;0;-1;0;716487687;720798125;26362867
1152;4.26289e-15;-224;1587;9258;10117;1;575;-2.14748e+09;-6.59505e+06;-1;0;0;0;-1;0;716487687;720798125;26362867
1153;1.18811e-14;-217;1754;25945;19979;1;709;-2.14748e+09;-6.57662e+06;0;0;0;0;0;0;717002714;721335954;26457835
1153;4.26289e-15;-224;1587;9258;10117;1;575;-2.14748e+09;-6.57652e+06;-1;0;0;0;-1;0;717002714;721335954;26457835
1154;1.18811e-14;-218;1754;25945;19979;1;709;-2.14748e+09;-6.55818e+06;0;0;0;0;0;0;717516414;721872508;26552818
1154;4.26289e-15;-224;1587;9258;10117;1;575;-2.14748e+09;-6.55818e+06;-1;0;0;0;-1;0;717516414;721872508;26552818
1155;1.18811e-14;-218;1754;25945;19979;1;709;-2.14748e+09;-6.54e+06;-1;0;0;0;-1;0;718028793;722407792;26647814
1155;4.26289e-15;-225;1587;9258;10117;1;575;-2.14748e+09;-6.54e+06;0;0;0;0;0;0;718028793;722407792;26647814
1156;1.18811e-14;-219;1754;25945;19979;1;709;-2.14748e+09;-6.52171e+06;0;0;0;0;0;0;718539855;722941809;26742824
1156;4.26289e-15;-226;1587;9258;10117;1;575;-2.14748e+09;-6.52171e+06;0;0;0;0;0;0;718539855;722941809;26742824
1157;1.18811e-14;-219;1754;25945;19979;1;709;-2.14748e+09;-6.50359e+06;-1;0;0;0;-1;0;719049604;723474564;26837846
1157;4.26289e-15;-227;1587;9258;10117;1;575;-2.14748e+09;-6.50359e+06;0;0;0;0;0;0;719049604;723474564;26837846
1158;1.18811e-14;-219;1754;25945;19979;1;709;-2.14748e+09;-6.48554e+06;-1;0;0;0;-1;0;719558045;724006061;26932880
1158;4.26289e-15;-228;1587;9258;10117;1;575;-2.14748e+09;-6.48554e+06;0;0;0;0;0;0;719558045;724006061;26932880
1159;1.18811e-14;-220;1754;25945;19979;1;709;-2.14748e+09;-6.46757e+06;0;0;0;0;0;0;720065182;724536305;27027924
1159;4.26289e-15;-229;1587;9258;10117;1;575;-2.14748e+09;-6.46757e+06;0;0;0;0;0;0;720065182;724536305;27027924
1160;1.18811e-14;-221;1754;25945;19979;1;709;-2.14748e+09;-6.44967e+06;0;0;0;0;0;0;720571020;725065300;27122979
1160;4.26289e-15;-230;1587;9258;10117;1;575;-2.14748e+09;-6.44967e+06;0;0;0;0;0;0;720571020;725065300;27122979
1161;1.18811e-14;-221;1754;25945;19979;1;709;-2.14748e+09;-6.43194e+06;-1;0;0;0;-1;0;721075563;725593049;27218044
1161;4.26289e-15;-231;1587;9258;10117;1;575;-2.14748e+09;-6.43194e+06;0;0;0;0;0;0;721075563;725593049;27218044
1162;1.18811e-14;-221;1754;25945;19979;1;709;-2.14748e+09;-6.41419e+06;-1;0;0;0;-1;0;721578816;726119558;27313117
1162;4.26289e-15;-232;1587;9258;10117;1;575;-2.14748e+09;-6.41419e+06;0;0;0;0;0;0;721578816;726119558;27313117
1163;1.18811e-14;-222;1754;25945;19979;1;709;-2.14748e+09;-6.39652e+06;0;0;0;0;0;0;722080783;726644830;27408198
1163;4.26289e-15;-232;1587;9258;10117;1;575;-2.14748e+09;-6.39652e+06;-1;0;0;0;-1;0;722080783;726644830;27408198
1164;1.18811e-14;-222;1754;25945;19979;1;709;-2.14748e+09;-6.37881e+06;-1;0;0;0;-1;0;722581468;727168869;27503287
1164;4.26289e-15;-232;1587;9258;10117;1;575;-2.14748e+09;-6.37881e+06;-1;0;0;0;-1;0;722581468;727168869;27503287
1165;1.18811e-14;-222;1754;25945;19979;1;709;-2.14748e+09;-6.36137e+06;-1;0;0;0;-1;0;723080876;727691680;27598382
1165;4.26289e-15;-233;1587;9258;10117;1;575;-2.14748e+09;-6.36127e+06;0;0;0;0;0;0;723080876;727691680;27598382
1166;1.18811e-14;-223;1754;25945;19979;1;709;-2.14748e+09;-6.34391e+06;0;0;0;0;0;0;723579010;728213267;27693484
1166;4.26289e-15;-233;1587;9258;10117;1;575;-2.14748e+09;-6.34391e+06;-1;0;0;0;-1;0;723579010;728213267;27693484
1167;1.18811e-14;-224;1754;25945;19979;1;709;-2.14748e+09;-6.32642e+06;0;0;0;0;0;0;724075876;728733634;27788590
1167;4.26289e-15;-233;1587;9258;10117;1;575;-2.14748e+09;-6.32642e+06;-1;0;0;0;-1;0;724075876;728733634;27788590
1168;1.18811e-14;-224;1754;25945;19979;1;709;-2.14748e+09;-6.30909e+06;-1;0;0;0;-1;0;724571478;729252786;27883701
1168;4.26289e-15;-234;1587;9258;10117;1;575;-2.14748e+09;-6.30909e+06;0;0;0;0;0;0;724571478;729252786;27883701
1169;1.18811e-14;-225;1754;25945;19979;1;709;-2.14748e+09;-6.29184e+06;0;0;0;0;0;0;725065819;729770725;27978817
1169;4.26289e-15;-234;1587;9258;10117;1;575;-2.14748e+09;-6.29184e+06;-1;0;0;0;-1;0;725065819;729770725;27978817
1170;1.18811e-14;-226;1754;25945;19979;1;709;-2.14748e+09;-6.27466e+06;0;0;0;0;0;0;725558904;730287456;28073935
1170;4.26289e-15;-234;1587;9258;10117;1;575;-2.14748e+09;-6.27466e+06;-1;0;0;0;-1;0;725558904;730287456;28073935
1171;1.18811e-14;-227;1754;25945;19979;1;709;-2.14748e+09;-6.25764e+06;0;0;0;0;0;0;726050738;730802984;28169056
1171;4.26289e-15;-234;1587;9258;10117;1;575;-2.14748e+09;-6.25764e+06;-1;0;0;0;-1;0;726050738;730802984;28169056
1172;1.18811e-14;-227;1754;25945;19979;1;709;-2.14748e+09;-6.2405e+06;-1;0;0;0;-1;0;726541324;731317311;28264178
1172;4.26289e-15;-235;1587;9258;10117;1;575;-2.14748e+09;-6.2405e+06;0;0;0;0;0;0;726541324;731317311;28264178
1173;1.18811e-14;-228;1754;25945;19979;1;709;-2.14748e+09;-6.22352e+06;0;0;0;0;0;0;727030666;731830443;28359302
1173;4.26289e-15;-235;1587;9258;10117;1;575;-2.14748e+09;-6.22352e+06;-1;0;0;0;-1;0;727030666;731830443;28359302
1174;1.18811e-14;-228;1754;25945;19979;1;709;-2.14748e+09;-6.20661e+06;-1;0;0;0;-1;0;727518769;732342383;28454426
1174;4.26289e-15;-236;1587;9258;10117;1;575;-2.14748e+09;-6.20661e+06;0;0;0;0;0;0;727518769;732342383;28454426
1175;1.18811e-14;-229;1754;25945;19979;1;709;-2.14748e+09;-6.18977e+06;0;0;0;0;0;0;728005637;732853135;28549551
1175;4.26289e-15;-236;1587;9258;10117;1;575;-2.14748e+09;-6.18977e+06;-1;0;0;0;-1;0;728005637;732853135;28549551
1176;1.18811e-14;-230;1754;25945;19979;1;709;-2.14748e+09;-6.1731e+06;0;0;0;0;0;0;728491274;733362703;28644674
1176;4.26289e-15;-236;1587;9258;10117;1;575;-2.14748e+09;-6.1731e+06;-1;0;0;0;-1;0;728491274;733362703;28644674
1177;1.18811e-14;-231;1754;25945;19979;1;709;-2.14748e+09;-6.15629e+06;0;0;0;0;0;0;728975684;733871091;28739796
1177;4.26289e-15;-236;1587;9258;10117;1;575;-2.14748e+09;-6.15629e+06;-1;0;0;0;-1;0;728975684;733871091;28739796
1178;1.18811e-14;-231;1754;25945;19979;1;709;-2.14748e+09;-6.13965e+06;-1;0;0;0;-1;0;729458871;734378303;28834916
1178;4.26289e-15;-236;1587;9258;10117;1;575;-2.14748e+09;-6.13965e+06;-1;0;0;0;-1;0;729458871;734378303;28834916
1179;1.18811e-14;-232;1754;25945;19979;1;709;-2.14748e+09;-6.12317e+06;0;0;0;0;0;0;729940839;734884343;28930033
1179;4.26289e-15;-237;1587;9258;10117;1;575;-2.14748e+09;-6.12317e+06;0;0;0;0;0;0;729940839;734884343;28930033
1180;1.18811e-14;-233;1754;25945;19979;1;709;-2.14748e+09;-6.10656e+06;0;0;0;0;0;0;730421593;735389214;29025146
1180;4.26289e-15;-238;1587;9258;10117;1;575;-2.14748e+09;-6.10656e+06;0;0;0;0;0;0;730421593;735389214;29025146
1181;1.18811e-14;-233;1754;25945;19979;1;709;-2.14748e+09;-6.09012e+06;-1;0;0;0;-1;0;730901136;735892921;29120256
1181;4.26289e-15;-239;1587;9258;10117;1;575;-2.14748e+09;-6.09012e+06;0;0;0;0;0;0;730901136;735892921;29120256
1182;1.18811e-14;-234;1754;25945;19979;1;709;-2.14748e+09;-6.07374e+06;0;0;0;0;0;0;731379471;736395466;29215360
1182;4.26289e-15;-239;1587;9258;10117;1;575;-2.14748e+09;-6.07374e+06;-1;0;0;0;-1;0;731379471;736395466;29215360
1183;1.18811e-14;-234;1754;25945;19979;1;709;-2.14748e+09;-6.05743e+06;-1;0;0;0;-1;0;731856605;736896855;29310460
1183;4.26289e-15;-239;1587;9258;10117;1;575;-2.14748e+09;-6.05743e+06;-1;0;0;0;-1;0;731856605;736896855;29310460
1184;1.18811e-14;-234;1754;25945;19979;1;709;-2.14748e+09;-6.04118e+06;-1;0;0;0;-1;0;732332539;737397091;29405553
1184;4.26289e-15;-240;1587;9258;10117;1;575;-2.14748e+09;-6.04118e+06;0;0;0;0;0;0;732332539;737397091;29405553
1185;1.18811e-14;-235;1754;25945;19979;1;709;-2.14748e+09;-6.02499e+06;0;0;0;0;0;0;732807279;737896177;29500640
1185;4.26289e-15;-241;1587;9258;10117;1;575;-2.14748e+09;-6.02499e+06;0;0;0;0;0;0;732807279;737896177;29500640
1186;1.18811e-14;-236;1754;25945;19979;1;709;-2.14748e+09;-6.00886e+06;0;0;0;0;0;0;733280827;738394117;29595719
1186;4.26289e-15;-242;1587;9258;10117;1;575;-2.14748e+09;-6.00886e+06;0;0;0;0;0;0;733280827;738394117;29595719
1187;1.18811e-14;-237;1754;25945;19979;1;709;-2.14748e+09;-5.9929e+06;0;0;0;0;0;0;733753189;738890916;29690791
1187;4.26289e-15;-243;1587;9258;10117;1;575;-2.14748e+09;-5.9928e+06;0;0;0;0;0;0;733753189;738890916;29690791
1188;1.18811e-14;-238;1754;25945;19979;1;709;-2.14748e+09;-5.97681e+06;0;0;0;0;0;0;734224367;739386576;29785854
1188;4.26289e-15;-243;1587;9258;10117;1;575;-2.14748e+09;-5.97681e+06;-1;0;0;0;-1;0;734224367;739386576;29785854
1189;1.18811e-14;-238;1754;25945;19979;1;709;-2.14748e+09;-5.96097e+06;-1;0;0;0;-1;0;734694366;739881101;29880908
1189;4.26289e-15;-244;1587;9258;10117;1;575;-2.14748e+09;-5.96087e+06;0;0;0;0;0;0;734694366;739881101;29880908
1190;1.18811e-14;-238;1754;25945;19979;1;709;-2.14748e+09;-5.945e+06;-1;0;0;0;-1;0;735163190;740374496;29975952
1190;4.26289e-15;-245;1587;9258;10117;1;575;-2.14748e+09;-5.945e+06;0;0;0;0;0;0;735163190;740374496;29975952
1191;1.18811e-14;-238;1754;25945;19979;1;709;-2.14748e+09;-5.92918e+06;-1;0;0;0;-1;0;735630842;740866764;30070986
1191;4.26289e-15;-245;1587;9258;10117;1;575;-2.14748e+09;-5.92918e+06;-1;0;0;0;-1;0;735630842;740866764;30070986
1192;1.18811e-14;-238;1754;25945;19979;1;709;-2.14748e+09;-5.91343e+06;-1;0;0;0;-1;0;736097327;741357907;30166009
1192;4.26289e-15;-245;1587;9258;10117;1;575;-2.14748e+09;-5.91343e+06;-1;0;0;0;-1;0;736097327;741357907;30166009
1193;1.18811e-14;-239;1754;25945;19979;1;709;-2.14748e+09;-5.89774e+06;0;0;0;0;0;0;736562647;741847931;30261021
1193;4.26289e-15;-245;1587;9258;10117;1;575;-2.14748e+09;-5.89774e+06;-1;0;0;0;-1;0;736562647;741847931;30261021
1194;1.18811e-14;-239;1754;25945;19979;1;709;-2.14748e+09;-5.88221e+06;-1;0;0;0;-1;0;737026808;742336838;30356020
1194;4.26289e-15;-246;1587;9258;10117;1;575;-2.14748e+09;-5.88211e+06;0;0;0;0;0;0;737026808;742336838;30356020
1195;1.18811e-14;-239;1754;25945;19979;1;709;-2.14748e+09;-5.86664e+06;-1;0;0;0;-1;0;737489812;742824633;30451006
1195;4.26289e-15;-246;1587;9258;10117;1;575;-2.14748e+09;-5.86654e+06;-1;0;0;0;-1;0;737489812;742824633;30451006
1196;1.18811e-14;-239;1754;25945;19979;1;709;-2.14748e+09;-5.85103e+06;-1;0;0;0;-1;0;737951663;743311318;30545979
1196;4.26289e-15;-247;1587;9258;10117;1;575;-2.14748e+09;-5.85103e+06;0;0;0;0;0;0;737951663;743311318;30545979
1197;1.18811e-14;-240;1754;25945;19979;1;709;-2.14748e+09;-5.83558e+06;0;0;0;0;0;0;738412366;743796898;30640939
1197;4.26289e-15;-247;1587;9258;10117;1;575;-2.14748e+09;-5.83558e+06;-1;0;0;0;-1;0;738412366;743796898;30640939
1198;1.18811e-14;-240;1754;25945;19979;1;709;-2.14748e+09;-5.82019e+06;-1;0;0;0;-1;0;738871923;744281375;30735883
1198;4.26289e-15;-248;1587;9258;10117;1;575;-2.14748e+09;-5.82019e+06;0;0;0;0;0;0;738871923;744281375;30735883
1199;1.18811e-14;-240;1754;25945;19979;1;709;-2.14748e+09;-5.80486e+06;-1;0;0;0;-1;0;739330339;744764754;30830813
1199;4.26289e-15;-248;1587;9258;10117;1;575;-2.14748e+09;-5.80486e+06;-1;0;0;0;-1;0;739330339;744764754;30830813
1200;1.18811e-14;-241;1754;25945;19979;1;709;-2.14748e+09;-5.78969e+06;0;0;0;0;0;0;739787617;745247037;30925726
1200;4.26289e-15;-248;1587;9258;10117;1;575;-2.14748e+09;-5.78969e+06;-1;0;0;0;-1;0;739787617;745247037;30925726
1201;1.18811e-14;-241;1754;25945;19979;1;709;-2.14748e+09;-5.77437e+06;-1;0;0;0;-1;0;740243761;745728229;31020624
1201;4.26289e-15;-248;1587;9258;10117;1;575;-2.14748e+09;-5.77437e+06;-1;0;0;0;-1;0;740243761;745728229;31020624
1202;1.18811e-14;-242;1754;25945;19979;1;709;-2.14748e+09;-5.75921e+06;0;0;0;0;0;0;740698775;746208333;31115505
1202;4.26289e-15;-248;1587;9258;10117;1;575;-2.14748e+09;-5.75921e+06;-1;0;0;0;-1;0;740698775;746208333;31115505
1203;1.18811e-14;-243;1754;25945;19979;1;709;-2.14748e+09;-5.74421e+06;0;0;0;0;0;0;741152661;746687352;31210368
1203;4.26289e-15;-248;1587;9258;10117;1;575;-2.14748e+09;-5.74421e+06;-1;0;0;0;-1;0;741152661;746687352;31210368
1204;1.18811e-14;-244;1754;25945;19979;1;709;-2.14748e+09;-5.72907e+06;0;0;0;0;0;0;741605425;747165289;31305213
1204;4.26289e-15;-249;1587;9258;10117;1;575;-2.14748e+09;-5.72907e+06;0;0;0;0;0;0;741605425;747165289;31305213
1205;1.18811e-14;-245;1754;25945;19979;1;709;-2.14748e+09;-5.71408e+06;0;0;0;0;0;0;742057069;747642149;31400040
1205;4.26289e-15;-249;1587;9258;10117;1;575;-2.14748e+09;-5.71408e+06;-1;0;0;0;-1;0;742057069;747642149;31400040
1206;1.18811e-14;-245;1754;25945;19979;1;709;-2.14748e+09;-5.69925e+06;-1;0;0;0;-1;0;742507597;748117934;31494847
1206;4.26289e-15;-249;1587;9258;10117;1;575;-2.14748e+09;-5.69925e+06;-1;0;0;0;-1;0;742507597;748117934;31494847
1207;1.18811e-14;-246;1754;25945;19979;1;709;-2.14748e+09;-5.68428e+06;0;0;0;0;0;0;742957013;748592648;31589635
1207;4.26289e-15;-249;1587;9258;10117;1;575;-2.14748e+09;-5.68428e+06;-1;0;0;0;-1;0;742957013;748592648;31589635
1208;1.18811e-14;-246;1754;25945;19979;1;709;-2.14748e+09;-5.66956e+06;-1;0;0;0;-1;0;743405319;749066294;31684403
1208;4.26289e-15;-249;1587;9258;10117;1;575;-2.14748e+09;-5.66946e+06;-1;0;0;0;-1;0;743405319;749066294;31684403
1209;1.18811e-14;-247;1754;25945;19979;1;709;-2.14748e+09;-5.6548e+06;0;0;0;0;0;0;743852521;749538876;31779150
1209;4.26289e-15;-250;1587;9258;10117;1;575;-2.14748e+09;-5.6548e+06;0;0;0;0;0;0;743852521;749538876;31779150
1210;1.18811e-14;-248;1754;25945;19979;1;709;-2.14748e+09;-5.64009e+06;0;0;0;0;0;0;744298620;750010397;31873875
1210;4.26289e-15;-251;1587;9258;10117;1;575;-2.14748e+09;-5.64009e+06;0;0;0;0;0;0;744298620;750010397;31873875
1211;1.18811e-14;-249;1754;25945;19979;1;709;-2.14748e+09;-5.62534e+06;0;0;0;0;0;0;744743622;750480860;31968579
1211;4.26289e-15;-252;1587;9258;10117;1;575;-2.14748e+09;-5.62534e+06;0;0;0;0;0;0;744743622;750480860;31968579
1212;1.18811e-14;-249;1754;25945;19979;1;709;-2.14748e+09;-5.61074e+06;-1;0;0;0;-1;0;745187528;750950268;32063260
1212;4.26289e-15;-252;1587;9258;10117;1;575;-2.14748e+09;-5.61074e+06;-1;0;0;0;-1;0;745187528;750950268;32063260
1213;1.18811e-14;-249;1754;25945;19979;1;709;-2.14748e+09;-5.5962e+06;-1;0;0;0;-1;0;745630344;751418626;32157918
1213;4.26289e-15;-253;1587;9258;10117;1;575;-2.14748e+09;-5.5962e+06;0;0;0;0;0;0;745630344;751418626;32157918
1214;1.18811e-14;-249;1754;25945;19979;1;709;-2.14748e+09;-5.58181e+06;-1;0;0;0;-1;0;746072071;751885935;32252553
1214;4.26289e-15;-253;1587;9258;10117;1;575;-2.14748e+09;-5.58181e+06;-1;0;0;0;-1;0;746072071;751885935;32252553
1215;1.18811e-14;-249;1754;25945;19979;1;709;-2.14748e+09;-5.56728e+06;-1;0;0;0;-1;0;746512714;752352200;32347164
1215;4.26289e-15;-253;1587;9258;10117;1;575;-2.14748e+09;-5.56728e+06;-1;0;0;0;-1;0;746512714;752352200;32347164
1216;1.18811e-14;-250;1754;25945;19979;1;709;-2.14748e+09;-5.553e+06;0;0;0;0;0;0;746952276;752817424;32441750
1216;4.26289e-15;-254;1587;9258;10117;1;575;-2.14748e+09;-5.553e+06;0;0;0;0;0;0;746952276;752817424;32441750
1217;1.18811e-14;-250;1754;25945;19979;1;709;-2.14748e+09;-5.53867e+06;-1;0;0;0;-1;0;747390761;753281609;32536311
1217;4.26289e-15;-255;1587;9258;10117;1;575;-2.14748e+09;-5.53857e+06;0;0;0;0;0;0;747390761;753281609;32536311
1218;1.18811e-14;-250;1754;25945;19979;1;709;-2.14748e+09;-5.5243e+06;-1;0;0;0;-1;0;747828172;753744760;32630846
1218;4.26289e-15;-256;1587;9258;10117;1;575;-2.14748e+09;-5.5243e+06;0;0;0;0;0;0;747828172;753744760;32630846
1219;1.18811e-14;-250;1754;25945;19979;1;709;-2.14748e+09;-5.51007e+06;-1;0;0;0;-1;0;748264511;754206878;32725356
1219;4.26289e-15;-257;1587;9258;10117;1;575;-2.14748e+09;-5.51007e+06;0;0;0;0;0;0;748264511;754206878;32725356
1220;1.18811e-14;-251;1754;25945;19979;1;709;-2.14748e+09;-5.496e+06;0;0;0;0;0;0;748699784;754667969;32819838
1220;4.26289e-15;-258;1587;9258;10117;1;575;-2.14748e+09;-5.4959e+06;0;0;0;0;0;0;748699784;754667969;32819838
1221;1.18811e-14;-251;1754;25945;19979;1;709;-2.14748e+09;-5.48179e+06;-1;0;0;0;-1;0;749133992;755128034;32914294
1221;4.26289e-15;-258;1587;9258;10117;1;575;-2.14748e+09;-5.48179e+06;-1;0;0;0;-1;0;749133992;755128034;32914294
1222;1.18811e-14;-252;1754;25945;19979;1;709;-2.14748e+09;-5.46782e+06;0;0;0;0;0;0;749567140;755587076;33008721
1222;4.26289e-15;-259;1587;9258;10117;1;575;-2.14748e+09;-5.46772e+06;0;0;0;0;0;0;749567140;755587076;33008721
1223;1.18811e-14;-253;1754;25945;19979;1;709;-2.14748e+09;-5.45371e+06;0;0;0;0;0;0;749999230;756045100;33103121
1223;4.26289e-15;-260;1587;9258;10117;1;575;-2.14748e+09;-5.45371e+06;0;0;0;0;0;0;749999230;756045100;33103121
1224;1.18811e-14;-254;1754;25945;19979;1;709;-2.14748e+09;-5.43984e+06;0;0;0;0;0;0;750430267;756502107;33197492
1224;4.26289e-15;-260;1587;9258;10117;1;575;-2.14748e+09;-5.43974e+06;-1;0;0;0;-1;0;750430267;756502107;33197492
1225;1.18811e-14;-254;1754;25945;19979;1;709;-2.14748e+09;-5.42583e+06;-1;0;0;0;-1;0;750860253;756958102;33291833
1225;4.26289e-15;-260;1587;9258;10117;1;575;-2.14748e+09;-5.42583e+06;-1;0;0;0;-1;0;750860253;756958102;33291833
1226;1.18811e-14;-255;1754;25945;19979;1;709;-2.14748e+09;-5.41197e+06;0;0;0;0;0;0;751289191;757413087;33386145
1226;4.26289e-15;-260;1587;9258;10117;1;575;-2.14748e+09;-5.41197e+06;-1;0;0;0;-1;0;751289191;757413087;33386145
1227;1.18811e-14;-256;1754;25945;19979;1;709;-2.14748e+09;-5.39826e+06;0;0;0;0;0;0;751717085;757867066;33480427
1227;4.26289e-15;-260;1587;9258;10117;1;575;-2.14748e+09;-5.39816e+06;-1;0;0;0;-1;0;751717085;757867066;33480427
1228;1.18811e-14;-257;1754;25945;19979;1;709;-2.14748e+09;-5.3845e+06;0;0;0;0;0;0;752143939;758320041;33574678
1228;4.26289e-15;-261;1587;9258;10117;1;575;-2.14748e+09;-5.3845e+06;0;0;0;0;0;0;752143939;758320041;33574678
1229;1.18811e-14;-257;1754;25945;19979;1;709;-2.14748e+09;-5.37079e+06;-1;0;0;0;-1;0;752569755;758772015;33668898
1229;4.26289e-15;-262;1587;9258;10117;1;575;-2.14748e+09;-5.37079e+06;0;0;0;0;0;0;752569755;758772015;33668898
1230;1.18811e-14;-258;1754;25945;19979;1;709;-2.14748e+09;-5.35712e+06;0;0;0;0;0;0;752994536;759222992;33763086
1230;4.26289e-15;-262;1587;9258;10117;1;575;-2.14748e+09;-5.35712e+06;-1;0;0;0;-1;0;752994536;759222992;33763086
1231;1.18811e-14;-258;1754;25945;19979;1;709;-2.14748e+09;-5.34351e+06;-1;0;0;0;-1;0;753418286;759672975;33857242
1231;4.26289e-15;-263;1587;9258;10117;1;575;-2.14748e+09;-5.34351e+06;0;0;0;0;0;0;753418286;759672975;33857242
1232;1.18811e-14;-259;1754;25945;19979;1;709;-2.14748e+09;-5.32985e+06;0;0;0;0;0;0;753841008;760121966;33951365
1232;4.26289e-15;-263;1587;9258;10117;1;575;-2.14748e+09;-5.32985e+06;-1;0;0;0;-1;0;753841008;760121966;33951365
1233;1.18811e-14;-259;1754;25945;19979;1;709;-2.14748e+09;-5.31634e+06;-1;0;0;0;-1;0;754262706;760569968;34045455
1233;4.26289e-15;-263;1587;9258;10117;1;575;-2.14748e+09;-5.31634e+06;-1;0;0;0;-1;0;754262706;760569968;34045455
1234;1.18811e-14;-260;1754;25945;19979;1;709;-2.14748e+09;-5.30297e+06;0;0;0;0;0;0;754683382;761016985;34139512
1234;4.26289e-15;-264;1587;9258;10117;1;575;-2.14748e+09;-5.30297e+06;0;0;0;0;0;0;754683382;761016985;34139512
1235;1.18811e-14;-261;1754;25945;19979;1;709;-2.14748e+09;-5.28945e+06;0;0;0;0;0;0;755103039;761463020;34233534
1235;4.26289e-15;-264;1587;9258;10117;1;575;-2.14748e+09;-5.28945e+06;-1;0;0;0;-1;0;755103039;761463020;34233534
1236;1.18811e-14;-262;1754;25945;19979;1;709;-2.14748e+09;-5.27618e+06;0;0;0;0;0;0;755521682;761908075;34327522
1236;4.26289e-15;-265;1587;9258;10117;1;575;-2.14748e+09;-5.27618e+06;0;0;0;0;0;0;755521682;761908075;34327522
1237;1.18811e-14;-262;1754;25945;19979;1;709;-2.14748e+09;-5.26276e+06;-1;0;0;0;-1;0;755939312;762352154;34421475
1237;4.26289e-15;-266;1587;9258;10117;1;575;-2.14748e+09;-5.26276e+06;0;0;0;0;0;0;755939312;762352154;34421475
1238;1.18811e-14;-262;1754;25945;19979;1;709;-2.14748e+09;-5.24959e+06;-1;0;0;0;-1;0;756355933;762795259;34515393
1238;4.26289e-15;-267;1587;9258;10117;1;575;-2.14748e+09;-5.24959e+06;0;0;0;0;0;0;756355933;762795259;34515393
1239;1.18811e-14;-262;1754;25945;19979;1;709;-2.14748e+09;-5.23626e+06;-1;0;0;0;-1;0;756771548;763237393;34609274
1239;4.26289e-15;-267;1587;9258;10117;1;575;-2.14748e+09;-5.23626e+06;-1;0;0;0;-1;0;756771548;763237393;34609274
1240;1.18811e-14;-263;1754;25945;19979;1;709;-2.14748e+09;-5.22318e+06;0;0;0;0;0;0;757186161;763678560;34703119
1240;4.26289e-15;-267;1587;9258;10117;1;575;-2.14748e+09;-5.22318e+06;-1;0;0;0;-1;0;757186161;763678560;34703119
1241;1.18811e-14;-264;1754;25945;19979;1;709;-2.14748e+09;-5.20995e+06;0;0;0;0;0;0;757599773;764118761;34796927
1241;4.26289e-15;-267;1587;9258;10117;1;575;-2.14748e+09;-5.20995e+06;-1;0;0;0;-1;0;757599773;764118761;34796927
1242;1.18811e-14;-264;1754;25945;19979;1;709;-2.14748e+09;-5.19696e+06;-1;0;0;0;-1;0;758012390;764558001;34890698
1242;4.26289e-15;-268;1587;9258;10117;1;575;-2.14748e+09;-5.19696e+06;0;0;0;0;0;0;758012390;764558001;34890698
1243;1.18811e-14;-264;1754;25945;19979;1;709;-2.14748e+09;-5.18392e+06;-1;0;0;0;-1;0;758424012;764996281;34984431
1243;4.26289e-15;-268;1587;9258;10117;1;575;-2.14748e+09;-5.18392e+06;-1;0;0;0;-1;0;758424012;764996281;34984431
1244;1.18811e-14;-264;1754;25945;19979;1;709;-2.14748e+09;-5.17083e+06;-1;0;0;0;-1;0;758834644;765433605;35078126
1244;4.26289e-15;-269;1587;9258;10117;1;575;-2.14748e+09;-5.17083e+06;0;0;0;0;0;0;758834644;765433605;35078126
1245;1.18811e-14;-265;1754;25945;19979;1;709;-2.14748e+09;-5.15798e+06;0;0;0;0;0;0;759244289;765869976;35171783
1245;4.26289e-15;-269;1587;9258;10117;1;575;-2.14748e+09;-5.15788e+06;-1;0;0;0;-1;0;759244289;765869976;35171783
1246;1.18811e-14;-265;1754;25945;19979;1;709;-2.14748e+09;-5.14498e+06;-1;0;0;0;-1;0;759652949;766305396;35265400
1246;4.26289e-15;-269;1587;9258;10117;1;575;-2.14748e+09;-5.14498e+06;-1;0;0;0;-1;0;759652949;766305396;35265400
1247;1.18811e-14;-265;1754;25945;19979;1;709;-2.14748e+09;-5.13222e+06;-1;0;0;0;-1;0;760060627;766739868;35358977
1247;4.26289e-15;-269;1587;9258;10117;1;575;-2.14748e+09;-5.13222e+06;-1;0;0;0;-1;0;760060627;766739868;35358977
1248;1.18811e-14;-265;1754;25945;19979;1;709;-2.14748e+09;-5.11931e+06;-1;0;0;0;-1;0;760467328;767173396;35452515
1248;4.26289e-15;-269;1587;9258;10117;1;575;-2.14748e+09;-5.11931e+06;-1;0;0;0;-1;0;760467328;767173396;35452515
1249;1.18811e-14;-266;1754;25945;19979;1;709;-2.14748e+09;-5.10655e+06;0;0;0;0;0;0;760873052;767605981;35546012
1249;4.26289e-15;-270;1587;9258;10117;1;575;-2.14748e+09;-5.10655e+06;0;0;0;0;0;0;760873052;767605981;35546012
1250;1.18811e-14;-266;1754;25945;19979;1;709;-2.14748e+09;-5.09382e+06;-1;0;0;0;-1;0;761277804;768037626;35639468
1250;4.26289e-15;-271;1587;9258;10117;1;575;-2.14748e+09;-5.09382e+06;0;0;0;0;0;0;761277804;768037626;35639468
1251;1.18811e-14;-267;1754;25945;19979;1;709;-2.14748e+09;-5.08115e+06;0;0;0;0;0;0;761681587;768468335;35732884
1251;4.26289e-15;-271;1587;9258;10117;1;575;-2.14748e+09;-5.08115e+06;-1;0;0;0;-1;0;761681587;768468335;35732884
1252;1.18811e-14;-268;1754;25945;19979;1;709;-2.14748e+09;-5.06862e+06;0;0;0;0;0;0;762084403;768898111;35826257
1252;4.26289e-15;-271;1587;9258;10117;1;575;-2.14748e+09;-5.06851e+06;-1;0;0;0;-1;0;762084403;768898111;35826257
1253;1.18811e-14;-269;1754;25945;19979;1;709;-2.14748e+09;-5.05592e+06;0;0;0;0;0;0;762486256;769326955;35919588
1253;4.26289e-15;-271;1587;9258;10117;1;575;-2.14748e+09;-5.05592e+06;-1;0;0;0;-1;0;762486256;769326955;35919588
1254;1.18811e-14;-269;1754;25945;19979;1;709;-2.14748e+09;-5.04348e+06;-1;0;0;0;-1;0;762887147;769754870;36012877
1254;4.26289e-15;-271;1587;9258;10117;1;575;-2.14748e+09;-5.04348e+06;-1;0;0;0;-1;0;762887147;769754870;36012877
1255;1.18811e-14;-270;1754;25945;19979;1;709;-2.14748e+09;-5.03088e+06;0;0;0;0;0;0;763287081;770181860;36106123
1255;4.26289e-15;-272;1587;9258;10117;1;575;-2.14748e+09;-5.03088e+06;0;0;0;0;0;0;763287081;770181860;36106123
1256;1.18811e-14;-270;1754;25945;19979;1;709;-2.14748e+09;-5.01842e+06;-1;0;0;0;-1;0;763686060;770607927;36199325
1256;4.26289e-15;-273;1587;9258;10117;1;575;-2.14748e+09;-5.01842e+06;0;0;0;0;0;0;763686060;770607927;36199325
1257;1.18811e-14;-270;1754;25945;19979;1;709;-2.14748e+09;-5.006e+06;-1;0;0;0;-1;0;764084087;771033073;36292484
1257;4.26289e-15;-273;1587;9258;10117;1;575;-2.14748e+09;-5.006e+06;-1;0;0;0;-1;0;764084087;771033073;36292484
1258;1.18811e-14;-271;1754;25945;19979;1;709;-2.14748e+09;-4.99373e+06;0;0;0;0;0;0;764481165;771457302;36385598
1258;4.26289e-15;-274;1587;9258;10117;1;575;-2.14748e+09;-4.99363e+06;0;0;0;0;0;0;764481165;771457302;36385598
1259;1.18811e-14;-272;1754;25945;19979;1;709;-2.14748e+09;-4.9814e+06;0;0;0;0;0;0;764877296;771880617;36478668
1259;4.26289e-15;-274;1587;9258;10117;1;575;-2.14748e+09;-4.9813e+06;-1;0;0;0;-1;0;764877296;771880617;36478668
1260;1.18811e-14;-273;1754;25945;19979;1;709;-2.14748e+09;-4.96901e+06;0;0;0;0;0;0;765272484;772303018;36571692
1260;4.26289e-15;-274;1587;9258;10117;1;575;-2.14748e+09;-4.96901e+06;-1;0;0;0;-1;0;765272484;772303018;36571692
1261;1.18811e-14;-274;1754;25945;19979;1;709;-2.14748e+09;-4.95687e+06;0;0;0;0;0;0;765666731;772724510;36664672
1261;4.26289e-15;-274;1587;9258;10117;1;575;-2.14748e+09;-4.95687e+06;-1;0;0;0;-1;0;765666731;772724510;36664672
1262;1.18811e-14;-274;1754;25945;19979;1;709;-2.14748e+09;-4.94456e+06;-1;0;0;0;-1;0;766060041;773145096;36757605
1262;4.26289e-15;-275;1587;9258;10117;1;575;-2.14748e+09;-4.94456e+06;0;0;0;0;0;0;766060041;773145096;36757605
1263;1.18811e-14;-275;1754;25945;19979;1;709;-2.14748e+09;-4.9325e+06;0;0;0;0;0;0;766452415;773564777;36850492
1263;4.26289e-15;-275;1587;9258;10117;1;575;-2.14748e+09;-4.9325e+06;-1;0;0;0;-1;0;766452415;773564777;36850492
1264;1.18811e-14;-275;1754;25945;19979;1;709;-2.14748e+09;-4.92028e+06;-1;0;0;0;-1;0;766843858;773983556;36943333
1264;4.26289e-15;-275;1587;9258;10117;1;575;-2.14748e+09;-4.92028e+06;-1;0;0;0;-1;0;766843858;773983556;36943333
1265;1.18811e-14;-276;1754;25945;19979;1;709;-2.14748e+09;-4.90821e+06;0;0;0;0;0;0;767234371;774401436;37036127
1265;4.26289e-15;-275;1587;9258;10117;1;575;-2.14748e+09;-4.90821e+06;-1;0;0;0;-1;0;767234371;774401436;37036127
1266;1.18811e-14;-276;1754;25945;19979;1;709;-2.14748e+09;-4.89617e+06;-1;0;0;0;-1;0;767623957;774818419;37128873
1266;4.26289e-15;-275;1587;9258;10117;1;575;-2.14748e+09;-4.89617e+06;-1;0;0;0;-1;0;767623957;774818419;37128873
1267;1.18811e-14;-276;1754;25945;19979;1;709;-2.14748e+09;-4.88417e+06;-1;0;0;0;-1;0;768012620;775234509;37221571
1267;4.26289e-15;-275;1587;9258;10117;1;575;-2.14748e+09;-4.88417e+06;-1;0;0;0;-1;0;768012620;775234509;37221571
1268;1.18811e-14;-276;1754;25945;19979;1;709;-2.14748e+09;-4.87232e+06;-1;0;0;0;-1;0;768400361;775649707;37314221
1268;4.26289e-15;-275;1587;9258;10117;1;575;-2.14748e+09;-4.87232e+06;-1;0;0;0;-1;0;768400361;775649707;37314221
1269;1.18811e-14;-276;1754;25945;19979;1;709;-2.14748e+09;-4.8603e+06;-1;0;0;0;-1;0;768787185;776064016;37406823
1269;4.26289e-15;-275;1587;9258;10117;1;575;-2.14748e+09;-4.8603e+06;-1;0;0;0;-1;0;768787185;776064016;37406823
1270;1.18811e-14;-276;1754;25945;19979;1;709;-2.14748e+09;-4.84843e+06;-1;0;0;0;-1;0;769173092;776477439;37499376
1270;4.26289e-15;-276;1587;9258;10117;1;575;-2.14748e+09;-4.84843e+06;0;0;0;0;0;0;769173092;776477439;37499376
1271;1.18811e-14;-276;1754;25945;19979;1;709;-2.14748e+09;-4.83659e+06;-1;0;0;0;-1;0;769558087;776889978;37591879
1271;4.26289e-15;-276;1587;9258;10117;1;575;-2.14748e+09;-4.83659e+06;-1;0;0;0;-1;0;769558087;776889978;37591879
1272;1.18811e-14;-277;1754;25945;19979;1;709;-2.14748e+09;-4.8248e+06;0;0;0;0;0;0;769942172;777301636;37684333
1272;4.26289e-15;-277;1587;9258;10117;1;575;-2.14748e+09;-4.8248e+06;0;0;0;0;0;0;769942172;777301636;37684333
1273;1.18811e-14;-277;1754;25945;19979;1;709;-2.14748e+09;-4.81304e+06;-1;0;0;0;-1;0;770325349;777712415;37776737
1273;4.26289e-15;-278;1587;9258;10117;1;575;-2.14748e+09;-4.81304e+06;0;0;0;0;0;0;770325349;777712415;37776737
1274;1.18811e-14;-278;1754;25945;19979;1;709;-2.14748e+09;-4.80143e+06;0;0;0;0;0;0;770707622;778122319;37869090
1274;4.26289e-15;-278;1587;9258;10117;1;575;-2.14748e+09;-4.80143e+06;-1;0;0;0;-1;0;770707622;778122319;37869090
1275;1.18811e-14;-279;1754;25945;19979;1;709;-2.14748e+09;-4.78965e+06;0;0;0;0;0;0;771088992;778531348;37961393
1275;4.26289e-15;-279;1587;9258;10117;1;575;-2.14748e+09;-4.78965e+06;0;0;0;0;0;0;771088992;778531348;37961393
1276;1.18811e-14;-279;1754;25945;19979;1;709;-2.14748e+09;-4.77802e+06;-1;0;0;0;-1;0;771469464;778939506;38053644
1276;4.26289e-15;-279;1587;9258;10117;1;575;-2.14748e+09;-4.77802e+06;-1;0;0;0;-1;0;771469464;778939506;38053644
1277;1.18811e-14;-279;1754;25945;19979;1;709;-2.14748e+09;-4.76642e+06;-1;0;0;0;-1;0;771849038;779346796;38145844
1277;4.26289e-15;-279;1587;9258;10117;1;575;-2.14748e+09;-4.76642e+06;-1;0;0;0;-1;0;771849038;779346796;38145844
1278;1.18811e-14;-280;1754;25945;19979;1;709;-2.14748e+09;-4.75486e+06;0;0;0;0;0;0;772227718;779753219;38237992
1278;4.26289e-15;-279;1587;9258;10117;1;575;-2.14748e+09;-4.75486e+06;-1;0;0;0;-1;0;772227718;779753219;38237992
1279;1.18811e-14;-281;1754;25945;19979;1;709;-2.14748e+09;-4.74344e+06;0;0;0;0;0;0;772605507;780158778;38330088
1279;4.26289e-15;-280;1587;9258;10117;1;575;-2.14748e+09;-4.74334e+06;0;0;0;0;0;0;772605507;780158778;38330088
1280;1.18811e-14;-282;1754;25945;19979;1;709;-2.14748e+09;-4.73186e+06;0;0;0;0;0;0;772982407;780563476;38422131
1280;4.26289e-15;-280;1587;9258;10117;1;575;-2.14748e+09;-4.73186e+06;-1;0;0;0;-1;0;772982407;780563476;38422131
1281;1.18811e-14;-282;1754;25945;19979;1;709;-2.14748e+09;-4.72042e+06;-1;0;0;0;-1;0;773358422;780967315;38514121
1281;4.26289e-15;-281;1587;9258;10117;1;575;-2.14748e+09;-4.72042e+06;0;0;0;0;0;0;773358422;780967315;38514121
1282;1.18811e-14;-283;1754;25945;19979;1;709;-2.14748e+09;-4.70901e+06;0;0;0;0;0;0;773733552;781370298;38606058
1282;4.26289e-15;-282;1587;9258;10117;1;575;-2.14748e+09;-4.70901e+06;0;0;0;0;0;0;773733552;781370298;38606058
1283;1.18811e-14;-283;1754;25945;19979;1;709;-2.14748e+09;-4.69774e+06;-1;0;0;0;-1;0;774107802;781772426;38697941
1283;4.26289e-15;-282;1587;9258;10117;1;575;-2.14748e+09;-4.69774e+06;-1;0;0;0;-1;0;774107802;781772426;38697941
1284;1.18811e-14;-283;1754;25945;19979;1;709;-2.14748e+09;-4.68632e+06;-1;0;0;0;-1;0;774481173;782173703;38789771
1284;4.26289e-15;-283;1587;9258;10117;1;575;-2.14748e+09;-4.68632e+06;0;0;0;0;0;0;774481173;782173703;38789771
1285;1.18811e-14;-283;1754;25945;19979;1;709;-2.14748e+09;-4.67502e+06;-1;0;0;0;-1;0;774853668;782574131;38881545
1285;4.26289e-15;-284;1587;9258;10117;1;575;-2.14748e+09;-4.67502e+06;0;0;0;0;0;0;774853668;782574131;38881545
1286;1.18811e-14;-283;1754;25945;19979;1;709;-2.14748e+09;-4.66377e+06;-1;0;0;0;-1;0;775225290;782973711;38973266
1286;4.26289e-15;-285;1587;9258;10117;1;575;-2.14748e+09;-4.66377e+06;0;0;0;0;0;0;775225290;782973711;38973266
1287;1.18811e-14;-284;1754;25945;19979;1;709;-2.14748e+09;-4.65265e+06;0;0;0;0;0;0;775596042;783372447;39064931
1287;4.26289e-15;-286;1587;9258;10117;1;575;-2.14748e+09;-4.65265e+06;0;0;0;0;0;0;775596042;783372447;39064931
1288;1.18811e-14;-285;1754;25945;19979;1;709;-2.14748e+09;-4.64147e+06;0;0;0;0;0;0;775965925;783770341;39156541
1288;4.26289e-15;-286;1587;9258;10117;1;575;-2.14748e+09;-4.64137e+06;-1;0;0;0;-1;0;775965925;783770341;39156541
1289;1.18811e-14;-285;1754;25945;19979;1;709;-2.14748e+09;-4.63022e+06;-1;0;0;0;-1;0;776334942;784167395;39248095
1289;4.26289e-15;-286;1587;9258;10117;1;575;-2.14748e+09;-4.63022e+06;-1;0;0;0;-1;0;776334942;784167395;39248095
1290;1.18811e-14;-286;1754;25945;19979;1;709;-2.14748e+09;-4.61912e+06;0;0;0;0;0;0;776703097;784563611;39339593
1290;4.26289e-15;-286;1587;9258;10117;1;575;-2.14748e+09;-4.61912e+06;-1;0;0;0;-1;0;776703097;784563611;39339593
1291;1.18811e-14;-287;1754;25945;19979;1;709;-2.14748e+09;-4.60805e+06;0;0;0;0;0;0;777070391;784958992;39431035
1291;4.26289e-15;-286;1587;9258;10117;1;575;-2.14748e+09;-4.60805e+06;-1;0;0;0;-1;0;777070391;784958992;39431035
1292;1.18811e-14;-287;1754;25945;19979;1;709;-2.14748e+09;-4.59701e+06;-1;0;0;0;-1;0;777436827;785353541;39522420
1292;4.26289e-15;-286;1587;9258;10117;1;575;-2.14748e+09;-4.59701e+06;-1;0;0;0;-1;0;777436827;785353541;39522420
1293;1.18811e-14;-287;1754;25945;19979;1;709;-2.14748e+09;-4.58601e+06;-1;0;0;0;-1;0;777802408;785747258;39613749
1293;4.26289e-15;-286;1587;9258;10117;1;575;-2.14748e+09;-4.58601e+06;-1;0;0;0;-1;0;777802408;785747258;39613749
1294;1.18811e-14;-287;1754;25945;19979;1;709;-2.14748e+09;-4.57515e+06;-1;0;0;0;-1;0;778167135;786140148;39705019
1294;4.26289e-15;-287;1587;9258;10117;1;575;-2.14748e+09;-4.57515e+06;0;0;0;0;0;0;778167135;786140148;39705019
1295;1.18811e-14;-288;1754;25945;19979;1;709;-2.14748e+09;-4.56422e+06;0;0;0;0;0;0;778531012;786532212;39796233
1295;4.26289e-15;-288;1587;9258;10117;1;575;-2.14748e+09;-4.56422e+06;0;0;0;0;0;0;778531012;786532212;39796233
1296;1.18811e-14;-288;1754;25945;19979;1;709;-2.14748e+09;-4.55323e+06;-1;0;0;0;-1;0;778894041;786923452;39887388
1296;4.26289e-15;-289;1587;9258;10117;1;575;-2.14748e+09;-4.55323e+06;0;0;0;0;0;0;778894041;786923452;39887388
1297;1.18811e-14;-289;1754;25945;19979;1;709;-2.14748e+09;-4.54248e+06;0;0;0;0;0;0;779256224;787313870;39978485
1297;4.26289e-15;-290;1587;9258;10117;1;575;-2.14748e+09;-4.54248e+06;0;0;0;0;0;0;779256224;787313870;39978485
1298;1.18811e-14;-290;1754;25945;19979;1;709;-2.14748e+09;-4.53156e+06;0;0;0;0;0;0;779617564;787703470;40069523
1298;4.26289e-15;-291;1587;9258;10117;1;575;-2.14748e+09;-4.53156e+06;0;0;0;0;0;0;779617564;787703470;40069523
1299;1.18811e-14;-290;1754;25945;19979;1;709;-2.14748e+09;-4.52087e+06;-1;0;0;0;-1;0;779978064;788092252;40160503
1299;4.26289e-15;-292;1587;9258;10117;1;575;-2.14748e+09;-4.52087e+06;0;0;0;0;0;0;779978064;788092252;40160503
1300;1.18811e-14;-291;1754;25945;19979;1;709;-2.14748e+09;-4.51012e+06;0;0;0;0;0;0;780337724;788480220;40251423
1300;4.26289e-15;-293;1587;9258;10117;1;575;-2.14748e+09;-4.51002e+06;0;0;0;0;0;0;780337724;788480220;40251423
1301;1.18811e-14;-291;1754;25945;19979;1;709;-2.14748e+09;-4.4994e+06;-1;0;0;0;-1;0;780696550;788867376;40342284
1301;4.26289e-15;-293;1587;9258;10117;1;575;-2.14748e+09;-4.4994e+06;-1;0;0;0;-1;0;780696550;788867376;40342284
1302;1.18811e-14;-291;1754;25945;19979;1;709;-2.14748e+09;-4.48862e+06;-1;0;0;0;-1;0;781054541;789253721;40433085
1302;4.26289e-15;-293;1587;9258;10117;1;575;-2.14748e+09;-4.48862e+06;-1;0;0;0;-1;0;781054541;789253721;40433085
1303;1.18811e-14;-291;1754;25945;19979;1;709;-2.14748e+09;-4.47798e+06;-1;0;0;0;-1;0;781411702;789639259;40523826
1303;4.26289e-15;-294;1587;9258;10117;1;575;-2.14748e+09;-4.47798e+06;0;0;0;0;0;0;781411702;789639259;40523826
1304;1.18811e-14;-292;1754;25945;19979;1;709;-2.14748e+09;-4.46746e+06;0;0;0;0;0;0;781768033;790023991;40614507
1304;4.26289e-15;-295;1587;9258;10117;1;575;-2.14748e+09;-4.46746e+06;0;0;0;0;0;0;781768033;790023991;40614507
1305;1.18811e-14;-292;1754;25945;19979;1;709;-2.14748e+09;-4.45678e+06;-1;0;0;0;-1;0;782123539;790407919;40705126
1305;4.26289e-15;-295;1587;9258;10117;1;575;-2.14748e+09;-4.45678e+06;-1;0;0;0;-1;0;782123539;790407919;40705126
1306;1.18811e-14;-292;1754;25945;19979;1;709;-2.14748e+09;-4.44624e+06;-1;0;0;0;-1;0;782478220;790791046;40795685
1306;4.26289e-15;-295;1587;9258;10117;1;575;-2.14748e+09;-4.44624e+06;-1;0;0;0;-1;0;782478220;790791046;40795685
1307;1.18811e-14;-292;1754;25945;19979;1;709;-2.14748e+09;-4.43573e+06;-1;0;0;0;-1;0;782832080;791173374;40886183
1307;4.26289e-15;-295;1587;9258;10117;1;575;-2.14748e+09;-4.43573e+06;-1;0;0;0;-1;0;782832080;791173374;40886183
1308;1.18811e-14;-293;1754;25945;19979;1;709;-2.14748e+09;-4.42535e+06;0;0;0;0;0;0;783185121;791554905;40976618
1308;4.26289e-15;-295;1587;9258;10117;1;575;-2.14748e+09;-4.42535e+06;-1;0;0;0;-1;0;783185121;791554905;40976618
1309;1.18811e-14;-294;1754;25945;19979;1;709;-2.14748e+09;-4.41481e+06;0;0;0;0;0;0;783537345;791935641;41066992
1309;4.26289e-15;-296;1587;9258;10117;1;575;-2.14748e+09;-4.41481e+06;0;0;0;0;0;0;783537345;791935641;41066992
1310;1.18811e-14;-295;1754;25945;19979;1;709;-2.14748e+09;-4.4045e+06;0;0;0;0;0;0;783888754;792315585;41157304
1310;4.26289e-15;-296;1587;9258;10117;1;575;-2.14748e+09;-4.4045e+06;-1;0;0;0;-1;0;783888754;792315585;41157304
1311;1.18811e-14;-296;1754;25945;19979;1;709;-2.14748e+09;-4.39402e+06;0;0;0;0;0;0;784239351;792694738;41247553
1311;4.26289e-15;-297;1587;9258;10117;1;575;-2.14748e+09;-4.39402e+06;0;0;0;0;0;0;784239351;792694738;41247553
1312;1.18811e-14;-296;1754;25945;19979;1;709;-2.14748e+09;-4.38368e+06;-1;0;0;0;-1;0;784589139;793073102;41337740
1312;4.26289e-15;-297;1587;9258;10117;1;575;-2.14748e+09;-4.38368e+06;-1;0;0;0;-1;0;784589139;793073102;41337740
1313;1.18811e-14;-296;1754;25945;19979;1;709;-2.14748e+09;-4.37346e+06;-1;0;0;0;-1;0;784938119;793450681;41427864
1313;4.26289e-15;-297;1587;9258;10117;1;575;-2.14748e+09;-4.37346e+06;-1;0;0;0;-1;0;784938119;793450681;41427864
1314;1.18811e-14;-297;1754;25945;19979;1;709;-2.14748e+09;-4.36308e+06;0;0;0;0;0;0;785286293;793827475;41517924
1314;4.26289e-15;-297;1587;9258;10117;1;575;-2.14748e+09;-4.36308e+06;-1;0;0;0;-1;0;785286293;793827475;41517924
1315;1.18811e-14;-297;1754;25945;19979;1;709;-2.14748e+09;-4.35294e+06;-1;0;0;0;-1;0;785633665;794203487;41607920
1315;4.26289e-15;-297;1587;9258;10117;1;575;-2.14748e+09;-4.35294e+06;-1;0;0;0;-1;0;785633665;794203487;41607920
1316;1.18811e-14;-297;1754;25945;19979;1;709;-2.14748e+09;-4.34262e+06;-1;0;0;0;-1;0;785980235;794578720;41697853
1316;4.26289e-15;-297;1587;9258;10117;1;575;-2.14748e+09;-4.34262e+06;-1;0;0;0;-1;0;785980235;794578720;41697853
1317;1.18811e-14;-298;1754;25945;19979;1;709;-2.14748e+09;-4.33254e+06;0;0;0;0;0;0;786326008;794953175;41787722
1317;4.26289e-15;-298;1587;9258;10117;1;575;-2.14748e+09;-4.33254e+06;0;0;0;0;0;0;786326008;794953175;41787722
1318;1.18811e-14;-298;1754;25945;19979;1;709;-2.14748e+09;-4.32229e+06;-1;0;0;0;-1;0;786670984;795326854;41877526
1318;4.26289e-15;-298;1587;9258;10117;1;575;-2.14748e+09;-4.32229e+06;-1;0;0;0;-1;0;786670984;795326854;41877526
1319;1.18811e-14;-299;1754;25945;19979;1;709;-2.14748e+09;-4.31218e+06;0;0;0;0;0;0;787015166;795699759;41967266
1319;4.26289e-15;-299;1587;9258;10117;1;575;-2.14748e+09;-4.31218e+06;0;0;0;0;0;0;787015166;795699759;41967266
1320;1.18811e-14;-299;1754;25945;19979;1;709;-2.14748e+09;-4.30219e+06;-1;0;0;0;-1;0;787358557;796071893;42056940
1320;4.26289e-15;-299;1587;9258;10117;1;575;-2.14748e+09;-4.30219e+06;-1;0;0;0;-1;0;787358557;796071893;42056940
1321;1.18811e-14;-299;1754;25945;19979;1;709;-2.14748e+09;-4.29204e+06;-1;0;0;0;-1;0;787701158;796443257;42146550
1321;4.26289e-15;-299;1587;9258;10117;1;575;-2.14748e+09;-4.29204e+06;-1;0;0;0;-1;0;787701158;796443257;42146550
1322;1.18811e-14;-300;1754;25945;19979;1;709;-2.14748e+09;-4.28211e+06;0;0;0;0;0;0;788042973;796813854;42236094
1322;4.26289e-15;-299;1587;9258;10117;1;575;-2.14748e+09;-4.28211e+06;-1;0;0;0;-1;0;788042973;796813854;42236094
1323;1.18811e-14;-300;1754;25945;19979;1;709;-2.14748e+09;-4.27202e+06;-1;0;0;0;-1;0;788384002;797183686;42325572
1323;4.26289e-15;-300;1587;9258;10117;1;575;-2.14748e+09;-4.27202e+06;0;0;0;0;0;0;788384002;797183686;42325572
1324;1.18811e-14;-301;1754;25945;19979;1;709;-2.14748e+09;-4.26206e+06;0;0;0;0;0;0;788724249;797552754;42414984
1324;4.26289e-15;-301;1587;9258;10117;1;575;-2.14748e+09;-4.26206e+06;0;0;0;0;0;0;788724249;797552754;42414984
1325;1.18811e-14;-301;1754;25945;19979;1;709;-2.14748e+09;-4.25213e+06;-1;0;0;0;-1;0;789063715;797921061;42504330
1325;4.26289e-15;-301;1587;9258;10117;1;575;-2.14748e+09;-4.25213e+06;-1;0;0;0;-1;0;789063715;797921061;42504330
1326;1.18811e-14;-301;1754;25945;19979;1;709;-2.14748e+09;-4.24224e+06;-1;0;0;0;-1;0;789402403;798288609;42593610
1326;4.26289e-15;-302;1587;9258;10117;1;575;-2.14748e+09;-4.24224e+06;0;0;0;0;0;0;789402403;798288609;42593610
1327;1.18811e-14;-301;1754;25945;19979;1;709;-2.14748e+09;-4.23237e+06;-1;0;0;0;-1;0;789740314;798655400;42682823
1327;4.26289e-15;-302;1587;9258;10117;1;575;-2.14748e+09;-4.23237e+06;-1;0;0;0;-1;0;789740314;798655400;42682823
1328;1.18811e-14;-302;1754;25945;19979;1;709;-2.14748e+09;-4.22253e+06;0;0;0;0;0;0;790077452;799021435;42771969
1328;4.26289e-15;-302;1587;9258;10117;1;575;-2.14748e+09;-4.22253e+06;-1;0;0;0;-1;0;790077452;799021435;42771969
1329;1.18811e-14;-303;1754;25945;19979;1;709;-2.14748e+09;-4.21272e+06;0;0;0;0;0;0;790413818;799386717;42861047
1329;4.26289e-15;-303;1587;9258;10117;1;575;-2.14748e+09;-4.21272e+06;0;0;0;0;0;0;790413818;799386717;42861047
1330;1.18811e-14;-304;1754;25945;19979;1;709;-2.14748e+09;-4.20295e+06;0;0;0;0;0;0;790749415;799751248;42950058
1330;4.26289e-15;-304;1587;9258;10117;1;575;-2.14748e+09;-4.20295e+06;0;0;0;0;0;0;790749415;799751248;42950058
1331;1.18811e-14;-304;1754;25945;19979;1;709;-2.14748e+09;-4.1933e+06;-1;0;0;0;-1;0;791084244;800115029;43039001
1331;4.26289e-15;-305;1587;9258;10117;1;575;-2.14748e+09;-4.1933e+06;0;0;0;0;0;0;791084244;800115029;43039001
1332;1.18811e-14;-304;1754;25945;19979;1;709;-2.14748e+09;-4.18359e+06;-1;0;0;0;-1;0;791418307;800478064;43127877
1332;4.26289e-15;-305;1587;9258;10117;1;575;-2.14748e+09;-4.18359e+06;-1;0;0;0;-1;0;791418307;800478064;43127877
1333;1.18811e-14;-305;1754;25945;19979;1;709;-2.14748e+09;-4.1738e+06;0;0;0;0;0;0;791751608;800840353;43216684
1333;4.26289e-15;-305;1587;9258;10117;1;575;-2.14748e+09;-4.1738e+06;-1;0;0;0;-1;0;791751608;800840353;43216684
1334;1.18811e-14;-305;1754;25945;19979;1;709;-2.14748e+09;-4.16425e+06;-1;0;0;0;-1;0;792084148;801201898;43305422
1334;4.26289e-15;-305;1587;9258;10117;1;575;-2.14748e+09;-4.16415e+06;-1;0;0;0;-1;0;792084148;801201898;43305422
1335;1.18811e-14;-305;1754;25945;19979;1;709;-2.14748e+09;-4.15452e+06;-1;0;0;0;-1;0;792415928;801562702;43394092
1335;4.26289e-15;-306;1587;9258;10117;1;575;-2.14748e+09;-4.15452e+06;0;0;0;0;0;0;792415928;801562702;43394092
1336;1.18811e-14;-306;1754;25945;19979;1;709;-2.14748e+09;-4.14503e+06;0;0;0;0;0;0;792746952;801922767;43482693
1336;4.26289e-15;-306;1587;9258;10117;1;575;-2.14748e+09;-4.14493e+06;-1;0;0;0;-1;0;792746952;801922767;43482693
1337;1.18811e-14;-306;1754;25945;19979;1;709;-2.14748e+09;-4.13536e+06;-1;0;0;0;-1;0;793077222;802282094;43571225
1337;4.26289e-15;-306;1587;9258;10117;1;575;-2.14748e+09;-4.13536e+06;-1;0;0;0;-1;0;793077222;802282094;43571225
1338;1.18811e-14;-307;1754;25945;19979;1;709;-2.14748e+09;-4.12582e+06;0;0;0;0;0;0;793406739;802640686;43659687
1338;4.26289e-15;-306;1587;9258;10117;1;575;-2.14748e+09;-4.12582e+06;-1;0;0;0;-1;0;793406739;802640686;43659687
1339;1.18811e-14;-307;1754;25945;19979;1;709;-2.14748e+09;-4.11631e+06;-1;0;0;0;-1;0;793735505;802998544;43748080
1339;4.26289e-15;-306;1587;9258;10117;1;575;-2.14748e+09;-4.11631e+06;-1;0;0;0;-1;0;793735505;802998544;43748080
1340;1.18811e-14;-307;1754;25945;19979;1;709;-2.14748e+09;-4.10683e+06;-1;0;0;0;-1;0;794063524;803355670;43836403
1340;4.26289e-15;-306;1587;9258;10117;1;575;-2.14748e+09;-4.10683e+06;-1;0;0;0;-1;0;794063524;803355670;43836403
1341;1.18811e-14;-307;1754;25945;19979;1;709;-2.14748e+09;-4.09748e+06;-1;0;0;0;-1;0;794390795;803712066;43924656
1341;4.26289e-15;-307;1587;9258;10117;1;575;-2.14748e+09;-4.09748e+06;0;0;0;0;0;0;794390795;803712066;43924656
1342;1.18811e-14;-308;1754;25945;19979;1;709;-2.14748e+09;-4.08806e+06;0;0;0;0;0;0;794717323;804067735;44012838
1342;4.26289e-15;-307;1587;9258;10117;1;575;-2.14748e+09;-4.08806e+06;-1;0;0;0;-1;0;794717323;804067735;44012838
1343;1.18811e-14;-309;1754;25945;19979;1;709;-2.14748e+09;-4.07857e+06;0;0;0;0;0;0;795043109;804422677;44100950
1343;4.26289e-15;-308;1587;9258;10117;1;575;-2.14748e+09;-4.07857e+06;0;0;0;0;0;0;795043109;804422677;44100950
1344;1.18811e-14;-309;1754;25945;19979;1;709;-2.14748e+09;-4.0693e+06;-1;0;0;0;-1;0;795368154;804776895;44188991
1344;4.26289e-15;-308;1587;9258;10117;1;575;-2.14748e+09;-4.0693e+06;-1;0;0;0;-1;0;795368154;804776895;44188991
1345;1.18811e-14;-309;1754;25945;19979;1;709;-2.14748e+09;-4.05987e+06;-1;0;0;0;-1;0;795692462;805130391;44276961
1345;4.26289e-15;-309;1587;9258;10117;1;575;-2.14748e+09;-4.05987e+06;0;0;0;0;0;0;795692462;805130391;44276961
1346;1.18811e-14;-309;1754;25945;19979;1;709;-2.14748e+09;-4.05056e+06;-1;0;0;0;-1;0;796016033;805483167;44364860
1346;4.26289e-15;-309;1587;9258;10117;1;575;-2.14748e+09;-4.05056e+06;-1;0;0;0;-1;0;796016033;805483167;44364860
1347;1.18811e-14;-309;1754;25945;19979;1;709;-2.14748e+09;-4.04138e+06;-1;0;0;0;-1;0;796338871;805835224;44452688
1347;4.26289e-15;-309;1587;9258;10117;1;575;-2.14748e+09;-4.04128e+06;-1;0;0;0;-1;0;796338871;805835224;44452688
1348;1.18811e-14;-309;1754;25945;19979;1;709;-2.14748e+09;-4.03203e+06;-1;0;0;0;-1;0;796660977;806186564;44540444
1348;4.26289e-15;-309;1587;9258;10117;1;575;-2.14748e+09;-4.03203e+06;-1;0;0;0;-1;0;796660977;806186564;44540444
1349;1.18811e-14;-310;1754;25945;19979;1;709;-2.14748e+09;-4.02281e+06;0;0;0;0;0;0;796982353;806537190;44628128
1349;4.26289e-15;-309;1587;9258;10117;1;575;-2.14748e+09;-4.02281e+06;-1;0;0;0;-1;0;796982353;806537190;44628128
1350;1.18811e-14;-310;1754;25945;19979;1;709;-2.14748e+09;-4.01361e+06;-1;0;0;0;-1;0;797303001;806887102;44715740
1350;4.26289e-15;-309;1587;9258;10117;1;575;-2.14748e+09;-4.01361e+06;-1;0;0;0;-1;0;797303001;806887102;44715740
1351;1.18811e-14;-311;1754;25945;19979;1;709;-2.14748e+09;-4.00444e+06;0;0;0;0;0;0;797622923;807236304;44803279
1351;4.26289e-15;-309;1587;9258;10117;1;575;-2.14748e+09;-4.00444e+06;-1;0;0;0;-1;0;797622923;807236304;44803279
1352;1.18811e-14;-312;1754;25945;19979;1;709;-2.14748e+09;-3.9953e+06;0;0;0;0;0;0;797942121;807584796;44890746
1352;4.26289e-15;-309;1587;9258;10117;1;575;-2.14748e+09;-3.9953e+06;-1;0;0;0;-1;0;797942121;807584796;44890746
1353;1.18811e-14;-312;1754;25945;19979;1;709;-2.14748e+09;-3.98619e+06;-1;0;0;0;-1;0;798260598;807932580;44978141
1353;4.26289e-15;-310;1587;9258;10117;1;575;-2.14748e+09;-3.98619e+06;0;0;0;0;0;0;798260598;807932580;44978141
1354;1.18811e-14;-313;1754;25945;19979;1;709;-2.14748e+09;-3.9771e+06;0;0;0;0;0;0;798578354;808279659;45065463
1354;4.26289e-15;-311;1587;9258;10117;1;575;-2.14748e+09;-3.9771e+06;0;0;0;0;0;0;798578354;808279659;45065463
1355;1.18811e-14;-313;1754;25945;19979;1;709;-2.14748e+09;-3.96805e+06;-1;0;0;0;-1;0;798895393;808626034;45152711
1355;4.26289e-15;-311;1587;9258;10117;1;575;-2.14748e+09;-3.96805e+06;-1;0;0;0;-1;0;798895393;808626034;45152711
1356;1.18811e-14;-314;1754;25945;19979;1;709;-2.14748e+09;-3.95902e+06;0;0;0;0;0;0;799211715;808971707;45239887
1356;4.26289e-15;-311;1587;9258;10117;1;575;-2.14748e+09;-3.95902e+06;-1;0;0;0;-1;0;799211715;808971707;45239887
1357;1.18811e-14;-315;1754;25945;19979;1;709;-2.14748e+09;-3.95011e+06;0;0;0;0;0;0;799527324;809316680;45326988
1357;4.26289e-15;-312;1587;9258;10117;1;575;-2.14748e+09;-3.95001e+06;0;0;0;0;0;0;799527324;809316680;45326988
1358;1.18811e-14;-315;1754;25945;19979;1;709;-2.14748e+09;-3.94113e+06;-1;0;0;0;-1;0;799842221;809660954;45414017
1358;4.26289e-15;-313;1587;9258;10117;1;575;-2.14748e+09;-3.94113e+06;0;0;0;0;0;0;799842221;809660954;45414017
1359;1.18811e-14;-316;1754;25945;19979;1;709;-2.14748e+09;-3.93218e+06;0;0;0;0;0;0;800156407;810004532;45500971
1359;4.26289e-15;-313;1587;9258;10117;1;575;-2.14748e+09;-3.93208e+06;-1;0;0;0;-1;0;800156407;810004532;45500971
1360;1.18811e-14;-317;1754;25945;19979;1;709;-2.14748e+09;-3.92316e+06;0;0;0;0;0;0;800469886;810347415;45587851
1360;4.26289e-15;-314;1587;9258;10117;1;575;-2.14748e+09;-3.92316e+06;0;0;0;0;0;0;800469886;810347415;45587851
1361;1.18811e-14;-318;1754;25945;19979;1;709;-2.14748e+09;-3.91426e+06;0;0;0;0;0;0;800782658;810689604;45674657
1361;4.26289e-15;-314;1587;9258;10117;1;575;-2.14748e+09;-3.91426e+06;-1;0;0;0;-1;0;800782658;810689604;45674657
1362;1.18811e-14;-318;1754;25945;19979;1;709;-2.14748e+09;-3.90549e+06;-1;0;0;0;-1;0;801094726;811031102;45761388
1362;4.26289e-15;-314;1587;9258;10117;1;575;-2.14748e+09;-3.90539e+06;-1;0;0;0;-1;0;801094726;811031102;45761388
1363;1.18811e-14;-319;1754;25945;19979;1;709;-2.14748e+09;-3.89665e+06;0;0;0;0;0;0;801406092;811371911;45848045
1363;4.26289e-15;-314;1587;9258;10117;1;575;-2.14748e+09;-3.89665e+06;-1;0;0;0;-1;0;801406092;811371911;45848045
1364;1.18811e-14;-320;1754;25945;19979;1;709;-2.14748e+09;-3.88783e+06;0;0;0;0;0;0;801716757;811712031;45934627
1364;4.26289e-15;-315;1587;9258;10117;1;575;-2.14748e+09;-3.88783e+06;0;0;0;0;0;0;801716757;811712031;45934627
1365;1.18811e-14;-321;1754;25945;19979;1;709;-2.14748e+09;-3.87894e+06;0;0;0;0;0;0;802026724;812051466;46021134
1365;4.26289e-15;-316;1587;9258;10117;1;575;-2.14748e+09;-3.87894e+06;0;0;0;0;0;0;802026724;812051466;46021134
1366;1.18811e-14;-321;1754;25945;19979;1;709;-2.14748e+09;-3.87027e+06;-1;0;0;0;-1;0;802335994;812390216;46107566
1366;4.26289e-15;-316;1587;9258;10117;1;575;-2.14748e+09;-3.87017e+06;-1;0;0;0;-1;0;802335994;812390216;46107566
1367;1.18811e-14;-322;1754;25945;19979;1;709;-2.14748e+09;-3.86153e+06;0;0;0;0;0;0;802644569;812728283;46193923
1367;4.26289e-15;-317;1587;9258;10117;1;575;-2.14748e+09;-3.86143e+06;0;0;0;0;0;0;802644569;812728283;46193923
1368;1.18811e-14;-323;1754;25945;19979;1;709;-2.14748e+09;-3.85271e+06;0;0;0;0;0;0;802952452;813065670;46280203
1368;4.26289e-15;-317;1587;9258;10117;1;575;-2.14748e+09;-3.85271e+06;-1;0;0;0;-1;0;802952452;813065670;46280203
1369;1.18811e-14;-324;1754;25945;19979;1;709;-2.14748e+09;-3.84402e+06;0;0;0;0;0;0;803259644;813402377;46366409
1369;4.26289e-15;-317;1587;9258;10117;1;575;-2.14748e+09;-3.84402e+06;-1;0;0;0;-1;0;803259644;813402377;46366409
1370;1.18811e-14;-324;1754;25945;19979;1;709;-2.14748e+09;-3.83546e+06;-1;0;0;0;-1;0;803566146;813738407;46452538
1370;4.26289e-15;-317;1587;9258;10117;1;575;-2.14748e+09;-3.83546e+06;-1;0;0;0;-1;0;803566146;813738407;46452538
1371;1.18811e-14;-324;1754;25945;19979;1;709;-2.14748e+09;-3.82682e+06;-1;0;0;0;-1;0;803871961;814073761;46538591
1371;4.26289e-15;-318;1587;9258;10117;1;575;-2.14748e+09;-3.82682e+06;0;0;0;0;0;0;803871961;814073761;46538591
1372;1.18811e-14;-324;1754;25945;19979;1;709;-2.14748e+09;-3.81811e+06;-1;0;0;0;-1;0;804177091;814408440;46624568
1372;4.26289e-15;-318;1587;9258;10117;1;575;-2.14748e+09;-3.81811e+06;-1;0;0;0;-1;0;804177091;814408440;46624568
1373;1.18811e-14;-325;1754;25945;19979;1;709;-2.14748e+09;-3.80952e+06;0;0;0;0;0;0;804481538;814742448;46710468
1373;4.26289e-15;-318;1587;9258;10117;1;575;-2.14748e+09;-3.80952e+06;-1;0;0;0;-1;0;804481538;814742448;46710468
1374;1.18811e-14;-325;1754;25945;19979;1;709;-2.14748e+09;-3.80106e+06;-1;0;0;0;-1;0;804785302;815075785;46796292
1374;4.26289e-15;-318;1587;9258;10117;1;575;-2.14748e+09;-3.80106e+06;-1;0;0;0;-1;0;804785302;815075785;46796292
1375;1.18811e-14;-325;1754;25945;19979;1;709;-2.14748e+09;-3.79242e+06;-1;0;0;0;-1;0;805088387;815408452;46882039
1375;4.26289e-15;-319;1587;9258;10117;1;575;-2.14748e+09;-3.79242e+06;0;0;0;0;0;0;805088387;815408452;46882039
1376;1.18811e-14;-326;1754;25945;19979;1;709;-2.14748e+09;-3.784e+06;0;0;0;0;0;0;805390794;815740452;46967709
1376;4.26289e-15;-320;1587;9258;10117;1;575;-2.14748e+09;-3.784e+06;0;0;0;0;0;0;805390794;815740452;46967709
1377;1.18811e-14;-326;1754;25945;19979;1;709;-2.14748e+09;-3.77542e+06;-1;0;0;0;-1;0;805692525;816071787;47053302
1377;4.26289e-15;-321;1587;9258;10117;1;575;-2.14748e+09;-3.77542e+06;0;0;0;0;0;0;805692525;816071787;47053302
1378;1.18811e-14;-327;1754;25945;19979;1;709;-2.14748e+09;-3.76705e+06;0;0;0;0;0;0;805993581;816402457;47138818
1378;4.26289e-15;-321;1587;9258;10117;1;575;-2.14748e+09;-3.76705e+06;-1;0;0;0;-1;0;805993581;816402457;47138818
1379;1.18811e-14;-328;1754;25945;19979;1;709;-2.14748e+09;-3.75851e+06;0;0;0;0;0;0;806293965;816732465;47224256
1379;4.26289e-15;-321;1587;9258;10117;1;575;-2.14748e+09;-3.75851e+06;-1;0;0;0;-1;0;806293965;816732465;47224256
1380;1.18811e-14;-328;1754;25945;19979;1;709;-2.14748e+09;-3.7501e+06;-1;0;0;0;-1;0;806593678;817061813;47309617
1380;4.26289e-15;-321;1587;9258;10117;1;575;-2.14748e+09;-3.7501e+06;-1;0;0;0;-1;0;806593678;817061813;47309617
1381;1.18811e-14;-329;1754;25945;19979;1;709;-2.14748e+09;-3.74171e+06;0;0;0;0;0;0;806892723;817390501;47394900
1381;4.26289e-15;-322;1587;9258;10117;1;575;-2.14748e+09;-3.74171e+06;0;0;0;0;0;0;806892723;817390501;47394900
1382;1.18811e-14;-330;1754;25945;19979;1;709;-2.14748e+09;-3.73344e+06;0;0;0;0;0;0;807191100;817718532;47480104
1382;4.26289e-15;-322;1587;9258;10117;1;575;-2.14748e+09;-3.73334e+06;-1;0;0;0;-1;0;807191100;817718532;47480104
1383;1.18811e-14;-330;1754;25945;19979;1;709;-2.14748e+09;-3.725e+06;-1;0;0;0;-1;0;807488812;818045907;47565231
1383;4.26289e-15;-323;1587;9258;10117;1;575;-2.14748e+09;-3.725e+06;0;0;0;0;0;0;807488812;818045907;47565231
1384;1.18811e-14;-330;1754;25945;19979;1;709;-2.14748e+09;-3.71668e+06;-1;0;0;0;-1;0;807785860;818372627;47650280
1384;4.26289e-15;-324;1587;9258;10117;1;575;-2.14748e+09;-3.71668e+06;0;0;0;0;0;0;807785860;818372627;47650280
1385;1.18811e-14;-331;1754;25945;19979;1;709;-2.14748e+09;-3.70839e+06;0;0;0;0;0;0;808082247;818698695;47735250
1385;4.26289e-15;-325;1587;9258;10117;1;575;-2.14748e+09;-3.70839e+06;0;0;0;0;0;0;808082247;818698695;47735250
1386;1.18811e-14;-332;1754;25945;19979;1;709;-2.14748e+09;-3.70012e+06;0;0;0;0;0;0;808377973;819024112;47820142
1386;4.26289e-15;-326;1587;9258;10117;1;575;-2.14748e+09;-3.70012e+06;0;0;0;0;0;0;808377973;819024112;47820142
1387;1.18811e-14;-332;1754;25945;19979;1;709;-2.14748e+09;-3.69187e+06;-1;0;0;0;-1;0;808673042;819348880;47904955
1387;4.26289e-15;-327;1587;9258;10117;1;575;-2.14748e+09;-3.69187e+06;0;0;0;0;0;0;808673042;819348880;47904955
1388;1.18811e-14;-332;1754;25945;19979;1;709;-2.14748e+09;-3.68375e+06;-1;0;0;0;-1;0;808967453;819673000;47989689
1388;4.26289e-15;-327;1587;9258;10117;1;575;-2.14748e+09;-3.68365e+06;-1;0;0;0;-1;0;808967453;819673000;47989689
1389;1.18811e-14;-332;1754;25945;19979;1;709;-2.14748e+09;-3.67545e+06;-1;0;0;0;-1;0;809261211;819996474;48074344
1389;4.26289e-15;-327;1587;9258;10117;1;575;-2.14748e+09;-3.67545e+06;-1;0;0;0;-1;0;809261211;819996474;48074344
1390;1.18811e-14;-333;1754;25945;19979;1;709;-2.14748e+09;-3.66728e+06;0;0;0;0;0;0;809554315;820319303;48158920
1390;4.26289e-15;-327;1587;9258;10117;1;575;-2.14748e+09;-3.66728e+06;-1;0;0;0;-1;0;809554315;820319303;48158920
1391;1.18811e-14;-333;1754;25945;19979;1;709;-2.14748e+09;-3.65922e+06;-1;0;0;0;-1;0;809846768;820641490;48243417
1391;4.26289e-15;-328;1587;9258;10117;1;575;-2.14748e+09;-3.65922e+06;0;0;0;0;0;0;809846768;820641490;48243417
1392;1.18811e-14;-333;1754;25945;19979;1;709;-2.14748e+09;-3.651e+06;-1;0;0;0;-1;0;810138571;820963034;48327834
1392;4.26289e-15;-329;1587;9258;10117;1;575;-2.14748e+09;-3.651e+06;0;0;0;0;0;0;810138571;820963034;48327834
1393;1.18811e-14;-333;1754;25945;19979;1;709;-2.14748e+09;-3.64299e+06;-1;0;0;0;-1;0;810429727;821283940;48412172
1393;4.26289e-15;-329;1587;9258;10117;1;575;-2.14748e+09;-3.64299e+06;-1;0;0;0;-1;0;810429727;821283940;48412172
1394;1.18811e-14;-334;1754;25945;19979;1;709;-2.14748e+09;-3.63481e+06;0;0;0;0;0;0;810720236;821604206;48496430
1394;4.26289e-15;-329;1587;9258;10117;1;575;-2.14748e+09;-3.63481e+06;-1;0;0;0;-1;0;810720236;821604206;48496430
1395;1.18811e-14;-335;1754;25945;19979;1;709;-2.14748e+09;-3.62685e+06;0;0;0;0;0;0;811010102;821923836;48580608
1395;4.26289e-15;-329;1587;9258;10117;1;575;-2.14748e+09;-3.62685e+06;-1;0;0;0;-1;0;811010102;821923836;48580608
1396;1.18811e-14;-335;1754;25945;19979;1;709;-2.14748e+09;-3.61881e+06;-1;0;0;0;-1;0;811299324;822242831;48664706
1396;4.26289e-15;-330;1587;9258;10117;1;575;-2.14748e+09;-3.61871e+06;0;0;0;0;0;0;811299324;822242831;48664706
1397;1.18811e-14;-335;1754;25945;19979;1;709;-2.14748e+09;-3.6108e+06;-1;0;0;0;-1;0;811587906;822561193;48748724
1397;4.26289e-15;-331;1587;9258;10117;1;575;-2.14748e+09;-3.6108e+06;0;0;0;0;0;0;811587906;822561193;48748724
1398;1.18811e-14;-336;1754;25945;19979;1;709;-2.14748e+09;-3.60271e+06;0;0;0;0;0;0;811875849;822878922;48832662
1398;4.26289e-15;-332;1587;9258;10117;1;575;-2.14748e+09;-3.60271e+06;0;0;0;0;0;0;811875849;822878922;48832662
1399;1.18811e-14;-336;1754;25945;19979;1;709;-2.14748e+09;-3.59474e+06;-1;0;0;0;-1;0;812163154;823196021;48916519
1399;4.26289e-15;-332;1587;9258;10117;1;575;-2.14748e+09;-3.59474e+06;-1;0;0;0;-1;0;812163154;823196021;48916519
1400;1.18811e-14;-337;1754;25945;19979;1;709;-2.14748e+09;-3.58679e+06;0;0;0;0;0;0;812449823;823512491;49000296
1400;4.26289e-15;-333;1587;9258;10117;1;575;-2.14748e+09;-3.58679e+06;0;0;0;0;0;0;812449823;823512491;49000296
1401;1.18811e-14;-337;1754;25945;19979;1;709;-2.14748e+09;-3.57897e+06;-1;0;0;0;-1;0;812735858;823828333;49083992
1401;4.26289e-15;-334;1587;9258;10117;1;575;-2.14748e+09;-3.57887e+06;0;0;0;0;0;0;812735858;823828333;49083992
1402;1.18811e-14;-338;1754;25945;19979;1;709;-2.14748e+09;-3.57097e+06;0;0;0;0;0;0;813021260;824143549;49167607
1402;4.26289e-15;-335;1587;9258;10117;1;575;-2.14748e+09;-3.57097e+06;0;0;0;0;0;0;813021260;824143549;49167607
1403;1.18811e-14;-339;1754;25945;19979;1;709;-2.14748e+09;-3.56309e+06;0;0;0;0;0;0;813306032;824458141;49251142
1403;4.26289e-15;-336;1587;9258;10117;1;575;-2.14748e+09;-3.56309e+06;0;0;0;0;0;0;813306032;824458141;49251142
1404;1.18811e-14;-339;1754;25945;19979;1;709;-2.14748e+09;-3.55523e+06;-1;0;0;0;-1;0;813590175;824772111;49334595
1404;4.26289e-15;-336;1587;9258;10117;1;575;-2.14748e+09;-3.55523e+06;-1;0;0;0;-1;0;813590175;824772111;49334595
1405;1.18811e-14;-340;1754;25945;19979;1;709;-2.14748e+09;-3.5474e+06;0;0;0;0;0;0;813873690;825085459;49417967
1405;4.26289e-15;-337;1587;9258;10117;1;575;-2.14748e+09;-3.5474e+06;0;0;0;0;0;0;813873690;825085459;49417967
1406;1.18811e-14;-340;1754;25945;19979;1;709;-2.14748e+09;-3.53959e+06;-1;0;0;0;-1;0;814156579;825398187;49501258
1406;4.26289e-15;-338;1587;9258;10117;1;575;-2.14748e+09;-3.53959e+06;0;0;0;0;0;0;814156579;825398187;49501258
1407;1.18811e-14;-341;1754;25945;19979;1;709;-2.14748e+09;-3.5318e+06;0;0;0;0;0;0;814438844;825710296;49584467
1407;4.26289e-15;-338;1587;9258;10117;1;575;-2.14748e+09;-3.5318e+06;-1;0;0;0;-1;0;814438844;825710296;49584467
1408;1.18811e-14;-341;1754;25945;19979;1;709;-2.14748e+09;-3.52403e+06;-1;0;0;0;-1;0;814720486;826021789;49667595
1408;4.26289e-15;-338;1587;9258;10117;1;575;-2.14748e+09;-3.52403e+06;-1;0;0;0;-1;0;814720486;826021789;49667595
1409;1.18811e-14;-342;1754;25945;19979;1;709;-2.14748e+09;-3.51628e+06;0;0;0;0;0;0;815001508;826332666;49750641
1409;4.26289e-15;-339;1587;9258;10117;1;575;-2.14748e+09;-3.51628e+06;0;0;0;0;0;0;815001508;826332666;49750641
1410;1.18811e-14;-342;1754;25945;19979;1;709;-2.14748e+09;-3.50856e+06;-1;0;0;0;-1;0;815281910;826642930;49833606
1410;4.26289e-15;-340;1587;9258;10117;1;575;-2.14748e+09;-3.50856e+06;0;0;0;0;0;0;815281910;826642930;49833606
1411;1.18811e-14;-343;1754;25945;19979;1;709;-2.14748e+09;-3.50085e+06;0;0;0;0;0;0;815561695;826952581;49916488
1411;4.26289e-15;-341;1587;9258;10117;1;575;-2.14748e+09;-3.50085e+06;0;0;0;0;0;0;815561695;826952581;49916488
1412;1.18811e-14;-343;1754;25945;19979;1;709;-2.14748e+09;-3.49327e+06;-1;0;0;0;-1;0;815840863;827261621;49999288
1412;4.26289e-15;-341;1587;9258;10117;1;575;-2.14748e+09;-3.49327e+06;-1;0;0;0;-1;0;815840863;827261621;49999288
1413;1.18811e-14;-344;1754;25945;19979;1;709;-2.14748e+09;-3.48551e+06;0;0;0;0;0;0;816119418;827570051;50082007
1413;4.26289e-15;-342;1587;9258;10117;1;575;-2.14748e+09;-3.48551e+06;0;0;0;0;0;0;816119418;827570051;50082007
1414;1.18811e-14;-345;1754;25945;19979;1;709;-2.14748e+09;-3.47787e+06;0;0;0;0;0;0;816397359;827877874;50164643
1414;4.26289e-15;-342;1587;9258;10117;1;575;-2.14748e+09;-3.47787e+06;-1;0;0;0;-1;0;816397359;827877874;50164643
1415;1.18811e-14;-346;1754;25945;19979;1;709;-2.14748e+09;-3.47035e+06;0;0;0;0;0;0;816674689;828185090;50247196
1415;4.26289e-15;-343;1587;9258;10117;1;575;-2.14748e+09;-3.47035e+06;0;0;0;0;0;0;816674689;828185090;50247196
1416;1.18811e-14;-346;1754;25945;19979;1;709;-2.14748e+09;-3.46275e+06;-1;0;0;0;-1;0;816951410;828491701;50329667
1416;4.26289e-15;-343;1587;9258;10117;1;575;-2.14748e+09;-3.46275e+06;-1;0;0;0;-1;0;816951410;828491701;50329667
1417;1.18811e-14;-347;1754;25945;19979;1;709;-2.14748e+09;-3.45508e+06;0;0;0;0;0;0;817227522;828797708;50412056
1417;4.26289e-15;-344;1587;9258;10117;1;575;-2.14748e+09;-3.45508e+06;0;0;0;0;0;0;817227522;828797708;50412056
1418;1.18811e-14;-347;1754;25945;19979;1;709;-2.14748e+09;-3.44762e+06;-1;0;0;0;-1;0;817503028;829103113;50494362
1418;4.26289e-15;-345;1587;9258;10117;1;575;-2.14748e+09;-3.44762e+06;0;0;0;0;0;0;817503028;829103113;50494362
1419;1.18811e-14;-348;1754;25945;19979;1;709;-2.14748e+09;-3.43999e+06;0;0;0;0;0;0;817777929;829407917;50576585
1419;4.26289e-15;-346;1587;9258;10117;1;575;-2.14748e+09;-3.43999e+06;0;0;0;0;0;0;817777929;829407917;50576585
1420;1.18811e-14;-348;1754;25945;19979;1;709;-2.14748e+09;-3.43248e+06;-1;0;0;0;-1;0;818052227;829712122;50658725
1420;4.26289e-15;-347;1587;9258;10117;1;575;-2.14748e+09;-3.43248e+06;0;0;0;0;0;0;818052227;829712122;50658725
1421;1.18811e-14;-348;1754;25945;19979;1;709;-2.14748e+09;-3.42508e+06;-1;0;0;0;-1;0;818325923;830015729;50740782
1421;4.26289e-15;-348;1587;9258;10117;1;575;-2.14748e+09;-3.42508e+06;0;0;0;0;0;0;818325923;830015729;50740782
1422;1.18811e-14;-349;1754;25945;19979;1;709;-2.14748e+09;-3.41761e+06;0;0;0;0;0;0;818599019;830318739;50822755
1422;4.26289e-15;-348;1587;9258;10117;1;575;-2.14748e+09;-3.41761e+06;-1;0;0;0;-1;0;818599019;830318739;50822755
1423;1.18811e-14;-350;1754;25945;19979;1;709;-2.14748e+09;-3.41016e+06;0;0;0;0;0;0;818871517;830621154;50904646
1423;4.26289e-15;-349;1587;9258;10117;1;575;-2.14748e+09;-3.41016e+06;0;0;0;0;0;0;818871517;830621154;50904646
1424;1.18811e-14;-350;1754;25945;19979;1;709;-2.14748e+09;-3.40263e+06;-1;0;0;0;-1;0;819143417;830922976;50986453
1424;4.26289e-15;-350;1587;9258;10117;1;575;-2.14748e+09;-3.40263e+06;0;0;0;0;0;0;819143417;830922976;50986453
1425;1.18811e-14;-350;1754;25945;19979;1;709;-2.14748e+09;-3.39532e+06;-1;0;0;0;-1;0;819414722;831224205;51068177
1425;4.26289e-15;-351;1587;9258;10117;1;575;-2.14748e+09;-3.39532e+06;0;0;0;0;0;0;819414722;831224205;51068177
1426;1.18811e-14;-350;1754;25945;19979;1;709;-2.14748e+09;-3.38793e+06;-1;0;0;0;-1;0;819685433;831524844;51149817
1426;4.26289e-15;-352;1587;9258;10117;1;575;-2.14748e+09;-3.38793e+06;0;0;0;0;0;0;819685433;831524844;51149817
1427;1.18811e-14;-350;1754;25945;19979;1;709;-2.14748e+09;-3.38046e+06;-1;0;0;0;-1;0;819955552;831824893;51231374
1427;4.26289e-15;-353;1587;9258;10117;1;575;-2.14748e+09;-3.38046e+06;0;0;0;0;0;0;819955552;831824893;51231374
1428;1.18811e-14;-351;1754;25945;19979;1;709;-2.14748e+09;-3.37311e+06;0;0;0;0;0;0;820225079;832124354;51312847
1428;4.26289e-15;-354;1587;9258;10117;1;575;-2.14748e+09;-3.37311e+06;0;0;0;0;0;0;820225079;832124354;51312847
1429;1.18811e-14;-352;1754;25945;19979;1;709;-2.14748e+09;-3.36588e+06;0;0;0;0;0;0;820494018;832423228;51394236
1429;4.26289e-15;-354;1587;9258;10117;1;575;-2.14748e+09;-3.36578e+06;-1;0;0;0;-1;0;820494018;832423228;51394236
1430;1.18811e-14;-352;1754;25945;19979;1;709;-2.14748e+09;-3.35847e+06;-1;0;0;0;-1;0;820762368;832721517;51475541
1430;4.26289e-15;-355;1587;9258;10117;1;575;-2.14748e+09;-3.35847e+06;0;0;0;0;0;0;820762368;832721517;51475541
1431;1.18811e-14;-353;1754;25945;19979;1;709;-2.14748e+09;-3.35128e+06;0;0;0;0;0;0;821030133;833019222;51556762
1431;4.26289e-15;-355;1587;9258;10117;1;575;-2.14748e+09;-3.35128e+06;-1;0;0;0;-1;0;821030133;833019222;51556762
1432;1.18811e-14;-353;1754;25945;19979;1;709;-2.14748e+09;-3.34391e+06;-1;0;0;0;-1;0;821297312;833316345;51637899
1432;4.26289e-15;-356;1587;9258;10117;1;575;-2.14748e+09;-3.34391e+06;0;0;0;0;0;0;821297312;833316345;51637899
1433;1.18811e-14;-353;1754;25945;19979;1;709;-2.14748e+09;-3.33666e+06;-1;0;0;0;-1;0;821563909;833612886;51718952
1433;4.26289e-15;-356;1587;9258;10117;1;575;-2.14748e+09;-3.33666e+06;-1;0;0;0;-1;0;821563909;833612886;51718952
1434;1.18811e-14;-354;1754;25945;19979;1;709;-2.14748e+09;-3.32943e+06;0;0;0;0;0;0;821829923;833908847;51799920
1434;4.26289e-15;-357;1587;9258;10117;1;575;-2.14748e+09;-3.32943e+06;0;0;0;0;0;0;821829923;833908847;51799920
1435;1.18811e-14;-354;1754;25945;19979;1;709;-2.14748e+09;-3.32222e+06;-1;0;0;0;-1;0;822095357;834204231;51880804
1435;4.26289e-15;-358;1587;9258;10117;1;575;-2.14748e+09;-3.32222e+06;0;0;0;0;0;0;822095357;834204231;51880804
1436;1.18811e-14;-354;1754;25945;19979;1;709;-2.14748e+09;-3.31503e+06;-1;0;0;0;-1;0;822360213;834499037;51961604
1436;4.26289e-15;-358;1587;9258;10117;1;575;-2.14748e+09;-3.31503e+06;-1;0;0;0;-1;0;822360213;834499037;51961604
1437;1.18811e-14;-355;1754;25945;19979;1;709;-2.14748e+09;-3.30786e+06;0;0;0;0;0;0;822624491;834793267;52042319
1437;4.26289e-15;-358;1587;9258;10117;1;575;-2.14748e+09;-3.30786e+06;-1;0;0;0;-1;0;822624491;834793267;52042319
1438;1.18811e-14;-356;1754;25945;19979;1;709;-2.14748e+09;-3.3007e+06;0;0;0;0;0;0;822888193;835086923;52122949
1438;4.26289e-15;-358;1587;9258;10117;1;575;-2.14748e+09;-3.3007e+06;-1;0;0;0;-1;0;822888193;835086923;52122949
1439;1.18811e-14;-356;1754;25945;19979;1;709;-2.14748e+09;-3.29367e+06;-1;0;0;0;-1;0;823151322;835380006;52203495
1439;4.26289e-15;-359;1587;9258;10117;1;575;-2.14748e+09;-3.29367e+06;0;0;0;0;0;0;823151322;835380006;52203495
1440;1.18811e-14;-357;1754;25945;19979;1;709;-2.14748e+09;-3.28646e+06;0;0;0;0;0;0;823413877;835672517;52283955
1440;4.26289e-15;-359;1587;9258;10117;1;575;-2.14748e+09;-3.28646e+06;-1;0;0;0;-1;0;823413877;835672517;52283955
1441;1.18811e-14;-358;1754;25945;19979;1;709;-2.14748e+09;-3.27946e+06;0;0;0;0;0;0;823675861;835964458;52364331
1441;4.26289e-15;-360;1587;9258;10117;1;575;-2.14748e+09;-3.27946e+06;0;0;0;0;0;0;823675861;835964458;52364331
1442;1.18811e-14;-358;1754;25945;19979;1;709;-2.14748e+09;-3.27229e+06;-1;0;0;0;-1;0;823937275;836255829;52444622
1442;4.26289e-15;-360;1587;9258;10117;1;575;-2.14748e+09;-3.27229e+06;-1;0;0;0;-1;0;823937275;836255829;52444622
1443;1.18811e-14;-358;1754;25945;19979;1;709;-2.14748e+09;-3.26533e+06;-1;0;0;0;-1;0;824198120;836546634;52524828
1443;4.26289e-15;-360;1587;9258;10117;1;575;-2.14748e+09;-3.26533e+06;-1;0;0;0;-1;0;824198120;836546634;52524828
1444;1.18811e-14;-359;1754;25945;19979;1;709;-2.14748e+09;-3.2582e+06;0;0;0;0;0;0;824458399;836836871;52604949
1444;4.26289e-15;-361;1587;9258;10117;1;575;-2.14748e+09;-3.2582e+06;0;0;0;0;0;0;824458399;836836871;52604949
1445;1.18811e-14;-359;1754;25945;19979;1;709;-2.14748e+09;-3.25128e+06;-1;0;0;0;-1;0;824718112;837126544;52684984
1445;4.26289e-15;-362;1587;9258;10117;1;575;-2.14748e+09;-3.25128e+06;0;0;0;0;0;0;824718112;837126544;52684984
1446;1.18811e-14;-359;1754;25945;19979;1;709;-2.14748e+09;-3.24418e+06;-1;0;0;0;-1;0;824977261;837415653;52764934
1446;4.26289e-15;-362;1587;9258;10117;1;575;-2.14748e+09;-3.24418e+06;-1;0;0;0;-1;0;824977261;837415653;52764934
1447;1.18811e-14;-359;1754;25945;19979;1;709;-2.14748e+09;-3.2373e+06;-1;0;0;0;-1;0;825235847;837704199;52844799
1447;4.26289e-15;-363;1587;9258;10117;1;575;-2.14748e+09;-3.2373e+06;0;0;0;0;0;0;825235847;837704199;52844799
1448;1.18811e-14;-359;1754;25945;19979;1;709;-2.14748e+09;-3.23034e+06;-1;0;0;0;-1;0;825493872;837992184;52924578
1448;4.26289e-15;-363;1587;9258;10117;1;575;-2.14748e+09;-3.23024e+06;-1;0;0;0;-1;0;825493872;837992184;52924578
1449;1.18811e-14;-360;1754;25945;19979;1;709;-2.14748e+09;-3.22329e+06;0;0;0;0;0;0;825751337;838279610;53004272
1449;4.26289e-15;-364;1587;9258;10117;1;575;-2.14748e+09;-3.22329e+06;0;0;0;0;0;0;825751337;838279610;53004272
1450;1.18811e-14;-361;1754;25945;19979;1;709;-2.14748e+09;-3.21647e+06;0;0;0;0;0;0;826008244;838566477;53083880
1450;4.26289e-15;-365;1587;9258;10117;1;575;-2.14748e+09;-3.21637e+06;0;0;0;0;0;0;826008244;838566477;53083880
1451;1.18811e-14;-361;1754;25945;19979;1;709;-2.14748e+09;-3.20946e+06;-1;0;0;0;-1;0;826264594;838852786;53163402
1451;4.26289e-15;-366;1587;9258;10117;1;575;-2.14748e+09;-3.20946e+06;0;0;0;0;0;0;826264594;838852786;53163402
1452;1.18811e-14;-362;1754;25945;19979;1;709;-2.14748e+09;-3.20257e+06;0;0;0;0;0;0;826520388;839138540;53242839
1452;4.26289e-15;-367;1587;9258;10117;1;575;-2.14748e+09;-3.20257e+06;0;0;0;0;0;0;826520388;839138540;53242839
1453;1.18811e-14;-362;1754;25945;19979;1;709;-2.14748e+09;-3.1958e+06;-1;0;0;0;-1;0;826775629;839423739;53322190
1453;4.26289e-15;-367;1587;9258;10117;1;575;-2.14748e+09;-3.1958e+06;-1;0;0;0;-1;0;826775629;839423739;53322190
1454;1.18811e-14;-363;1754;25945;19979;1;709;-2.14748e+09;-3.18895e+06;0;0;0;0;0;0;827030317;839708385;53401455
1454;4.26289e-15;-368;1587;9258;10117;1;575;-2.14748e+09;-3.18895e+06;0;0;0;0;0;0;827030317;839708385;53401455
1455;1.18811e-14;-364;1754;25945;19979;1;709;-2.14748e+09;-3.18212e+06;0;0;0;0;0;0;827284453;839992478;53480634
1455;4.26289e-15;-369;1587;9258;10117;1;575;-2.14748e+09;-3.18212e+06;0;0;0;0;0;0;827284453;839992478;53480634
1456;1.18811e-14;-365;1754;25945;19979;1;709;-2.14748e+09;-3.1753e+06;0;0;0;0;0;0;827538039;840276020;53559726
1456;4.26289e-15;-369;1587;9258;10117;1;575;-2.14748e+09;-3.1753e+06;-1;0;0;0;-1;0;827538039;840276020;53559726
1457;1.18811e-14;-366;1754;25945;19979;1;709;-2.14748e+09;-3.16841e+06;0;0;0;0;0;0;827791077;840559013;53638733
1457;4.26289e-15;-370;1587;9258;10117;1;575;-2.14748e+09;-3.16841e+06;0;0;0;0;0;0;827791077;840559013;53638733
1458;1.18811e-14;-366;1754;25945;19979;1;709;-2.14748e+09;-3.16163e+06;-1;0;0;0;-1;0;828043568;840841458;53717654
1458;4.26289e-15;-370;1587;9258;10117;1;575;-2.14748e+09;-3.16163e+06;-1;0;0;0;-1;0;828043568;840841458;53717654
1459;1.18811e-14;-367;1754;25945;19979;1;709;-2.14748e+09;-3.15487e+06;0;0;0;0;0;0;828295513;841123356;53796489
1459;4.26289e-15;-371;1587;9258;10117;1;575;-2.14748e+09;-3.15487e+06;0;0;0;0;0;0;828295513;841123356;53796489
1460;1.18811e-14;-367;1754;25945;19979;1;709;-2.14748e+09;-3.14812e+06;-1;0;0;0;-1;0;828546914;841404707;53875237
1460;4.26289e-15;-371;1587;9258;10117;1;575;-2.14748e+09;-3.14812e+06;-1;0;0;0;-1;0;828546914;841404707;53875237
1461;1.18811e-14;-368;1754;25945;19979;1;709;-2.14748e+09;-3.1415e+06;0;0;0;0;0;0;828797772;841685515;53953899
1461;4.26289e-15;-371;1587;9258;10117;1;575;-2.14748e+09;-3.1414e+06;-1;0;0;0;-1;0;828797772;841685515;53953899
1462;1.18811e-14;-369;1754;25945;19979;1;709;-2.14748e+09;-3.13469e+06;0;0;0;0;0;0;829048088;841965778;54032474
1462;4.26289e-15;-371;1587;9258;10117;1;575;-2.14748e+09;-3.13469e+06;-1;0;0;0;-1;0;829048088;841965778;54032474
1463;1.18811e-14;-369;1754;25945;19979;1;709;-2.14748e+09;-3.128e+06;-1;0;0;0;-1;0;829297864;842245500;54110963
1463;4.26289e-15;-372;1587;9258;10117;1;575;-2.14748e+09;-3.128e+06;0;0;0;0;0;0;829297864;842245500;54110963
1464;1.18811e-14;-369;1754;25945;19979;1;709;-2.14748e+09;-3.12133e+06;-1;0;0;0;-1;0;829547101;842524681;54189366
1464;4.26289e-15;-372;1587;9258;10117;1;575;-2.14748e+09;-3.12133e+06;-1;0;0;0;-1;0;829547101;842524681;54189366
1465;1.18811e-14;-369;1754;25945;19979;1;709;-2.14748e+09;-3.11478e+06;-1;0;0;0;-1;0;829795801;842803322;54267681
1465;4.26289e-15;-372;1587;9258;10117;1;575;-2.14748e+09;-3.11478e+06;-1;0;0;0;-1;0;829795801;842803322;54267681
1466;1.18811e-14;-370;1754;25945;19979;1;709;-2.14748e+09;-3.10814e+06;0;0;0;0;0;0;830043965;843081425;54345911
1466;4.26289e-15;-373;1587;9258;10117;1;575;-2.14748e+09;-3.10814e+06;0;0;0;0;0;0;830043965;843081425;54345911
1467;1.18811e-14;-370;1754;25945;19979;1;709;-2.14748e+09;-3.10142e+06;-1;0;0;0;-1;0;830291593;843358991;54424053
1467;4.26289e-15;-373;1587;9258;10117;1;575;-2.14748e+09;-3.10142e+06;-1;0;0;0;-1;0;830291593;843358991;54424053
1468;1.18811e-14;-370;1754;25945;19979;1;709;-2.14748e+09;-3.09492e+06;-1;0;0;0;-1;0;830538689;843636021;54502109
1468;4.26289e-15;-373;1587;9258;10117;1;575;-2.14748e+09;-3.09492e+06;-1;0;0;0;-1;0;830538689;843636021;54502109
1469;1.18811e-14;-371;1754;25945;19979;1;709;-2.14748e+09;-3.08823e+06;0;0;0;0;0;0;830785252;843912516;54580078
1469;4.26289e-15;-373;1587;9258;10117;1;575;-2.14748e+09;-3.08823e+06;-1;0;0;0;-1;0;830785252;843912516;54580078
1470;1.18811e-14;-372;1754;25945;19979;1;709;-2.14748e+09;-3.08176e+06;0;0;0;0;0;0;831031284;844188478;54657960
1470;4.26289e-15;-373;1587;9258;10117;1;575;-2.14748e+09;-3.08176e+06;-1;0;0;0;-1;0;831031284;844188478;54657960
1471;1.18811e-14;-372;1754;25945;19979;1;709;-2.14748e+09;-3.07521e+06;-1;0;0;0;-1;0;831276788;844463907;54735755
1471;4.26289e-15;-374;1587;9258;10117;1;575;-2.14748e+09;-3.07511e+06;0;0;0;0;0;0;831276788;844463907;54735755
1472;1.18811e-14;-372;1754;25945;19979;1;709;-2.14748e+09;-3.06858e+06;-1;0;0;0;-1;0;831521763;844738805;54813463
1472;4.26289e-15;-375;1587;9258;10117;1;575;-2.14748e+09;-3.06858e+06;0;0;0;0;0;0;831521763;844738805;54813463
1473;1.18811e-14;-373;1754;25945;19979;1;709;-2.14748e+09;-3.06206e+06;0;0;0;0;0;0;831766211;845013174;54891085
1473;4.26289e-15;-376;1587;9258;10117;1;575;-2.14748e+09;-3.06206e+06;0;0;0;0;0;0;831766211;845013174;54891085
1474;1.18811e-14;-374;1754;25945;19979;1;709;-2.14748e+09;-3.05556e+06;0;0;0;0;0;0;832010133;845287013;54968619
1474;4.26289e-15;-377;1587;9258;10117;1;575;-2.14748e+09;-3.05556e+06;0;0;0;0;0;0;832010133;845287013;54968619
1475;1.18811e-14;-374;1754;25945;19979;1;709;-2.14748e+09;-3.04908e+06;-1;0;0;0;-1;0;832253532;845560326;55046066
1475;4.26289e-15;-378;1587;9258;10117;1;575;-2.14748e+09;-3.04908e+06;0;0;0;0;0;0;832253532;845560326;55046066
1476;1.18811e-14;-375;1754;25945;19979;1;709;-2.14748e+09;-3.04262e+06;0;0;0;0;0;0;832496408;845833112;55123426
1476;4.26289e-15;-379;1587;9258;10117;1;575;-2.14748e+09;-3.04262e+06;0;0;0;0;0;0;832496408;845833112;55123426
1477;1.18811e-14;-375;1754;25945;19979;1;709;-2.14748e+09;-3.03617e+06;-1;0;0;0;-1;0;832738762;846105372;55200698
1477;4.26289e-15;-379;1587;9258;10117;1;575;-2.14748e+09;-3.03617e+06;-1;0;0;0;-1;0;832738762;846105372;55200698
1478;1.18811e-14;-375;1754;25945;19979;1;709;-2.14748e+09;-3.02974e+06;-1;0;0;0;-1;0;832980596;846377109;55277884
1478;4.26289e-15;-379;1587;9258;10117;1;575;-2.14748e+09;-3.02974e+06;-1;0;0;0;-1;0;832980596;846377109;55277884
1479;1.18811e-14;-375;1754;25945;19979;1;709;-2.14748e+09;-3.02332e+06;-1;0;0;0;-1;0;833221911;846648324;55354982
1479;4.26289e-15;-380;1587;9258;10117;1;575;-2.14748e+09;-3.02332e+06;0;0;0;0;0;0;833221911;846648324;55354982
1480;1.18811e-14;-376;1754;25945;19979;1;709;-2.14748e+09;-3.01702e+06;0;0;0;0;0;0;833462709;846919016;55431993
1480;4.26289e-15;-381;1587;9258;10117;1;575;-2.14748e+09;-3.01702e+06;0;0;0;0;0;0;833462709;846919016;55431993
1481;1.18811e-14;-376;1754;25945;19979;1;709;-2.14748e+09;-3.01054e+06;-1;0;0;0;-1;0;833702990;847189188;55508916
1481;4.26289e-15;-382;1587;9258;10117;1;575;-2.14748e+09;-3.01054e+06;0;0;0;0;0;0;833702990;847189188;55508916
1482;1.18811e-14;-376;1754;25945;19979;1;709;-2.14748e+09;-3.00417e+06;-1;0;0;0;-1;0;833942756;847458841;55585752
1482;4.26289e-15;-382;1587;9258;10117;1;575;-2.14748e+09;-3.00417e+06;-1;0;0;0;-1;0;833942756;847458841;55585752
1483;1.18811e-14;-376;1754;25945;19979;1;709;-2.14748e+09;-2.99792e+06;-1;0;0;0;-1;0;834182009;847727976;55662501
1483;4.26289e-15;-382;1587;9258;10117;1;575;-2.14748e+09;-2.99782e+06;-1;0;0;0;-1;0;834182009;847727976;55662501
1484;1.18811e-14;-377;1754;25945;19979;1;709;-2.14748e+09;-2.99149e+06;0;0;0;0;0;0;834420749;847996595;55739161
1484;4.26289e-15;-383;1587;9258;10117;1;575;-2.14748e+09;-2.99149e+06;0;0;0;0;0;0;834420749;847996595;55739161
1485;1.18811e-14;-377;1754;25945;19979;1;709;-2.14748e+09;-2.98518e+06;-1;0;0;0;-1;0;834658978;848264697;55815735
1485;4.26289e-15;-383;1587;9258;10117;1;575;-2.14748e+09;-2.98518e+06;-1;0;0;0;-1;0;834658978;848264697;55815735
1486;1.18811e-14;-377;1754;25945;19979;1;709;-2.14748e+09;-2.97888e+06;-1;0;0;0;-1;0;834896696;848532285;55892221
1486;4.26289e-15;-384;1587;9258;10117;1;575;-2.14748e+09;-2.97888e+06;0;0;0;0;0;0;834896696;848532285;55892221
1487;1.18811e-14;-377;1754;25945;19979;1;709;-2.14748e+09;-2.97269e+06;-1;0;0;0;-1;0;835133907;848799359;55968619
1487;4.26289e-15;-385;1587;9258;10117;1;575;-2.14748e+09;-2.97259e+06;0;0;0;0;0;0;835133907;848799359;55968619
1488;1.18811e-14;-378;1754;25945;19979;1;709;-2.14748e+09;-2.96632e+06;0;0;0;0;0;0;835370610;849065921;56044929
1488;4.26289e-15;-385;1587;9258;10117;1;575;-2.14748e+09;-2.96632e+06;-1;0;0;0;-1;0;835370610;849065921;56044929
1489;1.18811e-14;-378;1754;25945;19979;1;709;-2.14748e+09;-2.96007e+06;-1;0;0;0;-1;0;835606806;849331972;56121152
1489;4.26289e-15;-385;1587;9258;10117;1;575;-2.14748e+09;-2.96007e+06;-1;0;0;0;-1;0;835606806;849331972;56121152
1490;1.18811e-14;-379;1754;25945;19979;1;709;-2.14748e+09;-2.95384e+06;0;0;0;0;0;0;835842498;849597513;56197287
1490;4.26289e-15;-386;1587;9258;10117;1;575;-2.14748e+09;-2.95384e+06;0;0;0;0;0;0;835842498;849597513;56197287
1491;1.18811e-14;-380;1754;25945;19979;1;709;-2.14748e+09;-2.94762e+06;0;0;0;0;0;0;836077686;849862545;56273335
1491;4.26289e-15;-387;1587;9258;10117;1;575;-2.14748e+09;-2.94762e+06;0;0;0;0;0;0;836077686;849862545;56273335
1492;1.18811e-14;-380;1754;25945;19979;1;709;-2.14748e+09;-2.94151e+06;-1;0;0;0;-1;0;836312372;850127070;56349294
1492;4.26289e-15;-387;1587;9258;10117;1;575;-2.14748e+09;-2.94141e+06;-1;0;0;0;-1;0;836312372;850127070;56349294
1493;1.18811e-14;-381;1754;25945;19979;1;709;-2.14748e+09;-2.93532e+06;0;0;0;0;0;0;836546557;850391088;56425166
1493;4.26289e-15;-388;1587;9258;10117;1;575;-2.14748e+09;-2.93532e+06;0;0;0;0;0;0;836546557;850391088;56425166
1494;1.18811e-14;-382;1754;25945;19979;1;709;-2.14748e+09;-2.92915e+06;0;0;0;0;0;0;836780242;850654600;56500950
1494;4.26289e-15;-389;1587;9258;10117;1;575;-2.14748e+09;-2.92915e+06;0;0;0;0;0;0;836780242;850654600;56500950
1495;1.18811e-14;-382;1754;25945;19979;1;709;-2.14748e+09;-2.923e+06;-1;0;0;0;-1;0;837013428;850917608;56576646
1495;4.26289e-15;-390;1587;9258;10117;1;575;-2.14748e+09;-2.923e+06;0;0;0;0;0;0;837013428;850917608;56576646
1496;1.18811e-14;-382;1754;25945;19979;1;709;-2.14748e+09;-2.91676e+06;-1;0;0;0;-1;0;837246117;851180113;56652254
1496;4.26289e-15;-390;1587;9258;10117;1;575;-2.14748e+09;-2.91676e+06;-1;0;0;0;-1;0;837246117;851180113;56652254
1497;1.18811e-14;-382;1754;25945;19979;1;709;-2.14748e+09;-2.91063e+06;-1;0;0;0;-1;0;837478310;851442116;56727774
1497;4.26289e-15;-391;1587;9258;10117;1;575;-2.14748e+09;-2.91063e+06;0;0;0;0;0;0;837478310;851442116;56727774
1498;1.18811e-14;-383;1754;25945;19979;1;709;-2.14748e+09;-2.90452e+06;0;0;0;0;0;0;837710007;851703617;56803206
1498;4.26289e-15;-391;1587;9258;10117;1;575;-2.14748e+09;-2.90452e+06;-1;0;0;0;-1;0;837710007;851703617;56803206
1499;1.18811e-14;-384;1754;25945;19979;1;709;-2.14748e+09;-2.89843e+06;0;0;0;0;0;0;837941211;851964619;56878550
1499;4.26289e-15;-391;1587;9258;10117;1;575;-2.14748e+09;-2.89843e+06;-1;0;0;0;-1;0;837941211;851964619;56878550
1500;1.18811e-14;-385;1754;25945;19979;1;709;-2.14748e+09;-2.89245e+06;0;0;0;0;0;0;838171923;852225122;56953806
1500;4.26289e-15;-391;1587;9258;10117;1;575;-2.14748e+09;-2.89235e+06;-1;0;0;0;-1;0;838171923;852225122;56953806
1501;1.18811e-14;-386;1754;25945;19979;1;709;-2.14748e+09;-2.88629e+06;0;0;0;0;0;0;838402143;852485128;57028973
1501;4.26289e-15;-392;1587;9258;10117;1;575;-2.14748e+09;-2.88629e+06;0;0;0;0;0;0;838402143;852485128;57028973
1502;1.18811e-14;-387;1754;25945;19979;1;709;-2.14748e+09;-2.88024e+06;0;0;0;0;0;0;838631873;852744637;57104053
1502;4.26289e-15;-393;1587;9258;10117;1;575;-2.14748e+09;-2.88024e+06;0;0;0;0;0;0;838631873;852744637;57104053
1503;1.18811e-14;-388;1754;25945;19979;1;709;-2.14748e+09;-2.87431e+06;0;0;0;0;0;0;838861114;853003650;57179045
1503;4.26289e-15;-394;1587;9258;10117;1;575;-2.14748e+09;-2.87431e+06;0;0;0;0;0;0;838861114;853003650;57179045
1504;1.18811e-14;-388;1754;25945;19979;1;709;-2.14748e+09;-2.86829e+06;-1;0;0;0;-1;0;839089868;853262169;57253948
1504;4.26289e-15;-395;1587;9258;10117;1;575;-2.14748e+09;-2.86829e+06;0;0;0;0;0;0;839089868;853262169;57253948
1505;1.18811e-14;-389;1754;25945;19979;1;709;-2.14748e+09;-2.86219e+06;0;0;0;0;0;0;839318135;853520195;57328764
1505;4.26289e-15;-395;1587;9258;10117;1;575;-2.14748e+09;-2.86219e+06;-1;0;0;0;-1;0;839318135;853520195;57328764
1506;1.18811e-14;-389;1754;25945;19979;1;709;-2.14748e+09;-2.8563e+06;-1;0;0;0;-1;0;839545916;853777729;57403491
1506;4.26289e-15;-395;1587;9258;10117;1;575;-2.14748e+09;-2.8563e+06;-1;0;0;0;-1;0;839545916;853777729;57403491
1507;1.18811e-14;-390;1754;25945;19979;1;709;-2.14748e+09;-2.85023e+06;0;0;0;0;0;0;839773214;854034771;57478130
1507;4.26289e-15;-395;1587;9258;10117;1;575;-2.14748e+09;-2.85023e+06;-1;0;0;0;-1;0;839773214;854034771;57478130
1508;1.18811e-14;-390;1754;25945;19979;1;709;-2.14748e+09;-2.84427e+06;-1;0;0;0;-1;0;840000028;854291323;57552681
1508;4.26289e-15;-395;1587;9258;10117;1;575;-2.14748e+09;-2.84427e+06;-1;0;0;0;-1;0;840000028;854291323;57552681
1509;1.18811e-14;-391;1754;25945;19979;1;709;-2.14748e+09;-2.83843e+06;0;0;0;0;0;0;840226361;854547387;57627143
1509;4.26289e-15;-396;1587;9258;10117;1;575;-2.14748e+09;-2.83843e+06;0;0;0;0;0;0;840226361;854547387;57627143
1510;1.18811e-14;-392;1754;25945;19979;1;709;-2.14748e+09;-2.8324e+06;0;0;0;0;0;0;840452214;854802963;57701517
1510;4.26289e-15;-396;1587;9258;10117;1;575;-2.14748e+09;-2.8324e+06;-1;0;0;0;-1;0;840452214;854802963;57701517
1511;1.18811e-14;-392;1754;25945;19979;1;709;-2.14748e+09;-2.82649e+06;-1;0;0;0;-1;0;840677587;855058051;57775803
1511;4.26289e-15;-397;1587;9258;10117;1;575;-2.14748e+09;-2.82649e+06;0;0;0;0;0;0;840677587;855058051;57775803
1512;1.18811e-14;-393;1754;25945;19979;1;709;-2.14748e+09;-2.8206e+06;0;0;0;0;0;0;840902482;855312654;57850000
1512;4.26289e-15;-397;1587;9258;10117;1;575;-2.14748e+09;-2.8206e+06;-1;0;0;0;-1;0;840902482;855312654;57850000
1513;1.18811e-14;-393;1754;25945;19979;1;709;-2.14748e+09;-2.81472e+06;-1;0;0;0;-1;0;841126900;855566773;57924110
1513;4.26289e-15;-398;1587;9258;10117;1;575;-2.14748e+09;-2.81472e+06;0;0;0;0;0;0;841126900;855566773;57924110
1514;1.18811e-14;-394;1754;25945;19979;1;709;-2.14748e+09;-2.80885e+06;0;0;0;0;0;0;841350842;855820407;57998131
1514;4.26289e-15;-399;1587;9258;10117;1;575;-2.14748e+09;-2.80885e+06;0;0;0;0;0;0;841350842;855820407;57998131
1515;1.18811e-14;-395;1754;25945;19979;1;709;-2.14748e+09;-2.803e+06;0;0;0;0;0;0;841574309;856073560;58072063
1515;4.26289e-15;-400;1587;9258;10117;1;575;-2.14748e+09;-2.803e+06;0;0;0;0;0;0;841574309;856073560;58072063
1516;1.18811e-14;-395;1754;25945;19979;1;709;-2.14748e+09;-2.79716e+06;-1;0;0;0;-1;0;841797303;856326230;58145907
1516;4.26289e-15;-401;1587;9258;10117;1;575;-2.14748e+09;-2.79716e+06;0;0;0;0;0;0;841797303;856326230;58145907
1517;1.18811e-14;-396;1754;25945;19979;1;709;-2.14748e+09;-2.79134e+06;0;0;0;0;0;0;842019824;856578420;58219663
1517;4.26289e-15;-401;1587;9258;10117;1;575;-2.14748e+09;-2.79134e+06;-1;0;0;0;-1;0;842019824;856578420;58219663
1518;1.18811e-14;-397;1754;25945;19979;1;709;-2.14748e+09;-2.78553e+06;0;0;0;0;0;0;842241874;856830131;58293330
1518;4.26289e-15;-402;1587;9258;10117;1;575;-2.14748e+09;-2.78553e+06;0;0;0;0;0;0;842241874;856830131;58293330
1519;1.18811e-14;-397;1754;25945;19979;1;709;-2.14748e+09;-2.77973e+06;-1;0;0;0;-1;0;842463454;857081363;58366909
1519;4.26289e-15;-402;1587;9258;10117;1;575;-2.14748e+09;-2.77973e+06;-1;0;0;0;-1;0;842463454;857081363;58366909
1520;1.18811e-14;-397;1754;25945;19979;1;709;-2.14748e+09;-2.77395e+06;-1;0;0;0;-1;0;842684565;857332119;58440400
1520;4.26289e-15;-403;1587;9258;10117;1;575;-2.14748e+09;-2.77395e+06;0;0;0;0;0;0;842684565;857332119;58440400
1521;1.18811e-14;-398;1754;25945;19979;1;709;-2.14748e+09;-2.76819e+06;0;0;0;0;0;0;842905209;857582397;58513802
1521;4.26289e-15;-404;1587;9258;10117;1;575;-2.14748e+09;-2.76819e+06;0;0;0;0;0;0;842905209;857582397;58513802
1522;1.18811e-14;-398;1754;25945;19979;1;709;-2.14748e+09;-2.76244e+06;-1;0;0;0;-1;0;843125385;857832201;58587115
1522;4.26289e-15;-405;1587;9258;10117;1;575;-2.14748e+09;-2.76244e+06;0;0;0;0;0;0;843125385;857832201;58587115
1523;1.18811e-14;-399;1754;25945;19979;1;709;-2.14748e+09;-2.7567e+06;0;0;0;0;0;0;843345096;858081530;58660340
1523;4.26289e-15;-406;1587;9258;10117;1;575;-2.14748e+09;-2.7567e+06;0;0;0;0;0;0;843345096;858081530;58660340
1524;1.18811e-14;-399;1754;25945;19979;1;709;-2.14748e+09;-2.75108e+06;-1;0;0;0;-1;0;843564343;858330386;58733477
1524;4.26289e-15;-407;1587;9258;10117;1;575;-2.14748e+09;-2.75098e+06;0;0;0;0;0;0;843564343;858330386;58733477
1525;1.18811e-14;-399;1754;25945;19979;1;709;-2.14748e+09;-2.74537e+06;-1;0;0;0;-1;0;843783127;858578770;58806525
1525;4.26289e-15;-408;1587;9258;10117;1;575;-2.14748e+09;-2.74537e+06;0;0;0;0;0;0;843783127;858578770;58806525
1526;1.18811e-14;-400;1754;25945;19979;1;709;-2.14748e+09;-2.73958e+06;0;0;0;0;0;0;844001448;858826683;58879485
1526;4.26289e-15;-409;1587;9258;10117;1;575;-2.14748e+09;-2.73958e+06;0;0;0;0;0;0;844001448;858826683;58879485
1527;1.18811e-14;-401;1754;25945;19979;1;709;-2.14748e+09;-2.734e+06;0;0;0;0;0;0;844219309;859074126;58952356
1527;4.26289e-15;-410;1587;9258;10117;1;575;-2.14748e+09;-2.7339e+06;0;0;0;0;0;0;844219309;859074126;58952356
1528;1.18811e-14;-401;1754;25945;19979;1;709;-2.14748e+09;-2.72823e+06;-1;0;0;0;-1;0;844436709;859321100;59025138
1528;4.26289e-15;-410;1587;9258;10117;1;575;-2.14748e+09;-2.72823e+06;-1;0;0;0;-1;0;844436709;859321100;59025138
1529;1.18811e-14;-401;1754;25945;19979;1;709;-2.14748e+09;-2.72268e+06;-1;0;0;0;-1;0;844653651;859567605;59097833
1529;4.26289e-15;-411;1587;9258;10117;1;575;-2.14748e+09;-2.72258e+06;0;0;0;0;0;0;844653651;859567605;59097833
1530;1.18811e-14;-401;1754;25945;19979;1;709;-2.14748e+09;-2.71704e+06;-1;0;0;0;-1;0;844870135;859813644;59170438
1530;4.26289e-15;-412;1587;9258;10117;1;575;-2.14748e+09;-2.71694e+06;0;0;0;0;0;0;844870135;859813644;59170438
1531;1.18811e-14;-402;1754;25945;19979;1;709;-2.14748e+09;-2.71142e+06;0;0;0;0;0;0;845086162;860059216;59242955
1531;4.26289e-15;-413;1587;9258;10117;1;575;-2.14748e+09;-2.71132e+06;0;0;0;0;0;0;845086162;860059216;59242955
1532;1.18811e-14;-403;1754;25945;19979;1;709;-2.14748e+09;-2.70581e+06;0;0;0;0;0;0;845301734;860304324;59315384
1532;4.26289e-15;-414;1587;9258;10117;1;575;-2.14748e+09;-2.70571e+06;0;0;0;0;0;0;845301734;860304324;59315384
1533;1.18811e-14;-403;1754;25945;19979;1;709;-2.14748e+09;-2.70011e+06;-1;0;0;0;-1;0;845516852;860548967;59387724
1533;4.26289e-15;-414;1587;9258;10117;1;575;-2.14748e+09;-2.70011e+06;-1;0;0;0;-1;0;845516852;860548967;59387724
1534;1.18811e-14;-404;1754;25945;19979;1;709;-2.14748e+09;-2.69463e+06;0;0;0;0;0;0;845731517;860793147;59459975
1534;4.26289e-15;-414;1587;9258;10117;1;575;-2.14748e+09;-2.69453e+06;-1;0;0;0;-1;0;845731517;860793147;59459975
1535;1.18811e-14;-405;1754;25945;19979;1;709;-2.14748e+09;-2.68906e+06;0;0;0;0;0;0;845945729;861036865;59532138
1535;4.26289e-15;-415;1587;9258;10117;1;575;-2.14748e+09;-2.68906e+06;0;0;0;0;0;0;845945729;861036865;59532138
1536;1.18811e-14;-405;1754;25945;19979;1;709;-2.14748e+09;-2.68351e+06;-1;0;0;0;-1;0;846159490;861280123;59604213
1536;4.26289e-15;-415;1587;9258;10117;1;575;-2.14748e+09;-2.68341e+06;-1;0;0;0;-1;0;846159490;861280123;59604213
1537;1.18811e-14;-405;1754;25945;19979;1;709;-2.14748e+09;-2.67796e+06;-1;0;0;0;-1;0;846372801;861522920;59676199
1537;4.26289e-15;-415;1587;9258;10117;1;575;-2.14748e+09;-2.67796e+06;-1;0;0;0;-1;0;846372801;861522920;59676199
1538;1.18811e-14;-406;1754;25945;19979;1;709;-2.14748e+09;-2.67244e+06;0;0;0;0;0;0;846585664;861765258;59748096
1538;4.26289e-15;-415;1587;9258;10117;1;575;-2.14748e+09;-2.67244e+06;-1;0;0;0;-1;0;846585664;861765258;59748096
1539;1.18811e-14;-407;1754;25945;19979;1;709;-2.14748e+09;-2.66682e+06;0;0;0;0;0;0;846798078;862007138;59819905
1539;4.26289e-15;-415;1587;9258;10117;1;575;-2.14748e+09;-2.66682e+06;-1;0;0;0;-1;0;846798078;862007138;59819905
1540;1.18811e-14;-407;1754;25945;19979;1;709;-2.14748e+09;-2.66132e+06;-1;0;0;0;-1;0;847010046;862248560;59891625
1540;4.26289e-15;-416;1587;9258;10117;1;575;-2.14748e+09;-2.66132e+06;0;0;0;0;0;0;847010046;862248560;59891625
1541;1.18811e-14;-408;1754;25945;19979;1;709;-2.14748e+09;-2.65584e+06;0;0;0;0;0;0;847221568;862489527;59963257
1541;4.26289e-15;-417;1587;9258;10117;1;575;-2.14748e+09;-2.65584e+06;0;0;0;0;0;0;847221568;862489527;59963257
1542;1.18811e-14;-409;1754;25945;19979;1;709;-2.14748e+09;-2.65036e+06;0;0;0;0;0;0;847432646;862730039;60034800
1542;4.26289e-15;-418;1587;9258;10117;1;575;-2.14748e+09;-2.65036e+06;0;0;0;0;0;0;847432646;862730039;60034800
1543;1.18811e-14;-409;1754;25945;19979;1;709;-2.14748e+09;-2.6449e+06;-1;0;0;0;-1;0;847643280;862970096;60106255
1543;4.26289e-15;-418;1587;9258;10117;1;575;-2.14748e+09;-2.6449e+06;-1;0;0;0;-1;0;847643280;862970096;60106255
1544;1.18811e-14;-409;1754;25945;19979;1;709;-2.14748e+09;-2.63946e+06;-1;0;0;0;-1;0;847853471;863209700;60177621
1544;4.26289e-15;-419;1587;9258;10117;1;575;-2.14748e+09;-2.63946e+06;0;0;0;0;0;0;847853471;863209700;60177621
1545;1.18811e-14;-409;1754;25945;19979;1;709;-2.14748e+09;-2.63412e+06;-1;0;0;0;-1;0;848063221;863448852;60248899
1545;4.26289e-15;-419;1587;9258;10117;1;575;-2.14748e+09;-2.63412e+06;-1;0;0;0;-1;0;848063221;863448852;60248899
1546;1.18811e-14;-409;1754;25945;19979;1;709;-2.14748e+09;-2.6287e+06;-1;0;0;0;-1;0;848272531;863687553;60320088
1546;4.26289e-15;-420;1587;9258;10117;1;575;-2.14748e+09;-2.6286e+06;0;0;0;0;0;0;848272531;863687553;60320088
1547;1.18811e-14;-410;1754;25945;19979;1;709;-2.14748e+09;-2.62329e+06;0;0;0;0;0;0;848481402;863925803;60391188
1547;4.26289e-15;-421;1587;9258;10117;1;575;-2.14748e+09;-2.62329e+06;0;0;0;0;0;0;848481402;863925803;60391188
1548;1.18811e-14;-411;1754;25945;19979;1;709;-2.14748e+09;-2.6178e+06;0;0;0;0;0;0;848689834;864163604;60462201
1548;4.26289e-15;-421;1587;9258;10117;1;575;-2.14748e+09;-2.6178e+06;-1;0;0;0;-1;0;848689834;864163604;60462201
1549;1.18811e-14;-412;1754;25945;19979;1;709;-2.14748e+09;-2.61242e+06;0;0;0;0;0;0;848897829;864400957;60533124
1549;4.26289e-15;-422;1587;9258;10117;1;575;-2.14748e+09;-2.61242e+06;0;0;0;0;0;0;848897829;864400957;60533124
1550;1.18811e-14;-413;1754;25945;19979;1;709;-2.14748e+09;-2.60715e+06;0;0;0;0;0;0;849105388;864637862;60603959
1550;4.26289e-15;-422;1587;9258;10117;1;575;-2.14748e+09;-2.60705e+06;-1;0;0;0;-1;0;849105388;864637862;60603959
1551;1.18811e-14;-413;1754;25945;19979;1;709;-2.14748e+09;-2.6018e+06;-1;0;0;0;-1;0;849312512;864874320;60674706
1551;4.26289e-15;-423;1587;9258;10117;1;575;-2.14748e+09;-2.6017e+06;0;0;0;0;0;0;849312512;864874320;60674706
1552;1.18811e-14;-414;1754;25945;19979;1;709;-2.14748e+09;-2.59636e+06;0;0;0;0;0;0;849519202;865110334;60745364
1552;4.26289e-15;-424;1587;9258;10117;1;575;-2.14748e+09;-2.59636e+06;0;0;0;0;0;0;849519202;865110334;60745364
1553;1.18811e-14;-415;1754;25945;19979;1;709;-2.14748e+09;-2.59113e+06;0;0;0;0;0;0;849725459;865345902;60815934
1553;4.26289e-15;-425;1587;9258;10117;1;575;-2.14748e+09;-2.59113e+06;0;0;0;0;0;0;849725459;865345902;60815934
1554;1.18811e-14;-416;1754;25945;19979;1;709;-2.14748e+09;-2.58571e+06;0;0;0;0;0;0;849931284;865581027;60886415
1554;4.26289e-15;-425;1587;9258;10117;1;575;-2.14748e+09;-2.58571e+06;-1;0;0;0;-1;0;849931284;865581027;60886415
1555;1.18811e-14;-416;1754;25945;19979;1;709;-2.14748e+09;-2.58051e+06;-1;0;0;0;-1;0;850136678;865815709;60956808
1555;4.26289e-15;-425;1587;9258;10117;1;575;-2.14748e+09;-2.58041e+06;-1;0;0;0;-1;0;850136678;865815709;60956808
1556;1.18811e-14;-416;1754;25945;19979;1;709;-2.14748e+09;-2.57512e+06;-1;0;0;0;-1;0;850341642;866049950;61027112
1556;4.26289e-15;-426;1587;9258;10117;1;575;-2.14748e+09;-2.57512e+06;0;0;0;0;0;0;850341642;866049950;61027112
1557;1.18811e-14;-416;1754;25945;19979;1;709;-2.14748e+09;-2.56994e+06;-1;0;0;0;-1;0;850546177;866283749;61097328
1557;4.26289e-15;-426;1587;9258;10117;1;575;-2.14748e+09;-2.56984e+06;-1;0;0;0;-1;0;850546177;866283749;61097328
1558;1.18811e-14;-416;1754;25945;19979;1;709;-2.14748e+09;-2.56458e+06;-1;0;0;0;-1;0;850750285;866517109;61167456
1558;4.26289e-15;-427;1587;9258;10117;1;575;-2.14748e+09;-2.56458e+06;0;0;0;0;0;0;850750285;866517109;61167456
1559;1.18811e-14;-417;1754;25945;19979;1;709;-2.14748e+09;-2.55942e+06;0;0;0;0;0;0;850953965;866750030;61237495
1559;4.26289e-15;-428;1587;9258;10117;1;575;-2.14748e+09;-2.55942e+06;0;0;0;0;0;0;850953965;866750030;61237495
1560;1.18811e-14;-417;1754;25945;19979;1;709;-2.14748e+09;-2.55408e+06;-1;0;0;0;-1;0;851157220;866982513;61307446
1560;4.26289e-15;-429;1587;9258;10117;1;575;-2.14748e+09;-2.55409e+06;0;0;0;0;0;0;851157220;866982513;61307446
1561;1.18811e-14;-417;1754;25945;19979;1;709;-2.14748e+09;-2.54886e+06;-1;0;0;0;-1;0;851360050;867214558;61377308
1561;4.26289e-15;-429;1587;9258;10117;1;575;-2.14748e+09;-2.54886e+06;-1;0;0;0;-1;0;851360050;867214558;61377308
1562;1.18811e-14;-417;1754;25945;19979;1;709;-2.14748e+09;-2.54364e+06;-1;0;0;0;-1;0;851562456;867446168;61447082
1562;4.26289e-15;-429;1587;9258;10117;1;575;-2.14748e+09;-2.54364e+06;-1;0;0;0;-1;0;851562456;867446168;61447082
1563;1.18811e-14;-418;1754;25945;19979;1;709;-2.14748e+09;-2.53854e+06;0;0;0;0;0;0;851764439;867677342;61516768
1563;4.26289e-15;-430;1587;9258;10117;1;575;-2.14748e+09;-2.53854e+06;0;0;0;0;0;0;851764439;867677342;61516768
1564;1.18811e-14;-419;1754;25945;19979;1;709;-2.14748e+09;-2.53335e+06;0;0;0;0;0;0;851966001;867908082;61586365
1564;4.26289e-15;-430;1587;9258;10117;1;575;-2.14748e+09;-2.53335e+06;-1;0;0;0;-1;0;851966001;867908082;61586365
1565;1.18811e-14;-419;1754;25945;19979;1;709;-2.14748e+09;-2.52818e+06;-1;0;0;0;-1;0;852167142;868138388;61655875
1565;4.26289e-15;-430;1587;9258;10117;1;575;-2.14748e+09;-2.52808e+06;-1;0;0;0;-1;0;852167142;868138388;61655875
1566;1.18811e-14;-420;1754;25945;19979;1;709;-2.14748e+09;-2.52291e+06;0;0;0;0;0;0;852367863;868368262;61725295
1566;4.26289e-15;-431;1587;9258;10117;1;575;-2.14748e+09;-2.52291e+06;0;0;0;0;0;0;852367863;868368262;61725295
1567;1.18811e-14;-421;1754;25945;19979;1;709;-2.14748e+09;-2.51786e+06;0;0;0;0;0;0;852568165;868597705;61794628
1567;4.26289e-15;-432;1587;9258;10117;1;575;-2.14748e+09;-2.51776e+06;0;0;0;0;0;0;852568165;868597705;61794628
1568;1.18811e-14;-421;1754;25945;19979;1;709;-2.14748e+09;-2.51272e+06;-1;0;0;0;-1;0;852768049;868826716;61863872
1568;4.26289e-15;-433;1587;9258;10117;1;575;-2.14748e+09;-2.51262e+06;0;0;0;0;0;0;852768049;868826716;61863872
1569;1.18811e-14;-421;1754;25945;19979;1;709;-2.14748e+09;-2.5075e+06;-1;0;0;0;-1;0;852967517;869055298;61933028
1569;4.26289e-15;-434;1587;9258;10117;1;575;-2.14748e+09;-2.5075e+06;0;0;0;0;0;0;852967517;869055298;61933028
1570;1.18811e-14;-421;1754;25945;19979;1;709;-2.14748e+09;-2.50238e+06;-1;0;0;0;-1;0;853166569;869283451;62002096
1570;4.26289e-15;-434;1587;9258;10117;1;575;-2.14748e+09;-2.50238e+06;-1;0;0;0;-1;0;853166569;869283451;62002096
1571;1.18811e-14;-422;1754;25945;19979;1;709;-2.14748e+09;-2.49738e+06;0;0;0;0;0;0;853365206;869511176;62071075
1571;4.26289e-15;-434;1587;9258;10117;1;575;-2.14748e+09;-2.49738e+06;-1;0;0;0;-1;0;853365206;869511176;62071075
1572;1.18811e-14;-422;1754;25945;19979;1;709;-2.14748e+09;-2.49219e+06;-1;0;0;0;-1;0;853563429;869738474;62139967
1572;4.26289e-15;-435;1587;9258;10117;1;575;-2.14748e+09;-2.49219e+06;0;0;0;0;0;0;853563429;869738474;62139967
1573;1.18811e-14;-423;1754;25945;19979;1;709;-2.14748e+09;-2.48721e+06;0;0;0;0;0;0;853761239;869965346;62208770
1573;4.26289e-15;-436;1587;9258;10117;1;575;-2.14748e+09;-2.48721e+06;0;0;0;0;0;0;853761239;869965346;62208770
1574;1.18811e-14;-423;1754;25945;19979;1;709;-2.14748e+09;-2.48214e+06;-1;0;0;0;-1;0;853958637;870191792;62277485
1574;4.26289e-15;-437;1587;9258;10117;1;575;-2.14748e+09;-2.48214e+06;0;0;0;0;0;0;853958637;870191792;62277485
1575;1.18811e-14;-423;1754;25945;19979;1;709;-2.14748e+09;-2.47709e+06;-1;0;0;0;-1;0;854155624;870417814;62346112
1575;4.26289e-15;-437;1587;9258;10117;1;575;-2.14748e+09;-2.47709e+06;-1;0;0;0;-1;0;854155624;870417814;62346112
1576;1.18811e-14;-424;1754;25945;19979;1;709;-2.14748e+09;-2.47205e+06;0;0;0;0;0;0;854352202;870643413;62414651
1576;4.26289e-15;-438;1587;9258;10117;1;575;-2.14748e+09;-2.47195e+06;0;0;0;0;0;0;854352202;870643413;62414651
1577;1.18811e-14;-425;1754;25945;19979;1;709;-2.14748e+09;-2.46702e+06;0;0;0;0;0;0;854548370;870868589;62483102
1577;4.26289e-15;-439;1587;9258;10117;1;575;-2.14748e+09;-2.46702e+06;0;0;0;0;0;0;854548370;870868589;62483102
1578;1.18811e-14;-426;1754;25945;19979;1;709;-2.14748e+09;-2.462e+06;0;0;0;0;0;0;854744131;871093343;62551465
1578;4.26289e-15;-439;1587;9258;10117;1;575;-2.14748e+09;-2.462e+06;-1;0;0;0;-1;0;854744131;871093343;62551465
1579;1.18811e-14;-426;1754;25945;19979;1;709;-2.14748e+09;-2.45689e+06;-1;0;0;0;-1;0;854939484;871317676;62619739
1579;4.26289e-15;-439;1587;9258;10117;1;575;-2.14748e+09;-2.45689e+06;-1;0;0;0;-1;0;854939484;871317676;62619739
1580;1.18811e-14;-427;1754;25945;19979;1;709;-2.14748e+09;-2.4519e+06;0;0;0;0;0;0;855134431;871541589;62687926
1580;4.26289e-15;-440;1587;9258;10117;1;575;-2.14748e+09;-2.4519e+06;0;0;0;0;0;0;855134431;871541589;62687926
1581;1.18811e-14;-428;1754;25945;19979;1;709;-2.14748e+09;-2.44692e+06;0;0;0;0;0;0;855328973;871765084;62756025
1581;4.26289e-15;-440;1587;9258;10117;1;575;-2.14748e+09;-2.44692e+06;-1;0;0;0;-1;0;855328973;871765084;62756025
1582;1.18811e-14;-429;1754;25945;19979;1;709;-2.14748e+09;-2.44204e+06;0;0;0;0;0;0;855523111;871988159;62824035
1582;4.26289e-15;-441;1587;9258;10117;1;575;-2.14748e+09;-2.44204e+06;0;0;0;0;0;0;855523111;871988159;62824035
1583;1.18811e-14;-430;1754;25945;19979;1;709;-2.14748e+09;-2.43699e+06;0;0;0;0;0;0;855716846;872210818;62891958
1583;4.26289e-15;-442;1587;9258;10117;1;575;-2.14748e+09;-2.43699e+06;0;0;0;0;0;0;855716846;872210818;62891958
1584;1.18811e-14;-430;1754;25945;19979;1;709;-2.14748e+09;-2.43204e+06;-1;0;0;0;-1;0;855910178;872433060;62959793
1584;4.26289e-15;-443;1587;9258;10117;1;575;-2.14748e+09;-2.43204e+06;0;0;0;0;0;0;855910178;872433060;62959793
1585;1.18811e-14;-430;1754;25945;19979;1;709;-2.14748e+09;-2.4272e+06;-1;0;0;0;-1;0;856103109;872654887;63027540
1585;4.26289e-15;-444;1587;9258;10117;1;575;-2.14748e+09;-2.4272e+06;0;0;0;0;0;0;856103109;872654887;63027540
1586;1.18811e-14;-430;1754;25945;19979;1;709;-2.14748e+09;-2.42228e+06;-1;0;0;0;-1;0;856295640;872876298;63095199
1586;4.26289e-15;-445;1587;9258;10117;1;575;-2.14748e+09;-2.42228e+06;0;0;0;0;0;0;856295640;872876298;63095199
1587;1.18811e-14;-430;1754;25945;19979;1;709;-2.14748e+09;-2.41737e+06;-1;0;0;0;-1;0;856487771;873097296;63162771
1587;4.26289e-15;-446;1587;9258;10117;1;575;-2.14748e+09;-2.41727e+06;0;0;0;0;0;0;856487771;873097296;63162771
1588;1.18811e-14;-431;1754;25945;19979;1;709;-2.14748e+09;-2.41237e+06;0;0;0;0;0;0;856679504;873317881;63230254
1588;4.26289e-15;-447;1587;9258;10117;1;575;-2.14748e+09;-2.41237e+06;0;0;0;0;0;0;856679504;873317881;63230254
1589;1.18811e-14;-431;1754;25945;19979;1;709;-2.14748e+09;-2.40758e+06;-1;0;0;0;-1;0;856870839;873538053;63297650
1589;4.26289e-15;-447;1587;9258;10117;1;575;-2.14748e+09;-2.40758e+06;-1;0;0;0;-1;0;856870839;873538053;63297650
1590;1.18811e-14;-432;1754;25945;19979;1;709;-2.14748e+09;-2.4026e+06;0;0;0;0;0;0;857061777;873757814;63364958
1590;4.26289e-15;-448;1587;9258;10117;1;575;-2.14748e+09;-2.4026e+06;0;0;0;0;0;0;857061777;873757814;63364958
1591;1.18811e-14;-432;1754;25945;19979;1;709;-2.14748e+09;-2.39774e+06;-1;0;0;0;-1;0;857252320;873977165;63432178
1591;4.26289e-15;-449;1587;9258;10117;1;575;-2.14748e+09;-2.39774e+06;0;0;0;0;0;0;857252320;873977165;63432178
1592;1.18811e-14;-433;1754;25945;19979;1;709;-2.14748e+09;-2.39298e+06;0;0;0;0;0;0;857442468;874196106;63499311
1592;4.26289e-15;-449;1587;9258;10117;1;575;-2.14748e+09;-2.39288e+06;-1;0;0;0;-1;0;857442468;874196106;63499311
1593;1.18811e-14;-434;1754;25945;19979;1;709;-2.14748e+09;-2.38804e+06;0;0;0;0;0;0;857632222;874414638;63566356
1593;4.26289e-15;-449;1587;9258;10117;1;575;-2.14748e+09;-2.38804e+06;-1;0;0;0;-1;0;857632222;874414638;63566356
1594;1.18811e-14;-434;1754;25945;19979;1;709;-2.14748e+09;-2.38321e+06;-1;0;0;0;-1;0;857821582;874632763;63633313
1594;4.26289e-15;-450;1587;9258;10117;1;575;-2.14748e+09;-2.38321e+06;0;0;0;0;0;0;857821582;874632763;63633313
1595;1.18811e-14;-434;1754;25945;19979;1;709;-2.14748e+09;-2.37839e+06;-1;0;0;0;-1;0;858010551;874850480;63700183
1595;4.26289e-15;-451;1587;9258;10117;1;575;-2.14748e+09;-2.37839e+06;0;0;0;0;0;0;858010551;874850480;63700183
1596;1.18811e-14;-435;1754;25945;19979;1;709;-2.14748e+09;-2.37358e+06;0;0;0;0;0;0;858199129;875067791;63766965
1596;4.26289e-15;-451;1587;9258;10117;1;575;-2.14748e+09;-2.37358e+06;-1;0;0;0;-1;0;858199129;875067791;63766965
1597;1.18811e-14;-435;1754;25945;19979;1;709;-2.14748e+09;-2.36878e+06;-1;0;0;0;-1;0;858387317;875284696;63833659
1597;4.26289e-15;-451;1587;9258;10117;1;575;-2.14748e+09;-2.36878e+06;-1;0;0;0;-1;0;858387317;875284696;63833659
1598;1.18811e-14;-435;1754;25945;19979;1;709;-2.14748e+09;-2.36409e+06;-1;0;0;0;-1;0;858575115;875501197;63900266
1598;4.26289e-15;-452;1587;9258;10117;1;575;-2.14748e+09;-2.36399e+06;0;0;0;0;0;0;858575115;875501197;63900266
1599;1.18811e-14;-435;1754;25945;19979;1;709;-2.14748e+09;-2.35922e+06;-1;0;0;0;-1;0;858762525;875717295;63966786
1599;4.26289e-15;-453;1587;9258;10117;1;575;-2.14748e+09;-2.35922e+06;0;0;0;0;0;0;858762525;875717295;63966786
1600;1.18811e-14;-436;1754;25945;19979;1;709;-2.14748e+09;-2.35445e+06;0;0;0;0;0;0;858949548;875932989;64033218
1600;4.26289e-15;-453;1587;9258;10117;1;575;-2.14748e+09;-2.35445e+06;-1;0;0;0;-1;0;858949548;875932989;64033218
1601;1.18811e-14;-436;1754;25945;19979;1;709;-2.14748e+09;-2.3497e+06;-1;0;0;0;-1;0;859136184;876148281;64099563
1601;4.26289e-15;-454;1587;9258;10117;1;575;-2.14748e+09;-2.3497e+06;0;0;0;0;0;0;859136184;876148281;64099563
1602;1.18811e-14;-437;1754;25945;19979;1;709;-2.14748e+09;-2.34506e+06;0;0;0;0;0;0;859322434;876363172;64165820
1602;4.26289e-15;-454;1587;9258;10117;1;575;-2.14748e+09;-2.34506e+06;-1;0;0;0;-1;0;859322434;876363172;64165820
1603;1.18811e-14;-437;1754;25945;19979;1;709;-2.14748e+09;-2.34033e+06;-1;0;0;0;-1;0;859508299;876577663;64231990
1603;4.26289e-15;-455;1587;9258;10117;1;575;-2.14748e+09;-2.34023e+06;0;0;0;0;0;0;859508299;876577663;64231990
1604;1.18811e-14;-437;1754;25945;19979;1;709;-2.14748e+09;-2.33561e+06;-1;0;0;0;-1;0;859693781;876791754;64298073
1604;4.26289e-15;-456;1587;9258;10117;1;575;-2.14748e+09;-2.33561e+06;0;0;0;0;0;0;859693781;876791754;64298073
1605;1.18811e-14;-438;1754;25945;19979;1;709;-2.14748e+09;-2.3308e+06;0;0;0;0;0;0;859878879;877005446;64364069
1605;4.26289e-15;-457;1587;9258;10117;1;575;-2.14748e+09;-2.3308e+06;0;0;0;0;0;0;859878879;877005446;64364069
1606;1.18811e-14;-438;1754;25945;19979;1;709;-2.14748e+09;-2.3262e+06;-1;0;0;0;-1;0;860063596;877218741;64429977
1606;4.26289e-15;-457;1587;9258;10117;1;575;-2.14748e+09;-2.3262e+06;-1;0;0;0;-1;0;860063596;877218741;64429977
1607;1.18811e-14;-438;1754;25945;19979;1;709;-2.14748e+09;-2.32141e+06;-1;0;0;0;-1;0;860247931;877431638;64495798
1607;4.26289e-15;-457;1587;9258;10117;1;575;-2.14748e+09;-2.32141e+06;-1;0;0;0;-1;0;860247931;877431638;64495798
1608;1.18811e-14;-438;1754;25945;19979;1;709;-2.14748e+09;-2.31684e+06;-1;0;0;0;-1;0;860431886;877644139;64561532
1608;4.26289e-15;-458;1587;9258;10117;1;575;-2.14748e+09;-2.31674e+06;0;0;0;0;0;0;860431886;877644139;64561532
1609;1.18811e-14;-438;1754;25945;19979;1;709;-2.14748e+09;-2.31207e+06;-1;0;0;0;-1;0;860615461;877856244;64627179
1609;4.26289e-15;-458;1587;9258;10117;1;575;-2.14748e+09;-2.31207e+06;-1;0;0;0;-1;0;860615461;877856244;64627179
1610;1.18811e-14;-439;1754;25945;19979;1;709;-2.14748e+09;-2.30742e+06;0;0;0;0;0;0;860798658;878067955;64692738
1610;4.26289e-15;-459;1587;9258;10117;1;575;-2.14748e+09;-2.30742e+06;0;0;0;0;0;0;860798658;878067955;64692738
1611;1.18811e-14;-439;1754;25945;19979;1;709;-2.14748e+09;-2.30287e+06;-1;0;0;0;-1;0;860981477;878279271;64758211
1611;4.26289e-15;-459;1587;9258;10117;1;575;-2.14748e+09;-2.30287e+06;-1;0;0;0;-1;0;860981477;878279271;64758211
1612;1.18811e-14;-439;1754;25945;19979;1;709;-2.14748e+09;-2.29814e+06;-1;0;0;0;-1;0;861163920;878490195;64823597
1612;4.26289e-15;-460;1587;9258;10117;1;575;-2.14748e+09;-2.29814e+06;0;0;0;0;0;0;861163920;878490195;64823597
1613;1.18811e-14;-440;1754;25945;19979;1;709;-2.14748e+09;-2.29352e+06;0;0;0;0;0;0;861345986;878700726;64888895
1613;4.26289e-15;-461;1587;9258;10117;1;575;-2.14748e+09;-2.29352e+06;0;0;0;0;0;0;861345986;878700726;64888895
1614;1.18811e-14;-441;1754;25945;19979;1;709;-2.14748e+09;-2.28891e+06;0;0;0;0;0;0;861527678;878910866;64954107
1614;4.26289e-15;-461;1587;9258;10117;1;575;-2.14748e+09;-2.28891e+06;-1;0;0;0;-1;0;861527678;878910866;64954107
1615;1.18811e-14;-441;1754;25945;19979;1;709;-2.14748e+09;-2.28431e+06;-1;0;0;0;-1;0;861708995;879120615;65019232
1615;4.26289e-15;-461;1587;9258;10117;1;575;-2.14748e+09;-2.28431e+06;-1;0;0;0;-1;0;861708995;879120615;65019232
1616;1.18811e-14;-441;1754;25945;19979;1;709;-2.14748e+09;-2.27972e+06;-1;0;0;0;-1;0;861889939;879329974;65084270
1616;4.26289e-15;-461;1587;9258;10117;1;575;-2.14748e+09;-2.27972e+06;-1;0;0;0;-1;0;861889939;879329974;65084270
1617;1.18811e-14;-441;1754;25945;19979;1;709;-2.14748e+09;-2.27514e+06;-1;0;0;0;-1;0;862070510;879538945;65149221
1617;4.26289e-15;-461;1587;9258;10117;1;575;-2.14748e+09;-2.27514e+06;-1;0;0;0;-1;0;862070510;879538945;65149221
1618;1.18811e-14;-442;1754;25945;19979;1;709;-2.14748e+09;-2.27057e+06;0;0;0;0;0;0;862250710;879747527;65214086
1618;4.26289e-15;-462;1587;9258;10117;1;575;-2.14748e+09;-2.27057e+06;0;0;0;0;0;0;862250710;879747527;65214086
1619;1.18811e-14;-443;1754;25945;19979;1;709;-2.14748e+09;-2.26611e+06;0;0;0;0;0;0;862430539;879955721;65278863
1619;4.26289e-15;-462;1587;9258;10117;1;575;-2.14748e+09;-2.26601e+06;-1;0;0;0;-1;0;862430539;879955721;65278863
1620;1.18811e-14;-444;1754;25945;19979;1;709;-2.14748e+09;-2.26156e+06;0;0;0;0;0;0;862609998;880163529;65343554
1620;4.26289e-15;-463;1587;9258;10117;1;575;-2.14748e+09;-2.26156e+06;0;0;0;0;0;0;862609998;880163529;65343554
1621;1.18811e-14;-444;1754;25945;19979;1;709;-2.14748e+09;-2.25702e+06;-1;0;0;0;-1;0;862789088;880370950;65408159
1621;4.26289e-15;-463;1587;9258;10117;1;575;-2.14748e+09;-2.25692e+06;-1;0;0;0;-1;0;862789088;880370950;65408159
1622;1.18811e-14;-444;1754;25945;19979;1;709;-2.14748e+09;-2.2525e+06;-1;0;0;0;-1;0;862967810;880577987;65472676
1622;4.26289e-15;-464;1587;9258;10117;1;575;-2.14748e+09;-2.2525e+06;0;0;0;0;0;0;862967810;880577987;65472676
1623;1.18811e-14;-445;1754;25945;19979;1;709;-2.14748e+09;-2.24798e+06;0;0;0;0;0;0;863146165;880784639;65537107
1623;4.26289e-15;-464;1587;9258;10117;1;575;-2.14748e+09;-2.24788e+06;-1;0;0;0;-1;0;863146165;880784639;65537107
1624;1.18811e-14;-445;1754;25945;19979;1;709;-2.14748e+09;-2.24337e+06;-1;0;0;0;-1;0;863324153;880990908;65601452
1624;4.26289e-15;-465;1587;9258;10117;1;575;-2.14748e+09;-2.24337e+06;0;0;0;0;0;0;863324153;880990908;65601452
1625;1.18811e-14;-445;1754;25945;19979;1;709;-2.14748e+09;-2.23888e+06;-1;0;0;0;-1;0;863501775;881196794;65665710
1625;4.26289e-15;-465;1587;9258;10117;1;575;-2.14748e+09;-2.23888e+06;-1;0;0;0;-1;0;863501775;881196794;65665710
1626;1.18811e-14;-446;1754;25945;19979;1;709;-2.14748e+09;-2.23439e+06;0;0;0;0;0;0;863679033;881402298;65729882
1626;4.26289e-15;-465;1587;9258;10117;1;575;-2.14748e+09;-2.23439e+06;-1;0;0;0;-1;0;863679033;881402298;65729882
1627;1.18811e-14;-447;1754;25945;19979;1;709;-2.14748e+09;-2.22992e+06;0;0;0;0;0;0;863855927;881607420;65793967
1627;4.26289e-15;-465;1587;9258;10117;1;575;-2.14748e+09;-2.22992e+06;-1;0;0;0;-1;0;863855927;881607420;65793967
1628;1.18811e-14;-447;1754;25945;19979;1;709;-2.14748e+09;-2.22555e+06;-1;0;0;0;-1;0;864032457;881812163;65857966
1628;4.26289e-15;-466;1587;9258;10117;1;575;-2.14748e+09;-2.22555e+06;0;0;0;0;0;0;864032457;881812163;65857966
1629;1.18811e-14;-448;1754;25945;19979;1;709;-2.14748e+09;-2.2211e+06;0;0;0;0;0;0;864208626;882016525;65921879
1629;4.26289e-15;-466;1587;9258;10117;1;575;-2.14748e+09;-2.221e+06;-1;0;0;0;-1;0;864208625;882016525;65921879
1630;1.18811e-14;-448;1754;25945;19979;1;709;-2.14748e+09;-2.21655e+06;-1;0;0;0;-1;0;864384432;882220509;65985705
1630;4.26289e-15;-466;1587;9258;10117;1;575;-2.14748e+09;-2.21655e+06;-1;0;0;0;-1;0;864384432;882220509;65985705
1631;1.18811e-14;-448;1754;25945;19979;1;709;-2.14748e+09;-2.21212e+06;-1;0;0;0;-1;0;864559878;882424114;66049445
1631;4.26289e-15;-466;1587;9258;10117;1;575;-2.14748e+09;-2.21212e+06;-1;0;0;0;-1;0;864559878;882424114;66049445
1632;1.18811e-14;-449;1754;25945;19979;1;709;-2.14748e+09;-2.2078e+06;0;0;0;0;0;0;864734965;882627342;66113099
1632;4.26289e-15;-467;1587;9258;10117;1;575;-2.14748e+09;-2.2077e+06;0;0;0;0;0;0;864734965;882627342;66113099
1633;1.18811e-14;-449;1754;25945;19979;1;709;-2.14748e+09;-2.20328e+06;-1;0;0;0;-1;0;864909692;882830193;66176667
1633;4.26289e-15;-468;1587;9258;10117;1;575;-2.14748e+09;-2.20328e+06;0;0;0;0;0;0;864909692;882830193;66176667
1634;1.18811e-14;-449;1754;25945;19979;1;709;-2.14748e+09;-2.19898e+06;-1;0;0;0;-1;0;865084062;883032669;66240149
1634;4.26289e-15;-469;1587;9258;10117;1;575;-2.14748e+09;-2.19898e+06;0;0;0;0;0;0;865084062;883032669;66240149
1635;1.18811e-14;-450;1754;25945;19979;1;709;-2.14748e+09;-2.19458e+06;0;0;0;0;0;0;865258073;883234769;66303545
1635;4.26289e-15;-469;1587;9258;10117;1;575;-2.14748e+09;-2.19448e+06;-1;0;0;0;-1;0;865258073;883234769;66303545
1636;1.18811e-14;-450;1754;25945;19979;1;709;-2.14748e+09;-2.1901e+06;-1;0;0;0;-1;0;865431729;883436495;66366855
1636;4.26289e-15;-469;1587;9258;10117;1;575;-2.14748e+09;-2.1901e+06;-1;0;0;0;-1;0;865431729;883436495;66366855
1637;1.18811e-14;-450;1754;25945;19979;1;709;-2.14748e+09;-2.18582e+06;-1;0;0;0;-1;0;865605029;883637848;66430079
1637;4.26289e-15;-469;1587;9258;10117;1;575;-2.14748e+09;-2.18572e+06;-1;0;0;0;-1;0;865605029;883637848;66430079
1638;1.18811e-14;-451;1754;25945;19979;1;709;-2.14748e+09;-2.18136e+06;0;0;0;0;0;0;865777973;883838827;66493217
1638;4.26289e-15;-469;1587;9258;10117;1;575;-2.14748e+09;-2.18136e+06;-1;0;0;0;-1;0;865777973;883838827;66493217
1639;1.18811e-14;-452;1754;25945;19979;1;709;-2.14748e+09;-2.17701e+06;0;0;0;0;0;0;865950564;884039435;66556269
1639;4.26289e-15;-469;1587;9258;10117;1;575;-2.14748e+09;-2.17701e+06;-1;0;0;0;-1;0;865950564;884039435;66556269
1640;1.18811e-14;-452;1754;25945;19979;1;709;-2.14748e+09;-2.17276e+06;-1;0;0;0;-1;0;866122802;884239671;66619235
1640;4.26289e-15;-470;1587;9258;10117;1;575;-2.14748e+09;-2.17276e+06;0;0;0;0;0;0;866122802;884239671;66619235
1641;1.18811e-14;-453;1754;25945;19979;1;709;-2.14748e+09;-2.16833e+06;0;0;0;0;0;0;866294687;884439537;66682116
1641;4.26289e-15;-470;1587;9258;10117;1;575;-2.14748e+09;-2.16833e+06;-1;0;0;0;-1;0;866294687;884439537;66682116
1642;1.18811e-14;-454;1754;25945;19979;1;709;-2.14748e+09;-2.1641e+06;0;0;0;0;0;0;866466220;884639033;66744911
1642;4.26289e-15;-470;1587;9258;10117;1;575;-2.14748e+09;-2.1641e+06;-1;0;0;0;-1;0;866466220;884639033;66744911
1643;1.18811e-14;-455;1754;25945;19979;1;709;-2.14748e+09;-2.15979e+06;0;0;0;0;0;0;866637403;884838159;66807620
1643;4.26289e-15;-471;1587;9258;10117;1;575;-2.14748e+09;-2.15979e+06;0;0;0;0;0;0;866637403;884838159;66807620
1644;1.18811e-14;-456;1754;25945;19979;1;709;-2.14748e+09;-2.15548e+06;0;0;0;0;0;0;866808235;885036918;66870243
1644;4.26289e-15;-471;1587;9258;10117;1;575;-2.14748e+09;-2.15538e+06;-1;0;0;0;-1;0;866808235;885036918;66870243
1645;1.18811e-14;-457;1754;25945;19979;1;709;-2.14748e+09;-2.15109e+06;0;0;0;0;0;0;866978719;885235308;66932781
1645;4.26289e-15;-471;1587;9258;10117;1;575;-2.14748e+09;-2.15109e+06;-1;0;0;0;-1;0;866978719;885235308;66932781
1646;1.18811e-14;-457;1754;25945;19979;1;709;-2.14748e+09;-2.1469e+06;-1;0;0;0;-1;0;867148854;885433332;66995234
1646;4.26289e-15;-472;1587;9258;10117;1;575;-2.14748e+09;-2.1469e+06;0;0;0;0;0;0;867148854;885433332;66995234
1647;1.18811e-14;-458;1754;25945;19979;1;709;-2.14748e+09;-2.14253e+06;0;0;0;0;0;0;867318641;885630990;67057601
1647;4.26289e-15;-473;1587;9258;10117;1;575;-2.14748e+09;-2.14253e+06;0;0;0;0;0;0;867318641;885630990;67057601
1648;1.18811e-14;-458;1754;25945;19979;1;709;-2.14748e+09;-2.13826e+06;-1;0;0;0;-1;0;867488081;885828282;67119883
1648;4.26289e-15;-474;1587;9258;10117;1;575;-2.14748e+09;-2.13826e+06;0;0;0;0;0;0;867488081;885828282;67119883
1649;1.18811e-14;-458;1754;25945;19979;1;709;-2.14748e+09;-2.13411e+06;-1;0;0;0;-1;0;867657176;886025210;67182079
1649;4.26289e-15;-475;1587;9258;10117;1;575;-2.14748e+09;-2.13401e+06;0;0;0;0;0;0;867657176;886025210;67182079
1650;1.18811e-14;-459;1754;25945;19979;1;709;-2.14748e+09;-2.12976e+06;0;0;0;0;0;0;867825925;886221773;67244191
1650;4.26289e-15;-475;1587;9258;10117;1;575;-2.14748e+09;-2.12976e+06;-1;0;0;0;-1;0;867825925;886221773;67244191
1651;1.18811e-14;-459;1754;25945;19979;1;709;-2.14748e+09;-2.12562e+06;-1;0;0;0;-1;0;867994329;886417974;67306216
1651;4.26289e-15;-476;1587;9258;10117;1;575;-2.14748e+09;-2.12552e+06;0;0;0;0;0;0;867994329;886417974;67306216
1652;1.18811e-14;-459;1754;25945;19979;1;709;-2.14748e+09;-2.1213e+06;-1;0;0;0;-1;0;868162390;886613812;67368157
1652;4.26289e-15;-477;1587;9258;10117;1;575;-2.14748e+09;-2.1213e+06;0;0;0;0;0;0;868162390;886613812;67368157
1653;1.18811e-14;-460;1754;25945;19979;1;709;-2.14748e+09;-2.11708e+06;0;0;0;0;0;0;868330108;886809288;67430013
1653;4.26289e-15;-478;1587;9258;10117;1;575;-2.14748e+09;-2.11708e+06;0;0;0;0;0;0;868330108;886809288;67430013
1654;1.18811e-14;-461;1754;25945;19979;1;709;-2.14748e+09;-2.11297e+06;0;0;0;0;0;0;868497484;887004403;67491783
1654;4.26289e-15;-479;1587;9258;10117;1;575;-2.14748e+09;-2.11297e+06;0;0;0;0;0;0;868497484;887004403;67491783
1655;1.18811e-14;-462;1754;25945;19979;1;709;-2.14748e+09;-2.10867e+06;0;0;0;0;0;0;868664518;887199158;67553468
1655;4.26289e-15;-480;1587;9258;10117;1;575;-2.14748e+09;-2.10867e+06;0;0;0;0;0;0;868664518;887199158;67553468
1656;1.18811e-14;-463;1754;25945;19979;1;709;-2.14748e+09;-2.10458e+06;0;0;0;0;0;0;868831212;887393553;67615069
1656;4.26289e-15;-481;1587;9258;10117;1;575;-2.14748e+09;-2.10458e+06;0;0;0;0;0;0;868831212;887393553;67615069
1657;1.18811e-14;-463;1754;25945;19979;1;709;-2.14748e+09;-2.1003e+06;-1;0;0;0;-1;0;868997566;887587590;67676584
1657;4.26289e-15;-482;1587;9258;10117;1;575;-2.14748e+09;-2.1003e+06;0;0;0;0;0;0;868997566;887587590;67676584
1658;1.18811e-14;-463;1754;25945;19979;1;709;-2.14748e+09;-2.09613e+06;-1;0;0;0;-1;0;869163581;887781268;67738015
1658;4.26289e-15;-483;1587;9258;10117;1;575;-2.14748e+09;-2.09613e+06;0;0;0;0;0;0;869163581;887781268;67738015
1659;1.18811e-14;-463;1754;25945;19979;1;709;-2.14748e+09;-2.09197e+06;-1;0;0;0;-1;0;869329258;887974589;67799361
1659;4.26289e-15;-484;1587;9258;10117;1;575;-2.14748e+09;-2.09197e+06;0;0;0;0;0;0;869329258;887974589;67799361
1660;1.18811e-14;-464;1754;25945;19979;1;709;-2.14748e+09;-2.08782e+06;0;0;0;0;0;0;869494597;888167553;67860622
1660;4.26289e-15;-484;1587;9258;10117;1;575;-2.14748e+09;-2.08782e+06;-1;0;0;0;-1;0;869494597;888167553;67860622
1661;1.18811e-14;-465;1754;25945;19979;1;709;-2.14748e+09;-2.08377e+06;0;0;0;0;0;0;869659600;888360161;67921798
1661;4.26289e-15;-485;1587;9258;10117;1;575;-2.14748e+09;-2.08367e+06;0;0;0;0;0;0;869659599;888360161;67921798
1662;1.18811e-14;-465;1754;25945;19979;1;709;-2.14748e+09;-2.07964e+06;-1;0;0;0;-1;0;869824266;888552414;67982890
1662;4.26289e-15;-485;1587;9258;10117;1;575;-2.14748e+09;-2.07964e+06;-1;0;0;0;-1;0;869824266;888552414;67982890
1663;1.18811e-14;-465;1754;25945;19979;1;709;-2.14748e+09;-2.07552e+06;0;0;-1;0;0;-1;869988597;888744312;68043897
1663;4.26289e-15;-485;1587;9258;10117;1;575;-2.14748e+09;-2.07552e+06;-1;0;0;0;-1;0;869988597;888744312;68043897
1664;1.18811e-14;-466;1754;25945;19979;1;709;-2.14748e+09;-2.0713e+06;0;0;0;0;0;0;870152594;888935857;68104820
1664;4.26289e-15;-485;1587;9258;10117;1;575;-2.14748e+09;-2.0713e+06;-1;0;0;0;-1;0;870152594;888935857;68104820
1665;1.18811e-14;-466;1754;25945;19979;1;709;-2.14748e+09;-2.0673e+06;-1;0;0;0;-1;0;870316257;889127048;68165658
1665;4.26289e-15;-486;1587;9258;10117;1;575;-2.14748e+09;-2.0673e+06;0;0;0;0;0;0;870316257;889127048;68165658
1666;1.18811e-14;-466;1754;25945;19979;1;709;-2.14748e+09;-2.0632e+06;-1;0;0;0;-1;0;870479587;889317886;68226412
1666;4.26289e-15;-487;1587;9258;10117;1;575;-2.14748e+09;-2.0632e+06;0;0;0;0;0;0;870479587;889317886;68226412
1667;1.18811e-14;-467;1754;25945;19979;1;709;-2.14748e+09;-2.05911e+06;0;0;0;0;0;0;870642585;889508373;68287081
1667;4.26289e-15;-487;1587;9258;10117;1;575;-2.14748e+09;-2.05911e+06;-1;0;0;0;-1;0;870642585;889508373;68287081
1668;1.18811e-14;-468;1754;25945;19979;1;709;-2.14748e+09;-2.05493e+06;0;0;0;0;0;0;870805252;889698509;68347666
1668;4.26289e-15;-488;1587;9258;10117;1;575;-2.14748e+09;-2.05493e+06;0;0;0;0;0;0;870805252;889698509;68347666
1669;1.18811e-14;-468;1754;25945;19979;1;709;-2.14748e+09;-2.05096e+06;-1;0;0;0;-1;0;870967588;889888295;68408166
1669;4.26289e-15;-488;1587;9258;10117;1;575;-2.14748e+09;-2.05086e+06;-1;0;0;0;-1;0;870967588;889888295;68408166
1670;1.18811e-14;-469;1754;25945;19979;1;709;-2.14748e+09;-2.0468e+06;0;0;0;0;0;0;871129594;890077730;68468583
1670;4.26289e-15;-489;1587;9258;10117;1;575;-2.14748e+09;-2.0468e+06;0;0;0;0;0;0;871129594;890077730;68468583
1671;1.18811e-14;-470;1754;25945;19979;1;709;-2.14748e+09;-2.04275e+06;0;0;0;0;0;0;871291270;890266817;68528915
1671;4.26289e-15;-490;1587;9258;10117;1;575;-2.14748e+09;-2.04275e+06;0;0;0;0;0;0;871291270;890266817;68528915
1672;1.18811e-14;-471;1754;25945;19979;1;709;-2.14748e+09;-2.03881e+06;0;0;0;0;0;0;871452619;890455556;68589164
1672;4.26289e-15;-490;1587;9258;10117;1;575;-2.14748e+09;-2.03881e+06;-1;0;0;0;-1;0;871452619;890455556;68589164
1673;1.18811e-14;-472;1754;25945;19979;1;709;-2.14748e+09;-2.03478e+06;0;0;0;0;0;0;871613639;890643946;68649328
1673;4.26289e-15;-491;1587;9258;10117;1;575;-2.14748e+09;-2.03478e+06;0;0;0;0;0;0;871613639;890643946;68649328
1674;1.18811e-14;-473;1754;25945;19979;1;709;-2.14748e+09;-2.03076e+06;0;0;0;0;0;0;871774333;890831990;68709408
1674;4.26289e-15;-491;1587;9258;10117;1;575;-2.14748e+09;-2.03076e+06;-1;0;0;0;-1;0;871774333;890831990;68709408
1675;1.18811e-14;-473;1754;25945;19979;1;709;-2.14748e+09;-2.02664e+06;-1;0;0;0;-1;0;871934700;891019688;68769404
1675;4.26289e-15;-491;1587;9258;10117;1;575;-2.14748e+09;-2.02664e+06;-1;0;0;0;-1;0;871934700;891019688;68769404
1676;1.18811e-14;-473;1754;25945;19979;1;709;-2.14748e+09;-2.02263e+06;-1;0;0;0;-1;0;872094742;891207040;68829317
1676;4.26289e-15;-492;1587;9258;10117;1;575;-2.14748e+09;-2.02263e+06;0;0;0;0;0;0;872094742;891207040;68829317
1677;1.18811e-14;-474;1754;25945;19979;1;709;-2.14748e+09;-2.01874e+06;0;0;0;0;0;0;872254459;891394048;68889146
1677;4.26289e-15;-492;1587;9258;10117;1;575;-2.14748e+09;-2.01874e+06;-1;0;0;0;-1;0;872254459;891394048;68889146
1678;1.18811e-14;-474;1754;25945;19979;1;709;-2.14748e+09;-2.01465e+06;-1;0;0;0;-1;0;872413852;891580711;68948891
1678;4.26289e-15;-492;1587;9258;10117;1;575;-2.14748e+09;-2.01465e+06;-1;0;0;0;-1;0;872413852;891580711;68948891
1679;1.18811e-14;-474;1754;25945;19979;1;709;-2.14748e+09;-2.01067e+06;-1;0;0;0;-1;0;872572921;891767030;69008552
1679;4.26289e-15;-493;1587;9258;10117;1;575;-2.14748e+09;-2.01067e+06;0;0;0;0;0;0;872572921;891767030;69008552
1680;1.18811e-14;-475;1754;25945;19979;1;709;-2.14748e+09;-2.0068e+06;0;0;0;0;0;0;872731668;891953007;69068130
1680;4.26289e-15;-494;1587;9258;10117;1;575;-2.14748e+09;-2.0068e+06;0;0;0;0;0;0;872731668;891953007;69068130
1681;1.18811e-14;-476;1754;25945;19979;1;709;-2.14748e+09;-2.00274e+06;0;0;0;0;0;0;872890094;892138642;69127624
1681;4.26289e-15;-495;1587;9258;10117;1;575;-2.14748e+09;-2.00274e+06;0;0;0;0;0;0;872890094;892138642;69127624
1682;1.18811e-14;-477;1754;25945;19979;1;709;-2.14748e+09;-1.99888e+06;0;0;0;0;0;0;873048198;892323935;69187034
1682;4.26289e-15;-496;1587;9258;10117;1;575;-2.14748e+09;-1.99878e+06;0;0;0;0;0;0;873048198;892323935;69187034
1683;1.18811e-14;-477;1754;25945;19979;1;709;-2.14748e+09;-1.99494e+06;-1;0;0;0;-1;0;873205981;892508887;69246361
1683;4.26289e-15;-497;1587;9258;10117;1;575;-2.14748e+09;-1.99494e+06;0;0;0;0;0;0;873205981;892508887;69246361
1684;1.18811e-14;-478;1754;25945;19979;1;709;-2.14748e+09;-1.9909e+06;0;0;0;0;0;0;873363445;892693500;69305605
1684;4.26289e-15;-498;1587;9258;10117;1;575;-2.14748e+09;-1.9909e+06;0;0;0;0;0;0;873363445;892693500;69305605
1685;1.18811e-14;-478;1754;25945;19979;1;709;-2.14748e+09;-1.98698e+06;-1;0;0;0;-1;0;873520590;892877772;69364766
1685;4.26289e-15;-499;1587;9258;10117;1;575;-2.14748e+09;-1.98698e+06;0;0;0;0;0;0;873520590;892877772;69364766
1686;1.18811e-14;-478;1754;25945;19979;1;709;-2.14748e+09;-1.98306e+06;-1;0;0;0;-1;0;873677417;893061707;69423843
1686;4.26289e-15;-500;1587;9258;10117;1;575;-2.14748e+09;-1.98306e+06;0;0;0;0;0;0;873677417;893061707;69423843
1687;1.18811e-14;-479;1754;25945;19979;1;709;-2.14748e+09;-1.97915e+06;0;0;0;0;0;0;873833926;893245302;69482837
1687;4.26289e-15;-500;1587;9258;10117;1;575;-2.14748e+09;-1.97915e+06;-1;0;0;0;-1;0;873833926;893245302;69482837
1688;1.18811e-14;-480;1754;25945;19979;1;709;-2.14748e+09;-1.97525e+06;0;0;0;0;0;0;873990118;893428561;69541748
1688;4.26289e-15;-501;1587;9258;10117;1;575;-2.14748e+09;-1.97525e+06;0;0;0;0;0;0;873990118;893428561;69541748
1689;1.18811e-14;-480;1754;25945;19979;1;709;-2.14748e+09;-1.97136e+06;-1;0;0;0;-1;0;874145995;893611483;69600576
1689;4.26289e-15;-501;1587;9258;10117;1;575;-2.14748e+09;-1.97136e+06;-1;0;0;0;-1;0;874145995;893611483;69600576
1690;1.18811e-14;-481;1754;25945;19979;1;709;-2.14748e+09;-1.96757e+06;0;0;0;0;0;0;874301555;893794068;69659321
1690;4.26289e-15;-501;1587;9258;10117;1;575;-2.14748e+09;-1.96747e+06;-1;0;0;0;-1;0;874301555;893794068;69659321
1691;1.18811e-14;-482;1754;25945;19979;1;709;-2.14748e+09;-1.9636e+06;0;0;0;0;0;0;874456801;893976319;69717983
1691;4.26289e-15;-501;1587;9258;10117;1;575;-2.14748e+09;-1.9636e+06;-1;0;0;0;-1;0;874456801;893976319;69717983
1692;1.18811e-14;-482;1754;25945;19979;1;709;-2.14748e+09;-1.95973e+06;-1;0;0;0;-1;0;874611733;894158234;69776562
1692;4.26289e-15;-501;1587;9258;10117;1;575;-2.14748e+09;-1.95973e+06;-1;0;0;0;-1;0;874611733;894158234;69776562
1693;1.18811e-14;-482;1754;25945;19979;1;709;-2.14748e+09;-1.95588e+06;-1;0;0;0;-1;0;874766352;894339815;69835058
1693;4.26289e-15;-502;1587;9258;10117;1;575;-2.14748e+09;-1.95588e+06;0;0;0;0;0;0;874766352;894339815;69835058
1694;1.18811e-14;-483;1754;25945;19979;1;709;-2.14748e+09;-1.95213e+06;0;0;0;0;0;0;874920658;894521063;69893471
1694;4.26289e-15;-502;1587;9258;10117;1;575;-2.14748e+09;-1.95213e+06;-1;0;0;0;-1;0;874920658;894521063;69893471
1695;1.18811e-14;-483;1754;25945;19979;1;709;-2.14748e+09;-1.94828e+06;-1;0;0;0;-1;0;875074652;894701978;69951802
1695;4.26289e-15;-502;1587;9258;10117;1;575;-2.14748e+09;-1.94828e+06;-1;0;0;0;-1;0;875074652;894701978;69951802
1696;1.18811e-14;-484;1754;25945;19979;1;709;-2.14748e+09;-1.94435e+06;0;0;0;0;0;0;875228335;894882561;70010050
1696;4.26289e-15;-503;1587;9258;10117;1;575;-2.14748e+09;-1.94435e+06;0;0;0;0;0;0;875228335;894882561;70010050
1697;1.18811e-14;-484;1754;25945;19979;1;709;-2.14748e+09;-1.94063e+06;-1;0;0;0;-1;0;875381708;895062812;70068216
1697;4.26289e-15;-504;1587;9258;10117;1;575;-2.14748e+09;-1.94053e+06;0;0;0;0;0;0;875381708;895062812;70068216
1698;1.18811e-14;-485;1754;25945;19979;1;709;-2.14748e+09;-1.93671e+06;0;0;0;0;0;0;875534770;895242732;70126299
1698;4.26289e-15;-504;1587;9258;10117;1;575;-2.14748e+09;-1.93671e+06;-1;0;0;0;-1;0;875534770;895242732;70126299
1699;1.18811e-14;-486;1754;25945;19979;1;709;-2.14748e+09;-1.93291e+06;0;0;0;0;0;0;875687524;895422322;70184300
1699;4.26289e-15;-505;1587;9258;10117;1;575;-2.14748e+09;-1.9329e+06;0;0;0;0;0;0;875687524;895422322;70184300
1700;1.18811e-14;-486;1754;25945;19979;1;709;-2.14748e+09;-1.92911e+06;-1;0;0;0;-1;0;875839969;895601583;70242218
1700;4.26289e-15;-505;1587;9258;10117;1;575;-2.14748e+09;-1.92911e+06;-1;0;0;0;-1;0;875839969;895601583;70242218
1701;1.18811e-14;-486;1754;25945;19979;1;709;-2.14748e+09;-1.92532e+06;-1;0;0;0;-1;0;875992106;895780514;70300054
1701;4.26289e-15;-506;1587;9258;10117;1;575;-2.14748e+09;-1.92532e+06;0;0;0;0;0;0;875992106;895780514;70300054
1702;1.18811e-14;-486;1754;25945;19979;1;709;-2.14748e+09;-1.92163e+06;-1;0;0;0;-1;0;876143936;895959118;70357808
1702;4.26289e-15;-507;1587;9258;10117;1;575;-2.14748e+09;-1.92153e+06;0;0;0;0;0;0;876143936;895959118;70357808
1703;1.18811e-14;-487;1754;25945;19979;1;709;-2.14748e+09;-1.91786e+06;0;0;0;0;0;0;876295460;896137394;70415479
1703;4.26289e-15;-508;1587;9258;10117;1;575;-2.14748e+09;-1.91786e+06;0;0;0;0;0;0;876295460;896137394;70415479
1704;1.18811e-14;-488;1754;25945;19979;1;709;-2.14748e+09;-1.91409e+06;0;0;0;0;0;0;876446678;896315342;70473069
1704;4.26289e-15;-508;1587;9258;10117;1;575;-2.14748e+09;-1.91409e+06;-1;0;0;0;-1;0;876446678;896315342;70473069
1705;1.18811e-14;-488;1754;25945;19979;1;709;-2.14748e+09;-1.91024e+06;-1;0;0;0;-1;0;876597591;896492965;70530576
1705;4.26289e-15;-509;1587;9258;10117;1;575;-2.14748e+09;-1.91024e+06;0;0;0;0;0;0;876597591;896492965;70530576
1706;1.18811e-14;-488;1754;25945;19979;1;709;-2.14748e+09;-1.90649e+06;-1;0;0;0;-1;0;876748200;896670261;70588001
1706;4.26289e-15;-509;1587;9258;10117;1;575;-2.14748e+09;-1.90649e+06;-1;0;0;0;-1;0;876748200;896670261;70588001
1707;1.18811e-14;-489;1754;25945;19979;1;709;-2.14748e+09;-1.90275e+06;0;0;0;0;0;0;876898505;896847233;70645345
1707;4.26289e-15;-509;1587;9258;10117;1;575;-2.14748e+09;-1.90275e+06;-1;0;0;0;-1;0;876898505;896847233;70645345
1708;1.18811e-14;-489;1754;25945;19979;1;709;-2.14748e+09;-1.89901e+06;-1;0;0;0;-1;0;877048507;897023880;70702607
1708;4.26289e-15;-510;1587;9258;10117;1;575;-2.14748e+09;-1.89901e+06;0;0;0;0;0;0;877048507;897023880;70702607
1709;1.18811e-14;-489;1754;25945;19979;1;709;-2.14748e+09;-1.89539e+06;-1;0;0;0;-1;0;877198207;897200203;70759787
1709;4.26289e-15;-510;1587;9258;10117;1;575;-2.14748e+09;-1.89529e+06;-1;0;0;0;-1;0;877198207;897200203;70759787
1710;1.18811e-14;-489;1754;25945;19979;1;709;-2.14748e+09;-1.89167e+06;-1;0;0;0;-1;0;877347605;897376203;70816885
1710;4.26289e-15;-510;1587;9258;10117;1;575;-2.14748e+09;-1.89167e+06;-1;0;0;0;-1;0;877347605;897376203;70816885
1711;1.18811e-14;-490;1754;25945;19979;1;709;-2.14748e+09;-1.88786e+06;0;0;0;0;0;0;877496702;897551881;70873901
1711;4.26289e-15;-510;1587;9258;10117;1;575;-2.14748e+09;-1.88786e+06;-1;0;0;0;-1;0;877496702;897551881;70873901
1712;1.18811e-14;-490;1754;25945;19979;1;709;-2.14748e+09;-1.88426e+06;-1;0;0;0;-1;0;877645499;897727237;70930836
1712;4.26289e-15;-510;1587;9258;10117;1;575;-2.14748e+09;-1.88416e+06;-1;0;0;0;-1;0;877645499;897727237;70930836
1713;1.18811e-14;-490;1754;25945;19979;1;709;-2.14748e+09;-1.88047e+06;-1;0;0;0;-1;0;877793996;897902271;70987690
1713;4.26289e-15;-511;1587;9258;10117;1;575;-2.14748e+09;-1.88047e+06;0;0;0;0;0;0;877793996;897902271;70987690
1714;1.18811e-14;-490;1754;25945;19979;1;709;-2.14748e+09;-1.87679e+06;-1;0;0;0;-1;0;877942194;898076985;71044462
1714;4.26289e-15;-512;1587;9258;10117;1;575;-2.14748e+09;-1.87679e+06;0;0;0;0;0;0;877942194;898076985;71044462
1715;1.18811e-14;-490;1754;25945;19979;1;709;-2.14748e+09;-1.87311e+06;-1;0;0;0;-1;0;878090094;898251379;71101152
1715;4.26289e-15;-512;1587;9258;10117;1;575;-2.14748e+09;-1.87311e+06;-1;0;0;0;-1;0;878090094;898251379;71101152
1716;1.18811e-14;-491;1754;25945;19979;1;709;-2.14748e+09;-1.86944e+06;0;0;0;0;0;0;878237696;898425453;71157761
1716;4.26289e-15;-513;1587;9258;10117;1;575;-2.14748e+09;-1.86944e+06;0;0;0;0;0;0;878237696;898425453;71157761
1717;1.18811e-14;-491;1754;25945;19979;1;709;-2.14748e+09;-1.86578e+06;-1;0;0;0;-1;0;878385001;898599208;71214289
1717;4.26289e-15;-514;1587;9258;10117;1;575;-2.14748e+09;-1.86578e+06;0;0;0;0;0;0;878385001;898599208;71214289
1718;1.18811e-14;-491;1754;25945;19979;1;709;-2.14748e+09;-1.86213e+06;-1;0;0;0;-1;0;878532010;898772645;71270736
1718;4.26289e-15;-514;1587;9258;10117;1;575;-2.14748e+09;-1.86213e+06;-1;0;0;0;-1;0;878532010;898772645;71270736
1719;1.18811e-14;-492;1754;25945;19979;1;709;-2.14748e+09;-1.85858e+06;0;0;0;0;0;0;878678723;898945765;71327102
1719;4.26289e-15;-515;1587;9258;10117;1;575;-2.14748e+09;-1.85848e+06;0;0;0;0;0;0;878678723;898945765;71327102
1720;1.18811e-14;-493;1754;25945;19979;1;709;-2.14748e+09;-1.85495e+06;0;0;0;0;0;0;878825141;899118568;71383387
1720;4.26289e-15;-516;1587;9258;10117;1;575;-2.14748e+09;-1.85485e+06;0;0;0;0;0;0;878825141;899118568;71383387
1721;1.18811e-14;-493;1754;25945;19979;1;709;-2.14748e+09;-1.85122e+06;-1;0;0;0;-1;0;878971265;899291054;71439591
1721;4.26289e-15;-517;1587;9258;10117;1;575;-2.14748e+09;-1.85122e+06;0;0;0;0;0;0;878971265;899291054;71439591
1722;1.18811e-14;-493;1754;25945;19979;1;709;-2.14748e+09;-1.8476e+06;-1;0;0;0;-1;0;879117095;899463225;71495713
1722;4.26289e-15;-518;1587;9258;10117;1;575;-2.14748e+09;-1.8476e+06;0;0;0;0;0;0;879117095;899463225;71495713
1723;1.18811e-14;-493;1754;25945;19979;1;709;-2.14748e+09;-1.84399e+06;-1;0;0;0;-1;0;879262632;899635080;71551755
1723;4.26289e-15;-518;1587;9258;10117;1;575;-2.14748e+09;-1.84398e+06;-1;0;0;0;-1;0;879262632;899635080;71551755
1724;1.18811e-14;-493;1754;25945;19979;1;709;-2.14748e+09;-1.84038e+06;-1;0;0;0;-1;0;879407876;899806622;71607717
1724;4.26289e-15;-519;1587;9258;10117;1;575;-2.14748e+09;-1.84038e+06;0;0;0;0;0;0;879407876;899806622;71607717
1725;1.18811e-14;-493;1754;25945;19979;1;709;-2.14748e+09;-1.83678e+06;-1;0;0;0;-1;0;879552829;899977849;71663597
1725;4.26289e-15;-519;1587;9258;10117;1;575;-2.14748e+09;-1.83678e+06;-1;0;0;0;-1;0;879552829;899977849;71663597
1726;1.18811e-14;-493;1754;25945;19979;1;709;-2.14748e+09;-1.83319e+06;-1;0;0;0;-1;0;879697490;900148763;71719397
1726;4.26289e-15;-520;1587;9258;10117;1;575;-2.14748e+09;-1.83319e+06;0;0;0;0;0;0;879697490;900148763;71719397
1727;1.18811e-14;-493;1754;25945;19979;1;709;-2.14748e+09;-1.82961e+06;-1;0;0;0;-1;0;879841861;900319364;71775117
1727;4.26289e-15;-521;1587;9258;10117;1;575;-2.14748e+09;-1.82961e+06;0;0;0;0;0;0;879841861;900319364;71775117
1728;1.18811e-14;-493;1754;25945;19979;1;709;-2.14748e+09;-1.82614e+06;-1;0;0;0;-1;0;879985943;900489653;71830755
1728;4.26289e-15;-522;1587;9258;10117;1;575;-2.14748e+09;-1.82614e+06;0;0;0;0;0;0;879985943;900489653;71830755
1729;1.18811e-14;-493;1754;25945;19979;1;709;-2.14748e+09;-1.82247e+06;-1;0;0;0;-1;0;880129735;900659631;71886314
1729;4.26289e-15;-522;1587;9258;10117;1;575;-2.14748e+09;-1.82247e+06;-1;0;0;0;-1;0;880129735;900659631;71886314
1730;1.18811e-14;-494;1754;25945;19979;1;709;-2.14748e+09;-1.81901e+06;0;0;0;0;0;0;880273238;900829298;71941792
1730;4.26289e-15;-523;1587;9258;10117;1;575;-2.14748e+09;-1.81901e+06;0;0;0;0;0;0;880273238;900829298;71941792
1731;1.18811e-14;-495;1754;25945;19979;1;709;-2.14748e+09;-1.81536e+06;0;0;0;0;0;0;880416454;900998655;71997190
1731;4.26289e-15;-524;1587;9258;10117;1;575;-2.14748e+09;-1.81536e+06;0;0;0;0;0;0;880416454;900998655;71997190
1732;1.18811e-14;-495;1754;25945;19979;1;709;-2.14748e+09;-1.81182e+06;-1;0;0;0;-1;0;880559382;901167702;72052508
1732;4.26289e-15;-525;1587;9258;10117;1;575;-2.14748e+09;-1.81182e+06;0;0;0;0;0;0;880559382;901167702;72052508
1733;1.18811e-14;-495;1754;25945;19979;1;709;-2.14748e+09;-1.80838e+06;-1;0;0;0;-1;0;880702023;901336440;72107745
1733;4.26289e-15;-525;1587;9258;10117;1;575;-2.14748e+09;-1.80828e+06;-1;0;0;0;-1;0;880702023;901336440;72107745
1734;1.18811e-14;-495;1754;25945;19979;1;709;-2.14748e+09;-1.80475e+06;-1;0;0;0;-1;0;880844379;901504870;72162902
1734;4.26289e-15;-526;1587;9258;10117;1;575;-2.14748e+09;-1.80476e+06;0;0;0;0;0;0;880844379;901504870;72162902
1735;1.18811e-14;-496;1754;25945;19979;1;709;-2.14748e+09;-1.80133e+06;0;0;0;0;0;0;880986449;901672992;72217980
1735;4.26289e-15;-527;1587;9258;10117;1;575;-2.14748e+09;-1.80133e+06;0;0;0;0;0;0;880986449;901672992;72217980
1736;1.18811e-14;-496;1754;25945;19979;1;709;-2.14748e+09;-1.79772e+06;-1;0;0;0;-1;0;881128234;901840806;72272977
1736;4.26289e-15;-527;1587;9258;10117;1;575;-2.14748e+09;-1.79772e+06;-1;0;0;0;-1;0;881128234;901840806;72272977
1737;1.18811e-14;-497;1754;25945;19979;1;709;-2.14748e+09;-1.79422e+06;0;0;0;0;0;0;881269735;902008314;72327895
1737;4.26289e-15;-527;1587;9258;10117;1;575;-2.14748e+09;-1.79422e+06;-1;0;0;0;-1;0;881269735;902008314;72327895
1738;1.18811e-14;-497;1754;25945;19979;1;709;-2.14748e+09;-1.79072e+06;-1;0;0;0;-1;0;881410953;902175516;72382733
1738;4.26289e-15;-527;1587;9258;10117;1;575;-2.14748e+09;-1.79072e+06;-1;0;0;0;-1;0;881410953;902175516;72382733
1739;1.18811e-14;-498;1754;25945;19979;1;709;-2.14748e+09;-1.78723e+06;0;0;0;0;0;0;881551887;902342412;72437491
1739;4.26289e-15;-527;1587;9258;10117;1;575;-2.14748e+09;-1.78723e+06;-1;0;0;0;-1;0;881551887;902342412;72437491
1740;1.18811e-14;-499;1754;25945;19979;1;709;-2.14748e+09;-1.78375e+06;0;0;0;0;0;0;881692540;902509004;72492170
1740;4.26289e-15;-528;1587;9258;10117;1;575;-2.14748e+09;-1.78375e+06;0;0;0;0;0;0;881692540;902509004;72492170
1741;1.18811e-14;-499;1754;25945;19979;1;709;-2.14748e+09;-1.78027e+06;-1;0;0;0;-1;0;881832910;902675291;72546769
1741;4.26289e-15;-529;1587;9258;10117;1;575;-2.14748e+09;-1.78027e+06;0;0;0;0;0;0;881832910;902675291;72546769
1742;1.18811e-14;-499;1754;25945;19979;1;709;-2.14748e+09;-1.7768e+06;-1;0;0;0;-1;0;881973000;902841274;72601288
1742;4.26289e-15;-529;1587;9258;10117;1;575;-2.14748e+09;-1.7768e+06;-1;0;0;0;-1;0;881973000;902841274;72601288
1743;1.18811e-14;-500;1754;25945;19979;1;709;-2.14748e+09;-1.77344e+06;0;0;0;0;0;0;882112809;903006954;72655728
1743;4.26289e-15;-530;1587;9258;10117;1;575;-2.14748e+09;-1.77334e+06;0;0;0;0;0;0;882112809;903006954;72655728
1744;1.18811e-14;-501;1754;25945;19979;1;709;-2.14748e+09;-1.76989e+06;0;0;0;0;0;0;882252339;903172332;72710089
1744;4.26289e-15;-530;1587;9258;10117;1;575;-2.14748e+09;-1.76989e+06;-1;0;0;0;-1;0;882252339;903172332;72710089
1745;1.18811e-14;-502;1754;25945;19979;1;709;-2.14748e+09;-1.76654e+06;0;0;0;0;0;0;882391589;903337408;72764370
1745;4.26289e-15;-530;1587;9258;10117;1;575;-2.14748e+09;-1.76644e+06;-1;0;0;0;-1;0;882391589;903337408;72764370
1746;1.18811e-14;-502;1754;25945;19979;1;709;-2.14748e+09;-1.76301e+06;-1;0;0;0;-1;0;882530560;903502182;72818573
1746;4.26289e-15;-531;1587;9258;10117;1;575;-2.14748e+09;-1.76301e+06;0;0;0;0;0;0;882530560;903502182;72818573
1747;1.18811e-14;-502;1754;25945;19979;1;709;-2.14748e+09;-1.75958e+06;-1;0;0;0;-1;0;882669254;903666656;72872696
1747;4.26289e-15;-531;1587;9258;10117;1;575;-2.14748e+09;-1.75958e+06;-1;0;0;0;-1;0;882669254;903666656;72872696
1748;1.18811e-14;-502;1754;25945;19979;1;709;-2.14748e+09;-1.75625e+06;-1;0;0;0;-1;0;882807670;903830829;72926740
1748;4.26289e-15;-532;1587;9258;10117;1;575;-2.14748e+09;-1.75615e+06;0;0;0;0;0;0;882807670;903830829;72926740
1749;1.18811e-14;-503;1754;25945;19979;1;709;-2.14748e+09;-1.75284e+06;0;0;0;0;0;0;882945809;903994703;72980705
1749;4.26289e-15;-533;1587;9258;10117;1;575;-2.14748e+09;-1.75284e+06;0;0;0;0;0;0;882945809;903994703;72980705
1750;1.18811e-14;-503;1754;25945;19979;1;709;-2.14748e+09;-1.74943e+06;-1;0;0;0;-1;0;883083673;904158278;73034591
1750;4.26289e-15;-534;1587;9258;10117;1;575;-2.14748e+09;-1.74943e+06;0;0;0;0;0;0;883083673;904158278;73034591
1751;1.18811e-14;-503;1754;25945;19979;1;709;-2.14748e+09;-1.74593e+06;-1;0;0;0;-1;0;883221260;904321554;73088398
1751;4.26289e-15;-535;1587;9258;10117;1;575;-2.14748e+09;-1.74593e+06;0;0;0;0;0;0;883221260;904321554;73088398
1752;1.18811e-14;-504;1754;25945;19979;1;709;-2.14748e+09;-1.74263e+06;0;0;0;0;0;0;883358573;904484532;73142127
1752;4.26289e-15;-535;1587;9258;10117;1;575;-2.14748e+09;-1.74263e+06;-1;0;0;0;-1;0;883358573;904484532;73142127
1753;1.18811e-14;-504;1754;25945;19979;1;709;-2.14748e+09;-1.73914e+06;-1;0;0;0;-1;0;883495611;904647213;73195777
1753;4.26289e-15;-535;1587;9258;10117;1;575;-2.14748e+09;-1.73914e+06;-1;0;0;0;-1;0;883495611;904647213;73195777
1754;1.18811e-14;-505;1754;25945;19979;1;709;-2.14748e+09;-1.73586e+06;0;0;0;0;0;0;883632376;904809597;73249348
1754;4.26289e-15;-536;1587;9258;10117;1;575;-2.14748e+09;-1.73586e+06;0;0;0;0;0;0;883632376;904809597;73249348
1755;1.18811e-14;-505;1754;25945;19979;1;709;-2.14748e+09;-1.73249e+06;-1;0;0;0;-1;0;883768867;904971685;73302841
1755;4.26289e-15;-537;1587;9258;10117;1;575;-2.14748e+09;-1.73249e+06;0;0;0;0;0;0;883768867;904971685;73302841
1756;1.18811e-14;-506;1754;25945;19979;1;709;-2.14748e+09;-1.72903e+06;0;0;0;0;0;0;883905086;905133478;73356255
1756;4.26289e-15;-538;1587;9258;10117;1;575;-2.14748e+09;-1.72903e+06;0;0;0;0;0;0;883905086;905133478;73356255
1757;1.18811e-14;-507;1754;25945;19979;1;709;-2.14748e+09;-1.72567e+06;0;0;0;0;0;0;884041033;905294975;73409591
1757;4.26289e-15;-538;1587;9258;10117;1;575;-2.14748e+09;-1.72567e+06;-1;0;0;0;-1;0;884041033;905294975;73409591
1758;1.18811e-14;-507;1754;25945;19979;1;709;-2.14748e+09;-1.72232e+06;-1;0;0;0;-1;0;884176709;905456178;73462848
1758;4.26289e-15;-539;1587;9258;10117;1;575;-2.14748e+09;-1.72232e+06;0;0;0;0;0;0;884176709;905456178;73462848
1759;1.18811e-14;-508;1754;25945;19979;1;709;-2.14748e+09;-1.71898e+06;0;0;0;0;0;0;884312113;905617087;73516028
1759;4.26289e-15;-540;1587;9258;10117;1;575;-2.14748e+09;-1.71898e+06;0;0;0;0;0;0;884312113;905617087;73516028
1760;1.18811e-14;-509;1754;25945;19979;1;709;-2.14748e+09;-1.71574e+06;0;0;0;0;0;0;884447248;905777702;73569129
1760;4.26289e-15;-541;1587;9258;10117;1;575;-2.14748e+09;-1.71564e+06;0;0;0;0;0;0;884447248;905777702;73569129
1761;1.18811e-14;-510;1754;25945;19979;1;709;-2.14748e+09;-1.71241e+06;0;0;0;0;0;0;884582113;905938025;73622152
1761;4.26289e-15;-541;1587;9258;10117;1;575;-2.14748e+09;-1.71241e+06;-1;0;0;0;-1;0;884582113;905938025;73622152
1762;1.18811e-14;-510;1754;25945;19979;1;709;-2.14748e+09;-1.70899e+06;-1;0;0;0;-1;0;884716709;906098055;73675097
1762;4.26289e-15;-541;1587;9258;10117;1;575;-2.14748e+09;-1.70899e+06;-1;0;0;0;-1;0;884716709;906098055;73675097
1763;1.18811e-14;-511;1754;25945;19979;1;709;-2.14748e+09;-1.70567e+06;0;0;0;0;0;0;884851036;906257794;73727964
1763;4.26289e-15;-541;1587;9258;10117;1;575;-2.14748e+09;-1.70567e+06;-1;0;0;0;-1;0;884851036;906257794;73727964
1764;1.18811e-14;-512;1754;25945;19979;1;709;-2.14748e+09;-1.70236e+06;0;0;0;0;0;0;884985096;906417242;73780753
1764;4.26289e-15;-541;1587;9258;10117;1;575;-2.14748e+09;-1.70236e+06;-1;0;0;0;-1;0;884985096;906417242;73780753
1765;1.18811e-14;-512;1754;25945;19979;1;709;-2.14748e+09;-1.69906e+06;-1;0;0;0;-1;0;885118888;906576399;73833464
1765;4.26289e-15;-542;1587;9258;10117;1;575;-2.14748e+09;-1.69906e+06;0;0;0;0;0;0;885118888;906576399;73833464
1766;1.18811e-14;-513;1754;25945;19979;1;709;-2.14748e+09;-1.69577e+06;0;0;0;0;0;0;885252414;906735266;73886098
1766;4.26289e-15;-543;1587;9258;10117;1;575;-2.14748e+09;-1.69577e+06;0;0;0;0;0;0;885252414;906735266;73886098
1767;1.18811e-14;-513;1754;25945;19979;1;709;-2.14748e+09;-1.69258e+06;-1;0;0;0;-1;0;885385674;906893843;73938654
1767;4.26289e-15;-544;1587;9258;10117;1;575;-2.14748e+09;-1.69258e+06;0;0;0;0;0;0;885385674;906893843;73938654
1768;1.18811e-14;-514;1754;25945;19979;1;709;-2.14748e+09;-1.6892e+06;0;0;0;0;0;0;885518668;907052132;73991132
1768;4.26289e-15;-544;1587;9258;10117;1;575;-2.14748e+09;-1.6892e+06;-1;0;0;0;-1;0;885518668;907052132;73991132
1769;1.18811e-14;-514;1753;25945;19979;1;709;-2.14748e+09;-1.68592e+06;0;0;0;0;0;0;885651397;907210132;74043533
1769;4.26289e-15;-544;1587;9258;10117;1;575;-2.14748e+09;-1.68592e+06;-1;0;0;0;-1;0;885651397;907210132;74043533
1770;1.18811e-14;-514;1753;25945;19979;1;709;-2.14748e+09;-1.68266e+06;-1;0;0;0;-1;0;885783862;907367845;74095856
1770;4.26289e-15;-545;1587;9258;10117;1;575;-2.14748e+09;-1.68266e+06;0;0;0;0;0;0;885783862;907367845;74095856
1771;1.18811e-14;-515;1753;25945;19979;1;709;-2.14748e+09;-1.6795e+06;0;0;0;0;0;0;885916063;907525270;74148102
1771;4.26289e-15;-545;1587;9258;10117;1;575;-2.14748e+09;-1.6795e+06;-1;0;0;0;-1;0;885916063;907525270;74148102
1772;1.18811e-14;-515;1753;25945;19979;1;709;-2.14748e+09;-1.67615e+06;-1;0;0;0;-1;0;886048000;907682408;74200271
1772;4.26289e-15;-546;1587;9258;10117;1;575;-2.14748e+09;-1.67615e+06;0;0;0;0;0;0;886048000;907682408;74200271
1773;1.18811e-14;-515;1753;25945;19979;1;709;-2.14748e+09;-1.673e+06;-1;0;0;0;-1;0;886179676;907839261;74252363
1773;4.26289e-15;-547;1587;9258;10117;1;575;-2.14748e+09;-1.673e+06;0;0;0;0;0;0;886179676;907839261;74252363
1774;1.18811e-14;-516;1753;25945;19979;1;709;-2.14748e+09;-1.66966e+06;0;0;0;0;0;0;886311088;907995827;74304377
1774;4.26289e-15;-547;1587;9258;10117;1;575;-2.14748e+09;-1.66966e+06;-1;0;0;0;-1;0;886311088;907995827;74304377
1775;1.18811e-14;-516;1753;25945;19979;1;709;-2.14748e+09;-1.66643e+06;-1;0;0;0;-1;0;886442240;908152109;74356315
1775;4.26289e-15;-548;1587;9258;10117;1;575;-2.14748e+09;-1.66643e+06;0;0;0;0;0;0;886442240;908152109;74356315
1776;1.18811e-14;-516;1753;25945;19979;1;709;-2.14748e+09;-1.6633e+06;-1;0;0;0;-1;0;886573131;908308106;74408175
1776;4.26289e-15;-548;1587;9258;10117;1;575;-2.14748e+09;-1.6632e+06;-1;0;0;0;-1;0;886573131;908308106;74408175
1777;1.18811e-14;-517;1753;25945;19979;1;709;-2.14748e+09;-1.65999e+06;0;0;0;0;0;0;886703761;908463819;74459959
1777;4.26289e-15;-548;1587;9258;10117;1;575;-2.14748e+09;-1.65999e+06;-1;0;0;0;-1;0;886703761;908463819;74459959
1778;1.18811e-14;-518;1753;25945;19979;1;709;-2.14748e+09;-1.65677e+06;0;0;0;0;0;0;886834131;908619249;74511666
1778;4.26289e-15;-548;1587;9258;10117;1;575;-2.14748e+09;-1.65677e+06;-1;0;0;0;-1;0;886834131;908619249;74511666
1779;1.18811e-14;-518;1753;25945;19979;1;709;-2.14748e+09;-1.65357e+06;-1;0;0;0;-1;0;886964242;908774396;74563296
1779;4.26289e-15;-548;1587;9258;10117;1;575;-2.14748e+09;-1.65357e+06;-1;0;0;0;-1;0;886964242;908774396;74563296
1780;1.18811e-14;-519;1753;25945;19979;1;709;-2.14748e+09;-1.65037e+06;0;0;0;0;0;0;887094095;908929260;74614849
1780;4.26289e-15;-549;1587;9258;10117;1;575;-2.14748e+09;-1.65037e+06;0;0;0;0;0;0;887094095;908929260;74614849
1781;1.18811e-14;-520;1753;25945;19979;1;709;-2.14748e+09;-1.64728e+06;0;0;0;0;0;0;887223689;909083843;74666326
1781;4.26289e-15;-549;1587;9258;10117;1;575;-2.14748e+09;-1.64728e+06;-1;0;0;0;-1;0;887223689;909083843;74666326
1782;1.18811e-14;-520;1753;25945;19979;1;709;-2.14748e+09;-1.644e+06;-1;0;0;0;-1;0;887353026;909238144;74717727
1782;4.26289e-15;-550;1587;9258;10117;1;575;-2.14748e+09;-1.644e+06;0;0;0;0;0;0;887353026;909238144;74717727
1783;1.18811e-14;-521;1753;25945;19979;1;709;-2.14748e+09;-1.64082e+06;0;0;0;0;0;0;887482105;909392165;74769050
1783;4.26289e-15;-550;1587;9258;10117;1;575;-2.14748e+09;-1.64082e+06;-1;0;0;0;-1;0;887482105;909392165;74769050
1784;1.18811e-14;-521;1753;25945;19979;1;709;-2.14748e+09;-1.63765e+06;-1;0;0;0;-1;0;887610928;909545905;74820298
1784;4.26289e-15;-551;1587;9258;10117;1;575;-2.14748e+09;-1.63765e+06;0;0;0;0;0;0;887610928;909545905;74820298
1785;1.18811e-14;-522;1753;25945;19979;1;709;-2.14748e+09;-1.63448e+06;0;0;0;0;0;0;887739496;909699366;74871469
1785;4.26289e-15;-552;1587;9258;10117;1;575;-2.14748e+09;-1.63448e+06;0;0;0;0;0;0;887739496;909699366;74871469
1786;1.18811e-14;-522;1753;25945;19979;1;709;-2.14748e+09;-1.63132e+06;-1;0;0;0;-1;0;887867808;909852547;74922564
1786;4.26289e-15;-552;1587;9258;10117;1;575;-2.14748e+09;-1.63132e+06;-1;0;0;0;-1;0;887867808;909852547;74922564
1787;1.18811e-14;-522;1753;25945;19979;1;709;-2.14748e+09;-1.62827e+06;-1;0;0;0;-1;0;887995865;910005450;74973583
1787;4.26289e-15;-552;1587;9258;10117;1;575;-2.14748e+09;-1.62827e+06;-1;0;0;0;-1;0;887995865;910005450;74973583
1788;1.18811e-14;-523;1753;25945;19979;1;709;-2.14748e+09;-1.62513e+06;0;0;0;0;0;0;888123668;910158075;75024526
1788;4.26289e-15;-553;1587;9258;10117;1;575;-2.14748e+09;-1.62513e+06;0;0;0;0;0;0;888123668;910158075;75024526
1789;1.18811e-14;-523;1753;25945;19979;1;709;-2.14748e+09;-1.62199e+06;-1;0;0;0;-1;0;888251217;910310422;75075393
1789;4.26289e-15;-553;1587;9258;10117;1;575;-2.14748e+09;-1.62199e+06;-1;0;0;0;-1;0;888251217;910310422;75075393
1790;1.18811e-14;-523;1753;25945;19979;1;709;-2.14748e+09;-1.61876e+06;-1;0;0;0;-1;0;888378513;910462493;75126184
1790;4.26289e-15;-553;1587;9258;10117;1;575;-2.14748e+09;-1.61876e+06;-1;0;0;0;-1;0;888378513;910462493;75126184
1791;1.18811e-14;-524;1753;25945;19979;1;709;-2.14748e+09;-1.61563e+06;0;0;0;0;0;0;888505557;910614286;75176899
1791;4.26289e-15;-554;1587;9258;10117;1;575;-2.14748e+09;-1.61563e+06;0;0;0;0;0;0;888505557;910614286;75176899
1792;1.18811e-14;-524;1753;25945;19979;1;709;-2.14748e+09;-1.61252e+06;-1;0;0;0;-1;0;888632348;910765804;75227539
1792;4.26289e-15;-554;1587;9258;10117;1;575;-2.14748e+09;-1.61252e+06;-1;0;0;0;-1;0;888632348;910765804;75227539
1793;1.18811e-14;-524;1753;25945;19979;1;709;-2.14748e+09;-1.6094e+06;-1;0;0;0;-1;0;888758888;910917046;75278102
1793;4.26289e-15;-555;1587;9258;10117;1;575;-2.14748e+09;-1.6094e+06;0;0;0;0;0;0;888758888;910917046;75278102
1794;1.18811e-14;-525;1753;25945;19979;1;709;-2.14748e+09;-1.6063e+06;0;0;0;0;0;0;888885177;911068013;75328591
1794;4.26289e-15;-556;1587;9258;10117;1;575;-2.14748e+09;-1.6063e+06;0;0;0;0;0;0;888885177;911068013;75328591
1795;1.18811e-14;-525;1753;25945;19979;1;709;-2.14748e+09;-1.6032e+06;-1;0;0;0;-1;0;889011215;911218706;75379003
1795;4.26289e-15;-556;1587;9258;10117;1;575;-2.14748e+09;-1.6032e+06;-1;0;0;0;-1;0;889011215;911218706;75379003
1796;1.18811e-14;-526;1753;25945;19979;1;709;-2.14748e+09;-1.60011e+06;0;0;0;0;0;0;889137004;911369125;75429341
1796;4.26289e-15;-556;1587;9258;10117;1;575;-2.14748e+09;-1.60011e+06;-1;0;0;0;-1;0;889137004;911369125;75429341
1797;1.18811e-14;-527;1753;25945;19979;1;709;-2.14748e+09;-1.59702e+06;0;0;0;0;0;0;889262543;911519271;75479603
1797;4.26289e-15;-556;1587;9258;10117;1;575;-2.14748e+09;-1.59702e+06;-1;0;0;0;-1;0;889262543;911519271;75479603
1798;1.18811e-14;-527;1753;25945;19979;1;709;-2.14748e+09;-1.59404e+06;-1;0;0;0;-1;0;889387833;911669144;75529789
1798;4.26289e-15;-556;1587;9258;10117;1;575;-2.14748e+09;-1.59404e+06;-1;0;0;0;-1;0;889387833;911669144;75529789
1799;1.18811e-14;-527;1753;25945;19979;1;709;-2.14748e+09;-1.59087e+06;-1;0;0;0;-1;0;889512875;911818744;75579901
1799;4.26289e-15;-557;1587;9258;10117;1;575;-2.14748e+09;-1.59087e+06;0;0;0;0;0;0;889512875;911818744;75579901
1800;1.18811e-14;-528;1753;25945;19979;1;709;-2.14748e+09;-1.5878e+06;0;0;0;0;0;0;889637670;911968073;75629937
1800;4.26289e-15;-557;1587;9258;10117;1;575;-2.14748e+09;-1.5878e+06;-1;0;0;0;-1;0;889637670;911968073;75629937
1801;1.18811e-14;-529;1753;25945;19979;1;709;-2.14748e+09;-1.58484e+06;0;0;0;0;0;0;889762217;912117130;75679899
1801;4.26289e-15;-558;1587;9258;10117;1;575;-2.14748e+09;-1.58484e+06;0;0;0;0;0;0;889762217;912117130;75679899
1802;1.18811e-14;-529;1753;25945;19979;1;709;-2.14748e+09;-1.58179e+06;-1;0;0;0;-1;0;889886517;912265916;75729785
1802;4.26289e-15;-558;1587;9258;10117;1;575;-2.14748e+09;-1.58179e+06;-1;0;0;0;-1;0;889886517;912265916;75729785
1803;1.18811e-14;-530;1753;25945;19979;1;709;-2.14748e+09;-1.57874e+06;0;0;0;0;0;0;890010572;912414433;75779597
1803;4.26289e-15;-559;1587;9258;10117;1;575;-2.14748e+09;-1.57874e+06;0;0;0;0;0;0;890010572;912414433;75779597
1804;1.18811e-14;-530;1753;25945;19979;1;709;-2.14748e+09;-1.5757e+06;-1;0;0;0;-1;0;890134380;912562679;75829333
1804;4.26289e-15;-559;1587;9258;10117;1;575;-2.14748e+09;-1.5757e+06;-1;0;0;0;-1;0;890134380;912562679;75829333
1805;1.18811e-14;-531;1753;25945;19979;1;709;-2.14748e+09;-1.57257e+06;0;0;0;0;0;0;890257944;912710656;75878996
1805;4.26289e-15;-560;1587;9258;10117;1;575;-2.14748e+09;-1.57257e+06;0;0;0;0;0;0;890257944;912710656;75878996
1806;1.18811e-14;-531;1753;25945;19979;1;709;-2.14748e+09;-1.56954e+06;-1;0;0;0;-1;0;890381263;912858364;75928583
1806;4.26289e-15;-560;1587;9258;10117;1;575;-2.14748e+09;-1.56954e+06;-1;0;0;0;-1;0;890381263;912858364;75928583
1807;1.18811e-14;-532;1753;25945;19979;1;709;-2.14748e+09;-1.56652e+06;0;0;0;0;0;0;890504338;913005805;75978096
1807;4.26289e-15;-560;1587;9258;10117;1;575;-2.14748e+09;-1.56652e+06;-1;0;0;0;-1;0;890504338;913005805;75978096
1808;1.18811e-14;-533;1753;25945;19979;1;709;-2.14748e+09;-1.5635e+06;0;0;0;0;0;0;890627169;913152977;76027534
1808;4.26289e-15;-560;1587;9258;10117;1;575;-2.14748e+09;-1.5635e+06;-1;0;0;0;-1;0;890627169;913152977;76027534
1809;1.18811e-14;-533;1753;25945;19979;1;709;-2.14748e+09;-1.56059e+06;-1;0;0;0;-1;0;890749757;913299882;76076898
1809;4.26289e-15;-560;1587;9258;10117;1;575;-2.14748e+09;-1.56049e+06;-1;0;0;0;-1;0;890749757;913299882;76076898
1810;1.18811e-14;-534;1753;25945;19979;1;709;-2.14748e+09;-1.55749e+06;0;0;0;0;0;0;890872103;913446520;76126188
1810;4.26289e-15;-560;1587;9258;10117;1;575;-2.14748e+09;-1.55749e+06;-1;0;0;0;-1;0;890872103;913446520;76126188
1811;1.18811e-14;-534;1753;25945;19979;1;709;-2.14748e+09;-1.55449e+06;-1;0;0;0;-1;0;890994207;913592893;76175403
1811;4.26289e-15;-561;1587;9258;10117;1;575;-2.14748e+09;-1.55449e+06;0;0;0;0;0;0;890994207;913592893;76175403
1812;1.18811e-14;-535;1753;25945;19979;1;709;-2.14748e+09;-1.5515e+06;0;0;0;0;0;0;891116070;913738999;76224544
1812;4.26289e-15;-562;1587;9258;10117;1;575;-2.14748e+09;-1.5515e+06;0;0;0;0;0;0;891116070;913738999;76224544
1813;1.18811e-14;-535;1753;25945;19979;1;709;-2.14748e+09;-1.54862e+06;-1;0;0;0;-1;0;891237691;913884840;76273611
1813;4.26289e-15;-562;1587;9258;10117;1;575;-2.14748e+09;-1.54862e+06;-1;0;0;0;-1;0;891237691;913884840;76273611
1814;1.18811e-14;-535;1753;25945;19979;1;709;-2.14748e+09;-1.54554e+06;-1;0;0;0;-1;0;891359072;914030417;76322605
1814;4.26289e-15;-562;1587;9258;10117;1;575;-2.14748e+09;-1.54554e+06;-1;0;0;0;-1;0;891359072;914030417;76322605
1815;1.18811e-14;-535;1753;25945;19979;1;709;-2.14748e+09;-1.54257e+06;-1;0;0;0;-1;0;891480214;914175729;76371524
1815;4.26289e-15;-563;1587;9258;10117;1;575;-2.14748e+09;-1.54257e+06;0;0;0;0;0;0;891480214;914175729;76371524
1816;1.18811e-14;-536;1753;25945;19979;1;709;-2.14748e+09;-1.5396e+06;0;0;0;0;0;0;891601116;914320777;76420369
1816;4.26289e-15;-563;1587;9258;10117;1;575;-2.14748e+09;-1.5396e+06;-1;0;0;0;-1;0;891601116;914320777;76420369
1817;1.18811e-14;-537;1753;25945;19979;1;709;-2.14748e+09;-1.53674e+06;0;0;0;0;0;0;891721779;914465563;76469141
1817;4.26289e-15;-564;1587;9258;10117;1;575;-2.14748e+09;-1.53674e+06;0;0;0;0;0;0;891721779;914465563;76469141
1818;1.18811e-14;-537;1753;25945;19979;1;709;-2.14748e+09;-1.53369e+06;-1;0;0;0;-1;0;891842203;914610085;76517839
1818;4.26289e-15;-564;1587;9258;10117;1;575;-2.14748e+09;-1.53369e+06;-1;0;0;0;-1;0;891842203;914610085;76517839
1819;1.18811e-14;-538;1753;25945;19979;1;709;-2.14748e+09;-1.53074e+06;0;0;0;0;0;0;891962390;914754346;76566463
1819;4.26289e-15;-565;1587;9258;10117;1;575;-2.14748e+09;-1.53074e+06;0;0;0;0;0;0;891962390;914754346;76566463
1820;1.18811e-14;-539;1753;25945;19979;1;709;-2.14748e+09;-1.5279e+06;0;0;0;0;0;0;892082340;914898344;76615014
1820;4.26289e-15;-565;1587;9258;10117;1;575;-2.14748e+09;-1.5278e+06;-1;0;0;0;-1;0;892082340;914898344;76615014
1821;1.18811e-14;-539;1753;25945;19979;1;709;-2.14748e+09;-1.52487e+06;-1;0;0;0;-1;0;892202052;915042082;76663491
1821;4.26289e-15;-565;1587;9258;10117;1;575;-2.14748e+09;-1.52487e+06;-1;0;0;0;-1;0;892202052;915042082;76663491
1822;1.18811e-14;-539;1753;25945;19979;1;709;-2.14748e+09;-1.52194e+06;-1;0;0;0;-1;0;892321529;915185558;76711895
1822;4.26289e-15;-566;1587;9258;10117;1;575;-2.14748e+09;-1.52194e+06;0;0;0;0;0;0;892321529;915185558;76711895
1823;1.18811e-14;-539;1753;25945;19979;1;709;-2.14748e+09;-1.51902e+06;-1;0;0;0;-1;0;892440769;915328774;76760226
1823;4.26289e-15;-566;1587;9258;10117;1;575;-2.14748e+09;-1.51902e+06;-1;0;0;0;-1;0;892440769;915328774;76760226
1824;1.18811e-14;-540;1753;25945;19979;1;709;-2.14748e+09;-1.5161e+06;0;0;0;0;0;0;892559774;915471731;76808483
1824;4.26289e-15;-567;1587;9258;10117;1;575;-2.14748e+09;-1.5161e+06;0;0;0;0;0;0;892559774;915471731;76808483
1825;1.18811e-14;-541;1753;25945;19979;1;709;-2.14748e+09;-1.51329e+06;0;0;0;0;0;0;892678544;915614428;76856668
1825;4.26289e-15;-567;1587;9258;10117;1;575;-2.14748e+09;-1.51319e+06;-1;0;0;0;-1;0;892678544;915614428;76856668
1826;1.18811e-14;-542;1753;25945;19979;1;709;-2.14748e+09;-1.51038e+06;0;0;0;0;0;0;892797080;915756867;76904779
1826;4.26289e-15;-568;1587;9258;10117;1;575;-2.14748e+09;-1.51028e+06;0;0;0;0;0;0;892797080;915756867;76904779
1827;1.18811e-14;-543;1753;25945;19979;1;709;-2.14748e+09;-1.50738e+06;0;0;0;0;0;0;892915383;915899047;76952817
1827;4.26289e-15;-568;1587;9258;10117;1;575;-2.14748e+09;-1.50738e+06;-1;0;0;0;-1;0;892915383;915899047;76952817
1828;1.18811e-14;-544;1753;25945;19979;1;709;-2.14748e+09;-1.50449e+06;0;0;0;0;0;0;893033451;916040969;77000783
1828;4.26289e-15;-569;1587;9258;10117;1;575;-2.14748e+09;-1.50449e+06;0;0;0;0;0;0;893033451;916040969;77000783
1829;1.18811e-14;-545;1753;25945;19979;1;709;-2.14748e+09;-1.5017e+06;0;0;0;0;0;0;893151287;916182634;77048675
1829;4.26289e-15;-570;1587;9258;10117;1;575;-2.14748e+09;-1.5016e+06;0;0;0;0;0;0;893151287;916182634;77048675
1830;1.18811e-14;-546;1753;25945;19979;1;709;-2.14748e+09;-1.49872e+06;0;0;0;0;0;0;893268891;916324042;77096495
1830;4.26289e-15;-570;1587;9258;10117;1;575;-2.14748e+09;-1.49872e+06;-1;0;0;0;-1;0;893268891;916324042;77096495
1831;1.18811e-14;-547;1753;25945;19979;1;709;-2.14748e+09;-1.49595e+06;0;0;0;0;0;0;893386263;916465194;77144243
1831;4.26289e-15;-571;1587;9258;10117;1;575;-2.14748e+09;-1.49585e+06;0;0;0;0;0;0;893386263;916465194;77144243
1832;1.18811e-14;-548;1753;25945;19979;1;709;-2.14748e+09;-1.49308e+06;0;0;0;0;0;0;893503404;916606090;77191917
1832;4.26289e-15;-571;1587;9258;10117;1;575;-2.14748e+09;-1.49298e+06;-1;0;0;0;-1;0;893503404;916606090;77191917
1833;1.18811e-14;-549;1753;25945;19979;1;709;-2.14748e+09;-1.49012e+06;0;0;0;0;0;0;893620313;916746730;77239520
1833;4.26289e-15;-571;1587;9258;10117;1;575;-2.14748e+09;-1.49012e+06;-1;0;0;0;-1;0;893620313;916746730;77239520
1834;1.18811e-14;-549;1753;25945;19979;1;709;-2.14748e+09;-1.48726e+06;-1;0;0;0;-1;0;893736993;916887115;77287049
1834;4.26289e-15;-572;1587;9258;10117;1;575;-2.14748e+09;-1.48726e+06;0;0;0;0;0;0;893736993;916887115;77287049
1835;1.18811e-14;-549;1753;25945;19979;1;709;-2.14748e+09;-1.48451e+06;-1;0;0;0;-1;0;893853442;917027246;77334507
1835;4.26289e-15;-572;1587;9258;10117;1;575;-2.14748e+09;-1.48451e+06;-1;0;0;0;-1;0;893853442;917027246;77334507
1836;1.18811e-14;-549;1753;25945;19979;1;709;-2.14748e+09;-1.48156e+06;-1;0;0;0;-1;0;893969662;917167123;77381892
1836;4.26289e-15;-573;1587;9258;10117;1;575;-2.14748e+09;-1.48156e+06;0;0;0;0;0;0;893969662;917167123;77381892
1837;1.18811e-14;-550;1753;25945;19979;1;709;-2.14748e+09;-1.47882e+06;0;0;0;0;0;0;894085653;917306747;77429205
1837;4.26289e-15;-573;1587;9258;10117;1;575;-2.14748e+09;-1.47872e+06;-1;0;0;0;-1;0;894085653;917306747;77429205
1838;1.18811e-14;-550;1753;25945;19979;1;709;-2.14748e+09;-1.47589e+06;-1;0;0;0;-1;0;894201416;917446117;77476446
1838;4.26289e-15;-574;1587;9258;10117;1;575;-2.14748e+09;-1.47589e+06;0;0;0;0;0;0;894201416;917446117;77476446
1839;1.18811e-14;-551;1753;25945;19979;1;709;-2.14748e+09;-1.47306e+06;0;0;0;0;0;0;894316951;917585235;77523615
1839;4.26289e-15;-575;1587;9258;10117;1;575;-2.14748e+09;-1.47306e+06;0;0;0;0;0;0;894316951;917585235;77523615
1840;1.18811e-14;-551;1753;25945;19979;1;709;-2.14748e+09;-1.47024e+06;-1;0;0;0;-1;0;894432259;917724101;77570712
1840;4.26289e-15;-576;1587;9258;10117;1;575;-2.14748e+09;-1.47024e+06;0;0;0;0;0;0;894432259;917724101;77570712
1841;1.18811e-14;-552;1753;25945;19979;1;709;-2.14748e+09;-1.46742e+06;0;0;0;0;0;0;894547339;917862715;77617738
1841;4.26289e-15;-576;1587;9258;10117;1;575;-2.14748e+09;-1.46742e+06;-1;0;0;0;-1;0;894547339;917862715;77617738
1842;1.18811e-14;-553;1753;25945;19979;1;709;-2.14748e+09;-1.46462e+06;0;0;0;0;0;0;894662193;918001078;77664691
1842;4.26289e-15;-577;1587;9258;10117;1;575;-2.14748e+09;-1.46461e+06;0;0;0;0;0;0;894662193;918001078;77664691
1843;1.18811e-14;-553;1753;25945;19979;1;709;-2.14748e+09;-1.46181e+06;-1;0;0;0;-1;0;894776821;918139190;77711573
1843;4.26289e-15;-578;1587;9258;10117;1;575;-2.14748e+09;-1.46181e+06;0;0;0;0;0;0;894776821;918139190;77711573
1844;1.18811e-14;-554;1753;25945;19979;1;709;-2.14748e+09;-1.45901e+06;0;0;0;0;0;0;894891224;918277053;77758383
1844;4.26289e-15;-578;1587;9258;10117;1;575;-2.14748e+09;-1.45901e+06;-1;0;0;0;-1;0;894891224;918277053;77758383
1845;1.18811e-14;-554;1753;25945;19979;1;709;-2.14748e+09;-1.45622e+06;-1;0;0;0;-1;0;895005402;918414665;77805122
1845;4.26289e-15;-578;1587;9258;10117;1;575;-2.14748e+09;-1.45622e+06;-1;0;0;0;-1;0;895005402;918414665;77805122
1846;1.18811e-14;-554;1753;25945;19979;1;709;-2.14748e+09;-1.45343e+06;-1;0;0;0;-1;0;895119355;918552028;77851789
1846;4.26289e-15;-579;1587;9258;10117;1;575;-2.14748e+09;-1.45343e+06;0;0;0;0;0;0;895119355;918552028;77851789
1847;1.18811e-14;-555;1753;25945;19979;1;709;-2.14748e+09;-1.45075e+06;0;0;0;0;0;0;895233084;918689143;77898385
1847;4.26289e-15;-580;1587;9258;10117;1;575;-2.14748e+09;-1.45075e+06;0;0;0;0;0;0;895233084;918689143;77898385
1848;1.18811e-14;-555;1753;25945;19979;1;709;-2.14748e+09;-1.44788e+06;-1;0;0;0;-1;0;895346589;918826009;77944910
1848;4.26289e-15;-580;1587;9258;10117;1;575;-2.14748e+09;-1.44788e+06;-1;0;0;0;-1;0;895346589;918826009;77944910
1849;1.18811e-14;-555;1753;25945;19979;1;709;-2.14748e+09;-1.4451e+06;-1;0;0;0;-1;0;895459871;918962627;77991363
1849;4.26289e-15;-580;1587;9258;10117;1;575;-2.14748e+09;-1.4451e+06;-1;0;0;0;-1;0;895459871;918962627;77991363
1850;1.18811e-14;-555;1753;25945;19979;1;709;-2.14748e+09;-1.44234e+06;-1;0;0;0;-1;0;895572931;919098998;78037746
1850;4.26289e-15;-581;1587;9258;10117;1;575;-2.14748e+09;-1.44234e+06;0;0;0;0;0;0;895572931;919098998;78037746
1851;1.18811e-14;-556;1753;25945;19979;1;709;-2.14748e+09;-1.43968e+06;0;0;0;0;0;0;895685768;919235121;78084057
1851;4.26289e-15;-582;1587;9258;10117;1;575;-2.14748e+09;-1.43958e+06;0;0;0;0;0;0;895685768;919235121;78084057
1852;1.18811e-14;-556;1753;25945;19979;1;709;-2.14748e+09;-1.43693e+06;-1;0;0;0;-1;0;895798384;919370999;78130297
1852;4.26289e-15;-582;1587;9258;10117;1;575;-2.14748e+09;-1.43683e+06;-1;0;0;0;-1;0;895798384;919370999;78130297
1853;1.18811e-14;-557;1753;25945;19979;1;709;-2.14748e+09;-1.43418e+06;0;0;0;0;0;0;895910778;919506630;78176467
1853;4.26289e-15;-582;1587;9258;10117;1;575;-2.14748e+09;-1.43408e+06;-1;0;0;0;-1;0;895910778;919506630;78176467
1854;1.18811e-14;-558;1753;25945;19979;1;709;-2.14748e+09;-1.43134e+06;0;0;0;0;0;0;896022952;919642016;78222566
1854;4.26289e-15;-583;1587;9258;10117;1;575;-2.14748e+09;-1.43134e+06;0;0;0;0;0;0;896022952;919642016;78222566
1855;1.18811e-14;-559;1753;25945;19979;1;709;-2.14748e+09;-1.4287e+06;0;0;0;0;0;0;896134905;919777157;78268594
1855;4.26289e-15;-584;1587;9258;10117;1;575;-2.14748e+09;-1.4286e+06;0;0;0;0;0;0;896134905;919777157;78268594
1856;1.18811e-14;-559;1753;25945;19979;1;709;-2.14748e+09;-1.42587e+06;-1;0;0;0;-1;0;896246639;919912053;78314551
1856;4.26289e-15;-585;1587;9258;10117;1;575;-2.14748e+09;-1.42587e+06;0;0;0;0;0;0;896246639;919912053;78314551
1857;1.18811e-14;-559;1753;25945;19979;1;709;-2.14748e+09;-1.42325e+06;-1;0;0;0;-1;0;896358153;920046704;78360438
1857;4.26289e-15;-585;1587;9258;10117;1;575;-2.14748e+09;-1.42315e+06;-1;0;0;0;-1;0;896358153;920046704;78360438
1858;1.18811e-14;-560;1753;25945;19979;1;709;-2.14748e+09;-1.42043e+06;0;0;0;0;0;0;896469448;920181113;78406254
1858;4.26289e-15;-585;1587;9258;10117;1;575;-2.14748e+09;-1.42043e+06;-1;0;0;0;-1;0;896469448;920181113;78406254
1859;1.18811e-14;-561;1753;25945;19979;1;709;-2.14748e+09;-1.41771e+06;0;0;0;0;0;0;896580525;920315277;78452000
1859;4.26289e-15;-586;1587;9258;10117;1;575;-2.14748e+09;-1.41771e+06;0;0;0;0;0;0;896580525;920315277;78452000
1860;1.18811e-14;-562;1753;25945;19979;1;709;-2.14748e+09;-1.41501e+06;0;0;0;0;0;0;896691384;920449199;78497676
1860;4.26289e-15;-587;1587;9258;10117;1;575;-2.14748e+09;-1.41501e+06;0;0;0;0;0;0;896691384;920449199;78497676
1861;1.18811e-14;-562;1753;25945;19979;1;709;-2.14748e+09;-1.4124e+06;-1;0;0;0;-1;0;896802025;920582879;78543282
1861;4.26289e-15;-588;1587;9258;10117;1;575;-2.14748e+09;-1.4123e+06;0;0;0;0;0;0;896802025;920582879;78543282
1862;1.18811e-14;-563;1753;25945;19979;1;709;-2.14748e+09;-1.40961e+06;0;0;0;0;0;0;896912449;920716317;78588817
1862;4.26289e-15;-588;1587;9258;10117;1;575;-2.14748e+09;-1.40961e+06;-1;0;0;0;-1;0;896912449;920716317;78588817
1863;1.18811e-14;-563;1753;25945;19979;1;709;-2.14748e+09;-1.40691e+06;-1;0;0;0;-1;0;897022657;920849513;78634282
1863;4.26289e-15;-588;1587;9258;10117;1;575;-2.14748e+09;-1.40691e+06;-1;0;0;0;-1;0;897022657;920849513;78634282
1864;1.18811e-14;-563;1753;25945;19979;1;709;-2.14748e+09;-1.40423e+06;-1;0;0;0;-1;0;897132648;920982468;78679678
1864;4.26289e-15;-589;1587;9258;10117;1;575;-2.14748e+09;-1.40423e+06;0;0;0;0;0;0;897132648;920982468;78679678
1865;1.18811e-14;-563;1753;25945;19979;1;709;-2.14748e+09;-1.40155e+06;-1;0;0;0;-1;0;897242424;921115183;78725003
1865;4.26289e-15;-590;1587;9258;10117;1;575;-2.14748e+09;-1.40155e+06;0;0;0;0;0;0;897242424;921115183;78725003
1866;1.18811e-14;-564;1753;25945;19979;1;709;-2.14748e+09;-1.39897e+06;0;0;0;0;0;0;897351984;921247658;78770259
1866;4.26289e-15;-590;1587;9258;10117;1;575;-2.14748e+09;-1.39887e+06;-1;0;0;0;-1;0;897351984;921247657;78770259
1867;1.18811e-14;-564;1753;25945;19979;1;709;-2.14748e+09;-1.3962e+06;-1;0;0;0;-1;0;897461330;921379892;78815445
1867;4.26289e-15;-591;1587;9258;10117;1;575;-2.14748e+09;-1.3962e+06;0;0;0;0;0;0;897461330;921379892;78815445
1868;1.18811e-14;-564;1753;25945;19979;1;709;-2.14748e+09;-1.39354e+06;-1;0;0;0;-1;0;897570461;921511888;78860561
1868;4.26289e-15;-591;1587;9258;10117;1;575;-2.14748e+09;-1.39354e+06;-1;0;0;0;-1;0;897570461;921511888;78860561
1869;1.18811e-14;-564;1753;25945;19979;1;709;-2.14748e+09;-1.39098e+06;-1;0;0;0;-1;0;897679379;921643645;78905608
1869;4.26289e-15;-591;1587;9258;10117;1;575;-2.14748e+09;-1.39088e+06;-1;0;0;0;-1;0;897679379;921643645;78905608
1870;1.18811e-14;-565;1753;25945;19979;1;709;-2.14748e+09;-1.38823e+06;0;0;0;0;0;0;897788083;921775163;78950585
1870;4.26289e-15;-592;1587;9258;10117;1;575;-2.14748e+09;-1.38823e+06;0;0;0;0;0;0;897788083;921775163;78950585
1871;1.18811e-14;-565;1753;25945;19979;1;709;-2.14748e+09;-1.38558e+06;-1;0;0;0;-1;0;897896574;921906444;78995493
1871;4.26289e-15;-593;1587;9258;10117;1;575;-2.14748e+09;-1.38558e+06;0;0;0;0;0;0;897896574;921906444;78995493
1872;1.18811e-14;-566;1753;25945;19979;1;709;-2.14748e+09;-1.38294e+06;0;0;0;0;0;0;898004853;922037487;79040331
1872;4.26289e-15;-594;1587;9258;10117;1;575;-2.14748e+09;-1.38294e+06;0;0;0;0;0;0;898004853;922037487;79040331
1873;1.18811e-14;-567;1753;25945;19979;1;709;-2.14748e+09;-1.3803e+06;0;0;0;0;0;0;898112919;922168293;79085101
1873;4.26289e-15;-594;1587;9258;10117;1;575;-2.14748e+09;-1.3803e+06;-1;0;0;0;-1;0;898112919;922168293;79085101
1874;1.18811e-14;-568;1753;25945;19979;1;709;-2.14748e+09;-1.37767e+06;0;0;0;0;0;0;898220774;922298863;79129801
1874;4.26289e-15;-594;1587;9258;10117;1;575;-2.14748e+09;-1.37767e+06;-1;0;0;0;-1;0;898220774;922298863;79129801
1875;1.18811e-14;-568;1753;25945;19979;1;709;-2.14748e+09;-1.37504e+06;-1;0;0;0;-1;0;898328418;922429197;79174432
1875;4.26289e-15;-594;1587;9258;10117;1;575;-2.14748e+09;-1.37504e+06;-1;0;0;0;-1;0;898328418;922429197;79174432
1876;1.18811e-14;-568;1753;25945;19979;1;709;-2.14748e+09;-1.37242e+06;-1;0;0;0;-1;0;898435850;922559294;79218994
1876;4.26289e-15;-594;1587;9258;10117;1;575;-2.14748e+09;-1.37242e+06;-1;0;0;0;-1;0;898435850;922559294;79218994
1877;1.18811e-14;-568;1753;25945;19979;1;709;-2.14748e+09;-1.3699e+06;-1;0;0;0;-1;0;898543073;922689157;79263487
1877;4.26289e-15;-595;1587;9258;10117;1;575;-2.14748e+09;-1.3698e+06;0;0;0;0;0;0;898543073;922689157;79263487
1878;1.18811e-14;-569;1753;25945;19979;1;709;-2.14748e+09;-1.36729e+06;0;0;0;0;0;0;898650086;922818785;79307911
1878;4.26289e-15;-596;1587;9258;10117;1;575;-2.14748e+09;-1.36719e+06;0;0;0;0;0;0;898650086;922818785;79307911
1879;1.18811e-14;-569;1753;25945;19979;1;709;-2.14748e+09;-1.36459e+06;-1;0;0;0;-1;0;898756889;922948178;79352267
1879;4.26289e-15;-597;1587;9258;10117;1;575;-2.14748e+09;-1.36459e+06;0;0;0;0;0;0;898756889;922948178;79352267
1880;1.18811e-14;-570;1753;25945;19979;1;709;-2.14748e+09;-1.36209e+06;0;0;0;0;0;0;898863483;923077338;79396554
1880;4.26289e-15;-597;1587;9258;10117;1;575;-2.14748e+09;-1.36199e+06;-1;0;0;0;-1;0;898863483;923077338;79396554
1881;1.18811e-14;-571;1753;25945;19979;1;709;-2.14748e+09;-1.35939e+06;0;0;0;0;0;0;898969869;923206264;79440772
1881;4.26289e-15;-598;1587;9258;10117;1;575;-2.14748e+09;-1.35939e+06;0;0;0;0;0;0;898969869;923206264;79440772
1882;1.18811e-14;-572;1753;25945;19979;1;709;-2.14748e+09;-1.3568e+06;0;0;0;0;0;0;899076047;923334956;79484922
1882;4.26289e-15;-598;1587;9258;10117;1;575;-2.14748e+09;-1.3568e+06;-1;0;0;0;-1;0;899076047;923334956;79484922
1883;1.18811e-14;-573;1753;25945;19979;1;709;-2.14748e+09;-1.35422e+06;0;0;0;0;0;0;899182017;923463417;79529004
1883;4.26289e-15;-598;1587;9258;10117;1;575;-2.14748e+09;-1.35422e+06;-1;0;0;0;-1;0;899182017;923463417;79529004
1884;1.18811e-14;-573;1753;25945;19979;1;709;-2.14748e+09;-1.35164e+06;-1;0;0;0;-1;0;899287779;923591645;79573017
1884;4.26289e-15;-599;1587;9258;10117;1;575;-2.14748e+09;-1.35164e+06;0;0;0;0;0;0;899287779;923591645;79573017
1885;1.18811e-14;-574;1753;25945;19979;1;709;-2.14748e+09;-1.34917e+06;0;0;0;0;0;0;899393335;923719641;79616962
1885;4.26289e-15;-600;1587;9258;10117;1;575;-2.14748e+09;-1.34907e+06;0;0;0;0;0;0;899393335;923719641;79616962
1886;1.18811e-14;-575;1753;25945;19979;1;709;-2.14748e+09;-1.3465e+06;0;0;0;0;0;0;899498685;923847406;79660838
1886;4.26289e-15;-600;1587;9258;10117;1;575;-2.14748e+09;-1.3465e+06;-1;0;0;0;-1;0;899498685;923847406;79660838
1887;1.18811e-14;-575;1753;25945;19979;1;709;-2.14748e+09;-1.34403e+06;-1;0;0;0;-1;0;899603828;923974940;79704647
1887;4.26289e-15;-601;1587;9258;10117;1;575;-2.14748e+09;-1.34393e+06;0;0;0;0;0;0;899603828;923974940;79704647
1888;1.18811e-14;-576;1753;25945;19979;1;709;-2.14748e+09;-1.34148e+06;0;0;0;0;0;0;899708766;924102243;79748388
1888;4.26289e-15;-602;1587;9258;10117;1;575;-2.14748e+09;-1.34138e+06;0;0;0;0;0;0;899708766;924102243;79748388
1889;1.18811e-14;-577;1753;25945;19979;1;709;-2.14748e+09;-1.33882e+06;0;0;0;0;0;0;899813499;924229317;79792060
1889;4.26289e-15;-602;1587;9258;10117;1;575;-2.14748e+09;-1.33882e+06;-1;0;0;0;-1;0;899813499;924229317;79792060
1890;1.18811e-14;-577;1753;25945;19979;1;709;-2.14748e+09;-1.33628e+06;-1;0;0;0;-1;0;899918028;924356160;79835665
1890;4.26289e-15;-602;1587;9258;10117;1;575;-2.14748e+09;-1.33628e+06;-1;0;0;0;-1;0;899918028;924356160;79835665
1891;1.18811e-14;-577;1753;25945;19979;1;709;-2.14748e+09;-1.33383e+06;-1;0;0;0;-1;0;900022352;924482775;79879202
1891;4.26289e-15;-603;1587;9258;10117;1;575;-2.14748e+09;-1.33373e+06;0;0;0;0;0;0;900022352;924482775;79879202
1892;1.18811e-14;-577;1753;25945;19979;1;709;-2.14748e+09;-1.3312e+06;-1;0;0;0;-1;0;900126472;924609161;79922672
1892;4.26289e-15;-603;1587;9258;10117;1;575;-2.14748e+09;-1.3312e+06;-1;0;0;0;-1;0;900126472;924609161;79922672
1893;1.18811e-14;-577;1753;25945;19979;1;709;-2.14748e+09;-1.32866e+06;-1;0;0;0;-1;0;900230389;924735318;79966073
1893;4.26289e-15;-603;1587;9258;10117;1;575;-2.14748e+09;-1.32866e+06;-1;0;0;0;-1;0;900230389;924735318;79966073
1894;1.18811e-14;-577;1753;25945;19979;1;709;-2.14748e+09;-1.32614e+06;-1;0;0;0;-1;0;900334104;924861248;80009408
1894;4.26289e-15;-604;1587;9258;10117;1;575;-2.14748e+09;-1.32614e+06;0;0;0;0;0;0;900334104;924861248;80009408
1895;1.18811e-14;-578;1753;25945;19979;1;709;-2.14748e+09;-1.32361e+06;0;0;0;0;0;0;900437615;924986950;80052674
1895;4.26289e-15;-605;1587;9258;10117;1;575;-2.14748e+09;-1.32361e+06;0;0;0;0;0;0;900437615;924986950;80052674
1896;1.18811e-14;-579;1753;25945;19979;1;709;-2.14748e+09;-1.3211e+06;0;0;0;0;0;0;900540925;925112425;80095874
1896;4.26289e-15;-606;1587;9258;10117;1;575;-2.14748e+09;-1.3211e+06;0;0;0;0;0;0;900540925;925112425;80095874
1897;1.18811e-14;-580;1753;25945;19979;1;709;-2.14748e+09;-1.31858e+06;0;0;0;0;0;0;900644032;925237673;80139006
1897;4.26289e-15;-607;1587;9258;10117;1;575;-2.14748e+09;-1.31858e+06;0;0;0;0;0;0;900644032;925237673;80139006
1898;1.18811e-14;-581;1753;25945;19979;1;709;-2.14748e+09;-1.31618e+06;0;0;0;0;0;0;900746939;925362695;80182071
1898;4.26289e-15;-607;1587;9258;10117;1;575;-2.14748e+09;-1.31618e+06;-1;0;0;0;-1;0;900746939;925362695;80182071
1899;1.18811e-14;-582;1753;25945;19979;1;709;-2.14748e+09;-1.31368e+06;0;0;0;0;0;0;900849645;925487491;80225069
1899;4.26289e-15;-608;1587;9258;10117;1;575;-2.14748e+09;-1.31368e+06;0;0;0;0;0;0;900849645;925487491;80225069
1900;1.18811e-14;-582;1753;25945;19979;1;709;-2.14748e+09;-1.31118e+06;-1;0;0;0;-1;0;900952150;925612062;80268000
1900;4.26289e-15;-608;1587;9258;10117;1;575;-2.14748e+09;-1.31118e+06;-1;0;0;0;-1;0;900952150;925612062;80268000
1901;1.18811e-14;-583;1753;25945;19979;1;709;-2.14748e+09;-1.30869e+06;0;0;0;0;0;0;901054456;925736408;80310864
1901;4.26289e-15;-608;1587;9258;10117;1;575;-2.14748e+09;-1.30869e+06;-1;0;0;0;-1;0;901054456;925736408;80310864
1902;1.18811e-14;-584;1753;25945;19979;1;709;-2.14748e+09;-1.3061e+06;0;0;0;0;0;0;901156561;925860529;80353661
1902;4.26289e-15;-608;1587;9258;10117;1;575;-2.14748e+09;-1.3061e+06;-1;0;0;0;-1;0;901156561;925860529;80353661
1903;1.18811e-14;-585;1753;25945;19979;1;709;-2.14748e+09;-1.30372e+06;0;0;0;0;0;0;901258468;925984426;80396391
1903;4.26289e-15;-609;1587;9258;10117;1;575;-2.14748e+09;-1.30372e+06;0;0;0;0;0;0;901258468;925984426;80396391
1904;1.18811e-14;-586;1753;25945;19979;1;709;-2.14748e+09;-1.30114e+06;0;0;0;0;0;0;901360176;926108099;80439055
1904;4.26289e-15;-610;1587;9258;10117;1;575;-2.14748e+09;-1.30114e+06;0;0;0;0;0;0;901360176;926108099;80439055
1905;1.18811e-14;-586;1753;25945;19979;1;709;-2.14748e+09;-1.29867e+06;-1;0;0;0;-1;0;901461685;926231549;80481652
1905;4.26289e-15;-610;1587;9258;10117;1;575;-2.14748e+09;-1.29867e+06;-1;0;0;0;-1;0;901461685;926231549;80481652
1906;1.18811e-14;-587;1753;25945;19979;1;709;-2.14748e+09;-1.2963e+06;0;0;0;0;0;0;901562997;926354776;80524183
1906;4.26289e-15;-610;1587;9258;10117;1;575;-2.14748e+09;-1.2962e+06;-1;0;0;0;-1;0;901562997;926354776;80524183
1907;1.18811e-14;-588;1753;25945;19979;1;709;-2.14748e+09;-1.29374e+06;0;0;0;0;0;0;901664111;926477781;80566647
1907;4.26289e-15;-611;1587;9258;10117;1;575;-2.14748e+09;-1.29374e+06;0;0;0;0;0;0;901664111;926477781;80566647
1908;1.18811e-14;-588;1753;25945;19979;1;709;-2.14748e+09;-1.29129e+06;-1;0;0;0;-1;0;901765028;926600563;80609044
1908;4.26289e-15;-611;1587;9258;10117;1;575;-2.14748e+09;-1.29129e+06;-1;0;0;0;-1;0;901765028;926600563;80609044
1909;1.18811e-14;-589;1753;25945;19979;1;709;-2.14748e+09;-1.28884e+06;0;0;0;0;0;0;901865749;926723124;80651376
1909;4.26289e-15;-611;1587;9258;10117;1;575;-2.14748e+09;-1.28884e+06;-1;0;0;0;-1;0;901865749;926723124;80651376
1910;1.18811e-14;-590;1753;25945;19979;1;709;-2.14748e+09;-1.28649e+06;0;0;0;0;0;0;901966273;926845463;80693641
1910;4.26289e-15;-611;1587;9258;10117;1;575;-2.14748e+09;-1.28649e+06;-1;0;0;0;-1;0;901966273;926845463;80693641
1911;1.18811e-14;-591;1753;25945;19979;1;709;-2.14748e+09;-1.28395e+06;0;0;0;0;0;0;902066601;926967582;80735840
1911;4.26289e-15;-611;1587;9258;10117;1;575;-2.14748e+09;-1.28395e+06;-1;0;0;0;-1;0;902066601;926967582;80735840
1912;1.18811e-14;-591;1753;25945;19979;1;709;-2.14748e+09;-1.28161e+06;-1;0;0;0;-1;0;902166734;927089480;80777973
1912;4.26289e-15;-612;1587;9258;10117;1;575;-2.14748e+09;-1.28151e+06;0;0;0;0;0;0;902166734;927089480;80777973
1913;1.18811e-14;-592;1753;25945;19979;1;709;-2.14748e+09;-1.27908e+06;0;0;0;0;0;0;902266672;927211158;80820040
1913;4.26289e-15;-613;1587;9258;10117;1;575;-2.14748e+09;-1.27908e+06;0;0;0;0;0;0;902266672;927211158;80820040
1914;1.18811e-14;-593;1753;25945;19979;1;709;-2.14748e+09;-1.27665e+06;0;0;0;0;0;0;902366415;927332616;80862041
1914;4.26289e-15;-613;1587;9258;10117;1;575;-2.14748e+09;-1.27665e+06;-1;0;0;0;-1;0;902366415;927332616;80862041
1915;1.18811e-14;-593;1753;25945;19979;1;709;-2.14748e+09;-1.27423e+06;-1;0;0;0;-1;0;902465964;927453855;80903976
1915;4.26289e-15;-613;1587;9258;10117;1;575;-2.14748e+09;-1.27423e+06;-1;0;0;0;-1;0;902465964;927453855;80903976
1916;1.18811e-14;-593;1753;25945;19979;1;709;-2.14748e+09;-1.27191e+06;-1;0;0;0;-1;0;902565319;927574876;80945846
1916;4.26289e-15;-614;1587;9258;10117;1;575;-2.14748e+09;-1.27181e+06;0;0;0;0;0;0;902565319;927574876;80945846
1917;1.18811e-14;-593;1753;25945;19979;1;709;-2.14748e+09;-1.2694e+06;-1;0;0;0;-1;0;902664481;927695677;80987650
1917;4.26289e-15;-615;1587;9258;10117;1;575;-2.14748e+09;-1.2694e+06;0;0;0;0;0;0;902664481;927695677;80987650
1918;1.18811e-14;-594;1753;25945;19979;1;709;-2.14748e+09;-1.26699e+06;0;0;0;0;0;0;902763450;927816261;81029389
1918;4.26289e-15;-616;1587;9258;10117;1;575;-2.14748e+09;-1.26699e+06;0;0;0;0;0;0;902763450;927816261;81029389
1919;1.18811e-14;-594;1753;25945;19979;1;709;-2.14748e+09;-1.26459e+06;-1;0;0;0;-1;0;902862226;927936627;81071062
1919;4.26289e-15;-617;1587;9258;10117;1;575;-2.14748e+09;-1.26459e+06;0;0;0;0;0;0;902862226;927936627;81071062
1920;1.18811e-14;-595;1753;25945;19979;1;709;-2.14748e+09;-1.26219e+06;0;0;0;0;0;0;902960810;928056776;81112669
1920;4.26289e-15;-617;1587;9258;10117;1;575;-2.14748e+09;-1.26219e+06;-1;0;0;0;-1;0;902960810;928056776;81112669
1921;1.18811e-14;-596;1753;25945;19979;1;709;-2.14748e+09;-1.2598e+06;0;0;0;0;0;0;903059202;928176708;81154212
1921;4.26289e-15;-618;1587;9258;10117;1;575;-2.14748e+09;-1.2598e+06;0;0;0;0;0;0;903059202;928176708;81154212
1922;1.18811e-14;-596;1753;25945;19979;1;709;-2.14748e+09;-1.25741e+06;-1;0;0;0;-1;0;903157402;928296424;81195689
1922;4.26289e-15;-619;1587;9258;10117;1;575;-2.14748e+09;-1.25741e+06;0;0;0;0;0;0;903157402;928296424;81195689
1923;1.18811e-14;-597;1753;25945;19979;1;709;-2.14748e+09;-1.25512e+06;0;0;0;0;0;0;903255412;928415924;81237101
1923;4.26289e-15;-620;1587;9258;10117;1;575;-2.14748e+09;-1.25512e+06;0;0;0;0;0;0;903255412;928415924;81237101
1924;1.18811e-14;-598;1753;25945;19979;1;709;-2.14748e+09;-1.25265e+06;0;0;0;0;0;0;903353231;928535208;81278448
1924;4.26289e-15;-620;1587;9258;10117;1;575;-2.14748e+09;-1.25265e+06;-1;0;0;0;-1;0;903353231;928535208;81278448
1925;1.18811e-14;-599;1753;25945;19979;1;709;-2.14748e+09;-1.25037e+06;0;0;0;0;0;0;903450860;928654277;81319730
1925;4.26289e-15;-620;1587;9258;10117;1;575;-2.14748e+09;-1.25027e+06;-1;0;0;0;-1;0;903450860;928654277;81319730
1926;1.18811e-14;-600;1753;25945;19979;1;709;-2.14748e+09;-1.248e+06;0;0;0;0;0;0;903548299;928773131;81360947
1926;4.26289e-15;-621;1587;9258;10117;1;575;-2.14748e+09;-1.248e+06;0;0;0;0;0;0;903548299;928773131;81360947
1927;1.18811e-14;-601;1753;25945;19979;1;709;-2.14748e+09;-1.24554e+06;0;0;0;0;0;0;903645548;928891770;81402099
1927;4.26289e-15;-622;1587;9258;10117;1;575;-2.14748e+09;-1.24554e+06;0;0;0;0;0;0;903645548;928891770;81402099
1928;1.18811e-14;-601;1753;25945;19979;1;709;-2.14748e+09;-1.24318e+06;-1;0;0;0;-1;0;903742609;929010196;81443187
1928;4.26289e-15;-623;1587;9258;10117;1;575;-2.14748e+09;-1.24318e+06;0;0;0;0;0;0;903742609;929010196;81443187
1929;1.18811e-14;-601;1753;25945;19979;1;709;-2.14748e+09;-1.24082e+06;-1;0;0;0;-1;0;903839481;929128408;81484209
1929;4.26289e-15;-624;1587;9258;10117;1;575;-2.14748e+09;-1.24082e+06;0;0;0;0;0;0;903839481;929128408;81484209
1930;1.18811e-14;-602;1753;25945;19979;1;709;-2.14748e+09;-1.23847e+06;0;0;0;0;0;0;903936164;929246406;81525168
1930;4.26289e-15;-625;1587;9258;10117;1;575;-2.14748e+09;-1.23847e+06;0;0;0;0;0;0;903936164;929246406;81525168
1931;1.18811e-14;-603;1753;25945;19979;1;709;-2.14748e+09;-1.23613e+06;0;0;0;0;0;0;904032660;929364192;81566062
1931;4.26289e-15;-626;1587;9258;10117;1;575;-2.14748e+09;-1.23613e+06;0;0;0;0;0;0;904032660;929364192;81566062
1932;1.18811e-14;-604;1753;25945;19979;1;709;-2.14748e+09;-1.23378e+06;0;0;0;0;0;0;904128968;929481765;81606891
1932;4.26289e-15;-626;1587;9258;10117;1;575;-2.14748e+09;-1.23378e+06;-1;0;0;0;-1;0;904128968;929481765;81606891
1933;1.18811e-14;-605;1753;25945;19979;1;709;-2.14748e+09;-1.23155e+06;0;0;0;0;0;0;904225089;929599126;81647656
1933;4.26289e-15;-626;1587;9258;10117;1;575;-2.14748e+09;-1.23155e+06;-1;0;0;0;-1;0;904225089;929599126;81647656
1934;1.18811e-14;-606;1753;25945;19979;1;709;-2.14748e+09;-1.22912e+06;0;0;0;0;0;0;904321023;929716276;81688357
1934;4.26289e-15;-626;1587;9258;10117;1;575;-2.14748e+09;-1.22912e+06;-1;0;0;0;-1;0;904321023;929716276;81688357
1935;1.18811e-14;-607;1753;25945;19979;1;709;-2.14748e+09;-1.22679e+06;0;0;0;0;0;0;904416771;929833214;81728994
1935;4.26289e-15;-627;1587;9258;10117;1;575;-2.14748e+09;-1.22679e+06;0;0;0;0;0;0;904416771;929833214;81728994
1936;1.18811e-14;-608;1753;25945;19979;1;709;-2.14748e+09;-1.22447e+06;0;0;0;0;0;0;904512333;929949941;81769566
1936;4.26289e-15;-627;1587;9258;10117;1;575;-2.14748e+09;-1.22447e+06;-1;0;0;0;-1;0;904512333;929949941;81769566
1937;1.18811e-14;-609;1753;25945;19979;1;709;-2.14748e+09;-1.22215e+06;0;0;0;0;0;0;904607710;930066458;81810075
1937;4.26289e-15;-628;1587;9258;10117;1;575;-2.14748e+09;-1.22215e+06;0;0;0;0;0;0;904607710;930066458;81810075
1938;1.18811e-14;-610;1753;25945;19979;1;709;-2.14748e+09;-1.21994e+06;0;0;0;0;0;0;904702901;930182764;81850519
1938;4.26289e-15;-628;1587;9258;10117;1;575;-2.14748e+09;-1.21994e+06;-1;0;0;0;-1;0;904702901;930182764;81850519
1939;1.18811e-14;-610;1753;25945;19979;1;709;-2.14748e+09;-1.21763e+06;-1;0;0;0;-1;0;904797908;930298861;81890900
1939;4.26289e-15;-628;1587;9258;10117;1;575;-2.14748e+09;-1.21763e+06;-1;0;0;0;-1;0;904797908;930298861;81890900
1940;1.18811e-14;-610;1753;25945;19979;1;709;-2.14748e+09;-1.21532e+06;-1;0;0;0;-1;0;904892730;930414749;81931217
1940;4.26289e-15;-629;1587;9258;10117;1;575;-2.14748e+09;-1.21532e+06;0;0;0;0;0;0;904892730;930414749;81931217
1941;1.18811e-14;-610;1753;25945;19979;1;709;-2.14748e+09;-1.21293e+06;-1;0;0;0;-1;0;904987368;930530427;81971471
1941;4.26289e-15;-629;1587;9258;10117;1;575;-2.14748e+09;-1.21293e+06;-1;0;0;0;-1;0;904987368;930530427;81971471
1942;1.18811e-14;-610;1753;25945;19979;1;709;-2.14748e+09;-1.21073e+06;-1;0;0;0;-1;0;905081823;930645897;82011661
1942;4.26289e-15;-629;1587;9258;10117;1;575;-2.14748e+09;-1.21063e+06;-1;0;0;0;-1;0;905081823;930645897;82011661
1943;1.18811e-14;-610;1753;25945;19979;1;709;-2.14748e+09;-1.20834e+06;-1;0;0;0;-1;0;905176094;930761159;82051787
1943;4.26289e-15;-630;1587;9258;10117;1;575;-2.14748e+09;-1.20834e+06;0;0;0;0;0;0;905176094;930761159;82051787
1944;1.18811e-14;-611;1753;25945;19979;1;709;-2.14748e+09;-1.20606e+06;0;0;0;0;0;0;905270183;930876213;82091850
1944;4.26289e-15;-631;1587;9258;10117;1;575;-2.14748e+09;-1.20606e+06;0;0;0;0;0;0;905270183;930876213;82091850
1945;1.18811e-14;-611;1753;25945;19979;1;709;-2.14748e+09;-1.20387e+06;-1;0;0;0;-1;0;905364089;930991059;82131850
1945;4.26289e-15;-632;1587;9258;10117;1;575;-2.14748e+09;-1.20377e+06;0;0;0;0;0;0;905364088;930991059;82131850
1946;1.18811e-14;-611;1753;25945;19979;1;709;-2.14748e+09;-1.2016e+06;-1;0;0;0;-1;0;905457812;931105698;82171786
1946;4.26289e-15;-632;1587;9258;10117;1;575;-2.14748e+09;-1.2016e+06;-1;0;0;0;-1;0;905457812;931105698;82171786
1947;1.18811e-14;-611;1753;25945;19979;1;709;-2.14748e+09;-1.19923e+06;-1;0;0;0;-1;0;905551354;931220131;82211659
1947;4.26289e-15;-632;1587;9258;10117;1;575;-2.14748e+09;-1.19923e+06;-1;0;0;0;-1;0;905551354;931220131;82211659
1948;1.18811e-14;-611;1753;25945;19979;1;709;-2.14748e+09;-1.19706e+06;-1;0;0;0;-1;0;905644715;931334357;82251469
1948;4.26289e-15;-632;1587;9258;10117;1;575;-2.14748e+09;-1.19696e+06;-1;0;0;0;-1;0;905644715;931334357;82251469
1949;1.18811e-14;-611;1753;25945;19979;1;709;-2.14748e+09;-1.1947e+06;-1;0;0;0;-1;0;905737895;931448378;82291216
1949;4.26289e-15;-633;1587;9258;10117;1;575;-2.14748e+09;-1.1947e+06;0;0;0;0;0;0;905737895;931448378;82291216
1950;1.18811e-14;-612;1753;25945;19979;1;709;-2.14748e+09;-1.19244e+06;0;0;0;0;0;0;905830894;931562193;82330900
1950;4.26289e-15;-634;1587;9258;10117;1;575;-2.14748e+09;-1.19244e+06;0;0;0;0;0;0;905830894;931562193;82330900
1951;1.18811e-14;-613;1753;25945;19979;1;709;-2.14748e+09;-1.19028e+06;0;0;0;0;0;0;905923712;931675802;82370522
1951;4.26289e-15;-634;1587;9258;10117;1;575;-2.14748e+09;-1.19028e+06;-1;0;0;0;-1;0;905923712;931675802;82370522
1952;1.18811e-14;-614;1753;25945;19979;1;709;-2.14748e+09;-1.18793e+06;0;0;0;0;0;0;906016351;931789207;82410080
1952;4.26289e-15;-634;1587;9258;10117;1;575;-2.14748e+09;-1.18793e+06;-1;0;0;0;-1;0;906016351;931789207;82410080
1953;1.18811e-14;-615;1753;25945;19979;1;709;-2.14748e+09;-1.18579e+06;0;0;0;0;0;0;906108811;931902408;82449576
1953;4.26289e-15;-635;1587;9258;10117;1;575;-2.14748e+09;-1.18579e+06;0;0;0;0;0;0;906108811;931902408;82449576
1954;1.18811e-14;-616;1753;25945;19979;1;709;-2.14748e+09;-1.18355e+06;0;0;0;0;0;0;906201091;932015404;82489009
1954;4.26289e-15;-635;1587;9258;10117;1;575;-2.14748e+09;-1.18355e+06;-1;0;0;0;-1;0;906201091;932015404;82489009
1955;1.18811e-14;-616;1753;25945;19979;1;709;-2.14748e+09;-1.18131e+06;-1;0;0;0;-1;0;906293192;932128197;82528380
1955;4.26289e-15;-635;1587;9258;10117;1;575;-2.14748e+09;-1.18131e+06;-1;0;0;0;-1;0;906293192;932128197;82528380
1956;1.18811e-14;-616;1753;25945;19979;1;709;-2.14748e+09;-1.17898e+06;-1;0;0;0;-1;0;906385115;932240786;82567688
1956;4.26289e-15;-635;1587;9258;10117;1;575;-2.14748e+09;-1.17898e+06;-1;0;0;0;-1;0;906385115;932240786;82567688
1957;1.18811e-14;-617;1753;25945;19979;1;709;-2.14748e+09;-1.17685e+06;0;0;0;0;0;0;906476860;932353173;82606934
1957;4.26289e-15;-635;1587;9258;10117;1;575;-2.14748e+09;-1.17685e+06;-1;0;0;0;-1;0;906476860;932353173;82606934
1958;1.18811e-14;-617;1753;25945;19979;1;709;-2.14748e+09;-1.17463e+06;-1;0;0;0;-1;0;906568428;932465357;82646117
1958;4.26289e-15;-636;1587;9258;10117;1;575;-2.14748e+09;-1.17463e+06;0;0;0;0;0;0;906568428;932465357;82646117
1959;1.18811e-14;-617;1753;25945;19979;1;709;-2.14748e+09;-1.17231e+06;-1;0;0;0;-1;0;906659818;932577338;82685239
1959;4.26289e-15;-636;1587;9258;10117;1;575;-2.14748e+09;-1.17231e+06;-1;0;0;0;-1;0;906659818;932577338;82685239
1960;1.18811e-14;-617;1753;25945;19979;1;709;-2.14748e+09;-1.1702e+06;-1;0;0;0;-1;0;906751031;932689118;82724298
1960;4.26289e-15;-636;1587;9258;10117;1;575;-2.14748e+09;-1.1702e+06;-1;0;0;0;-1;0;906751031;932689118;82724298
1961;1.18811e-14;-618;1753;25945;19979;1;709;-2.14748e+09;-1.16789e+06;0;0;0;0;0;0;906842067;932800697;82763295
1961;4.26289e-15;-637;1587;9258;10117;1;575;-2.14748e+09;-1.16789e+06;0;0;0;0;0;0;906842067;932800697;82763295
1962;1.18811e-14;-618;1753;25945;19979;1;709;-2.14748e+09;-1.16578e+06;-1;0;0;0;-1;0;906932927;932912074;82802230
1962;4.26289e-15;-637;1587;9258;10117;1;575;-2.14748e+09;-1.16568e+06;-1;0;0;0;-1;0;906932927;932912074;82802230
1963;1.18811e-14;-618;1753;25945;19979;1;709;-2.14748e+09;-1.16348e+06;-1;0;0;0;-1;0;907023612;933023251;82841104
1963;4.26289e-15;-638;1587;9258;10117;1;575;-2.14748e+09;-1.16348e+06;0;0;0;0;0;0;907023612;933023251;82841104
1964;1.18811e-14;-619;1753;25945;19979;1;709;-2.14748e+09;-1.16129e+06;0;0;0;0;0;0;907114121;933134227;82879915
1964;4.26289e-15;-639;1587;9258;10117;1;575;-2.14748e+09;-1.16129e+06;0;0;0;0;0;0;907114121;933134227;82879915
1965;1.18811e-14;-619;1753;25945;19979;1;709;-2.14748e+09;-1.1592e+06;-1;0;0;0;-1;0;907204455;933245004;82918665
1965;4.26289e-15;-639;1587;9258;10117;1;575;-2.14748e+09;-1.1592e+06;-1;0;0;0;-1;0;907204455;933245004;82918665
1966;1.18811e-14;-620;1753;25945;19979;1;709;-2.14748e+09;-1.15691e+06;0;0;0;0;0;0;907294614;933355581;82957353
1966;4.26289e-15;-640;1587;9258;10117;1;575;-2.14748e+09;-1.15691e+06;0;0;0;0;0;0;907294614;933355581;82957353
1967;1.18811e-14;-620;1753;25945;19979;1;709;-2.14748e+09;-1.15472e+06;-1;0;0;0;-1;0;907384598;933465958;82995980
1967;4.26289e-15;-641;1587;9258;10117;1;575;-2.14748e+09;-1.15472e+06;0;0;0;0;0;0;907384598;933465958;82995980
1968;1.18811e-14;-620;1753;25945;19979;1;709;-2.14748e+09;-1.15265e+06;-1;0;0;0;-1;0;907474409;933576137;83034545
1968;4.26289e-15;-641;1587;9258;10117;1;575;-2.14748e+09;-1.15265e+06;-1;0;0;0;-1;0;907474409;933576137;83034545
1969;1.18811e-14;-621;1753;25945;19979;1;709;-2.14748e+09;-1.15037e+06;0;0;0;0;0;0;907564046;933686117;83073048
1969;4.26289e-15;-642;1587;9258;10117;1;575;-2.14748e+09;-1.15037e+06;0;0;0;0;0;0;907564046;933686117;83073048
1970;1.18811e-14;-622;1753;25945;19979;1;709;-2.14748e+09;-1.1483e+06;0;0;0;0;0;0;907653509;933795899;83111491
1970;4.26289e-15;-643;1587;9258;10117;1;575;-2.14748e+09;-1.1482e+06;0;0;0;0;0;0;907653509;933795899;83111491
1971;1.18811e-14;-623;1753;25945;19979;1;709;-2.14748e+09;-1.14614e+06;0;0;0;0;0;0;907742800;933905484;83149872
1971;4.26289e-15;-643;1587;9258;10117;1;575;-2.14748e+09;-1.14604e+06;-1;0;0;0;-1;0;907742800;933905484;83149872
1972;1.18811e-14;-623;1753;25945;19979;1;709;-2.14748e+09;-1.14387e+06;-1;0;0;0;-1;0;907831918;934014871;83188192
1972;4.26289e-15;-643;1587;9258;10117;1;575;-2.14748e+09;-1.14387e+06;-1;0;0;0;-1;0;907831918;934014871;83188192
1973;1.18811e-14;-624;1753;25945;19979;1;709;-2.14748e+09;-1.14172e+06;0;0;0;0;0;0;907920863;934124060;83226451
1973;4.26289e-15;-643;1587;9258;10117;1;575;-2.14748e+09;-1.14172e+06;-1;0;0;0;-1;0;907920863;934124060;83226451
1974;1.18811e-14;-625;1753;25945;19979;1;709;-2.14748e+09;-1.13956e+06;0;0;0;0;0;0;908009637;934233053;83264649
1974;4.26289e-15;-643;1587;9258;10117;1;575;-2.14748e+09;-1.13956e+06;-1;0;0;0;-1;0;908009637;934233053;83264649
1975;1.18811e-14;-626;1753;25945;19979;1;709;-2.14748e+09;-1.13751e+06;0;0;0;0;0;0;908098239;934341850;83302786
1975;4.26289e-15;-643;1587;9258;10117;1;575;-2.14748e+09;-1.13741e+06;-1;0;0;0;-1;0;908098239;934341850;83302786
1976;1.18811e-14;-626;1753;25945;19979;1;709;-2.14748e+09;-1.13527e+06;-1;0;0;0;-1;0;908186670;934450451;83340862
1976;4.26289e-15;-643;1587;9258;10117;1;575;-2.14748e+09;-1.13527e+06;-1;0;0;0;-1;0;908186670;934450451;83340862
1977;1.18811e-14;-627;1753;25945;19979;1;709;-2.14748e+09;-1.13313e+06;0;0;0;0;0;0;908274930;934558856;83378878
1977;4.26289e-15;-643;1587;9258;10117;1;575;-2.14748e+09;-1.13313e+06;-1;0;0;0;-1;0;908274930;934558856;83378878
1978;1.18811e-14;-627;1753;25945;19979;1;709;-2.14748e+09;-1.13099e+06;-1;0;0;0;-1;0;908363020;934667066;83416833
1978;4.26289e-15;-643;1587;9258;10117;1;575;-2.14748e+09;-1.13099e+06;-1;0;0;0;-1;0;908363020;934667066;83416833
1979;1.18811e-14;-628;1753;25945;19979;1;709;-2.14748e+09;-1.12886e+06;0;0;0;0;0;0;908450939;934775081;83454727
1979;4.26289e-15;-644;1587;9258;10117;1;575;-2.14748e+09;-1.12886e+06;0;0;0;0;0;0;908450939;934775081;83454727
1980;1.18811e-14;-628;1753;25945;19979;1;709;-2.14748e+09;-1.12673e+06;-1;0;0;0;-1;0;908538689;934882902;83492561
1980;4.26289e-15;-644;1587;9258;10117;1;575;-2.14748e+09;-1.12673e+06;-1;0;0;0;-1;0;908538689;934882902;83492561
1981;1.18811e-14;-628;1753;25945;19979;1;709;-2.14748e+09;-1.12471e+06;-1;0;0;0;-1;0;908626269;934990528;83530334
1981;4.26289e-15;-645;1587;9258;10117;1;575;-2.14748e+09;-1.12471e+06;0;0;0;0;0;0;908626269;934990528;83530334
1982;1.18811e-14;-629;1753;25945;19979;1;709;-2.14748e+09;-1.12249e+06;0;0;0;0;0;0;908713680;935097960;83568047
1982;4.26289e-15;-646;1587;9258;10117;1;575;-2.14748e+09;-1.12249e+06;0;0;0;0;0;0;908713680;935097960;83568047
1983;1.18811e-14;-629;1753;25945;19979;1;709;-2.14748e+09;-1.12037e+06;-1;0;0;0;-1;0;908800922;935205199;83605699
1983;4.26289e-15;-647;1587;9258;10117;1;575;-2.14748e+09;-1.12037e+06;0;0;0;0;0;0;908800922;935205199;83605699
1984;1.18811e-14;-629;1753;25945;19979;1;709;-2.14748e+09;-1.11836e+06;-1;0;0;0;-1;0;908887996;935312245;83643292
1984;4.26289e-15;-648;1587;9258;10117;1;575;-2.14748e+09;-1.11826e+06;0;0;0;0;0;0;908887996;935312245;83643292
1985;1.18811e-14;-630;1753;25945;19979;1;709;-2.14748e+09;-1.11616e+06;0;0;0;0;0;0;908974902;935419098;83680824
1985;4.26289e-15;-648;1587;9258;10117;1;575;-2.14748e+09;-1.11616e+06;-1;0;0;0;-1;0;908974902;935419098;83680824
1986;1.18811e-14;-630;1753;25945;19979;1;709;-2.14748e+09;-1.11405e+06;-1;0;0;0;-1;0;909061640;935525759;83718297
1986;4.26289e-15;-648;1587;9258;10117;1;575;-2.14748e+09;-1.11405e+06;-1;0;0;0;-1;0;909061640;935525759;83718297
1987;1.18811e-14;-631;1753;25945;19979;1;709;-2.14748e+09;-1.11206e+06;0;0;0;0;0;0;909148211;935632227;83755709
1987;4.26289e-15;-648;1587;9258;10117;1;575;-2.14748e+09;-1.11196e+06;-1;0;0;0;-1;0;909148211;935632227;83755709
1988;1.18811e-14;-632;1753;25945;19979;1;709;-2.14748e+09;-1.10986e+06;0;0;0;0;0;0;909234614;935738504;83793061
1988;4.26289e-15;-648;1587;9258;10117;1;575;-2.14748e+09;-1.10986e+06;-1;0;0;0;-1;0;909234614;935738504;83793061
1989;1.18811e-14;-632;1753;25945;19979;1;709;-2.14748e+09;-1.10777e+06;-1;0;0;0;-1;0;909320851;935844590;83830354
1989;4.26289e-15;-648;1587;9258;10117;1;575;-2.14748e+09;-1.10777e+06;-1;0;0;0;-1;0;909320851;935844590;83830354
1990;1.18811e-14;-633;1753;25945;19979;1;709;-2.14748e+09;-1.10578e+06;0;0;0;0;0;0;909406922;935950484;83867587
1990;4.26289e-15;-648;1587;9258;10117;1;575;-2.14748e+09;-1.10568e+06;-1;0;0;0;-1;0;909406922;935950484;83867587
1991;1.18811e-14;-634;1753;25945;19979;1;709;-2.14748e+09;-1.1037e+06;0;0;0;0;0;0;909492826;936056188;83904761
1991;4.26289e-15;-648;1587;9258;10117;1;575;-2.14748e+09;-1.1037e+06;-1;0;0;0;-1;0;909492826;936056188;83904761
1992;1.18811e-14;-634;1753;25945;19979;1;709;-2.14748e+09;-1.10162e+06;-1;0;0;0;-1;0;909578565;936161701;83941874
1992;4.26289e-15;-649;1587;9258;10117;1;575;-2.14748e+09;-1.10162e+06;0;0;0;0;0;0;909578565;936161701;83941874
1993;1.18811e-14;-634;1753;25945;19979;1;709;-2.14748e+09;-1.09955e+06;-1;0;0;0;-1;0;909664138;936267025;83978929
1993;4.26289e-15;-649;1587;9258;10117;1;575;-2.14748e+09;-1.09945e+06;-1;0;0;0;-1;0;909664138;936267025;83978929
1994;1.18811e-14;-635;1753;25945;19979;1;709;-2.14748e+09;-1.09738e+06;0;0;0;0;0;0;909749546;936372159;84015924
1994;4.26289e-15;-650;1587;9258;10117;1;575;-2.14748e+09;-1.09738e+06;0;0;0;0;0;0;909749546;936372159;84015924
1995;1.18811e-14;-636;1753;25945;19979;1;709;-2.14748e+09;-1.09532e+06;0;0;0;0;0;0;909834790;936477103;84052859
1995;4.26289e-15;-650;1587;9258;10117;1;575;-2.14748e+09;-1.09532e+06;-1;0;0;0;-1;0;909834790;936477103;84052859
1996;1.18811e-14;-636;1753;25945;19979;1;709;-2.14748e+09;-1.09325e+06;-1;0;0;0;-1;0;909919870;936581859;84089736
1996;4.26289e-15;-651;1587;9258;10117;1;575;-2.14748e+09;-1.09325e+06;0;0;0;0;0;0;909919870;936581859;84089736
1997;1.18811e-14;-636;1753;25945;19979;1;709;-2.14748e+09;-1.0912e+06;-1;0;0;0;-1;0;910004785;936686426;84126553
1997;4.26289e-15;-652;1587;9258;10117;1;575;-2.14748e+09;-1.0912e+06;0;0;0;0;0;0;910004785;936686426;84126553
1998;1.18811e-14;-637;1753;25945;19979;1;709;-2.14748e+09;-1.08914e+06;0;0;0;0;0;0;910089537;936790805;84163311
1998;4.26289e-15;-652;1587;9258;10117;1;575;-2.14748e+09;-1.08914e+06;-1;0;0;0;-1;0;910089537;936790805;84163311
1999;1.18811e-14;-637;1753;25945;19979;1;709;-2.14748e+09;-1.08719e+06;-1;0;0;0;-1;0;910174125;936894995;84200011
1999;4.26289e-15;-652;1587;9258;10117;1;575;-2.14748e+09;-1.08719e+06;-1;0;0;0;-1;0;910174125;936894995;84200011
