step;volume;A_0;B_0;C;L;p;Compl;Aext;Bext;A_ingresso;A_uscita;B_ingresso;B_uscita;A_netto;B_netto;Avicino;Amedio;Alontano
401;4.18816e-15;80;564;13184;10038;1;0;787;3499;482;128;449;132;354;317;98;90;3
401;4.18816e-15;80;564;13184;10038;1;0;755;3499;512;149;485;142;363;343;98;90;3
402;4.21217e-15;184;1310;13071;10100;1;125;744;3499;391;77;1858;488;314;1370;98;90;3
402;4.21217e-15;212;1304;13071;10120;1;119;689;3499;381;72;1763;486;309;1277;98;88;3
403;4.25146e-15;195;1571;12976;10169;1;250;722;3499;363;94;1777;699;269;1078;98;89;3
403;4.26416e-15;192;1475;12968;10200;1;250;695;3499;339;105;1778;771;234;1007;98;89;3
404;4.29596e-15;173;1722;12946;10245;1;336;718;3500;339;115;1647;835;224;812;98;90;3
404;4.31508e-15;198;1647;12922;10279;1;349;667;3500;347;96;1772;771;251;1001;98;90;3
405;4.34381e-15;193;1686;12958;10314;1;398;703;3500;383;109;1752;832;274;920;98;90;3
405;4.36556e-15;165;1675;12937;10350;1;425;678;3500;317;109;1764;824;208;940;98;90;3
406;4.38799e-15;184;1654;12972;10392;1;471;693;3501;346;97;1681;805;249;876;98;91;3
406;4.4111e-15;170;1733;12979;10433;1;473;644;3501;349;93;1768;852;256;916;98;91;3
407;4.43811e-15;197;1731;13000;10450;1;522;682;3501;361;112;1771;826;249;945;97;91;3
407;4.46454e-15;169;1706;13031;10514;1;511;635;3501;317;90;1839;884;227;955;97;91;3
408;4.47551e-15;195;1682;13036;10513;1;566;641;3502;329;103;1822;860;226;962;97;91;3
408;4.51689e-15;195;1681;13117;10578;1;527;606;3502;316;91;1750;859;225;891;97;91;3
409;4.51624e-15;190;1588;13113;10591;1;601;611;3502;299;89;1740;853;210;887;97;89;3
409;4.5584e-15;199;1669;13180;10657;1;555;578;3502;308;99;1717;820;209;897;97;89;3
410;4.56685e-15;187;1699;13211;10654;1;615;554;3502;322;82;1704;805;240;899;96;89;3
410;4.60982e-15;170;1697;13217;10737;1;603;533;3502;285;78;1671;835;207;836;96;89;3
411;4.60786e-15;174;1660;13302;10727;1;635;578;3503;312;94;1776;813;218;963;95;90;3
411;4.66208e-15;162;1616;13325;10814;1;607;557;3503;255;79;1790;869;176;921;95;90;3
412;4.65554e-15;156;1629;13424;10808;1;641;558;3503;264;88;1723;865;176;858;95;89;3
412;4.71257e-15;149;1671;13445;10873;1;599;540;3503;259;78;1686;830;181;856;95;88;3
413;4.70863e-15;173;1549;13496;10866;1;666;560;3504;256;80;1734;821;176;913;94;89;3
413;4.75138e-15;141;1662;13560;10946;1;602;540;3504;266;61;1719;829;205;890;94;89;3
414;4.74677e-15;185;1620;13617;10936;1;656;551;3504;317;81;1713;791;236;922;94;88;3
414;4.79955e-15;152;1674;13649;11026;1;608;523;3504;298;84;1730;863;214;867;94;88;3
415;4.79294e-15;161;1666;13727;10994;1;657;437;3405;284;82;1692;864;202;828;95;88;3
415;4.85252e-15;146;1702;13736;11102;1;610;409;3405;257;74;1787;832;183;955;95;88;3
416;4.8313e-15;124;1596;13859;11056;1;646;526;3505;187;74;1753;824;113;929;94;89;3
416;4.90302e-15;116;1686;13845;11164;1;605;518;3505;212;63;1708;803;149;905;94;89;3
417;4.87243e-15;163;1583;13956;11131;1;651;559;3505;267;91;1743;797;176;946;94;89;3
417;4.94435e-15;154;1711;13982;11241;1;584;531;3505;248;69;1817;838;179;979;94;89;3
418;4.92234e-15;162;1602;14075;11210;1;653;556;3506;255;88;1856;765;167;1091;94;88;3
418;4.99584e-15;174;1671;14056;11318;1;595;536;3506;250;72;1798;855;178;943;94;87;3
419;4.97509e-15;137;1659;14156;11278;1;675;544;3506;252;73;1824;780;179;1044;94;88;3
419;5.0475e-15;144;1754;14160;11382;1;598;525;3506;292;83;1664;835;209;829;94;87;3
420;5.02064e-15;147;1668;14259;11339;1;670;561;3507;276;78;1785;823;198;962;93;88;3
420;5.09058e-15;150;1638;14322;11460;1;569;540;3507;286;80;1816;877;206;939;93;88;3
421;5.06163e-15;151;1692;14366;11409;1;664;555;3507;277;78;1798;804;199;994;94;87;3
421;5.14325e-15;183;1641;14373;11527;1;597;525;3507;263;83;1694;828;180;866;94;87;3
422;5.1088e-15;174;1684;14467;11489;1;671;510;3507;285;66;1703;826;219;877;93;87;3
422;5.18864e-15;172;1604;14440;11610;1;621;500;3507;275;76;1725;848;199;877;93;87;3
423;5.16288e-15;153;1647;14595;11569;1;664;548;3508;250;78;1755;834;172;921;93;87;3
423;5.24505e-15;145;1654;14517;11685;1;644;519;3508;269;78;1759;871;191;888;93;87;3
424;5.21716e-15;158;1628;14719;11631;1;654;545;3508;275;67;1684;804;208;880;92;87;3
424;5.2962e-15;138;1682;14611;11752;1;649;516;3508;263;85;1729;801;178;928;92;87;3
425;5.25935e-15;166;1633;14829;11687;1;656;528;3509;281;78;1783;821;203;962;92;85;3
425;5.34203e-15;156;1696;14702;11820;1;655;519;3509;257;80;1728;809;177;919;92;85;3
426;5.29756e-15;151;1625;14937;11757;1;656;529;3509;276;86;1743;847;190;896;91;86;3
426;5.38868e-15;149;1665;14779;11884;1;671;479;3509;271;70;1850;800;201;1050;91;85;3
427;5.34546e-15;150;1671;15031;11821;1;668;516;3509;275;87;1790;857;188;933;91;85;3
427;5.43271e-15;141;1782;14861;11959;1;682;496;3509;241;63;1740;829;178;911;91;85;3
428;5.38937e-15;153;1737;15132;11891;1;666;526;3510;238;74;1728;862;164;866;91;86;3
428;5.48446e-15;121;1692;15006;12020;1;654;511;3510;227;80;1782;867;147;915;91;84;3
429;5.43754e-15;149;1612;15243;11956;1;663;528;3510;293;73;1783;869;220;914;90;85;3
429;5.52668e-15;142;1652;15066;12094;1;671;519;3510;238;58;1781;862;180;919;90;85;3
430;5.48239e-15;181;1663;15321;12016;1;675;546;3511;255;73;1716;798;182;918;90;85;3
430;5.57803e-15;171;1578;15188;12168;1;652;508;3511;211;75;1717;814;136;903;90;84;3
431;5.5239e-15;164;1668;15396;12076;1;698;545;3511;307;75;1753;834;232;919;91;85;3
431;5.62954e-15;176;1633;15243;12232;1;677;510;3511;259;86;1756;800;173;956;91;84;3
432;5.56552e-15;158;1622;15482;12141;1;721;536;3511;266;80;1783;819;186;964;91;83;3
432;5.67422e-15;161;1727;15339;12308;1;686;508;3511;252;74;1778;848;178;930;91;83;3
433;5.61073e-15;170;1627;15607;12211;1;718;543;3512;272;69;1794;804;203;990;91;84;3
433;5.72743e-15;155;1733;15430;12377;1;696;517;3512;250;74;1767;849;176;918;91;84;3
434;5.65955e-15;138;1626;15702;12284;1;724;517;3512;258;80;1819;861;178;958;91;82;3
434;5.77588e-15;154;1658;15541;12450;1;697;507;3512;265;77;1802;901;188;901;91;82;3
435;5.71061e-15;150;1582;15788;12344;1;740;545;3513;277;74;1764;803;203;961;90;83;4
435;5.82729e-15;165;1719;15645;12503;1;693;517;3513;244;89;1680;843;155;837;90;83;4
436;5.75269e-15;161;1696;15907;12422;1;731;546;3513;242;88;1793;799;154;994;89;82;4
436;5.86471e-15;151;1681;15738;12557;1;699;527;3513;276;81;1780;837;195;943;89;82;4
437;5.80756e-15;158;1583;15962;12491;1;766;549;3513;270;80;1735;832;190;903;89;82;4
437;5.90292e-15;149;1703;15786;12621;1;726;518;3513;270;72;1764;821;198;943;89;82;4
438;5.85623e-15;179;1671;16065;12560;1;761;535;3514;246;83;1689;805;163;884;90;82;4
438;5.94831e-15;140;1602;15895;12685;1;717;517;3514;242;79;1735;870;163;865;90;82;4
439;5.90505e-15;171;1640;16176;12636;1;769;543;3514;262;87;1724;840;175;884;89;83;4
439;5.99382e-15;160;1681;15993;12744;1;714;522;3514;250;73;1748;837;177;911;89;83;4
440;5.95897e-15;168;1641;16278;12703;1;770;529;3514;284;82;1749;856;202;893;90;83;4
440;6.03588e-15;173;1711;16079;12804;1;727;492;3514;270;68;1736;796;202;940;90;82;4
441;6.00664e-15;175;1595;16356;12778;1;784;526;3515;272;76;1796;847;196;949;90;83;4
441;6.07875e-15;162;1621;16184;12870;1;724;498;3515;257;85;1873;907;172;966;90;83;4
442;6.06016e-15;156;1559;16455;12863;1;784;528;3515;286;86;1691;789;200;902;90;83;4
442;6.12602e-15;140;1633;16264;12929;1;740;494;3515;226;71;1839;820;155;1019;90;82;4
443;6.121e-15;146;1624;16533;12933;1;797;534;3516;252;80;1749;808;172;941;90;83;4
443;6.16838e-15;145;1629;16366;13008;1;735;506;3516;242;83;1751;850;159;901;90;83;4
444;6.17126e-15;150;1660;16632;12999;1;806;544;3516;257;86;1725;864;171;861;89;83;4
444;6.22526e-15;144;1658;16452;13071;1;745;515;3516;269;73;1754;811;196;943;89;83;4
445;6.21877e-15;150;1612;16764;13074;1;795;518;3516;290;75;1738;801;215;937;89;82;4
445;6.27074e-15;148;1756;16550;13134;1;750;482;3516;248;82;1838;812;166;1026;89;82;4
446;6.27291e-15;137;1661;16853;13124;1;807;541;3517;251;74;1717;746;177;971;89;83;4
446;6.31634e-15;144;1657;16654;13188;1;741;512;3517;233;68;1673;879;165;794;89;82;4
447;6.30909e-15;148;1757;16934;13192;1;814;535;3517;274;85;1789;802;189;987;88;83;4
447;6.3555e-15;158;1700;16739;13252;1;751;501;3517;243;66;1752;812;177;940;88;82;4
448;6.35841e-15;173;1695;17085;13261;1;784;547;3517;272;80;1764;857;192;907;89;83;4
448;6.40203e-15;145;1638;16822;13308;1;758;527;3517;267;72;1828;807;195;1021;89;81;4
449;6.40858e-15;164;1653;17219;13321;1;768;503;3518;272;91;1777;861;181;916;88;81;4
449;6.44283e-15;158;1663;16917;13367;1;766;483;3518;297;84;1736;848;213;888;88;81;4
450;6.45232e-15;174;1632;17306;13378;1;774;546;3518;271;74;1755;833;197;922;87;82;4
450;6.48592e-15;142;1605;17046;13418;1;748;521;3518;255;77;1798;838;178;960;87;82;4
451;6.49396e-15;156;1645;17373;13442;1;799;538;3519;276;92;1765;859;184;906;87;81;4
451;6.52323e-15;144;1578;17133;13488;1;759;518;3519;260;80;1756;800;180;956;87;79;4
452;6.54082e-15;171;1617;17449;13499;1;813;541;3519;247;82;1695;811;165;884;86;80;4
452;6.57457e-15;158;1658;17203;13552;1;778;513;3519;249;86;1759;819;163;940;86;80;4
453;6.58265e-15;150;1634;17554;13564;1;822;533;3519;261;92;1817;779;169;1038;85;79;4
453;6.62163e-15;159;1690;17319;13628;1;768;516;3519;248;81;1763;811;167;952;85;79;4
454;6.63046e-15;185;1648;17650;13628;1;819;508;3520;245;79;1747;819;166;928;85;80;4
454;6.67765e-15;151;1632;17416;13687;1;766;492;3520;256;96;1751;846;160;905;85;79;4
455;6.67765e-15;144;1663;17765;13695;1;812;548;3520;271;97;1745;816;174;929;85;80;4
455;6.72125e-15;155;1593;17524;13750;1;752;522;3520;235;68;1755;797;167;958;85;80;4
456;6.72717e-15;150;1723;17850;13759;1;828;560;3520;281;73;1694;873;208;821;85;80;4
456;6.76792e-15;148;1666;17607;13817;1;763;543;3520;259;74;1734;813;185;921;85;79;4
457;6.77459e-15;183;1741;17917;13837;1;844;541;3521;294;82;1752;860;212;892;86;80;4
457;6.81766e-15;157;1612;17692;13867;1;778;533;3521;246;80;1757;838;166;919;86;79;4
458;6.83253e-15;156;1765;18010;13916;1;858;468;3421;300;84;1776;847;216;929;86;80;4
458;6.85486e-15;150;1652;17775;13928;1;797;541;3521;236;77;1793;801;159;992;86;79;4
459;6.89138e-15;146;1678;18068;13986;1;882;563;3521;247;77;1722;824;170;898;84;80;4
459;6.90034e-15;137;1571;17871;13999;1;801;529;3521;263;77;1714;875;186;839;84;79;4
460;6.94367e-15;178;1596;18189;14058;1;871;550;3522;275;81;1775;866;194;909;83;80;4
460;6.95339e-15;161;1660;17951;14064;1;811;533;3522;257;80;1763;777;177;986;83;79;4
461;6.99759e-15;165;1649;18306;14126;1;869;559;3522;301;91;1777;766;210;1011;83;80;4
461;7.00209e-15;165;1643;18039;14130;1;830;530;3522;260;81;1771;849;179;922;83;79;4
462;7.04864e-15;165;1608;18423;14187;1;862;444;3423;290;81;1697;828;209;869;84;80;4
462;7.05165e-15;160;1682;18150;14188;1;820;435;3423;264;87;1833;836;177;997;84;80;4
463;7.09454e-15;144;1654;18547;14242;1;843;556;3523;211;76;1660;775;135;885;83;80;4
463;7.0953e-15;135;1595;18231;14253;1;826;525;3523;224;69;1662;827;155;835;83;80;4
464;7.13602e-15;153;1650;18650;14305;1;838;516;3523;293;72;1740;826;221;914;82;79;4
464;7.14432e-15;159;1595;18319;14304;1;832;497;3523;280;75;1743;848;205;895;82;79;4
465;7.18362e-15;157;1631;18716;14371;1;860;562;3524;244;72;1764;803;172;961;82;80;4
465;7.18286e-15;151;1660;18431;14367;1;826;530;3524;262;84;1753;863;178;890;82;80;4
466;7.23361e-15;165;1726;18785;14430;1;887;542;3524;287;79;1801;818;208;983;82;80;4
466;7.23057e-15;152;1674;18555;14443;1;807;514;3524;273;80;1732;815;193;917;82;80;4
467;7.27839e-15;152;1636;18902;14515;1;874;555;3524;273;81;1750;872;192;878;81;79;4
467;7.28827e-15;158;1714;18647;14493;1;805;524;3524;284;80;1765;832;204;933;81;79;4
468;7.34307e-15;163;1570;19013;14572;1;864;495;3525;261;81;1763;844;180;919;81;78;4
468;7.32631e-15;172;1609;18740;14546;1;812;486;3525;258;85;1752;845;173;907;81;78;4
469;7.38655e-15;160;1705;19063;14639;1;894;552;3525;234;84;1769;823;150;946;82;78;4
469;7.3667e-15;153;1640;18821;14606;1;821;524;3525;232;89;1816;847;143;969;82;78;4
470;7.43776e-15;170;1714;19167;14706;1;891;551;3525;334;84;1675;847;250;828;82;78;4
470;7.41252e-15;153;1778;18898;14663;1;835;523;3525;265;74;1754;797;191;957;82;77;4
471;7.4891e-15;160;1663;19262;14763;1;898;544;3526;250;89;1819;860;161;959;82;78;4
471;7.45614e-15;185;1670;19009;14721;1;831;518;3526;267;83;1712;858;184;854;82;78;4
472;7.53286e-15;174;1583;19395;14821;1;873;514;3526;282;92;1810;867;190;943;81;78;4
472;7.50061e-15;196;1689;19084;14787;1;850;495;3526;274;79;1816;820;195;996;81;77;4
473;7.57749e-15;156;1619;19489;14895;1;876;540;3526;264;72;1831;801;192;1030;81;78;4
473;7.55132e-15;154;1694;19168;14867;1;859;511;3526;262;84;1756;855;178;901;81;78;4
474;7.63455e-15;166;1643;19579;14967;1;887;547;3527;248;83;1736;822;165;914;82;78;4
474;7.61294e-15;169;1684;19269;14930;1;853;529;3527;252;90;1742;865;162;877;82;78;4
475;7.6902e-15;167;1700;19671;15040;1;896;541;3527;291;80;1629;812;211;817;81;78;4
475;7.66158e-15;162;1711;19362;14982;1;861;521;3527;244;68;1692;870;176;822;81;78;4
476;7.74677e-15;169;1704;19752;15112;1;908;547;3527;281;74;1776;870;207;906;81;78;4
476;7.70181e-15;158;1660;19482;15033;1;852;508;3527;296;77;1775;831;219;944;81;78;4
477;7.80269e-15;166;1716;19890;15176;1;886;541;3528;295;87;1751;869;208;882;81;78;4
477;7.74134e-15;157;1622;19573;15091;1;854;523;3528;257;84;1820;825;173;995;81;78;4
478;7.85252e-15;180;1763;19986;15235;1;891;541;3528;263;78;1759;806;185;953;81;78;4
478;7.78637e-15;142;1652;19690;15153;1;841;505;3528;261;75;1734;820;186;914;81;77;4
479;7.89854e-15;172;1635;20063;15294;1;908;506;3528;261;80;1699;877;181;822;81;77;4
479;7.8346e-15;148;1705;19767;15213;1;852;488;3528;250;68;1682;856;182;826;81;77;4
480;7.94466e-15;139;1546;20149;15358;1;917;545;3529;251;75;1684;835;176;849;81;77;4
480;7.88137e-15;153;1626;19845;15275;1;862;488;3529;217;72;1812;825;145;987;81;76;4
481;7.99479e-15;159;1616;20239;15414;1;920;526;3529;268;69;1762;816;199;946;81;77;4
481;7.9298e-15;141;1731;19950;15324;1;857;494;3529;285;75;1765;787;210;978;81;77;4
482;8.03952e-15;159;1602;20349;15478;1;913;516;3529;258;82;1770;844;176;926;80;77;4
482;7.96814e-15;169;1713;20017;15371;1;871;483;3529;237;76;1749;909;161;840;80;77;4
483;8.08906e-15;170;1609;20444;15535;1;912;520;3530;239;71;1815;826;168;989;80;77;4
483;8.00498e-15;172;1756;20105;15434;1;872;495;3530;237;93;1799;824;144;975;80;76;4
484;8.13396e-15;132;1722;20508;15605;1;936;520;3530;269;91;1760;801;178;959;80;77;5
484;8.05445e-15;176;1731;20237;15485;1;861;492;3530;257;66;1785;826;191;959;80;76;5
485;8.18923e-15;175;1672;20601;15672;1;938;472;3530;275;75;1722;899;200;823;79;76;5
485;8.09457e-15;142;1648;20293;15553;1;887;430;3530;244;85;1733;833;159;900;79;76;5
486;8.24224e-15;145;1630;20680;15724;1;947;465;3531;248;76;1727;851;172;876;79;75;5
486;8.14816e-15;113;1689;20371;15634;1;886;457;3531;233;68;1739;886;165;853;79;75;5
487;8.28346e-15;146;1622;20811;15789;1;922;432;3531;241;78;1851;809;163;1042;79;75;5
487;8.21216e-15;143;1703;20488;15695;1;865;410;3531;239;75;1775;828;164;947;79;75;5
488;8.33509e-15;140;1615;20899;15854;1;920;426;3531;229;66;1878;829;163;1049;80;75;5
488;8.26047e-15;137;1723;20567;15756;1;867;418;3531;211;57;1787;826;154;961;80;75;5
489;8.38682e-15;127;1671;21006;15905;1;900;453;3532;192;72;1742;780;120;962;79;74;5
489;8.30887e-15;136;1672;20670;15817;1;858;429;3532;196;66;1761;863;130;898;79;74;5
490;8.42749e-15;130;1710;21082;15967;1;899;424;3532;210;66;1681;864;144;817;79;74;5
490;8.35816e-15;137;1657;20734;15880;1;869;416;3532;220;55;1749;832;165;917;79;74;5
491;8.47701e-15;121;1633;21181;16036;1;890;424;3532;202;60;1850;834;142;1016;79;74;5
491;8.40754e-15;144;1603;20841;15928;1;857;407;3532;223;57;1725;793;166;932;79;74;5
492;8.53224e-15;128;1678;21258;16099;1;893;450;3533;212;67;1819;803;145;1016;78;74;5
492;8.44585e-15;121;1641;20914;15982;1;864;443;3533;204;73;1793;817;131;976;78;74;5
493;8.58277e-15;133;1632;21366;16170;1;875;425;3533;217;68;1792;864;149;928;78;73;5
493;8.48981e-15;131;1707;21015;16041;1;848;411;3533;204;66;1763;844;138;919;78;73;5
494;8.63984e-15;132;1659;21445;16224;1;875;439;3533;225;61;1744;819;164;925;78;73;5
494;8.53625e-15;141;1667;21122;16106;1;832;416;3533;217;59;1842;889;158;953;78;73;5
495;8.68333e-15;133;1690;21531;16292;1;874;438;3534;223;75;1820;861;148;959;78;73;5
495;8.58839e-15;143;1725;21157;16155;1;857;422;3534;213;69;1845;838;144;1007;78;73;5
496;8.7382e-15;150;1662;21631;16353;1;866;428;3534;231;67;1787;818;164;969;78;73;5
496;8.62777e-15;134;1717;21263;16228;1;842;421;3534;190;61;1781;875;129;906;78;73;5
497;8.78752e-15;129;1698;21693;16417;1;877;426;3534;232;79;1729;868;153;861;78;72;5
497;8.68655e-15;135;1746;21330;16285;1;846;395;3534;240;66;1885;817;174;1068;78;72;5
498;8.84017e-15;120;1739;21796;16469;1;867;422;3535;214;64;1811;833;150;978;77;72;5
498;8.73254e-15;137;1649;21420;16334;1;844;409;3535;202;66;1750;826;136;924;77;72;5
499;8.88237e-15;124;1668;21899;16535;1;853;429;3535;194;52;1758;856;142;902;77;72;5
499;8.77214e-15;143;1669;21481;16405;1;847;415;3535;206;52;1735;833;154;902;77;72;5
500;8.93602e-15;137;1667;21971;16592;1;857;409;3535;212;52;1796;794;160;1002;77;72;5
500;8.83044e-15;124;1696;21537;16459;1;859;397;3535;190;55;1792;831;135;961;77;72;5
501;8.98245e-15;125;1694;22013;16653;1;881;433;3536;225;58;1748;828;167;920;76;72;5
501;8.87425e-15;115;1672;21649;16526;1;838;416;3536;197;58;1771;830;139;941;76;72;5
502;9.03223e-15;142;1687;22043;16706;1;913;434;3536;211;68;1760;836;143;924;76;72;5
502;8.9287e-15;121;1696;21741;16583;1;830;395;3536;221;59;1688;853;162;835;76;72;5
503;9.07555e-15;133;1647;22127;16764;1;911;434;3536;238;74;1726;839;164;887;75;72;5
503;8.97512e-15;129;1751;21844;16626;1;818;406;3536;200;53;1706;850;147;856;75;72;5
504;9.12303e-15;152;1681;22218;16825;1;904;443;3537;204;67;1705;800;137;905;75;72;5
504;9.01018e-15;149;1708;21941;16696;1;802;429;3537;189;56;1794;834;133;960;75;72;5
505;9.17307e-15;141;1655;22246;16888;1;932;446;3537;227;66;1689;874;161;815;75;72;5
505;9.06737e-15;130;1683;22022;16770;1;802;430;3537;212;65;1758;902;147;856;75;72;5
506;9.22484e-15;161;1668;22363;16952;1;906;432;3537;227;84;1766;865;143;901;74;71;5
506;9.12795e-15;114;1703;22090;16845;1;814;424;3537;213;61;1769;856;152;913;74;71;5
507;9.27753e-15;123;1615;22400;17006;1;929;455;3537;202;76;1779;829;126;950;75;71;5
507;9.18949e-15;129;1655;22153;16902;1;816;428;3537;241;72;1799;836;169;963;75;71;5
508;9.32206e-15;138;1608;22508;17069;1;914;427;3538;227;64;1757;838;163;919;75;71;5
508;9.23635e-15;154;1698;22192;16955;1;840;419;3538;213;64;1827;836;149;991;75;71;5
509;9.37411e-15;145;1634;22573;17130;1;927;388;3538;213;65;1742;815;148;927;74;71;5
509;9.28e-15;120;1669;22258;17018;1;847;381;3538;217;66;1835;841;151;994;74;71;5
510;9.4246e-15;125;1704;22589;17181;1;967;408;3538;196;71;1835;868;125;967;74;71;5
510;9.33197e-15;111;1645;22348;17088;1;842;395;3538;204;66;1812;816;138;996;74;71;5
511;9.46688e-15;132;1706;22674;17236;1;961;404;3539;203;64;1728;897;139;831;73;71;5
511;9.38983e-15;135;1641;22427;17156;1;841;391;3539;174;48;1707;855;126;852;73;71;5
512;9.51255e-15;115;1723;22764;17311;1;950;372;3539;196;70;1751;810;126;941;72;71;5
512;9.44615e-15;111;1725;22535;17212;1;819;366;3539;190;68;1772;825;122;947;72;71;5
513;9.57494e-15;118;1644;22857;17367;1;936;406;3539;187;51;1803;840;136;963;72;70;5
513;9.49261e-15;120;1701;22630;17280;1;806;399;3539;189;50;1787;878;139;909;72;70;5
514;9.62162e-15;117;1748;22966;17419;1;912;342;3540;162;72;1733;840;90;893;72;70;5
514;9.54914e-15;108;1694;22715;17331;1;798;315;3540;205;56;1686;852;149;834;72;70;5
515;9.66503e-15;91;1682;23058;17481;1;897;365;3540;160;62;1807;865;98;942;72;71;5
515;9.5916e-15;107;1694;22782;17371;1;793;353;3540;180;59;1819;826;121;993;72;69;5
516;9.71687e-15;117;1684;23106;17532;1;913;359;3540;168;45;1812;841;123;971;72;70;5
516;9.62496e-15;118;1704;22861;17427;1;782;340;3540;195;55;1819;854;140;965;72;70;5
517;9.75959e-15;107;1693;23199;17582;1;906;307;3541;173;78;1756;800;95;956;73;70;5
517;9.67171e-15;109;1689;22953;17492;1;766;302;3541;156;60;1739;847;96;892;73;70;5
518;9.80152e-15;93;1629;23284;17643;1;896;332;3541;162;44;1763;857;118;906;72;70;5
518;9.72608e-15;95;1755;23014;17566;1;762;302;3541;145;40;1755;839;105;916;72;70;5
519;9.85277e-15;102;1653;23417;17711;1;851;353;3541;137;38;1695;852;99;843;71;70;5
519;9.7881e-15;83;1775;23106;17615;1;742;347;3541;152;45;1709;889;107;820;71;70;5
520;9.91e-15;100;1738;23468;17766;1;857;363;3541;176;50;1737;826;126;911;72;69;5
520;9.82924e-15;98;1747;23174;17674;1;732;303;3541;163;44;1764;798;119;966;72;69;5
521;9.95637e-15;97;1733;23578;17822;1;830;354;3542;196;62;1812;869;134;943;71;69;5
521;9.87885e-15;111;1719;23283;17735;1;701;338;3542;143;46;1842;862;97;980;71;69;5
522;1.00037e-14;118;1738;23647;17890;1;825;344;3542;190;53;1788;819;137;969;71;68;5
522;9.93023e-15;113;1645;23334;17794;1;706;327;3542;182;56;1774;870;126;904;71;68;5
523;1.00612e-14;120;1724;23692;17946;1;839;347;3542;180;63;1822;901;117;921;70;69;5
523;9.98001e-15;103;1649;23389;17852;1;705;325;3542;126;55;1724;862;71;862;70;69;5
524;1.01086e-14;128;1718;23778;17998;1;835;322;3543;147;50;1834;849;97;985;70;68;5
524;1.0029e-14;110;1683;23489;17927;1;686;316;3543;167;51;1814;811;116;1003;70;68;5
525;1.01528e-14;122;1684;23852;18062;1;830;352;3543;164;46;1732;863;118;869;70;68;5
525;1.00925e-14;83;1733;23528;17984;1;701;334;3543;159;53;1735;846;106;889;70;68;5
526;1.02072e-14;118;1740;23936;18130;1;822;369;3543;171;62;1820;861;109;959;70;69;5
526;1.01409e-14;112;1745;23573;18039;1;709;364;3543;149;41;1728;895;108;833;70;68;5
527;1.02651e-14;106;1712;24012;18195;1;816;349;3544;203;68;1652;877;135;775;69;68;5
527;1.01876e-14;113;1771;23629;18104;1;717;338;3544;173;64;1754;851;109;903;69;68;5
528;1.03205e-14;101;1687;24089;18256;1;806;350;3544;169;59;1771;837;110;934;70;68;5
528;1.02429e-14;100;1662;23696;18153;1;713;331;3544;178;63;1749;895;115;854;70;68;5
529;1.03727e-14;109;1687;24134;18313;1;821;305;3544;160;50;1748;869;110;879;70;67;5
529;1.02847e-14;111;1654;23748;18209;1;716;300;3544;148;59;1768;864;89;904;70;67;5
530;1.04215e-14;106;1702;24210;18363;1;815;337;3544;149;50;1752;873;99;879;70;68;5
530;1.03325e-14;96;1764;23790;18276;1;726;327;3544;145;52;1787;785;93;1002;70;68;5
531;1.04644e-14;94;1666;24288;18415;1;805;341;3545;171;59;1857;839;112;1018;70;68;5
531;1.03898e-14;95;1770;23816;18317;1;743;336;3545;156;54;1797;885;102;912;70;68;5
532;1.0509e-14;96;1657;24359;18465;1;796;355;3545;166;52;1663;851;114;812;70;68;5
532;1.04249e-14;101;1661;23886;18383;1;739;343;3545;169;53;1667;861;116;806;70;68;5
533;1.0552e-14;101;1713;24403;18510;1;810;315;3545;190;50;1734;830;140;904;69;68;5
533;1.04815e-14;102;1748;23948;18432;1;736;289;3545;181;53;1773;831;128;942;69;68;5
534;1.05907e-14;100;1759;24468;18556;1;803;289;3546;167;53;1797;847;114;950;69;68;5
534;1.05236e-14;81;1771;24010;18496;1;728;275;3546;144;54;1798;888;90;910;69;68;5
535;1.06304e-14;90;1767;24520;18608;1;808;285;3546;147;45;1795;858;102;937;69;68;5
535;1.05787e-14;92;1707;24086;18548;1;717;278;3546;129;44;1820;884;85;936;69;68;5
536;1.06753e-14;100;1759;24606;18667;1;791;297;3546;143;46;1844;888;97;956;69;68;5
536;1.06235e-14;89;1801;24133;18606;1;718;282;3546;154;46;1811;857;108;954;69;68;5
537;1.07263e-14;89;1717;24657;18711;1;796;314;3546;163;51;1729;848;112;881;68;68;5
537;1.06735e-14;81;1732;24180;18656;1;723;299;3546;135;38;1792;866;97;926;68;68;5
538;1.07643e-14;96;1608;24734;18771;1;785;310;3547;149;60;1775;834;89;941;68;68;5
538;1.07167e-14;81;1688;24235;18730;1;720;293;3547;171;39;1770;821;132;949;68;68;5
539;1.08163e-14;105;1641;24784;18817;1;788;313;3547;145;42;1806;791;103;1015;68;67;6
539;1.07808e-14;78;1696;24272;18783;1;727;275;3547;149;41;1775;858;108;917;68;67;6
540;1.08563e-14;103;1672;24851;18870;1;782;316;3547;154;40;1829;879;114;950;68;67;6
540;1.08268e-14;82;1753;24348;18828;1;707;301;3547;131;37;1840;902;94;938;68;67;6
541;1.09023e-14;91;1764;24893;18922;1;792;266;3548;158;39;1754;788;119;966;68;66;6
541;1.08658e-14;92;1734;24400;18879;1;711;260;3548;162;42;1788;862;120;926;68;66;6
542;1.09476e-14;90;1736;24970;18982;1;783;349;3548;159;34;1817;899;125;918;68;67;6
542;1.09102e-14;66;1711;24442;18928;1;715;333;3548;127;35;1798;894;92;904;68;67;6
543;1.09999e-14;113;1722;25044;19033;1;775;313;3548;172;42;1812;858;130;954;68;67;6
543;1.09528e-14;93;1731;24491;18985;1;715;291;3548;165;36;1815;846;129;969;68;67;6
544;1.10444e-14;116;1689;25110;19080;1;777;306;3548;165;47;1775;868;118;907;67;67;6
544;1.10025e-14;95;1748;24551;19033;1;714;286;3548;151;49;1758;828;102;930;67;67;6
545;1.10855e-14;116;1748;25161;19129;1;790;304;3549;160;52;1819;844;108;975;68;67;6
545;1.10444e-14;92;1743;24623;19085;1;705;291;3549;138;54;1758;850;84;908;68;67;6
546;1.11284e-14;103;1717;25217;19171;1;791;292;3549;157;52;1776;861;105;915;68;65;6
546;1.10899e-14;110;1702;24672;19137;1;703;258;3549;139;51;1810;898;88;912;68;65;6
547;1.11652e-14;92;1721;25268;19231;1;797;264;3549;145;44;1782;877;101;905;68;66;6
547;1.11354e-14;88;1721;24733;19189;1;697;257;3549;123;52;1758;846;71;912;68;66;6
548;1.12178e-14;79;1737;25344;19289;1;783;285;3550;147;47;1752;853;100;899;67;66;6
548;1.1181e-14;86;1667;24772;19251;1;705;256;3550;136;47;1826;836;89;990;67;66;6
549;1.12688e-14;95;1687;25418;19337;1;771;322;3550;144;41;1781;829;103;952;67;66;6
549;1.12354e-14;77;1680;24819;19301;1;705;305;3550;150;48;1710;891;102;819;67;66;6
550;1.13111e-14;112;1714;25470;19390;1;774;223;3450;153;50;1809;861;103;948;68;66;6
550;1.12794e-14;91;1707;24888;19358;1;697;297;3550;153;46;1745;882;107;863;67;66;6
551;1.13578e-14;94;1592;25549;19437;1;754;336;3550;120;54;1730;871;66;859;67;66;6
551;1.13296e-14;84;1699;24948;19412;1;692;321;3550;166;40;1663;896;126;767;67;66;6
552;1.13992e-14;102;1646;25601;19490;1;756;285;3551;177;55;1777;829;122;948;67;65;6
552;1.13772e-14;93;1647;25017;19469;1;678;279;3551;174;50;1740;833;124;907;67;65;6
553;1.1446e-14;97;1673;25646;19546;1;758;312;3551;167;40;1792;875;127;917;66;65;6
553;1.14275e-14;79;1691;25071;19524;1;682;308;3551;123;36;1809;840;87;969;66;65;6
554;1.14956e-14;108;1742;25676;19598;1;772;298;3551;139;49;1791;892;90;899;66;65;6
554;1.14761e-14;82;1730;25107;19581;1;693;269;3551;151;42;1805;865;109;940;66;65;6
555;1.15417e-14;85;1721;25716;19654;1;787;330;3551;140;50;1708;946;90;762;66;65;6
555;1.15266e-14;79;1730;25167;19637;1;684;319;3551;134;40;1732;876;94;856;66;65;6
556;1.15913e-14;91;1635;25795;19707;1;771;332;3552;176;40;1731;866;136;865;66;65;6
556;1.15763e-14;95;1721;25240;19690;1;669;315;3552;174;51;1770;845;123;925;66;65;6
557;1.16384e-14;86;1695;25843;19764;1;780;324;3552;163;47;1775;816;116;959;66;65;6
557;1.16233e-14;93;1742;25285;19733;1;672;316;3552;131;60;1712;850;71;862;66;65;6
558;1.16891e-14;99;1694;25891;19817;1;779;322;3552;151;52;1798;881;99;917;66;65;6
558;1.16616e-14;97;1774;25339;19802;1;670;311;3552;151;44;1843;832;107;1011;66;65;6
559;1.17364e-14;104;1699;25929;19856;1;787;328;3553;163;57;1836;868;106;968;66;64;6
559;1.1723e-14;96;1754;25365;19856;1;686;309;3553;160;53;1800;883;107;917;66;64;6
560;1.17711e-14;107;1715;25965;19921;1;800;232;3453;163;58;1763;848;105;915;66;64;6
560;1.17711e-14;101;1694;25425;19907;1;679;215;3453;147;47;1722;901;100;821;66;64;6
561;1.18292e-14;88;1703;26024;19963;1;794;336;3553;96;48;1707;803;48;904;65;64;6
561;1.18167e-14;83;1828;25465;19942;1;681;325;3553;113;35;1654;769;78;885;65;64;6
562;1.18668e-14;104;1771;26092;20030;1;784;324;3553;157;54;1782;846;103;936;65;64;6
562;1.1848e-14;125;1742;25522;19995;1;678;277;3553;149;39;1769;907;110;862;65;63;6
563;4.19826e-15;94;1275;9390;10059;1;720;326;3554;153;30;1847;547;123;1300;64;63;6
563;1.18954e-14;112;1741;25584;20043;1;670;275;3554;116;59;1728;916;57;812;64;63;6
564;4.22547e-15;110;1495;9537;10131;1;677;1.07374e+08;-2.14748e+09;139;43;1732;737;96;995;64;63;6
564;4.20206e-15;77;1296;9137;10075.5;1;641;1.07374e+08;-2.14748e+09;134;34;1803;497;100;1306;64;63;6
565;4.27178e-15;110;1493;9537;10131;1;677;1.032e+08;-2.06399e+09;0;0;-1;0;0;-1;65;63;6
565;4.23624e-15;77;1296;9137;10075.5;1;641;1.032e+08;-2.06399e+09;0;0;-1;0;0;-1;65;63;6
566;4.27178e-15;110;1492;9537;10131;1;677;3.09788e+08;-1.98428e+09;1;0;-1;0;1;-1;64;62;6
566;4.23624e-15;77;1295;9137;10075.5;1;641;3.09788e+08;-1.98428e+09;0;0;-1;0;0;-1;64;62;6
567;4.27178e-15;110;1492;9537;10131;1;677;2.97823e+08;-1.90817e+09;0;0;-1;0;0;-1;239;238;6
567;4.23624e-15;77;1294;9137;10075.5;1;641;2.97823e+08;-1.90817e+09;0;0;-1;0;0;-1;239;238;6
568;4.27178e-15;111;1489;9537;10131;1;677;4.96971e+08;-1.83548e+09;0;0;-1;0;0;-1;913;913;6
568;4.23624e-15;77;1292;9137;10075.5;1;641;4.96971e+08;-1.83548e+09;0;0;-1;0;0;-1;913;913;6
569;4.27178e-15;111;1487;9537;10131;1;677;5.85273e+08;-1.76604e+09;0;0;-1;0;0;-1;2534;2533;6
569;4.23624e-15;77;1292;9137;10075.5;1;641;5.85273e+08;-1.76604e+09;0;0;-1;0;0;-1;2534;2533;6
570;4.27178e-15;111;1487;9537;10131;1;677;5.62884e+08;-1.69969e+09;0;0;-1;0;0;-1;5648;5647;6
570;4.23624e-15;77;1292;9137;10075.5;1;641;5.62884e+08;-1.69969e+09;0;0;-1;0;0;-1;5648;5647;6
571;4.27178e-15;111;1487;9537;10131;1;677;7.52072e+08;-1.63627e+09;0;0;-1;0;0;-1;10888;10887;6
571;4.23624e-15;78;1291;9137;10075.5;1;641;7.52072e+08;-1.63627e+09;0;0;-1;0;0;-1;10888;10887;6
572;4.27178e-15;112;1483;9537;10131;1;677;7.2348e+08;-1.57565e+09;0;0;-1;0;0;-1;18951;18950;6
572;4.23624e-15;78;1290;9137;10075.5;1;641;8.30855e+08;-1.57565e+09;0;0;-1;0;0;-1;18951;18950;6
573;4.27178e-15;113;1483;9537;10131;1;677;7.99365e+08;-1.51768e+09;0;0;-1;0;0;-1;30582;30581;6
573;4.23624e-15;78;1289;9137;10075.5;1;641;9.06739e+08;-1.51768e+09;0;0;-1;0;0;-1;30582;30581;6
574;4.27178e-15;113;1481;9537;10131;1;677;8.72477e+08;-1.46224e+09;1;0;-1;0;1;-1;46565;46564;6
574;4.23624e-15;79;1288;9137;10075.5;1;641;8.72477e+08;-1.46224e+09;0;0;-1;0;0;-1;46565;46564;6
575;4.27178e-15;114;1481;9537;10131;1;677;9.42938e+08;-1.40921e+09;0;0;-1;0;0;-1;67707;67706;6
575;4.23624e-15;79;1288;9137;10075.5;1;641;1.05031e+09;-1.40921e+09;0;0;-1;0;0;-1;67707;67706;6
576;4.27178e-15;114;1481;9537;10131;1;677;1.01086e+09;-1.35846e+09;0;0;-1;0;0;-1;94830;94828;6
576;4.23624e-15;79;1288;9137;10075.5;1;641;1.11824e+09;-1.35846e+09;0;0;-1;0;0;-1;94830;94828;6
577;4.27178e-15;115;1480;9537;10131;1;677;1.07636e+09;-1.30989e+09;2;0;-1;0;2;-1;128760;128758;6
577;4.23624e-15;82;1286;9137;10075.5;1;641;1.07636e+09;-1.30989e+09;6;0;-1;0;6;-1;128760;128758;6
578;4.27178e-15;115;1480;9537;10131;1;677;1.13953e+09;-1.2634e+09;0;0;-1;0;0;-1;170321;170319;6
578;4.23624e-15;82;1286;9137;10075.5;1;641;1.13953e+09;-1.2634e+09;0;0;-1;0;0;-1;170321;170319;6
579;4.27178e-15;116;1479;9537;10131;1;677;1.20047e+09;-1.21888e+09;0;0;-1;0;0;-1;220327;220326;6
579;4.23624e-15;82;1285;9137;10075.5;1;641;1.30785e+09;-1.21888e+09;1;0;-1;0;1;-1;220327;220326;6
580;4.27178e-15;116;1479;9537;10131;1;677;1.25928e+09;-1.17625e+09;0;0;-1;0;0;-1;279577;279575;6
580;4.23624e-15;82;1285;9137;10075.5;1;641;1.25928e+09;-1.17625e+09;1;0;-1;0;1;-1;279577;279575;6
581;4.27178e-15;116;1478;9537;10131;1;677;1.31605e+09;-1.13541e+09;1;0;-1;0;1;-1;348848;348846;6
581;4.23624e-15;83;1282;9137;10075.5;1;641;1.31605e+09;-1.13541e+09;2;0;-1;0;2;-1;348848;348846;6
582;4.27178e-15;116;1478;9537;10131;1;677;1.37087e+09;-1.09627e+09;0;0;-1;0;0;-1;428893;428891;6
582;4.23624e-15;83;1280;9137;10075.5;1;641;1.37087e+09;-1.09627e+09;0;0;-1;0;0;-1;428893;428891;6
583;4.27178e-15;118;1477;9537;10131;1;677;1.42381e+09;-1.05877e+09;0;0;-1;0;0;-1;520438;520436;6
583;4.23624e-15;83;1280;9137;10075.5;1;641;1.53118e+09;-1.05877e+09;0;0;-1;0;0;-1;520438;520436;6
584;4.27178e-15;119;1477;9537;10131;1;677;1.47495e+09;-1.02281e+09;1;0;-1;0;1;-1;624174;624173;6
584;4.23624e-15;89;1275;9137;10075.5;1;641;1.47495e+09;-1.02281e+09;14;0;-1;0;14;-1;624174;624173;6
585;4.27178e-15;121;1477;9537;10131;1;677;1.52436e+09;-9.88342e+08;1;0;-1;0;1;-1;740763;740762;6
585;4.23624e-15;95;1268;9137;10075.5;1;641;1.52436e+09;-9.88342e+08;5;0;-1;0;5;-1;740763;740762;6
586;4.27178e-15;123;1477;9537;10131;1;677;1.57213e+09;-9.5528e+08;0;0;-1;0;0;-1;870830;870828;6
586;4.23624e-15;96;1267;9137;10075.5;1;641;1.6795e+09;-9.5528e+08;1;0;-1;0;1;-1;870830;870828;6
587;4.27178e-15;126;1477;9537;10131;1;677;1.61831e+09;-9.23566e+08;2;0;-1;0;2;-1;1014962;1014960;6
587;4.23624e-15;98;1267;9137;10075.5;1;641;1.61831e+09;-9.23566e+08;0;0;-1;0;0;-1;1014962;1014960;6
588;4.27178e-15;133;1473;9537;10131;1;677;1.66296e+09;-8.93136e+08;11;0;-1;0;11;-1;1173709;1173707;6
588;4.23624e-15;99;1266;9137;10075.5;1;641;1.66296e+09;-8.93136e+08;1;0;-1;0;1;-1;1173709;1173707;6
589;4.27178e-15;134;1473;9537;10131;1;677;1.70616e+09;-8.63933e+08;2;0;-1;0;2;-1;1347583;1347581;6
589;4.23624e-15;100;1266;9137;10075.5;1;641;1.70616e+09;-8.63933e+08;0;0;-1;0;0;-1;1347583;1347581;6
590;4.27178e-15;137;1470;9537;10131;1;677;1.74796e+09;-8.359e+08;2;0;-1;0;2;-1;1537058;1537056;6
590;4.23624e-15;100;1266;9137;10075.5;1;641;1.74796e+09;-8.359e+08;1;0;-1;0;1;-1;1537058;1537056;6
591;4.27178e-15;137;1469;9537;10131;1;677;1.78841e+09;-8.08984e+08;2;0;-1;0;2;-1;1742568;1742566;6
591;4.23624e-15;111;1260;9137;10075.5;1;641;1.78841e+09;-8.08984e+08;4;0;-1;0;4;-1;1742568;1742566;6
592;4.27178e-15;137;1469;9537;10131;1;677;1.82756e+09;-7.83135e+08;1;0;-1;0;1;-1;1964509;1964508;6
592;4.23624e-15;113;1258;9137;10075.5;1;641;1.82756e+09;-7.83135e+08;2;0;-1;0;2;-1;1964509;1964508;6
593;4.27178e-15;137;1469;9537;10131;1;677;1.97285e+09;-7.58305e+08;0;0;-1;0;0;-1;2203240;2203238;6
593;4.23624e-15;113;1258;9137;10075.5;1;641;1.97285e+09;-7.58305e+08;0;0;-1;0;0;-1;2203240;2203238;6
594;4.27178e-15;137;1469;9537;10131;1;677;1.9022e+09;-7.34449e+08;3;0;-1;0;3;-1;2459079;2459077;6
594;4.23624e-15;114;1257;9137;10075.5;1;641;1.9022e+09;-7.34449e+08;2;0;-1;0;2;-1;2459079;2459077;6
595;4.27178e-15;139;1468;9537;10131;1;677;1.93778e+09;-7.11523e+08;0;0;-1;0;0;-1;2732311;2732309;6
595;4.23624e-15;114;1257;9137;10075.5;1;641;1.93778e+09;-7.11523e+08;2;0;-1;0;2;-1;2732311;2732309;6
596;4.27178e-15;144;1468;9537;10131;1;677;1.97225e+09;-6.89486e+08;5;0;-1;0;5;-1;3023183;3023181;7
596;4.23624e-15;116;1257;9137;10075.5;1;641;1.97225e+09;-6.89486e+08;0;0;-1;0;0;-1;3023183;3023181;7
597;4.27178e-15;145;1468;9537;10131;1;677;2.00567e+09;-6.68298e+08;1;0;-1;0;1;-1;3331907;3331905;7
597;4.23624e-15;117;1257;9137;10075.5;1;641;2.11304e+09;-6.68298e+08;0;0;-1;0;0;-1;3331907;3331905;7
598;4.27178e-15;145;1468;9537;10131;1;677;2.03806e+09;-6.47923e+08;0;0;-1;0;0;-1;3658661;3658659;7
598;4.23624e-15;123;1256;9137;10075.5;1;641;2.03806e+09;-6.47923e+08;4;0;-1;0;4;-1;3658661;3658659;7
599;4.27178e-15;155;1466;9537;10131;1;677;2.06948e+09;-6.28325e+08;20;0;-1;0;20;-1;4003589;4003587;7
599;4.23624e-15;126;1253;9137;10075.5;1;641;2.06948e+09;-6.28325e+08;7;0;-1;0;7;-1;4003589;4003587;7
600;4.27178e-15;155;1466;9537;10131;1;677;2.09995e+09;-6.0947e+08;0;0;-1;0;0;-1;4366806;4366804;7
600;4.23624e-15;129;1249;9137;10075.5;1;641;2.09995e+09;-6.0947e+08;8;0;-1;0;8;-1;4366806;4366804;7
601;4.27178e-15;164;1466;9537;10131;1;677;2.12952e+09;-5.91326e+08;8;0;-1;0;8;-1;4748392;4748390;7
601;4.23624e-15;129;1249;9137;10075.5;1;641;2.12952e+09;-5.91326e+08;0;0;-1;0;0;-1;4748392;4748390;7
602;4.27178e-15;167;1465;9537;10131;1;677;-2.14748e+09;-5.73862e+08;1;0;-1;0;1;-1;5148402;5148400;7
602;4.23624e-15;135;1248;9137;10075.5;1;641;-2.14748e+09;-5.73862e+08;14;0;-1;0;14;-1;5148402;5148400;7
603;4.27178e-15;166;1465;9537;10131;1;677;-2.14748e+09;-5.57049e+08;-1;0;0;0;-1;0;5566860;5566858;8
603;4.23624e-15;133;1248;9137;10075.5;1;641;-2.14748e+09;-5.57049e+08;-1;0;0;0;-1;0;5566860;5566858;8
604;4.27178e-15;164;1465;9537;10131;1;677;-2.14748e+09;-5.40859e+08;-1;0;0;0;-1;0;6003764;6003762;8
604;4.23624e-15;133;1248;9137;10075.5;1;641;-2.14748e+09;-5.40859e+08;0;0;-1;0;0;-1;6003764;6003762;8
605;4.27178e-15;163;1465;9537;10131;1;677;-2.14748e+09;-5.25265e+08;0;0;-1;0;0;-1;6459086;6459085;8
605;4.23624e-15;131;1248;9137;10075.5;1;641;-2.14748e+09;-5.25265e+08;0;0;-1;0;0;-1;6459086;6459085;8
606;4.27178e-15;161;1465;9537;10131;1;677;-2.14748e+09;-5.10244e+08;-1;0;0;0;-1;0;6932775;6932773;9
606;4.23624e-15;130;1248;9137;10075.5;1;641;-2.14748e+09;-5.10244e+08;-1;0;0;0;-1;0;6932775;6932773;9
607;4.27178e-15;156;1463;9537;10131;1;677;-2.14748e+09;-4.95769e+08;-1;0;0;0;-1;0;7424755;7424753;9
607;4.23624e-15;130;1248;9137;10075.5;1;641;-2.14748e+09;-4.95769e+08;-1;0;0;0;-1;0;7424755;7424753;9
608;4.27178e-15;156;1463;9537;10131;1;677;-2.14748e+09;-4.81819e+08;-1;0;0;0;-1;0;7934928;7934927;10
608;4.23624e-15;129;1248;9137;10075.5;1;641;-2.14748e+09;-4.81819e+08;-1;0;0;0;-1;0;7934928;7934927;10
609;4.27178e-15;156;1463;9537;10131;1;677;-2.14748e+09;-4.68371e+08;-1;0;0;0;-1;0;8463179;8463177;11
609;4.23624e-15;127;1248;9137;10075.5;1;641;-2.14748e+09;-4.68371e+08;-1;0;0;0;-1;0;8463179;8463177;11
610;4.27178e-15;155;1463;9537;10131;1;677;-2.14748e+09;-4.55404e+08;-1;0;0;0;-1;0;9009369;9009367;12
610;4.23624e-15;126;1248;9137;10075.5;1;641;-2.14748e+09;-4.55404e+08;-1;0;0;0;-1;0;9009369;9009367;12
611;4.27178e-15;153;1462;9537;10131;1;677;-2.14748e+09;-4.429e+08;0;0;-1;0;0;-1;9573344;9573342;13
611;4.23624e-15;126;1248;9137;10075.5;1;641;-2.14748e+09;-4.429e+08;-1;0;0;0;-1;0;9573344;9573342;13
612;4.27178e-15;153;1462;9537;10131;1;677;-2.14748e+09;-4.30837e+08;-1;0;0;0;-1;0;10154931;10154930;14
612;4.23624e-15;125;1248;9137;10075.5;1;641;-2.14748e+09;-4.30837e+08;-1;0;0;0;-1;0;10154931;10154930;14
613;4.27178e-15;152;1462;9537;10131;1;677;-2.14748e+09;-4.192e+08;-1;0;0;0;-1;0;10753944;10753942;16
613;4.23624e-15;124;1247;9137;10075.5;1;641;-2.14748e+09;-4.192e+08;-1;0;0;0;-1;0;10753944;10753942;16
614;4.27178e-15;152;1462;9537;10131;1;677;-2.14748e+09;-4.07969e+08;-1;0;0;0;-1;0;11370178;11370177;18
614;4.23624e-15;124;1246;9137;10075.5;1;641;-2.14748e+09;-4.07969e+08;-1;0;0;0;-1;0;11370178;11370177;18
615;4.27178e-15;152;1462;9537;10131;1;677;-2.14748e+09;-3.97129e+08;0;0;-1;0;0;-1;12003419;12003417;20
615;4.23624e-15;124;1246;9137;10075.5;1;641;-2.14748e+09;-3.97129e+08;-1;0;0;0;-1;0;12003419;12003417;20
616;4.27178e-15;152;1462;9537;10131;1;677;-2.14748e+09;-3.86664e+08;-1;0;0;0;-1;0;12653436;12653435;23
616;4.23624e-15;121;1246;9137;10075.5;1;641;-2.14748e+09;-3.86664e+08;-1;0;0;0;-1;0;12653436;12653435;23
617;4.27178e-15;151;1462;9537;10131;1;677;-2.14748e+09;-3.76558e+08;-1;0;0;0;-1;0;13319990;13319989;26
617;4.23624e-15;121;1246;9137;10075.5;1;641;-2.14748e+09;-3.76558e+08;-1;0;0;0;-1;0;13319990;13319989;26
618;4.27178e-15;151;1462;9537;10131;1;677;-2.14748e+09;-3.66798e+08;-1;0;0;0;-1;0;14002829;14002828;29
618;4.23624e-15;121;1246;9137;10075.5;1;641;-2.14748e+09;-3.66798e+08;-1;0;0;0;-1;0;14002829;14002828;29
619;4.27178e-15;151;1462;9537;10131;1;677;-2.14748e+09;-3.57369e+08;-1;0;0;0;-1;0;14701692;14701692;33
619;4.23624e-15;121;1246;9137;10075.5;1;641;-2.14748e+09;-3.57369e+08;-1;0;0;0;-1;0;14701692;14701692;33
620;4.27178e-15;150;1462;9537;10131;1;677;-2.14748e+09;-3.48258e+08;-1;0;0;0;-1;0;15416310;15416309;38
620;4.23624e-15;120;1246;9137;10075.5;1;641;-2.14748e+09;-3.48258e+08;-1;0;0;0;-1;0;15416310;15416309;38
621;4.27178e-15;149;1462;9537;10131;1;677;-2.14748e+09;-3.39454e+08;-1;0;0;0;-1;0;16146404;16146404;43
621;4.23624e-15;120;1246;9137;10075.5;1;641;-2.14748e+09;-3.39454e+08;-1;0;0;0;-1;0;16146404;16146404;43
622;4.27178e-15;149;1462;9537;10131;1;677;-2.14748e+09;-3.30943e+08;-1;0;0;0;-1;0;16891690;16891690;49
622;4.23624e-15;118;1246;9137;10075.5;1;641;-2.14748e+09;-3.30943e+08;0;0;-1;0;0;-1;16891690;16891690;49
623;4.27178e-15;145;1461;9537;10131;1;677;-2.14748e+09;-3.22714e+08;0;0;-1;0;0;-1;17651876;17651876;56
623;4.23624e-15;118;1246;9137;10075.5;1;641;-2.14748e+09;-3.22714e+08;-1;0;0;0;-1;0;17651876;17651876;56
624;4.27178e-15;143;1460;9537;10131;1;677;-2.14748e+09;-3.14757e+08;-1;0;0;0;-1;0;18426665;18426666;64
624;4.23624e-15;116;1246;9137;10075.5;1;641;-2.14748e+09;-3.14757e+08;-1;0;0;0;-1;0;18426665;18426666;64
625;4.27178e-15;143;1460;9537;10131;1;677;-2.14748e+09;-3.07061e+08;-1;0;0;0;-1;0;19215756;19215757;72
625;4.23624e-15;116;1246;9137;10075.5;1;641;-2.14748e+09;-3.07061e+08;-1;0;0;0;-1;0;19215756;19215757;72
626;4.27178e-15;143;1459;9537;10131;1;677;-2.14748e+09;-2.99615e+08;-1;0;0;0;-1;0;20018843;20018844;82
626;4.23624e-15;116;1246;9137;10075.5;1;641;-2.14748e+09;-2.99615e+08;-1;0;0;0;-1;0;20018843;20018844;82
627;4.27178e-15;142;1459;9537;10131;1;677;-2.14748e+09;-2.92411e+08;0;0;-1;0;0;-1;20835615;20835617;93
627;4.23624e-15;116;1246;9137;10075.5;1;641;-2.14748e+09;-2.92411e+08;-1;0;0;0;-1;0;20835615;20835617;93
628;4.27178e-15;139;1459;9537;10131;1;677;-2.14748e+09;-2.85438e+08;-1;0;0;0;-1;0;21665761;21665763;106
628;4.23624e-15;116;1246;9137;10075.5;1;641;-2.14748e+09;-2.85438e+08;-1;0;0;0;-1;0;21665761;21665763;106
629;4.27178e-15;138;1459;9537;10131;1;677;-2.14748e+09;-2.78689e+08;-1;0;0;0;-1;0;22508964;22508967;120
629;4.23624e-15;116;1246;9137;10075.5;1;641;-2.14748e+09;-2.78689e+08;-1;0;0;0;-1;0;22508964;22508967;120
630;4.27178e-15;138;1459;9537;10131;1;677;-2.14748e+09;-2.72154e+08;-1;0;0;0;-1;0;23364909;23364913;136
630;4.23624e-15;114;1246;9137;10075.5;1;641;-2.14748e+09;-2.72154e+08;-1;0;0;0;-1;0;23364909;23364913;136
631;4.27178e-15;138;1459;9537;10131;1;677;-2.14748e+09;-2.65826e+08;-1;0;0;0;-1;0;24233278;24233283;153
631;4.23624e-15;112;1246;9137;10075.5;1;641;-2.14748e+09;-2.65826e+08;-1;0;0;0;-1;0;24233278;24233283;153
632;4.27178e-15;137;1459;9537;10131;1;677;-2.14748e+09;-2.59697e+08;-1;0;0;0;-1;0;25113751;25113756;172
632;4.23624e-15;108;1246;9137;10075.5;1;641;-2.14748e+09;-2.59696e+08;-1;0;0;0;-1;0;25113751;25113756;172
633;4.27178e-15;136;1459;9537;10131;1;677;-2.14748e+09;-2.53759e+08;-1;0;0;0;-1;0;26006008;26006015;194
633;4.23624e-15;108;1246;9137;10075.5;1;641;-2.14748e+09;-2.53759e+08;-1;0;0;0;-1;0;26006008;26006015;194
634;4.27178e-15;136;1459;9537;10131;1;677;-2.14748e+09;-2.48005e+08;-1;0;0;0;-1;0;26909732;26909739;218
634;4.23624e-15;108;1246;9137;10075.5;1;641;-2.14748e+09;-2.48005e+08;-1;0;0;0;-1;0;26909732;26909739;218
635;4.27178e-15;136;1459;9537;10131;1;677;-2.14748e+09;-2.42429e+08;-1;0;0;0;-1;0;27824602;27824611;244
635;4.23624e-15;108;1246;9137;10075.5;1;641;-2.14748e+09;-2.42429e+08;-1;0;0;0;-1;0;27824602;27824611;244
636;4.27178e-15;135;1459;9537;10131;1;677;-2.14748e+09;-2.37024e+08;-1;0;0;0;-1;0;28750301;28750312;273
636;4.23624e-15;108;1246;9137;10075.5;1;641;-2.14748e+09;-2.37024e+08;-1;0;0;0;-1;0;28750301;28750312;273
637;4.27178e-15;135;1459;9537;10131;1;677;-2.14748e+09;-2.31784e+08;-1;0;0;0;-1;0;29686513;29686525;305
637;4.23624e-15;107;1246;9137;10075.5;1;641;-2.14748e+09;-2.31784e+08;-1;0;0;0;-1;0;29686513;29686525;305
638;4.27178e-15;133;1459;9537;10131;1;677;-2.14748e+09;-2.26703e+08;-1;0;0;0;-1;0;30632922;30632935;340
638;4.23624e-15;105;1246;9137;10075.5;1;641;-2.14748e+09;-2.26703e+08;-1;0;0;0;-1;0;30632922;30632935;340
639;4.27178e-15;132;1459;9537;10131;1;677;-2.14748e+09;-2.21775e+08;-1;0;0;0;-1;0;31589215;31589230;379
639;4.23624e-15;105;1246;9137;10075.5;1;641;-2.14748e+09;-2.21775e+08;-1;0;0;0;-1;0;31589215;31589230;379
640;4.27178e-15;132;1459;9537;10131;1;677;-2.14748e+09;-2.16994e+08;-1;0;0;0;-1;0;32555081;32555098;421
640;4.23624e-15;102;1246;9137;10075.5;1;641;-2.14748e+09;-2.16994e+08;-1;0;0;0;-1;0;32555081;32555098;421
641;4.27178e-15;132;1459;9537;10131;1;677;-2.14748e+09;-2.12356e+08;-1;0;0;0;-1;0;33530210;33530230;467
641;4.23624e-15;99;1246;9137;10075.5;1;641;-2.14748e+09;-2.12356e+08;-1;0;0;0;-1;0;33530210;33530230;467
642;4.27178e-15;132;1459;9537;10131;1;677;-2.14748e+09;-2.07855e+08;-1;0;0;0;-1;0;34514298;34514320;517
642;4.23624e-15;99;1246;9137;10075.5;1;641;-2.14748e+09;-2.07855e+08;-1;0;0;0;-1;0;34514298;34514320;517
643;4.27178e-15;132;1459;9537;10131;1;677;-2.14748e+09;-2.03486e+08;-1;0;0;0;-1;0;35507041;35507065;572
643;4.23624e-15;98;1246;9137;10075.5;1;641;-2.14748e+09;-2.03486e+08;0;0;-1;0;0;-1;35507041;35507065;572
644;4.27178e-15;132;1459;9537;10131;1;677;-2.14748e+09;-1.99245e+08;-1;0;0;0;-1;0;36508138;36508166;632
644;4.23624e-15;98;1246;9137;10075.5;1;641;-2.14748e+09;-1.99245e+08;-1;0;0;0;-1;0;36508138;36508166;632
645;4.27178e-15;131;1459;9537;10131;1;677;-2.14748e+09;-1.95127e+08;-1;0;0;0;-1;0;37517293;37517324;697
645;4.23624e-15;96;1246;9137;10075.5;1;641;-2.14748e+09;-1.95127e+08;-1;0;0;0;-1;0;37517293;37517324;697
646;4.27178e-15;130;1459;9537;10131;1;677;-2.14748e+09;-1.91128e+08;-1;0;0;0;-1;0;38534214;38534248;767
646;4.23624e-15;95;1246;9137;10075.5;1;641;-2.14748e+09;-1.91128e+08;-1;0;0;0;-1;0;38534214;38534248;767
647;4.27178e-15;130;1459;9537;10131;1;677;-2.14748e+09;-1.87243e+08;-1;0;0;0;-1;0;39558609;39558647;843
647;4.23624e-15;95;1246;9137;10075.5;1;641;-2.14748e+09;-1.87243e+08;-1;0;0;0;-1;0;39558609;39558647;843
648;4.27178e-15;128;1459;9537;10131;1;677;-2.14748e+09;-1.83469e+08;-1;0;0;0;-1;0;40590194;40590236;926
648;4.23624e-15;95;1246;9137;10075.5;1;641;-2.14748e+09;-1.83469e+08;-1;0;0;0;-1;0;40590194;40590236;926
649;4.27178e-15;128;1459;9537;10131;1;677;-2.14748e+09;-1.79803e+08;-1;0;0;0;-1;0;41628686;41628732;1015
649;4.23624e-15;95;1246;9137;10075.5;1;641;-2.14748e+09;-1.79803e+08;-1;0;0;0;-1;0;41628686;41628732;1015
650;4.27178e-15;128;1459;9537;10131;1;677;-2.14748e+09;-1.76239e+08;-1;0;0;0;-1;0;42673808;42673858;1111
650;4.23624e-15;95;1246;9137;10075.5;1;641;-2.14748e+09;-1.76239e+08;-1;0;0;0;-1;0;42673808;42673858;1111
651;4.27178e-15;128;1459;9537;10131;1;677;-2.14748e+09;-1.72776e+08;-1;0;0;0;-1;0;43725285;43725340;1214
651;4.23624e-15;94;1246;9137;10075.5;1;641;-2.14748e+09;-1.72776e+08;0;0;-1;0;0;-1;43725285;43725340;1214
652;4.27178e-15;127;1459;9537;10131;1;677;-2.14748e+09;-1.69408e+08;-1;0;0;0;-1;0;44782848;44782908;1326
652;4.23624e-15;93;1246;9137;10075.5;1;641;-2.14748e+09;-1.69408e+08;-1;0;0;0;-1;0;44782848;44782908;1326
653;4.27178e-15;123;1459;9537;10131;1;677;-2.14748e+09;-1.66134e+08;0;0;-1;0;0;-1;45846232;45846298;1445
653;4.23624e-15;93;1246;9137;10075.5;1;641;-2.14748e+09;-1.66134e+08;-1;0;0;0;-1;0;45846232;45846298;1445
654;4.27178e-15;123;1459;9537;10131;1;677;-2.14748e+09;-1.6295e+08;-1;0;0;0;-1;0;46915175;46915248;1574
654;4.23624e-15;92;1246;9137;10075.5;1;641;-2.14748e+09;-1.6295e+08;-1;0;0;0;-1;0;46915175;46915248;1574
655;4.27178e-15;123;1459;9537;10131;1;677;-2.14748e+09;-1.59852e+08;-1;0;0;0;-1;0;47989423;47989502;1712
655;4.23624e-15;90;1246;9137;10075.5;1;641;-2.14748e+09;-1.59852e+08;0;0;-1;0;0;-1;47989423;47989502;1712
656;4.27178e-15;123;1458;9537;10131;1;677;-2.14748e+09;-1.56839e+08;-1;0;0;0;-1;0;49068721;49068807;1860
656;4.23624e-15;86;1245;9137;10075.5;1;641;-2.14748e+09;-1.56839e+08;-1;0;0;0;-1;0;49068721;49068807;1860
657;4.27178e-15;123;1458;9537;10131;1;677;-2.14748e+09;-1.53907e+08;-1;0;0;0;-1;0;50152824;50152917;2018
657;4.23624e-15;84;1245;9137;10075.5;1;641;-2.14748e+09;-1.53907e+08;-1;0;0;0;-1;0;50152824;50152917;2018
658;4.27178e-15;121;1458;9537;10131;1;677;-2.14748e+09;-1.51054e+08;-1;0;0;0;-1;0;51241487;51241589;2186
658;4.23624e-15;82;1245;9137;10075.5;1;641;-2.14748e+09;-1.51054e+08;-1;0;0;0;-1;0;51241487;51241589;2186
659;4.27178e-15;121;1458;9537;10131;1;677;-2.14748e+09;-1.48277e+08;-1;0;0;0;-1;0;52334473;52334584;2367
659;4.23624e-15;82;1245;9137;10075.5;1;641;-2.14748e+09;-1.48277e+08;-1;0;0;0;-1;0;52334473;52334584;2367
660;4.27178e-15;117;1458;9537;10131;1;677;-2.14748e+09;-1.45573e+08;0;0;-1;0;0;-1;53431548;53431668;2559
660;4.23624e-15;82;1245;9137;10075.5;1;641;-2.14748e+09;-1.45573e+08;-1;0;0;0;-1;0;53431548;53431668;2559
661;4.27178e-15;117;1458;9537;10131;1;677;-2.14748e+09;-1.42941e+08;-1;0;0;0;-1;0;54532483;54532613;2764
661;4.23624e-15;82;1245;9137;10075.5;1;641;-2.14748e+09;-1.42941e+08;-1;0;0;0;-1;0;54532483;54532613;2764
662;4.27178e-15;115;1458;9537;10131;1;677;-2.14748e+09;-1.40378e+08;-1;0;0;0;-1;0;55637054;55637194;2982
662;4.23624e-15;82;1245;9137;10075.5;1;641;-2.14748e+09;-1.40378e+08;-1;0;0;0;-1;0;55637054;55637194;2982
663;4.27178e-15;114;1458;9537;10131;1;677;-2.14748e+09;-1.37881e+08;0;0;-1;0;0;-1;56745040;56745192;3214
663;4.23624e-15;82;1245;9137;10075.5;1;641;-2.14748e+09;-1.37881e+08;-1;0;0;0;-1;0;56745040;56745192;3214
664;4.27178e-15;114;1458;9537;10131;1;677;-2.14748e+09;-1.35448e+08;-1;0;0;0;-1;0;57856226;57856390;3461
664;4.23624e-15;81;1245;9137;10075.5;1;641;-2.14748e+09;-1.35448e+08;-1;0;0;0;-1;0;57856226;57856390;3461
665;4.27178e-15;114;1458;9537;10131;1;677;-2.14748e+09;-1.33079e+08;-1;0;0;0;-1;0;58970402;58970579;3722
665;4.23624e-15;81;1245;9137;10075.5;1;641;-2.14748e+09;-1.33079e+08;-1;0;0;0;-1;0;58970402;58970579;3722
666;4.27178e-15;112;1458;9537;10131;1;677;-2.14748e+09;-1.30769e+08;-1;0;0;0;-1;0;60087362;60087552;4000
666;4.23624e-15;81;1245;9137;10075.5;1;641;-2.14748e+09;-1.30769e+08;-1;0;0;0;-1;0;60087362;60087552;4000
667;4.27178e-15;112;1458;9537;10131;1;677;-2.14748e+09;-1.28519e+08;-1;0;0;0;-1;0;61206903;61207107;4294
667;4.23624e-15;79;1245;9137;10075.5;1;641;-2.14748e+09;-1.28519e+08;-1;0;0;0;-1;0;61206903;61207107;4294
668;4.27178e-15;111;1458;9537;10131;1;677;-2.14748e+09;-1.26325e+08;-1;0;0;0;-1;0;62328829;62329048;4605
668;4.23624e-15;79;1245;9137;10075.5;1;641;-2.14748e+09;-1.26325e+08;-1;0;0;0;-1;0;62328829;62329048;4605
669;4.27178e-15;109;1458;9537;10131;1;677;-2.14748e+09;-1.24186e+08;-1;0;0;0;-1;0;63452947;63453183;4935
669;4.23624e-15;77;1245;9137;10075.5;1;641;-2.14748e+09;-1.24186e+08;-1;0;0;0;-1;0;63452947;63453183;4935
670;4.27178e-15;106;1457;9537;10131;1;677;-2.14748e+09;-1.221e+08;-1;0;0;0;-1;0;64579069;64579322;5283
670;4.23624e-15;74;1245;9137;10075.5;1;641;-2.14748e+09;-1.221e+08;-1;0;0;0;-1;0;64579069;64579322;5283
671;4.27178e-15;105;1457;9537;10131;1;677;-2.14748e+09;-1.20066e+08;-1;0;0;0;-1;0;65707012;65707284;5651
671;4.23624e-15;74;1245;9137;10075.5;1;641;-2.14748e+09;-1.20066e+08;-1;0;0;0;-1;0;65707012;65707284;5651
672;4.27178e-15;105;1457;9537;10131;1;677;-2.14748e+09;-1.18082e+08;-1;0;0;0;-1;0;66836596;66836887;6039
672;4.23624e-15;73;1245;9137;10075.5;1;641;-2.14748e+09;-1.18082e+08;-1;0;0;0;-1;0;66836596;66836887;6039
673;4.27178e-15;105;1457;9537;10131;1;677;-2.14748e+09;-1.16147e+08;-1;0;0;0;-1;0;67967647;67967958;6448
673;4.23624e-15;73;1245;9137;10075.5;1;641;-2.14748e+09;-1.16147e+08;-1;0;0;0;-1;0;67967647;67967958;6448
674;4.27178e-15;104;1457;9537;10131;1;677;-2.14748e+09;-1.14258e+08;-1;0;0;0;-1;0;69099992;69100325;6879
674;4.23624e-15;73;1245;9137;10075.5;1;641;-2.14748e+09;-1.14258e+08;-1;0;0;0;-1;0;69099992;69100325;6879
675;4.27178e-15;102;1457;9537;10131;1;677;-2.14748e+09;-1.12416e+08;-1;0;0;0;-1;0;70233467;70233822;7333
675;4.23624e-15;73;1245;9137;10075.5;1;641;-2.14748e+09;-1.12415e+08;-1;0;0;0;-1;0;70233467;70233822;7333
676;4.27178e-15;101;1457;9537;10131;1;677;-2.14748e+09;-1.10617e+08;-1;0;0;0;-1;0;71367907;71368288;7811
676;4.23624e-15;73;1245;9137;10075.5;1;641;-2.14748e+09;-1.10617e+08;-1;0;0;0;-1;0;71367907;71368288;7811
677;4.27178e-15;100;1457;9537;10131;1;677;-2.14748e+09;-1.08861e+08;-1;0;0;0;-1;0;72503157;72503563;8313
677;4.23624e-15;73;1245;9137;10075.5;1;641;-2.14748e+09;-1.08861e+08;-1;0;0;0;-1;0;72503157;72503563;8313
678;4.27178e-15;99;1457;9537;10131;1;677;-2.14748e+09;-1.07148e+08;-1;0;0;0;-1;0;73639061;73639493;8841
678;4.23624e-15;73;1245;9137;10075.5;1;641;-2.14748e+09;-1.07148e+08;-1;0;0;0;-1;0;73639061;73639493;8841
679;4.27178e-15;96;1457;9537;10131;1;677;-2.14748e+09;-1.05474e+08;-1;0;0;0;-1;0;74775469;74775930;9395
679;4.23624e-15;72;1245;9137;10075.5;1;641;-2.14748e+09;-1.05474e+08;-1;0;0;0;-1;0;74775469;74775930;9395
680;4.27178e-15;95;1457;9537;10131;1;677;-2.14748e+09;-1.0384e+08;-1;0;0;0;-1;0;75912236;75912726;9976
680;4.23624e-15;71;1245;9137;10075.5;1;641;-2.14748e+09;-1.0384e+08;-1;0;0;0;-1;0;75912236;75912726;9976
681;4.27178e-15;95;1457;9537;10131;1;677;-2.14748e+09;-1.02244e+08;-1;0;0;0;-1;0;77049218;77049740;10585
681;4.23624e-15;68;1245;9137;10075.5;1;641;-2.14748e+09;-1.02244e+08;-1;0;0;0;-1;0;77049218;77049740;10585
682;4.27178e-15;95;1457;9537;10131;1;677;-2.14748e+09;-1.00684e+08;-1;0;0;0;-1;0;78186278;78186832;11224
682;4.23624e-15;68;1245;9137;10075.5;1;641;-2.14748e+09;-1.00684e+08;0;0;-1;0;0;-1;78186278;78186832;11224
683;4.27178e-15;94;1457;9537;10131;1;677;-2.14748e+09;-9.9161e+07;-1;0;0;0;-1;0;79323281;79323869;11893
683;4.23624e-15;66;1245;9137;10075.5;1;641;-2.14748e+09;-9.9161e+07;-1;0;0;0;-1;0;79323281;79323869;11893
684;4.27178e-15;94;1457;9537;10131;1;677;-2.14748e+09;-9.76725e+07;-1;0;0;0;-1;0;80460095;80460720;12593
684;4.23624e-15;63;1245;9137;10075.5;1;641;-2.14748e+09;-9.76725e+07;-1;0;0;0;-1;0;80460095;80460720;12593
685;4.27178e-15;90;1457;9537;10131;1;677;-2.14748e+09;-9.62179e+07;-1;0;0;0;-1;0;81596595;81597258;13325
685;4.23624e-15;63;1245;9137;10075.5;1;641;-2.14748e+09;-9.62178e+07;-1;0;0;0;-1;0;81596595;81597258;13325
686;4.27178e-15;89;1457;9537;10131;1;677;-2.14748e+09;-9.47961e+07;-1;0;0;0;-1;0;82732656;82733358;14091
686;4.23624e-15;63;1245;9137;10075.5;1;641;-2.14748e+09;-9.47961e+07;-1;0;0;0;-1;0;82732656;82733358;14091
687;4.27178e-15;87;1457;9537;10131;1;677;-2.14748e+09;-9.34063e+07;-1;0;0;0;-1;0;83868157;83868901;14890
687;4.23624e-15;60;1245;9137;10075.5;1;641;-2.14748e+09;-9.34062e+07;-1;0;0;0;-1;0;83868157;83868901;14890
688;4.27178e-15;87;1457;9537;10131;1;677;-2.14748e+09;-9.20474e+07;-1;0;0;0;-1;0;85002983;85003771;15725
688;4.23624e-15;56;1245;9137;10075.5;1;641;-2.14748e+09;-9.20473e+07;-1;0;0;0;-1;0;85002983;85003771;15725
689;4.27178e-15;87;1457;9537;10131;1;677;-2.14748e+09;-9.07187e+07;-1;0;0;0;-1;0;86137020;86137853;16596
689;4.23624e-15;54;1245;9137;10075.5;1;641;-2.14748e+09;-9.07187e+07;-1;0;0;0;-1;0;86137020;86137853;16596
690;4.27178e-15;87;1457;9537;10131;1;677;-2.14748e+09;-8.94192e+07;-1;0;0;0;-1;0;87270158;87271039;17505
690;4.23624e-15;52;1245;9137;10075.5;1;641;-2.14748e+09;-8.94192e+07;-1;0;0;0;-1;0;87270158;87271039;17505
691;4.27178e-15;87;1457;9537;10131;1;677;-2.14748e+09;-8.81483e+07;-1;0;0;0;-1;0;88402290;88403222;18452
691;4.23624e-15;52;1245;9137;10075.5;1;641;-2.14748e+09;-8.81483e+07;-1;0;0;0;-1;0;88402290;88403222;18452
692;4.27178e-15;87;1457;9537;10131;1;677;-2.14748e+09;-8.69051e+07;-1;0;0;0;-1;0;89533314;89534297;19438
692;4.23624e-15;49;1245;9137;10075.5;1;641;-2.14748e+09;-8.69051e+07;-1;0;0;0;-1;0;89533314;89534297;19438
693;4.27178e-15;87;1457;9537;10131;1;677;-2.14748e+09;-8.56888e+07;-1;0;0;0;-1;0;90663128;90664166;20466
693;4.23624e-15;48;1245;9137;10075.5;1;641;-2.14748e+09;-8.56888e+07;-1;0;0;0;-1;0;90663128;90664166;20466
694;4.27178e-15;87;1457;9537;10131;1;677;-2.14748e+09;-8.44987e+07;0;0;-1;0;0;-1;91791635;91792731;21535
694;4.23624e-15;47;1245;9137;10075.5;1;641;-2.14748e+09;-8.44987e+07;-1;0;0;0;-1;0;91791635;91792731;21535
695;4.27178e-15;87;1457;9537;10131;1;677;-2.14748e+09;-8.33342e+07;0;0;-1;0;0;-1;92918742;92919898;22647
695;4.23624e-15;43;1245;9137;10075.5;1;641;-2.14748e+09;-8.33342e+07;-1;0;0;0;-1;0;92918742;92919898;22647
696;4.27178e-15;87;1457;9537;10131;1;677;-2.14748e+09;-8.21942e+07;-1;0;0;0;-1;0;94044357;94045575;23804
696;4.23624e-15;41;1245;9137;10075.5;1;641;-2.14748e+09;-8.21942e+07;-1;0;0;0;-1;0;94044357;94045575;23804
697;4.27178e-15;87;1457;9537;10131;1;677;-2.14748e+09;-8.10785e+07;-1;0;0;0;-1;0;95168392;95169675;25005
697;4.23624e-15;36;1245;9137;10075.5;1;641;-2.14748e+09;-8.10785e+07;-1;0;0;0;-1;0;95168392;95169675;25005
698;4.27178e-15;87;1457;9537;10131;1;677;-2.14748e+09;-7.99863e+07;0;0;-1;0;0;-1;96290761;96292112;26253
698;4.23624e-15;36;1245;9137;10075.5;1;641;-2.14748e+09;-7.99863e+07;-1;0;0;0;-1;0;96290761;96292112;26253
699;4.27178e-15;87;1457;9537;10131;1;677;-2.14748e+09;-7.89168e+07;-1;0;0;0;-1;0;97411382;97412803;27549
699;4.23624e-15;36;1245;9137;10075.5;1;641;-2.14748e+09;-7.89168e+07;-1;0;0;0;-1;0;97411382;97412803;27549
700;4.27178e-15;85;1457;9537;10131;1;677;-2.14748e+09;-7.78695e+07;-1;0;0;0;-1;0;98530174;98531668;28894
700;4.23624e-15;36;1245;9137;10075.5;1;641;-2.14748e+09;-7.78695e+07;-1;0;0;0;-1;0;98530174;98531668;28894
701;4.27178e-15;85;1457;9537;10131;1;677;-2.14748e+09;-7.68437e+07;-1;0;0;0;-1;0;99647061;99648631;30288
701;4.23624e-15;35;1245;9137;10075.5;1;641;-2.14748e+09;-7.68437e+07;-1;0;0;0;-1;0;99647061;99648631;30288
702;4.27178e-15;85;1457;9537;10131;1;677;-2.14748e+09;-7.58392e+07;-1;0;0;0;-1;0;100761967;100763617;31734
702;4.23624e-15;35;1245;9137;10075.5;1;641;-2.14748e+09;-7.58392e+07;-1;0;0;0;-1;0;100761967;100763617;31734
703;4.27178e-15;83;1457;9537;10131;1;677;-2.14748e+09;-7.48551e+07;0;0;-1;0;0;-1;101874821;101876553;33233
703;4.23624e-15;35;1245;9137;10075.5;1;641;-2.14748e+09;-7.4855e+07;-1;0;0;0;-1;0;101874821;101876553;33233
704;4.27178e-15;83;1457;9537;10131;1;677;-2.14748e+09;-7.38909e+07;-1;0;0;0;-1;0;102985552;102987370;34785
704;4.23624e-15;35;1244;9137;10075.5;1;641;-2.14748e+09;-7.38908e+07;-1;0;0;0;-1;0;102985552;102987370;34785
705;4.27178e-15;81;1457;9537;10131;1;677;-2.14748e+09;-7.29461e+07;-1;0;0;0;-1;0;104094094;104096000;36392
705;4.23624e-15;34;1244;9137;10075.5;1;641;-2.14748e+09;-7.2946e+07;-1;0;0;0;-1;0;104094094;104096000;36392
706;4.27178e-15;81;1457;9537;10131;1;677;-2.14748e+09;-7.20203e+07;-1;0;0;0;-1;0;105200381;105202380;38055
706;4.23624e-15;33;1244;9137;10075.5;1;641;-2.14748e+09;-7.20203e+07;-1;0;0;0;-1;0;105200381;105202380;38055
707;4.27178e-15;81;1457;9537;10131;1;677;-2.14748e+09;-7.11129e+07;-1;0;0;0;-1;0;106304351;106306446;39776
707;4.23624e-15;31;1244;9137;10075.5;1;641;-2.14748e+09;-7.11128e+07;-1;0;0;0;-1;0;106304350;106306446;39776
708;4.27178e-15;80;1457;9537;10131;1;677;-2.14748e+09;-7.02234e+07;-1;0;0;0;-1;0;107405942;107408137;41555
708;4.23624e-15;31;1244;9137;10075.5;1;641;-2.14748e+09;-7.02234e+07;-1;0;0;0;-1;0;107405942;107408137;41555
709;4.27178e-15;80;1457;9537;10131;1;677;-2.14748e+09;-6.93516e+07;-1;0;0;0;-1;0;108505099;108507397;43394
709;4.23624e-15;31;1244;9137;10075.5;1;641;-2.14748e+09;-6.93515e+07;0;0;-1;0;0;-1;108505098;108507397;43394
710;4.27178e-15;80;1457;9537;10131;1;677;-2.14748e+09;-6.84967e+07;0;0;-1;0;0;-1;109601764;109604169;45295
710;4.23624e-15;30;1244;9137;10075.5;1;641;-2.14748e+09;-6.84966e+07;-1;0;0;0;-1;0;109601763;109604169;45295
711;4.27178e-15;74;1457;9537;10131;1;677;-2.14748e+09;-6.76584e+07;-1;0;0;0;-1;0;110695882;110698399;47258
711;4.23624e-15;30;1244;9137;10075.5;1;641;-2.14748e+09;-6.76584e+07;-1;0;0;0;-1;0;110695882;110698399;47258
712;4.27178e-15;74;1457;9537;10131;1;677;-2.14748e+09;-6.68364e+07;-1;0;0;0;-1;0;111787405;111790036;49285
712;4.23624e-15;30;1244;9137;10075.5;1;641;-2.14748e+09;-6.68363e+07;-1;0;0;0;-1;0;111787404;111790036;49285
713;4.27178e-15;74;1457;9537;10131;1;677;-2.14748e+09;-6.60301e+07;-1;0;0;0;-1;0;112876279;112879029;51377
713;4.23624e-15;25;1244;9137;10075.5;1;641;-2.14748e+09;-6.60301e+07;-1;0;0;0;-1;0;112876279;112879029;51377
714;4.27178e-15;74;1457;9537;10131;1;677;-2.14748e+09;-6.52393e+07;-1;0;0;0;-1;0;113962459;113965331;53535
714;4.23624e-15;25;1244;9137;10075.5;1;641;-2.14748e+09;-6.52393e+07;-1;0;0;0;-1;0;113962459;113965331;53535
715;4.27178e-15;73;1457;9537;10131;1;677;-2.14748e+09;-6.44635e+07;-1;0;0;0;-1;0;115045897;115048897;55762
715;4.23624e-15;25;1244;9137;10075.5;1;641;-2.14748e+09;-6.44635e+07;-1;0;0;0;-1;0;115045897;115048897;55762
716;4.27178e-15;70;1457;9537;10131;1;677;-2.14748e+09;-6.37024e+07;-1;0;0;0;-1;0;116126550;116129683;58057
716;4.23624e-15;24;1244;9137;10075.5;1;641;-2.14748e+09;-6.37024e+07;-1;0;0;0;-1;0;116126550;116129683;58057
717;4.27178e-15;70;1457;9537;10131;1;677;-2.14748e+09;-6.29556e+07;-1;0;0;0;-1;0;117204376;117207645;60422
717;4.23624e-15;24;1244;9137;10075.5;1;641;-2.14748e+09;-6.29556e+07;-1;0;0;0;-1;0;117204376;117207645;60422
718;4.27178e-15;68;1457;9537;10131;1;677;-2.14748e+09;-6.22226e+07;-1;0;0;0;-1;0;118279333;118282744;62859
718;4.23624e-15;24;1244;9137;10075.5;1;641;-2.14748e+09;-6.22226e+07;-1;0;0;0;-1;0;118279333;118282744;62859
719;4.27178e-15;68;1457;9537;10131;1;677;-2.14748e+09;-6.15032e+07;-1;0;0;0;-1;0;119351383;119354940;65369
719;4.23624e-15;23;1244;9137;10075.5;1;641;-2.14748e+09;-6.15032e+07;-1;0;0;0;-1;0;119351383;119354940;65369
720;4.27178e-15;68;1457;9537;10131;1;677;-2.14748e+09;-6.07972e+07;-1;0;0;0;-1;0;120420489;120424197;67953
720;4.23624e-15;22;1244;9137;10075.5;1;641;-2.14748e+09;-6.07972e+07;-1;0;0;0;-1;0;120420489;120424197;67953
721;4.27178e-15;68;1457;9537;10131;1;677;-2.14748e+09;-6.01041e+07;-1;0;0;0;-1;0;121486616;121490479;70612
721;4.23624e-15;21;1244;9137;10075.5;1;641;-2.14748e+09;-6.01041e+07;-1;0;0;0;-1;0;121486616;121490479;70612
722;4.27178e-15;65;1457;9537;10131;1;677;-2.14748e+09;-5.94236e+07;-1;0;0;0;-1;0;122549729;122553753;73348
722;4.23624e-15;18;1244;9137;10075.5;1;641;-2.14748e+09;-5.94236e+07;-1;0;0;0;-1;0;122549729;122553753;73348
723;4.27178e-15;65;1457;9537;10131;1;677;-2.14748e+09;-5.87556e+07;-1;0;0;0;-1;0;123609795;123613985;76163
723;4.23624e-15;18;1244;9137;10075.5;1;641;-2.14748e+09;-5.87556e+07;-1;0;0;0;-1;0;123609795;123613985;76163
724;4.27178e-15;64;1457;9537;10131;1;677;-2.14748e+09;-5.80994e+07;-1;0;0;0;-1;0;124666785;124671146;79057
724;4.23624e-15;18;1244;9137;10075.5;1;641;-2.14748e+09;-5.80994e+07;-1;0;0;0;-1;0;124666785;124671146;79057
725;4.27178e-15;62;1457;9537;10131;1;677;-2.14748e+09;-5.74551e+07;-1;0;0;0;-1;0;125720668;125725205;82031
725;4.23624e-15;18;1244;9137;10075.5;1;641;-2.14748e+09;-5.74551e+07;-1;0;0;0;-1;0;125720668;125725205;82031
726;4.27178e-15;62;1457;9537;10131;1;677;-2.14748e+09;-5.68223e+07;-1;0;0;0;-1;0;126771416;126776136;85088
726;4.23624e-15;18;1244;9137;10075.5;1;641;-2.14748e+09;-5.68223e+07;-1;0;0;0;-1;0;126771416;126776136;85088
727;4.27178e-15;58;1457;9537;10131;1;677;-2.14748e+09;-5.62006e+07;-1;0;0;0;-1;0;127819003;127823911;88228
727;4.23624e-15;17;1244;9137;10075.5;1;641;-2.14748e+09;-5.62006e+07;-1;0;0;0;-1;0;127819003;127823911;88228
728;4.27178e-15;58;1457;9537;10131;1;677;-2.14748e+09;-5.55901e+07;-1;0;0;0;-1;0;128863404;128868505;91453
728;4.23624e-15;15;1244;9137;10075.5;1;641;-2.14748e+09;-5.55901e+07;-1;0;0;0;-1;0;128863404;128868505;91453
729;4.27178e-15;58;1457;9537;10131;1;677;-2.14748e+09;-5.499e+07;-1;0;0;0;-1;0;129904594;129909895;94763
729;4.23624e-15;13;1244;9137;10075.5;1;641;-2.14748e+09;-5.499e+07;-1;0;0;0;-1;0;129904594;129909895;94763
730;4.27178e-15;57;1457;9537;10131;1;677;-2.14748e+09;-5.44005e+07;-1;0;0;0;-1;0;130942550;130948056;98161
730;4.23624e-15;12;1244;9137;10075.5;1;641;-2.14748e+09;-5.44005e+07;-1;0;0;0;-1;0;130942550;130948056;98161
731;4.27178e-15;57;1457;9537;10131;1;677;-2.14748e+09;-5.38211e+07;-1;0;0;0;-1;0;131977251;131982970;101648
731;4.23624e-15;11;1244;9137;10075.5;1;641;-2.14748e+09;-5.38211e+07;-1;0;0;0;-1;0;131977251;131982970;101648
732;4.27178e-15;56;1457;9537;10131;1;677;-2.14748e+09;-5.32518e+07;-1;0;0;0;-1;0;133008677;133014614;105224
732;4.23624e-15;11;1244;9137;10075.5;1;641;-2.14748e+09;-5.32518e+07;-1;0;0;0;-1;0;133008677;133014614;105224
733;4.27178e-15;56;1457;9537;10131;1;677;-2.14748e+09;-5.26922e+07;-1;0;0;0;-1;0;134036809;134042970;108892
733;4.23624e-15;11;1244;9137;10075.5;1;641;-2.14748e+09;-5.26921e+07;-1;0;0;0;-1;0;134036809;134042970;108892
734;4.27178e-15;56;1457;9537;10131;1;677;-2.14748e+09;-5.21421e+07;-1;0;0;0;-1;0;135061629;135068021;112652
734;4.23624e-15;8;1243;9137;10075.5;1;641;-2.14748e+09;-5.2142e+07;-1;0;0;0;-1;0;135061629;135068021;112652
735;4.27178e-15;56;1457;9537;10131;1;677;-2.14748e+09;-5.16013e+07;-1;0;0;0;-1;0;136083119;136089749;116505
735;4.23624e-15;7;1243;9137;10075.5;1;641;-2.14748e+09;-5.16013e+07;-1;0;0;0;-1;0;136083119;136089749;116505
736;4.27178e-15;56;1457;9537;10131;1;677;-2.14748e+09;-5.10697e+07;-1;0;0;0;-1;0;137101264;137108138;120454
736;4.23624e-15;7;1243;9137;10075.5;1;641;-2.14748e+09;-5.10696e+07;-1;0;0;0;-1;0;137101264;137108138;120454
737;4.27178e-15;55;1457;9537;10131;1;677;-2.14748e+09;-5.05469e+07;0;0;-1;0;0;-1;138116049;138123175;124499
737;4.23624e-15;7;1243;9137;10075.5;1;641;-2.14748e+09;-5.05468e+07;-1;0;0;0;-1;0;138116049;138123175;124499
738;4.27178e-15;55;1457;9537;10131;1;677;-2.14748e+09;-5.00327e+07;-1;0;0;0;-1;0;139127460;139134844;128642
738;4.23624e-15;6;1243;9137;10075.5;1;641;-2.14748e+09;-5.00327e+07;-1;0;0;0;-1;0;139127460;139134844;128642
739;4.27178e-15;55;1457;9537;10131;1;677;-2.14748e+09;-4.95272e+07;-1;0;0;0;-1;0;140135485;140143135;132884
739;4.23624e-15;4;1243;9137;10075.5;1;641;-2.14748e+09;-4.95272e+07;-1;0;0;0;-1;0;140135485;140143135;132884
740;4.27178e-15;54;1457;9537;10131;1;677;-2.14748e+09;-4.90299e+07;-1;0;0;0;-1;0;141140112;141148035;137225
740;4.23624e-15;2;1243;9137;10075.5;1;641;-2.14748e+09;-4.90299e+07;-1;0;0;0;-1;0;141140112;141148035;137225
741;4.27178e-15;53;1457;9537;10131;1;677;-2.14748e+09;-4.85409e+07;-1;0;0;0;-1;0;142141329;142149532;141668
741;4.23624e-15;2;1243;9137;10075.5;1;641;-2.14748e+09;-4.85408e+07;-1;0;0;0;-1;0;142141329;142149532;141668
742;4.27178e-15;53;1457;9537;10131;1;677;-2.14748e+09;-4.80597e+07;-1;0;0;0;-1;0;143139127;143147618;146214
742;4.23624e-15;1;1243;9137;10075.5;1;641;-2.14748e+09;-4.80597e+07;-1;0;0;0;-1;0;143139127;143147618;146214
743;4.27178e-15;50;1457;9537;10131;1;677;-2.14748e+09;-4.75864e+07;-1;0;0;0;-1;0;144133496;144142284;150864
743;4.23624e-15;-1;1243;9137;10075.5;1;641;-2.14748e+09;-4.75863e+07;0;0;0;0;0;0;144133496;144142283;150864
744;4.27178e-15;50;1457;9537;10131;1;677;-2.14748e+09;-4.71205e+07;-1;0;0;0;-1;0;145124429;145133519;155618
744;4.23624e-15;-2;1243;9137;10075.5;1;641;-2.14748e+09;-4.71205e+07;0;0;0;0;0;0;145124429;145133519;155618
745;4.27178e-15;49;1457;9537;10131;1;677;-2.14748e+09;-4.66622e+07;-1;0;0;0;-1;0;146111917;146121319;160479
745;4.23624e-15;-2;1243;9137;10075.5;1;641;-2.14748e+09;-4.66622e+07;0;0;-1;0;0;-1;146111917;146121319;160479
746;4.27178e-15;49;1457;9537;10131;1;677;-2.14748e+09;-4.62113e+07;-1;0;0;0;-1;0;147095954;147105676;165448
746;4.23624e-15;-2;1243;9137;10075.5;1;641;-2.14748e+09;-4.62112e+07;-1;0;0;0;-1;0;147095954;147105676;165448
747;4.27178e-15;47;1457;9537;10131;1;677;-2.14748e+09;-4.57674e+07;-1;0;0;0;-1;0;148076534;148086584;170525
747;4.23624e-15;-2;1243;9137;10075.5;1;641;-2.14748e+09;-4.57674e+07;-1;0;0;0;-1;0;148076534;148086584;170525
748;4.27178e-15;47;1457;9537;10131;1;677;-2.14748e+09;-4.53305e+07;-1;0;0;0;-1;0;149053653;149064038;175712
748;4.23624e-15;-2;1243;9137;10075.5;1;641;-2.14748e+09;-4.53305e+07;-1;0;0;0;-1;0;149053653;149064038;175712
749;4.27178e-15;46;1457;9537;10131;1;677;-2.14748e+09;-4.49004e+07;-1;0;0;0;-1;0;150027304;150038035;181010
749;4.23624e-15;-2;1243;9137;10075.5;1;641;-2.14748e+09;-4.49004e+07;-1;0;0;0;-1;0;150027304;150038034;181010
750;4.27178e-15;45;1457;9537;10131;1;677;-2.14748e+09;-4.44771e+07;-1;0;0;0;-1;0;150997485;151008569;186421
750;4.23624e-15;-3;1243;9137;10075.5;1;641;-2.14748e+09;-4.44771e+07;0;0;0;0;0;0;150997485;151008569;186421
751;4.27178e-15;45;1457;9537;10131;1;677;-2.14748e+09;-4.40604e+07;-1;0;0;0;-1;0;151964192;151975638;191945
751;4.23624e-15;-3;1243;9137;10075.5;1;641;-2.14748e+09;-4.40603e+07;-1;0;0;0;-1;0;151964192;151975638;191945
752;4.27178e-15;41;1457;9537;10131;1;677;-2.14748e+09;-4.36499e+07;-1;0;0;0;-1;0;152927424;152939241;197584
752;4.23624e-15;-4;1243;9137;10075.5;1;641;-2.14748e+09;-4.36499e+07;0;0;0;0;0;0;152927424;152939241;197584
753;4.27178e-15;41;1457;9537;10131;1;677;-2.14748e+09;-4.32459e+07;-1;0;0;0;-1;0;153887177;153899375;203339
753;4.23624e-15;-5;1243;9137;10075.5;1;641;-2.14748e+09;-4.32458e+07;0;0;0;0;0;0;153887177;153899375;203339
754;4.27178e-15;40;1457;9537;10131;1;677;-2.14748e+09;-4.2848e+07;-1;0;0;0;-1;0;154843452;154856039;209211
754;4.23624e-15;-6;1243;9137;10075.5;1;641;-2.14748e+09;-4.28479e+07;0;0;0;0;0;0;154843452;154856039;209211
755;4.27178e-15;39;1457;9537;10131;1;677;-2.14748e+09;-4.24561e+07;-1;0;0;0;-1;0;155796247;155809233;215201
755;4.23624e-15;-7;1243;9137;10075.5;1;641;-2.14748e+09;-4.2456e+07;0;0;0;0;0;0;155796247;155809233;215201
756;4.27178e-15;39;1457;9537;10131;1;677;-2.14748e+09;-4.207e+07;-1;0;0;0;-1;0;156745562;156758957;221310
756;4.23624e-15;-7;1243;9137;10075.5;1;641;-2.14748e+09;-4.207e+07;-1;0;0;0;-1;0;156745562;156758957;221310
757;4.27178e-15;39;1457;9537;10131;1;677;-2.14748e+09;-4.16897e+07;-1;0;0;0;-1;0;157691398;157705212;227539
757;4.23624e-15;-8;1243;9137;10075.5;1;641;-2.14748e+09;-4.16897e+07;0;0;0;0;0;0;157691398;157705212;227539
758;4.27178e-15;39;1457;9537;10131;1;677;-2.14748e+09;-4.13152e+07;-1;0;0;0;-1;0;158633756;158647998;233890
758;4.23624e-15;-9;1243;9137;10075.5;1;641;-2.14748e+09;-4.13152e+07;0;0;0;0;0;0;158633756;158647998;233890
759;4.27178e-15;37;1457;9537;10131;1;677;-2.14748e+09;-4.09462e+07;-1;0;0;0;-1;0;159572638;159587318;240364
759;4.23624e-15;-10;1243;9137;10075.5;1;641;-2.14748e+09;-4.09462e+07;0;0;0;0;0;0;159572638;159587318;240364
760;4.27178e-15;36;1457;9537;10131;1;677;-2.14748e+09;-4.05826e+07;-1;0;0;0;-1;0;160508045;160523174;246961
760;4.23624e-15;-10;1243;9137;10075.5;1;641;-2.14748e+09;-4.05826e+07;-1;0;0;0;-1;0;160508045;160523174;246961
761;4.27178e-15;36;1457;9537;10131;1;677;-2.14748e+09;-4.02244e+07;-1;0;0;0;-1;0;161439981;161455567;253684
761;4.23624e-15;-11;1243;9137;10075.5;1;641;-2.14748e+09;-4.02244e+07;0;0;0;0;0;0;161439981;161455567;253684
762;4.27178e-15;35;1457;9537;10131;1;677;-2.14748e+09;-3.98714e+07;-1;0;0;0;-1;0;162368447;162384503;260532
762;4.23624e-15;-12;1243;9137;10075.5;1;641;-2.14748e+09;-3.98714e+07;0;0;0;0;0;0;162368447;162384503;260532
763;4.27178e-15;35;1457;9537;10131;1;677;-2.14748e+09;-3.95235e+07;-1;0;0;0;-1;0;163293449;163309984;267506
763;4.23624e-15;-12;1243;9137;10075.5;1;641;-2.14748e+09;-3.95235e+07;-1;0;0;0;-1;0;163293449;163309984;267506
764;4.27178e-15;34;1457;9537;10131;1;677;-2.14748e+09;-3.91808e+07;-1;0;0;0;-1;0;164214989;164232014;274609
764;4.23624e-15;-12;1243;9137;10075.5;1;641;-2.14748e+09;-3.91808e+07;-1;0;0;0;-1;0;164214989;164232014;274609
765;4.27178e-15;32;1457;9537;10131;1;677;-2.14748e+09;-3.88428e+07;-1;0;0;0;-1;0;165133072;165150598;281841
765;4.23624e-15;-13;1243;9137;10075.5;1;641;-2.14748e+09;-3.88428e+07;0;0;0;0;0;0;165133072;165150598;281841
766;4.27178e-15;32;1457;9537;10131;1;677;-2.14748e+09;-3.85098e+07;-1;0;0;0;-1;0;166047702;166065741;289202
766;4.23624e-15;-13;1243;9137;10075.5;1;641;-2.14748e+09;-3.85097e+07;-1;0;0;0;-1;0;166047702;166065741;289202
767;4.27178e-15;32;1457;9537;10131;1;677;-2.14748e+09;-3.81814e+07;-1;0;0;0;-1;0;166958886;166977448;296695
767;4.23624e-15;-14;1243;9137;10075.5;1;641;-2.14748e+09;-3.81813e+07;0;0;0;0;0;0;166958886;166977448;296695
768;4.27178e-15;32;1457;9537;10131;1;677;-2.14748e+09;-3.78576e+07;-1;0;0;0;-1;0;167866628;167885724;304320
768;4.23624e-15;-14;1243;9137;10075.5;1;641;-2.14748e+09;-3.78576e+07;-1;0;0;0;-1;0;167866628;167885724;304320
769;4.27178e-15;32;1457;9537;10131;1;677;-2.14748e+09;-3.75384e+07;-1;0;0;0;-1;0;168770934;168790577;312077
769;4.23624e-15;-15;1243;9137;10075.5;1;641;-2.14748e+09;-3.75384e+07;0;0;0;0;0;0;168770934;168790577;312077
770;4.27178e-15;31;1457;9537;10131;1;677;-2.14748e+09;-3.72237e+07;-1;0;0;0;-1;0;169671811;169692012;319969
770;4.23624e-15;-15;1243;9137;10075.5;1;641;-2.14748e+09;-3.72237e+07;-1;0;0;0;-1;0;169671811;169692012;319969
771;4.27178e-15;31;1457;9537;10131;1;677;-2.14748e+09;-3.69134e+07;0;0;-1;0;0;-1;170569266;170590035;327995
771;4.23624e-15;-15;1243;9137;10075.5;1;641;-2.14748e+09;-3.69134e+07;-1;0;0;0;-1;0;170569266;170590035;327995
772;4.27178e-15;30;1457;9537;10131;1;677;-2.14748e+09;-3.66073e+07;-1;0;0;0;-1;0;171463304;171484655;336157
772;4.23624e-15;-15;1243;9137;10075.5;1;641;-2.14748e+09;-3.66073e+07;-1;0;0;0;-1;0;171463304;171484655;336157
773;4.27178e-15;27;1457;9537;10131;1;677;-2.14748e+09;-3.63055e+07;-1;0;0;0;-1;0;172353933;172375878;344456
773;4.23624e-15;-16;1243;9137;10075.5;1;641;-2.14748e+09;-3.63055e+07;0;0;0;0;0;0;172353933;172375878;344456
774;4.27178e-15;25;1457;9537;10131;1;677;-2.14748e+09;-3.60078e+07;-1;0;0;0;-1;0;173241162;173263712;352892
774;4.23624e-15;-16;1243;9137;10075.5;1;641;-2.14748e+09;-3.60078e+07;-1;0;0;0;-1;0;173241162;173263712;352892
775;4.27178e-15;25;1457;9537;10131;1;677;-2.14748e+09;-3.57143e+07;-1;0;0;0;-1;0;174124997;174148165;361467
775;4.23624e-15;-16;1243;9137;10075.5;1;641;-2.14748e+09;-3.57142e+07;-1;0;0;0;-1;0;174124997;174148165;361467
776;4.27178e-15;25;1457;9537;10131;1;677;-2.14748e+09;-3.54247e+07;-1;0;0;0;-1;0;175005447;175029246;370182
776;4.23624e-15;-16;1243;9137;10075.5;1;641;-2.14748e+09;-3.54246e+07;-1;0;0;0;-1;0;175005447;175029246;370182
777;4.27178e-15;24;1457;9537;10131;1;677;-2.14748e+09;-3.5139e+07;-1;0;0;0;-1;0;175882520;175906962;379036
777;4.23624e-15;-17;1243;9137;10075.5;1;641;-2.14748e+09;-3.51389e+07;0;0;0;0;0;0;175882520;175906962;379036
778;4.27178e-15;24;1457;9537;10131;1;677;-2.14748e+09;-3.48571e+07;-1;0;0;0;-1;0;176756225;176781323;388032
778;4.23624e-15;-17;1243;9137;10075.5;1;641;-2.14748e+09;-3.4857e+07;-1;0;0;0;-1;0;176756225;176781323;388032
779;4.27178e-15;22;1457;9537;10131;1;677;-2.14748e+09;-3.45788e+07;-1;0;0;0;-1;0;177626570;177652338;397170
779;4.23624e-15;-18;1243;9137;10075.5;1;641;-2.14748e+09;-3.45788e+07;0;0;0;0;0;0;177626570;177652338;397170
780;4.27178e-15;21;1457;9537;10131;1;677;-2.14748e+09;-3.43045e+07;-1;0;0;0;-1;0;178493566;178520015;406451
780;4.23624e-15;-19;1243;9137;10075.5;1;641;-2.14748e+09;-3.43044e+07;0;0;0;0;0;0;178493566;178520015;406451
781;4.27178e-15;19;1457;9537;10131;1;677;-2.14748e+09;-3.40337e+07;-1;0;0;0;-1;0;179357220;179384365;415876
781;4.23624e-15;-19;1243;9137;10075.5;1;641;-2.14748e+09;-3.40337e+07;-1;0;0;0;-1;0;179357220;179384365;415876
782;4.27178e-15;18;1457;9537;10131;1;677;-2.14748e+09;-3.37665e+07;-1;0;0;0;-1;0;180217543;180245398;425445
782;4.23624e-15;-19;1243;9137;10075.5;1;641;-2.14748e+09;-3.37664e+07;-1;0;0;0;-1;0;180217543;180245398;425445
783;4.27178e-15;17;1457;9537;10131;1;677;-2.14748e+09;-3.35027e+07;-1;0;0;0;-1;0;181074545;181103122;435159
783;4.23624e-15;-20;1243;9137;10075.5;1;641;-2.14748e+09;-3.35027e+07;0;0;0;0;0;0;181074545;181103122;435159
784;4.27178e-15;17;1457;9537;10131;1;677;-2.14748e+09;-3.32423e+07;-1;0;0;0;-1;0;181928235;181957549;445019
784;4.23624e-15;-20;1243;9137;10075.5;1;641;-2.14748e+09;-3.32423e+07;-1;0;0;0;-1;0;181928235;181957549;445019
785;4.27178e-15;17;1457;9537;10131;1;677;-2.14748e+09;-3.29854e+07;-1;0;0;0;-1;0;182778623;182808688;455026
785;4.23624e-15;-21;1243;9137;10075.5;1;641;-2.14748e+09;-3.29854e+07;0;0;0;0;0;0;182778623;182808688;455026
786;4.27178e-15;15;1457;9537;10131;1;677;-2.14748e+09;-3.27317e+07;-1;0;0;0;-1;0;183625721;183656550;465181
786;4.23624e-15;-22;1243;9137;10075.5;1;641;-2.14748e+09;-3.27317e+07;0;0;0;0;0;0;183625721;183656550;465181
787;4.27178e-15;15;1457;9537;10131;1;677;-2.14748e+09;-3.24814e+07;-1;0;0;0;-1;0;184469538;184501146;475484
787;4.23624e-15;-23;1243;9137;10075.5;1;641;-2.14748e+09;-3.24814e+07;0;0;0;0;0;0;184469538;184501146;475484
788;4.27178e-15;15;1457;9537;10131;1;677;-2.14748e+09;-3.22343e+07;-1;0;0;0;-1;0;185310085;185342486;485936
788;4.23624e-15;-24;1243;9137;10075.5;1;641;-2.14748e+09;-3.22343e+07;0;0;0;0;0;0;185310085;185342486;485936
789;4.27178e-15;14;1457;9537;10131;1;677;-2.14748e+09;-3.19902e+07;-1;0;0;0;-1;0;186147373;186180582;496537
789;4.23624e-15;-25;1243;9137;10075.5;1;641;-2.14748e+09;-3.19902e+07;0;0;0;0;0;0;186147373;186180582;496537
790;4.27178e-15;10;1457;9537;10131;1;677;-2.14748e+09;-3.17492e+07;-1;0;0;0;-1;0;186981414;187015445;507289
790;4.23624e-15;-26;1243;9137;10075.5;1;641;-2.14748e+09;-3.17492e+07;0;0;0;0;0;0;186981414;187015445;507289
791;4.27178e-15;8;1457;9537;10131;1;677;-2.14748e+09;-3.15114e+07;-1;0;0;0;-1;0;187812217;187847086;518192
791;4.23624e-15;-26;1243;9137;10075.5;1;641;-2.14748e+09;-3.15113e+07;-1;0;0;0;-1;0;187812217;187847086;518192
792;4.27178e-15;4;1457;9537;10131;1;677;-2.14748e+09;-3.12764e+07;-1;0;0;0;-1;0;188639795;188675517;529247
792;4.23624e-15;-26;1243;9137;10075.5;1;641;-2.14748e+09;-3.12764e+07;-1;0;0;0;-1;0;188639795;188675517;529247
793;4.27178e-15;2;1457;9537;10131;1;677;-2.14748e+09;-3.10445e+07;-1;0;0;0;-1;0;189464159;189500748;540455
793;4.23624e-15;-26;1243;9137;10075.5;1;641;-2.14748e+09;-3.10444e+07;-1;0;0;0;-1;0;189464159;189500748;540455
794;4.27178e-15;0;1457;9537;10131;1;677;-2.14748e+09;-3.08153e+07;-1;0;0;0;-1;0;190285320;190322793;551815
794;4.23624e-15;-27;1243;9137;10075.5;1;641;-2.14748e+09;-3.08153e+07;0;0;0;0;0;0;190285320;190322793;551815
795;4.27178e-15;-1;1457;9537;10131;1;677;-2.14748e+09;-3.0589e+07;0;0;0;0;0;0;191103291;191141662;563329
795;4.23624e-15;-27;1243;9137;10075.5;1;641;-2.14748e+09;-3.0589e+07;-1;0;0;0;-1;0;191103291;191141662;563329
796;4.27178e-15;-2;1457;9537;10131;1;677;-2.14748e+09;-3.03655e+07;0;0;0;0;0;0;191918082;191957367;574997
796;4.23624e-15;-28;1243;9137;10075.5;1;641;-2.14748e+09;-3.03654e+07;0;0;0;0;0;0;191918082;191957367;574997
797;4.27178e-15;-2;1457;9537;10131;1;677;-2.14748e+09;-3.01447e+07;-1;0;0;0;-1;0;192729706;192769921;586820
797;4.23624e-15;-29;1243;9137;10075.5;1;641;-2.14748e+09;-3.01447e+07;0;0;0;0;0;0;192729706;192769921;586820
798;4.27178e-15;-3;1457;9537;10131;1;677;-2.14748e+09;-2.99265e+07;0;0;0;0;0;0;193538174;193579336;598799
798;4.23624e-15;-30;1243;9137;10075.5;1;641;-2.14748e+09;-2.99265e+07;0;0;0;0;0;0;193538174;193579336;598799
799;4.27178e-15;-3;1457;9537;10131;1;677;-2.14748e+09;-2.97112e+07;-1;0;0;0;-1;0;194343500;194385624;610933
799;4.23624e-15;-31;1243;9137;10075.5;1;641;-2.14748e+09;-2.97111e+07;0;0;0;0;0;0;194343500;194385624;610933
800;4.27178e-15;-3;1457;9537;10131;1;677;-2.14748e+09;-2.94983e+07;-1;0;0;0;-1;0;195145695;195188797;623224
800;4.23624e-15;-32;1243;9137;10075.5;1;641;-2.14748e+09;-2.94982e+07;0;0;0;0;0;0;195145695;195188797;623224
801;4.27178e-15;-3;1457;9537;10131;1;677;-2.14748e+09;-2.92879e+07;-1;0;0;0;-1;0;195944770;195988868;635672
801;4.23624e-15;-32;1243;9137;10075.5;1;641;-2.14748e+09;-2.92879e+07;-1;0;0;0;-1;0;195944770;195988868;635672
802;4.27178e-15;-3;1457;9537;10131;1;677;-2.14748e+09;-2.90801e+07;-1;0;0;0;-1;0;196740740;196785849;648278
802;4.23624e-15;-32;1243;9137;10075.5;1;641;-2.14748e+09;-2.90801e+07;-1;0;0;0;-1;0;196740740;196785849;648278
803;4.27178e-15;-4;1457;9537;10131;1;677;-2.14748e+09;-2.88747e+07;0;0;0;0;0;0;197533615;197579753;661042
803;4.23624e-15;-32;1243;9137;10075.5;1;641;-2.14748e+09;-2.88747e+07;-1;0;0;0;-1;0;197533615;197579753;661042
804;4.27178e-15;-5;1457;9537;10131;1;677;-2.14748e+09;-2.86718e+07;0;0;0;0;0;0;198323408;198370592;673964
804;4.23624e-15;-33;1243;9137;10075.5;1;641;-2.14748e+09;-2.86718e+07;0;0;0;0;0;0;198323408;198370592;673964
805;4.27178e-15;-6;1457;9537;10131;1;677;-2.14748e+09;-2.84714e+07;0;0;0;0;0;0;199110133;199158379;687046
805;4.23624e-15;-33;1243;9137;10075.5;1;641;-2.14748e+09;-2.84713e+07;-1;0;0;0;-1;0;199110133;199158379;687046
806;4.27178e-15;-6;1457;9537;10131;1;677;-2.14748e+09;-2.82731e+07;-1;0;0;0;-1;0;199893801;199943127;700287
806;4.23624e-15;-33;1243;9137;10075.5;1;641;-2.14748e+09;-2.82731e+07;-1;0;0;0;-1;0;199893801;199943127;700287
807;4.27178e-15;-7;1457;9537;10131;1;677;-2.14748e+09;-2.80773e+07;0;0;0;0;0;0;200674426;200724848;713688
807;4.23624e-15;-33;1243;9137;10075.5;1;641;-2.14748e+09;-2.80773e+07;-1;0;0;0;-1;0;200674426;200724848;713688
808;4.27178e-15;-8;1457;9537;10131;1;677;-2.14748e+09;-2.78837e+07;0;0;0;0;0;0;201452019;201503556;727249
808;4.23624e-15;-33;1243;9137;10075.5;1;641;-2.14748e+09;-2.78837e+07;-1;0;0;0;-1;0;201452019;201503556;727249
809;4.27178e-15;-8;1457;9537;10131;1;677;-2.14748e+09;-2.76923e+07;-1;0;0;0;-1;0;202226593;202279263;740971
809;4.23624e-15;-33;1243;9137;10075.5;1;641;-2.14748e+09;-2.76923e+07;-1;0;0;0;-1;0;202226593;202279263;740971
810;4.27178e-15;-9;1457;9537;10131;1;677;-2.14748e+09;-2.75033e+07;0;0;0;0;0;0;202998163;203051983;754854
810;4.23624e-15;-34;1243;9137;10075.5;1;641;-2.14748e+09;-2.75033e+07;0;0;0;0;0;0;202998163;203051983;754854
811;4.27178e-15;-10;1457;9537;10131;1;677;-2.14748e+09;-2.73162e+07;0;0;0;0;0;0;203766739;203821727;768899
811;4.23624e-15;-34;1243;9137;10075.5;1;641;-2.14748e+09;-2.73162e+07;-1;0;0;0;-1;0;203766739;203821727;768899
812;4.27178e-15;-10;1457;9537;10131;1;677;-2.14748e+09;-2.71314e+07;-1;0;0;0;-1;0;204532335;204588510;783106
812;4.23624e-15;-35;1243;9137;10075.5;1;641;-2.14748e+09;-2.71314e+07;0;0;0;0;0;0;204532335;204588510;783106
813;4.27178e-15;-10;1457;9537;10131;1;677;-2.14748e+09;-2.69485e+07;-1;0;0;0;-1;0;205294965;205352345;797476
813;4.23624e-15;-35;1243;9137;10075.5;1;641;-2.14748e+09;-2.69485e+07;-1;0;0;0;-1;0;205294965;205352345;797476
814;4.27178e-15;-10;1457;9537;10131;1;677;-2.14748e+09;-2.67678e+07;-1;0;0;0;-1;0;206054640;206113243;812008
814;4.23624e-15;-35;1243;9137;10075.5;1;641;-2.14748e+09;-2.67678e+07;-1;0;0;0;-1;0;206054640;206113243;812008
815;4.27178e-15;-10;1457;9537;10131;1;677;-2.14748e+09;-2.65892e+07;-1;0;0;0;-1;0;206811374;206871219;826703
815;4.23624e-15;-35;1243;9137;10075.5;1;641;-2.14748e+09;-2.65892e+07;-1;0;0;0;-1;0;206811374;206871219;826703
816;4.27178e-15;-11;1457;9537;10131;1;677;-2.14748e+09;-2.64125e+07;0;0;0;0;0;0;207565180;207626286;841561
816;4.23624e-15;-36;1243;9137;10075.5;1;641;-2.14748e+09;-2.64125e+07;0;0;0;0;0;0;207565180;207626286;841561
817;4.27178e-15;-11;1457;9537;10131;1;677;-2.14748e+09;-2.62378e+07;-1;0;0;0;-1;0;208316071;208378456;856583
817;4.23624e-15;-36;1243;9137;10075.5;1;641;-2.14748e+09;-2.62378e+07;-1;0;0;0;-1;0;208316071;208378456;856583
818;4.27178e-15;-11;1457;9537;10131;1;677;-2.14748e+09;-2.6065e+07;-1;0;0;0;-1;0;209064059;209127744;871769
818;4.23624e-15;-36;1243;9137;10075.5;1;641;-2.14748e+09;-2.6065e+07;-1;0;0;0;-1;0;209064059;209127744;871769
819;4.27178e-15;-12;1457;9537;10131;1;677;-2.14748e+09;-2.58942e+07;0;0;0;0;0;0;209809158;209874161;887120
819;4.23624e-15;-36;1243;9137;10075.5;1;641;-2.14748e+09;-2.58942e+07;-1;0;0;0;-1;0;209809158;209874161;887120
820;4.27178e-15;-13;1457;9537;10131;1;677;-2.14748e+09;-2.57251e+07;0;0;0;0;0;0;210551381;210617721;902634
820;4.23624e-15;-36;1243;9137;10075.5;1;641;-2.14748e+09;-2.57251e+07;-1;0;0;0;-1;0;210551381;210617721;902634
821;4.27178e-15;-13;1457;9537;10131;1;677;-2.14748e+09;-2.5558e+07;-1;0;0;0;-1;0;211290741;211358438;918314
821;4.23624e-15;-36;1243;9137;10075.5;1;641;-2.14748e+09;-2.5558e+07;-1;0;0;0;-1;0;211290741;211358438;918314
822;4.27178e-15;-14;1457;9537;10131;1;677;-2.14748e+09;-2.53927e+07;0;0;0;0;0;0;212027250;212096324;934158
822;4.23624e-15;-36;1243;9137;10075.5;1;641;-2.14748e+09;-2.53927e+07;-1;0;0;0;-1;0;212027250;212096324;934158
823;4.27178e-15;-15;1457;9537;10131;1;677;-2.14748e+09;-2.52292e+07;0;0;0;0;0;0;212760922;212831393;950168
823;4.23624e-15;-37;1243;9137;10075.5;1;641;-2.14748e+09;-2.52292e+07;0;0;0;0;0;0;212760922;212831393;950168
824;4.27178e-15;-16;1457;9537;10131;1;677;-2.14748e+09;-2.50675e+07;0;0;0;0;0;0;213491770;213563658;966343
824;4.23624e-15;-37;1243;9137;10075.5;1;641;-2.14748e+09;-2.50674e+07;0;0;-1;0;0;-1;213491770;213563658;966343
825;4.27178e-15;-17;1457;9537;10131;1;677;-2.14748e+09;-2.49075e+07;0;0;0;0;0;0;214219807;214293132;982684
825;4.23624e-15;-38;1243;9137;10075.5;1;641;-2.14748e+09;-2.49075e+07;0;0;0;0;0;0;214219807;214293132;982684
826;4.27178e-15;-17;1457;9537;10131;1;677;-2.14748e+09;-2.47491e+07;-1;0;0;0;-1;0;214945046;215019828;999191
826;4.23624e-15;-38;1243;9137;10075.5;1;641;-2.14748e+09;-2.47491e+07;-1;0;0;0;-1;0;214945046;215019828;999191
827;4.27178e-15;-17;1457;9537;10131;1;677;-2.14748e+09;-2.45925e+07;-1;0;0;0;-1;0;215667500;215743759;1015864
827;4.23624e-15;-38;1243;9137;10075.5;1;641;-2.14748e+09;-2.45925e+07;0;0;-1;0;0;-1;215667500;215743759;1015864
828;4.27178e-15;-18;1457;9537;10131;1;677;-2.14748e+09;-2.44375e+07;0;0;0;0;0;0;216387181;216464939;1032703
828;4.23624e-15;-39;1243;9137;10075.5;1;641;-2.14748e+09;-2.44375e+07;0;0;0;0;0;0;216387181;216464939;1032703
829;4.27178e-15;-18;1457;9537;10131;1;677;-2.14748e+09;-2.42842e+07;-1;0;0;0;-1;0;217104103;217183380;1049708
829;4.23624e-15;-40;1243;9137;10075.5;1;641;-2.14748e+09;-2.42842e+07;0;0;0;0;0;0;217104103;217183380;1049708
830;4.27178e-15;-19;1457;9537;10131;1;677;-2.14748e+09;-2.41325e+07;0;0;0;0;0;0;217818279;217899096;1066879
830;4.23624e-15;-40;1243;9137;10075.5;1;641;-2.14748e+09;-2.41324e+07;-1;0;0;0;-1;0;217818279;217899096;1066879
831;4.27178e-15;-20;1457;9537;10131;1;677;-2.14748e+09;-2.39824e+07;0;0;0;0;0;0;218529722;218612100;1084217
831;4.23624e-15;-41;1243;9137;10075.5;1;641;-2.14748e+09;-2.39823e+07;0;0;0;0;0;0;218529722;218612100;1084217
832;4.27178e-15;-21;1457;9537;10131;1;677;-2.14748e+09;-2.38337e+07;0;0;0;0;0;0;219238444;219322404;1101722
832;4.23624e-15;-42;1243;9137;10075.5;1;641;-2.14748e+09;-2.38337e+07;0;0;0;0;0;0;219238444;219322404;1101722
833;4.27178e-15;-21;1457;9537;10131;1;677;-2.14748e+09;-2.36867e+07;-1;0;0;0;-1;0;219944459;220030023;1119394
833;4.23624e-15;-42;1243;9137;10075.5;1;641;-2.14748e+09;-2.36867e+07;-1;0;0;0;-1;0;219944459;220030023;1119394
834;4.27178e-15;-21;1457;9537;10131;1;677;-2.14748e+09;-2.35412e+07;-1;0;0;0;-1;0;220647779;220734968;1137232
834;4.23624e-15;-43;1243;9137;10075.5;1;641;-2.14748e+09;-2.35412e+07;0;0;0;0;0;0;220647779;220734968;1137232
835;4.27178e-15;-21;1457;9537;10131;1;677;-2.14748e+09;-2.33972e+07;-1;0;0;0;-1;0;221348418;221437254;1155238
835;4.23624e-15;-44;1243;9137;10075.5;1;641;-2.14748e+09;-2.33972e+07;0;0;0;0;0;0;221348418;221437254;1155238
836;4.27178e-15;-21;1457;9537;10131;1;677;-2.14748e+09;-2.32547e+07;-1;0;0;0;-1;0;222046388;222136892;1173410
836;4.23624e-15;-45;1243;9137;10075.5;1;641;-2.14748e+09;-2.32547e+07;0;0;0;0;0;0;222046388;222136892;1173410
837;4.27178e-15;-21;1457;9537;10131;1;677;-2.14748e+09;-2.31136e+07;-1;0;0;0;-1;0;222741701;222833896;1191750
837;4.23624e-15;-45;1243;9137;10075.5;1;641;-2.14748e+09;-2.31136e+07;-1;0;0;0;-1;0;222741701;222833896;1191750
838;4.27178e-15;-21;1457;9537;10131;1;677;-2.14748e+09;-2.29739e+07;-1;0;0;0;-1;0;223434371;223528279;1210256
838;4.23624e-15;-46;1243;9137;10075.5;1;641;-2.14748e+09;-2.29739e+07;0;0;0;0;0;0;223434371;223528279;1210256
839;4.27178e-15;-21;1457;9537;10131;1;677;-2.14748e+09;-2.28357e+07;-1;0;0;0;-1;0;224124411;224220053;1228930
839;4.23624e-15;-47;1243;9137;10075.5;1;641;-2.14748e+09;-2.28357e+07;0;0;0;0;0;0;224124411;224220053;1228930
840;4.27178e-15;-21;1457;9537;10131;1;677;-2.14748e+09;-2.26989e+07;-1;0;0;0;-1;0;224811832;224909232;1247771
840;4.23624e-15;-48;1243;9137;10075.5;1;641;-2.14748e+09;-2.26989e+07;0;0;0;0;0;0;224811832;224909232;1247771
841;4.27178e-15;-22;1457;9537;10131;1;677;-2.14748e+09;-2.25634e+07;0;0;0;0;0;0;225496649;225595828;1266779
841;4.23624e-15;-49;1243;9137;10075.5;1;641;-2.14748e+09;-2.25634e+07;0;0;0;0;0;0;225496649;225595828;1266779
842;4.27178e-15;-23;1457;9537;10131;1;677;-2.14748e+09;-2.24293e+07;0;0;0;0;0;0;226178873;226279854;1285954
842;4.23624e-15;-49;1243;9137;10075.5;1;641;-2.14748e+09;-2.24293e+07;-1;0;0;0;-1;0;226178873;226279854;1285954
843;4.27178e-15;-23;1457;9537;10131;1;677;-2.14748e+09;-2.22966e+07;-1;0;0;0;-1;0;226858517;226961324;1305296
843;4.23624e-15;-50;1243;9137;10075.5;1;641;-2.14748e+09;-2.22966e+07;0;0;0;0;0;0;226858517;226961324;1305296
844;4.27178e-15;-24;1457;9537;10131;1;677;-2.14748e+09;-2.21652e+07;0;0;0;0;0;0;227535593;227640248;1324805
844;4.23624e-15;-50;1243;9137;10075.5;1;641;-2.14748e+09;-2.21651e+07;-1;0;0;0;-1;0;227535593;227640248;1324805
845;4.27178e-15;-25;1457;9537;10131;1;677;-2.14748e+09;-2.20349e+07;0;0;0;0;0;0;228210115;228316641;1344482
845;4.23624e-15;-51;1243;9137;10075.5;1;641;-2.14748e+09;-2.20349e+07;0;0;0;0;0;0;228210115;228316641;1344482
846;4.27178e-15;-26;1457;9537;10131;1;677;-2.14748e+09;-2.19061e+07;0;0;0;0;0;0;228882094;228990515;1364325
846;4.23624e-15;-52;1243;9137;10075.5;1;641;-2.14748e+09;-2.1906e+07;0;0;0;0;0;0;228882094;228990515;1364325
847;4.27178e-15;-27;1457;9537;10131;1;677;-2.14748e+09;-2.17784e+07;0;0;0;0;0;0;229551544;229661882;1384335
847;4.23624e-15;-52;1243;9137;10075.5;1;641;-2.14748e+09;-2.17784e+07;-1;0;0;0;-1;0;229551544;229661882;1384335
848;4.27178e-15;-27;1457;9537;10131;1;677;-2.14748e+09;-2.16521e+07;-1;0;0;0;-1;0;230218475;230330755;1404512
848;4.23624e-15;-53;1243;9137;10075.5;1;641;-2.14748e+09;-2.16521e+07;0;0;0;0;0;0;230218475;230330755;1404512
849;4.27178e-15;-28;1457;9537;10131;1;677;-2.14748e+09;-2.15269e+07;0;0;0;0;0;0;230882902;230997147;1424856
849;4.23624e-15;-53;1243;9137;10075.5;1;641;-2.14748e+09;-2.15269e+07;-1;0;0;0;-1;0;230882902;230997147;1424856
850;4.27178e-15;-28;1457;9537;10131;1;677;-2.14748e+09;-2.1403e+07;-1;0;0;0;-1;0;231544836;231661069;1445366
850;4.23624e-15;-54;1243;9137;10075.5;1;641;-2.14748e+09;-2.1403e+07;0;0;0;0;0;0;231544836;231661069;1445366
851;4.27178e-15;-28;1457;9537;10131;1;677;-2.14748e+09;-2.12802e+07;-1;0;0;0;-1;0;232204289;232322535;1466043
851;4.23624e-15;-54;1243;9137;10075.5;1;641;-2.14748e+09;-2.12802e+07;-1;0;0;0;-1;0;232204289;232322535;1466043
852;4.27178e-15;-29;1457;9537;10131;1;677;-2.14748e+09;-2.11587e+07;0;0;0;0;0;0;232861274;232981557;1486886
852;4.23624e-15;-55;1243;9137;10075.5;1;641;-2.14748e+09;-2.11587e+07;0;0;0;0;0;0;232861274;232981557;1486886
853;4.27178e-15;-29;1457;9537;10131;1;677;-2.14748e+09;-2.10383e+07;-1;0;0;0;-1;0;233515803;233638146;1507896
853;4.23624e-15;-56;1243;9137;10075.5;1;641;-2.14748e+09;-2.10383e+07;0;0;0;0;0;0;233515803;233638146;1507896
854;4.27178e-15;-30;1457;9537;10131;1;677;-2.14748e+09;-2.0919e+07;0;0;0;0;0;0;234167888;234292317;1529072
854;4.23624e-15;-56;1243;9137;10075.5;1;641;-2.14748e+09;-2.0919e+07;-1;0;0;0;-1;0;234167888;234292317;1529072
855;4.27178e-15;-30;1457;9537;10131;1;677;-2.14748e+09;-2.08009e+07;-1;0;0;0;-1;0;234817541;234944079;1550414
855;4.23624e-15;-57;1243;9137;10075.5;1;641;-2.14748e+09;-2.08009e+07;0;0;0;0;0;0;234817541;234944079;1550414
856;4.27178e-15;-30;1457;9537;10131;1;677;-2.14748e+09;-2.06839e+07;-1;0;0;0;-1;0;235464775;235593447;1571921
856;4.23624e-15;-58;1243;9137;10075.5;1;641;-2.14748e+09;-2.06839e+07;0;0;0;0;0;0;235464775;235593447;1571921
857;4.27178e-15;-30;1457;9537;10131;1;677;-2.14748e+09;-2.0568e+07;-1;0;0;0;-1;0;236109600;236240431;1593595
857;4.23624e-15;-58;1243;9137;10075.5;1;641;-2.14748e+09;-2.05679e+07;-1;0;0;0;-1;0;236109600;236240431;1593595
858;4.27178e-15;-30;1457;9537;10131;1;677;-2.14748e+09;-2.04532e+07;-1;0;0;0;-1;0;236752030;236885044;1615433
858;4.23624e-15;-58;1243;9137;10075.5;1;641;-2.14748e+09;-2.04531e+07;-1;0;0;0;-1;0;236752030;236885044;1615433
859;4.27178e-15;-30;1457;9537;10131;1;677;-2.14748e+09;-2.03394e+07;0;0;-1;0;0;-1;237392075;237527299;1637437
859;4.23624e-15;-58;1243;9137;10075.5;1;641;-2.14748e+09;-2.03394e+07;-1;0;0;0;-1;0;237392075;237527299;1637437
860;4.27178e-15;-30;1457;9537;10131;1;677;-2.14748e+09;-2.02268e+07;-1;0;0;0;-1;0;238029749;238167206;1659607
860;4.23624e-15;-58;1243;9137;10075.5;1;641;-2.14748e+09;-2.02267e+07;-1;0;0;0;-1;0;238029749;238167206;1659607
861;4.27178e-15;-31;1457;9537;10131;1;677;-2.14748e+09;-2.0115e+07;0;0;0;0;0;0;238665062;238804778;1681941
861;4.23624e-15;-58;1243;9137;10075.5;1;641;-2.14748e+09;-2.0115e+07;-1;0;0;0;-1;0;238665062;238804778;1681941
862;4.27178e-15;-32;1457;9537;10131;1;677;-2.14748e+09;-2.00044e+07;0;0;0;0;0;0;239298027;239440027;1704440
862;4.23624e-15;-59;1243;9137;10075.5;1;641;-2.14748e+09;-2.00044e+07;0;0;0;0;0;0;239298027;239440027;1704440
863;4.27178e-15;-33;1457;9537;10131;1;677;-2.14748e+09;-1.98948e+07;0;0;0;0;0;0;239928655;240072965;1727103
863;4.23624e-15;-60;1243;9137;10075.5;1;641;-2.14748e+09;-1.98948e+07;0;0;0;0;0;0;239928655;240072965;1727103
864;4.27178e-15;-33;1457;9537;10131;1;677;-2.14748e+09;-1.97863e+07;-1;0;0;0;-1;0;240556958;240703603;1749930
864;4.23624e-15;-60;1243;9137;10075.5;1;641;-2.14748e+09;-1.97863e+07;-1;0;0;0;-1;0;240556958;240703603;1749930
865;4.27178e-15;-34;1457;9537;10131;1;677;-2.14748e+09;-1.96787e+07;0;0;0;0;0;0;241182947;241331953;1772922
865;4.23624e-15;-60;1243;9137;10075.5;1;641;-2.14748e+09;-1.96787e+07;-1;0;0;0;-1;0;241182947;241331953;1772922
866;4.27178e-15;-35;1457;9537;10131;1;677;-2.14748e+09;-1.95719e+07;0;0;0;0;0;0;241806634;241958027;1796077
866;4.23624e-15;-61;1243;9137;10075.5;1;641;-2.14748e+09;-1.95719e+07;0;0;0;0;0;0;241806634;241958027;1796077
867;4.27178e-15;-35;1457;9537;10131;1;677;-2.14748e+09;-1.94663e+07;-1;0;0;0;-1;0;242428031;242581837;1819396
867;4.23624e-15;-62;1243;9137;10075.5;1;641;-2.14748e+09;-1.94663e+07;0;0;0;0;0;0;242428031;242581837;1819396
868;4.27178e-15;-35;1457;9537;10131;1;677;-2.14748e+09;-1.93615e+07;-1;0;0;0;-1;0;243047148;243203394;1842878
868;4.23624e-15;-62;1243;9137;10075.5;1;641;-2.14748e+09;-1.93615e+07;-1;0;0;0;-1;0;243047148;243203394;1842878
869;4.27178e-15;-35;1457;9537;10131;1;677;-2.14748e+09;-1.92578e+07;-1;0;0;0;-1;0;243663998;243822709;1866523
869;4.23624e-15;-63;1243;9137;10075.5;1;641;-2.14748e+09;-1.92578e+07;0;0;0;0;0;0;243663998;243822709;1866523
870;4.27178e-15;-35;1457;9537;10131;1;677;-2.14748e+09;-1.91549e+07;-1;0;0;0;-1;0;244278591;244439794;1890330
870;4.23624e-15;-64;1243;9137;10075.5;1;641;-2.14748e+09;-1.91549e+07;0;0;0;0;0;0;244278591;244439794;1890330
871;4.27178e-15;-36;1457;9537;10131;1;677;-2.14748e+09;-1.90531e+07;0;0;0;0;0;0;244890940;245054660;1914300
871;4.23624e-15;-64;1243;9137;10075.5;1;641;-2.14748e+09;-1.9053e+07;-1;0;0;0;-1;0;244890940;245054660;1914300
872;4.27178e-15;-36;1457;9537;10131;1;677;-2.14748e+09;-1.89519e+07;-1;0;0;0;-1;0;245501054;245667319;1938432
872;4.23624e-15;-65;1243;9137;10075.5;1;641;-2.14748e+09;-1.89519e+07;0;0;0;0;0;0;245501054;245667319;1938432
873;4.27178e-15;-36;1457;9537;10131;1;677;-2.14748e+09;-1.88518e+07;-1;0;0;0;-1;0;246108946;246277782;1962725
873;4.23624e-15;-66;1243;9137;10075.5;1;641;-2.14748e+09;-1.88518e+07;0;0;0;0;0;0;246108946;246277782;1962725
874;4.27178e-15;-36;1457;9537;10131;1;677;-2.14748e+09;-1.87526e+07;-1;0;0;0;-1;0;246714626;246886061;1987180
874;4.23624e-15;-67;1243;9137;10075.5;1;641;-2.14748e+09;-1.87526e+07;0;0;0;0;0;0;246714626;246886061;1987180
875;4.27178e-15;-36;1457;9537;10131;1;677;-2.14748e+09;-1.86542e+07;-1;0;0;0;-1;0;247318106;247492166;2011796
875;4.23624e-15;-67;1243;9137;10075.5;1;641;-2.14748e+09;-1.86542e+07;-1;0;0;0;-1;0;247318106;247492166;2011796
876;4.27178e-15;-37;1457;9537;10131;1;677;-2.14748e+09;-1.85566e+07;0;0;0;0;0;0;247919396;248096108;2036573
876;4.23624e-15;-68;1243;9137;10075.5;1;641;-2.14748e+09;-1.85566e+07;0;0;0;0;0;0;247919396;248096108;2036573
877;4.27178e-15;-37;1457;9537;10131;1;677;-2.14748e+09;-1.846e+07;-1;0;0;0;-1;0;248518508;248697899;2061510
877;4.23624e-15;-69;1243;9137;10075.5;1;641;-2.14748e+09;-1.846e+07;0;0;0;0;0;0;248518508;248697899;2061510
878;4.27178e-15;-38;1457;9537;10131;1;677;-2.14748e+09;-1.83641e+07;0;0;0;0;0;0;249115452;249297549;2086608
878;4.23624e-15;-70;1243;9137;10075.5;1;641;-2.14748e+09;-1.83641e+07;0;0;0;0;0;0;249115452;249297549;2086608
879;4.27178e-15;-39;1457;9537;10131;1;677;-2.14748e+09;-1.82692e+07;0;0;0;0;0;0;249710239;249895070;2111865
879;4.23624e-15;-70;1243;9137;10075.5;1;641;-2.14748e+09;-1.82691e+07;-1;0;0;0;-1;0;249710239;249895070;2111865
880;4.27178e-15;-40;1457;9537;10131;1;677;-2.14748e+09;-1.8175e+07;0;0;0;0;0;0;250302880;250490473;2137281
880;4.23624e-15;-70;1243;9137;10075.5;1;641;-2.14748e+09;-1.8175e+07;-1;0;0;0;-1;0;250302880;250490473;2137281
881;4.27178e-15;-41;1457;9537;10131;1;677;-2.14748e+09;-1.80817e+07;0;0;0;0;0;0;250893386;251083768;2162856
881;4.23624e-15;-71;1243;9137;10075.5;1;641;-2.14748e+09;-1.80816e+07;0;0;0;0;0;0;250893386;251083768;2162856
882;4.27178e-15;-42;1457;9537;10131;1;677;-2.14748e+09;-1.7989e+07;0;0;0;0;0;0;251481767;251674966;2188590
882;4.23624e-15;-71;1243;9137;10075.5;1;641;-2.14748e+09;-1.7989e+07;-1;0;0;0;-1;0;251481767;251674966;2188590
883;4.27178e-15;-43;1457;9537;10131;1;677;-2.14748e+09;-1.78972e+07;0;0;0;0;0;0;252068034;252264077;2214482
883;4.23624e-15;-72;1243;9137;10075.5;1;641;-2.14748e+09;-1.78972e+07;0;0;0;0;0;0;252068034;252264077;2214482
884;4.27178e-15;-43;1457;9537;10131;1;677;-2.14748e+09;-1.78062e+07;-1;0;0;0;-1;0;252652197;252851113;2240532
884;4.23624e-15;-72;1243;9137;10075.5;1;641;-2.14748e+09;-1.78062e+07;-1;0;0;0;-1;0;252652197;252851113;2240532
885;4.27178e-15;-43;1457;9537;10131;1;677;-2.14748e+09;-1.7716e+07;-1;0;0;0;-1;0;253234268;253436085;2266739
885;4.23624e-15;-72;1243;9137;10075.5;1;641;-2.14748e+09;-1.7716e+07;-1;0;0;0;-1;0;253234268;253436085;2266739
886;4.27178e-15;-44;1457;9537;10131;1;677;-2.14748e+09;-1.76266e+07;0;0;0;0;0;0;253814256;254019002;2293103
886;4.23624e-15;-73;1243;9137;10075.5;1;641;-2.14748e+09;-1.76266e+07;0;0;0;0;0;0;253814256;254019002;2293103
887;4.27178e-15;-45;1457;9537;10131;1;677;-2.14748e+09;-1.75378e+07;0;0;0;0;0;0;254392172;254599875;2319624
887;4.23624e-15;-74;1243;9137;10075.5;1;641;-2.14748e+09;-1.75378e+07;0;0;0;0;0;0;254392172;254599875;2319624
888;4.27178e-15;-45;1457;9537;10131;1;677;-2.14748e+09;-1.74498e+07;-1;0;0;0;-1;0;254968026;255178714;2346301
888;4.23624e-15;-75;1243;9137;10075.5;1;641;-2.14748e+09;-1.74498e+07;0;0;0;0;0;0;254968026;255178714;2346301
889;4.27178e-15;-45;1457;9537;10131;1;677;-2.14748e+09;-1.73625e+07;-1;0;0;0;-1;0;255541829;255755531;2373134
889;4.23624e-15;-75;1243;9137;10075.5;1;641;-2.14748e+09;-1.73625e+07;-1;0;0;0;-1;0;255541829;255755531;2373134
890;4.27178e-15;-45;1457;9537;10131;1;677;-2.14748e+09;-1.72761e+07;-1;0;0;0;-1;0;256113590;256330335;2400122
890;4.23624e-15;-76;1243;9137;10075.5;1;641;-2.14748e+09;-1.72761e+07;0;0;0;0;0;0;256113590;256330335;2400122
891;4.27178e-15;-46;1457;9537;10131;1;677;-2.14748e+09;-1.71902e+07;0;0;0;0;0;0;256683320;256903136;2427265
891;4.23624e-15;-77;1243;9137;10075.5;1;641;-2.14748e+09;-1.71902e+07;0;0;0;0;0;0;256683320;256903136;2427265
892;4.27178e-15;-47;1457;9537;10131;1;677;-2.14748e+09;-1.71052e+07;0;0;0;0;0;0;257251030;257473946;2454562
892;4.23624e-15;-78;1243;9137;10075.5;1;641;-2.14748e+09;-1.71052e+07;0;0;0;0;0;0;257251030;257473946;2454562
893;4.27178e-15;-48;1457;9537;10131;1;677;-2.14748e+09;-1.70207e+07;0;0;0;0;0;0;257816728;258042773;2482013
893;4.23624e-15;-78;1243;9137;10075.5;1;641;-2.14748e+09;-1.70207e+07;-1;0;0;0;-1;0;257816728;258042773;2482013
894;4.27178e-15;-49;1457;9537;10131;1;677;-2.14748e+09;-1.6937e+07;0;0;0;0;0;0;258380425;258609628;2509618
894;4.23624e-15;-79;1243;9137;10075.5;1;641;-2.14748e+09;-1.6937e+07;0;0;0;0;0;0;258380425;258609628;2509618
895;4.27178e-15;-49;1457;9537;10131;1;677;-2.14748e+09;-1.6854e+07;-1;0;0;0;-1;0;258942132;259174521;2537376
895;4.23624e-15;-79;1243;9137;10075.5;1;641;-2.14748e+09;-1.6854e+07;-1;0;0;0;-1;0;258942132;259174521;2537376
896;4.27178e-15;-49;1457;9537;10131;1;677;-2.14748e+09;-1.67716e+07;-1;0;0;0;-1;0;259501857;259737463;2565286
896;4.23624e-15;-79;1243;9137;10075.5;1;641;-2.14748e+09;-1.67716e+07;-1;0;0;0;-1;0;259501857;259737463;2565286
897;4.27178e-15;-49;1457;9537;10131;1;677;-2.14748e+09;-1.669e+07;-1;0;0;0;-1;0;260059611;260298462;2593349
897;4.23624e-15;-79;1243;9137;10075.5;1;641;-2.14748e+09;-1.66899e+07;-1;0;0;0;-1;0;260059611;260298462;2593349
898;4.27178e-15;-50;1457;9537;10131;1;677;-2.14748e+09;-1.66089e+07;0;0;0;0;0;0;260615404;260857530;2621563
898;4.23624e-15;-79;1243;9137;10075.5;1;641;-2.14748e+09;-1.66089e+07;-1;0;0;0;-1;0;260615404;260857530;2621563
899;4.27178e-15;-50;1457;9537;10131;1;677;-2.14748e+09;-1.65285e+07;-1;0;0;0;-1;0;261169244;261414675;2649928
899;4.23624e-15;-79;1243;9137;10075.5;1;641;-2.14748e+09;-1.65285e+07;-1;0;0;0;-1;0;261169244;261414675;2649928
900;4.27178e-15;-50;1457;9537;10131;1;677;-2.14748e+09;-1.64488e+07;-1;0;0;0;-1;0;261721143;261969907;2678444
900;4.23624e-15;-79;1243;9137;10075.5;1;641;-2.14748e+09;-1.64488e+07;-1;0;0;0;-1;0;261721143;261969907;2678444
901;4.27178e-15;-50;1457;9537;10131;1;677;-2.14748e+09;-1.63697e+07;-1;0;0;0;-1;0;262271109;262523237;2707110
901;4.23624e-15;-79;1243;9137;10075.5;1;641;-2.14748e+09;-1.63697e+07;-1;0;0;0;-1;0;262271109;262523237;2707110
902;4.27178e-15;-50;1457;9537;10131;1;677;-2.14748e+09;-1.62913e+07;-1;0;0;0;-1;0;262819153;263074673;2735926
902;4.23624e-15;-80;1243;9137;10075.5;1;641;-2.14748e+09;-1.62913e+07;0;0;0;0;0;0;262819153;263074673;2735926
903;4.27178e-15;-51;1457;9537;10131;1;677;-2.14748e+09;-1.62134e+07;0;0;0;0;0;0;263365283;263624226;2764891
903;4.23624e-15;-80;1243;9137;10075.5;1;641;-2.14748e+09;-1.62134e+07;-1;0;0;0;-1;0;263365283;263624226;2764891
904;4.27178e-15;-52;1457;9537;10131;1;677;-2.14748e+09;-1.61362e+07;0;0;0;0;0;0;263909509;264171905;2794005
904;4.23624e-15;-81;1243;9137;10075.5;1;641;-2.14748e+09;-1.61362e+07;0;0;0;0;0;0;263909509;264171905;2794005
905;4.27178e-15;-53;1457;9537;10131;1;677;-2.14748e+09;-1.60597e+07;0;0;0;0;0;0;264451840;264717720;2823266
905;4.23624e-15;-81;1243;9137;10075.5;1;641;-2.14748e+09;-1.60596e+07;-1;0;0;0;-1;0;264451840;264717720;2823266
906;4.27178e-15;-53;1457;9537;10131;1;677;-2.14748e+09;-1.59836e+07;-1;0;0;0;-1;0;264992286;265261679;2852676
906;4.23624e-15;-82;1243;9137;10075.5;1;641;-2.14748e+09;-1.59836e+07;0;0;0;0;0;0;264992286;265261679;2852676
907;4.27178e-15;-53;1457;9537;10131;1;677;-2.14748e+09;-1.59082e+07;-1;0;0;0;-1;0;265530857;265803793;2882232
907;4.23624e-15;-82;1243;9137;10075.5;1;641;-2.14748e+09;-1.59082e+07;-1;0;0;0;-1;0;265530857;265803793;2882232
908;4.27178e-15;-53;1457;9537;10131;1;677;-2.14748e+09;-1.58334e+07;-1;0;0;0;-1;0;266067560;266344070;2911936
908;4.23624e-15;-82;1243;9137;10075.5;1;641;-2.14748e+09;-1.58334e+07;-1;0;0;0;-1;0;266067560;266344070;2911936
909;4.27178e-15;-54;1457;9537;10131;1;677;-2.14748e+09;-1.57592e+07;0;0;0;0;0;0;266602406;266882520;2941785
909;4.23624e-15;-83;1243;9137;10075.5;1;641;-2.14748e+09;-1.57592e+07;0;0;0;0;0;0;266602406;266882520;2941785
910;4.27178e-15;-54;1457;9537;10131;1;677;-2.14748e+09;-1.56856e+07;-1;0;0;0;-1;0;267135404;267419152;2971779
910;4.23624e-15;-83;1243;9137;10075.5;1;641;-2.14748e+09;-1.56855e+07;-1;0;0;0;-1;0;267135404;267419152;2971779
911;4.27178e-15;-54;1457;9537;10131;1;677;-2.14748e+09;-1.56124e+07;-1;0;0;0;-1;0;267666563;267953975;3001919
911;4.23624e-15;-83;1243;9137;10075.5;1;641;-2.14748e+09;-1.56124e+07;-1;0;0;0;-1;0;267666563;267953975;3001919
912;4.27178e-15;-55;1457;9537;10131;1;677;-2.14748e+09;-1.55399e+07;0;0;0;0;0;0;268195891;268486999;3032203
912;4.23624e-15;-83;1243;9137;10075.5;1;641;-2.14748e+09;-1.55399e+07;-1;0;0;0;-1;0;268195891;268486999;3032203
913;4.27178e-15;-56;1457;9537;10131;1;677;-2.14748e+09;-1.5468e+07;0;0;0;0;0;0;268723398;269018232;3062631
913;4.23624e-15;-84;1243;9137;10075.5;1;641;-2.14748e+09;-1.54679e+07;0;0;0;0;0;0;268723398;269018232;3062631
914;4.27178e-15;-56;1457;9537;10131;1;677;-2.14748e+09;-1.53965e+07;-1;0;0;0;-1;0;269249092;269547683;3093202
914;4.23624e-15;-85;1243;9137;10075.5;1;641;-2.14748e+09;-1.53965e+07;0;0;0;0;0;0;269249092;269547683;3093202
915;4.27178e-15;-56;1457;9537;10131;1;677;-2.14748e+09;-1.53256e+07;-1;0;0;0;-1;0;269772983;270075362;3123916
915;4.23624e-15;-86;1243;9137;10075.5;1;641;-2.14748e+09;-1.53256e+07;0;0;0;0;0;0;269772983;270075362;3123916
916;4.27178e-15;-57;1457;9537;10131;1;677;-2.14748e+09;-1.52554e+07;0;0;0;0;0;0;270295079;270601277;3154773
916;4.23624e-15;-86;1243;9137;10075.5;1;641;-2.14748e+09;-1.52553e+07;-1;0;0;0;-1;0;270295079;270601277;3154773
917;4.27178e-15;-57;1457;9537;10131;1;677;-2.14748e+09;-1.51855e+07;-1;0;0;0;-1;0;270815390;271125437;3185771
917;4.23624e-15;-86;1243;9137;10075.5;1;641;-2.14748e+09;-1.51855e+07;-1;0;0;0;-1;0;270815390;271125437;3185771
918;4.27178e-15;-57;1457;9537;10131;1;677;-2.14748e+09;-1.51163e+07;-1;0;0;0;-1;0;271333923;271647851;3216910
918;4.23624e-15;-87;1243;9137;10075.5;1;641;-2.14748e+09;-1.51163e+07;0;0;0;0;0;0;271333923;271647851;3216910
919;4.27178e-15;-57;1457;9537;10131;1;677;-2.14748e+09;-1.50475e+07;-1;0;0;0;-1;0;271850687;272168527;3248189
919;4.23624e-15;-88;1243;9137;10075.5;1;641;-2.14748e+09;-1.50475e+07;0;0;0;0;0;0;271850687;272168527;3248189
920;4.27178e-15;-58;1457;9537;10131;1;677;-2.14748e+09;-1.49793e+07;0;0;0;0;0;0;272365692;272687474;3279608
920;4.23624e-15;-88;1243;9137;10075.5;1;641;-2.14748e+09;-1.49792e+07;-1;0;0;0;-1;0;272365692;272687474;3279608
921;4.27178e-15;-58;1457;9537;10131;1;677;-2.14748e+09;-1.49116e+07;-1;0;0;0;-1;0;272878945;273204702;3311167
921;4.23624e-15;-88;1243;9137;10075.5;1;641;-2.14748e+09;-1.49115e+07;-1;0;0;0;-1;0;272878945;273204702;3311167
922;4.27178e-15;-58;1457;9537;10131;1;677;-2.14748e+09;-1.48443e+07;-1;0;0;0;-1;0;273390455;273720218;3342865
922;4.23624e-15;-89;1243;9137;10075.5;1;641;-2.14748e+09;-1.48443e+07;0;0;0;0;0;0;273390455;273720218;3342865
923;4.27178e-15;-59;1457;9537;10131;1;677;-2.14748e+09;-1.47777e+07;0;0;0;0;0;0;273900230;274234031;3374701
923;4.23624e-15;-90;1243;9137;10075.5;1;641;-2.14748e+09;-1.47776e+07;0;0;0;0;0;0;273900230;274234031;3374701
924;4.27178e-15;-59;1457;9537;10131;1;677;-2.14748e+09;-1.47113e+07;-1;0;0;0;-1;0;274408280;274746149;3406674
924;4.23624e-15;-91;1243;9137;10075.5;1;641;-2.14748e+09;-1.47113e+07;0;0;0;0;0;0;274408280;274746149;3406674
925;4.27178e-15;-60;1457;9537;10131;1;677;-2.14748e+09;-1.46457e+07;0;0;0;0;0;0;274914612;275256581;3438784
925;4.23624e-15;-91;1243;9137;10075.5;1;641;-2.14748e+09;-1.46457e+07;-1;0;0;0;-1;0;274914612;275256581;3438784
926;4.27178e-15;-60;1457;9537;10131;1;677;-2.14748e+09;-1.45803e+07;-1;0;0;0;-1;0;275419234;275765336;3471031
926;4.23624e-15;-91;1243;9137;10075.5;1;641;-2.14748e+09;-1.45803e+07;-1;0;0;0;-1;0;275419234;275765336;3471031
927;4.27178e-15;-61;1457;9537;10131;1;677;-2.14748e+09;-1.45156e+07;0;0;0;0;0;0;275922155;276272421;3503414
927;4.23624e-15;-91;1243;9137;10075.5;1;641;-2.14748e+09;-1.45156e+07;-1;0;0;0;-1;0;275922155;276272421;3503414
928;4.27178e-15;-62;1457;9537;10131;1;677;-2.14748e+09;-1.44513e+07;0;0;0;0;0;0;276423384;276777845;3535932
928;4.23624e-15;-91;1243;9137;10075.5;1;641;-2.14748e+09;-1.44513e+07;-1;0;0;0;-1;0;276423384;276777845;3535932
929;4.27178e-15;-62;1457;9537;10131;1;677;-2.14748e+09;-1.43874e+07;-1;0;0;0;-1;0;276922927;277281615;3568584
929;4.23624e-15;-91;1243;9137;10075.5;1;641;-2.14748e+09;-1.43874e+07;-1;0;0;0;-1;0;276922927;277281615;3568584
930;4.27178e-15;-62;1457;9537;10131;1;677;-2.14748e+09;-1.43242e+07;-1;0;0;0;-1;0;277420794;277783741;3601371
930;4.23624e-15;-91;1243;9137;10075.5;1;641;-2.14748e+09;-1.43242e+07;-1;0;0;0;-1;0;277420794;277783741;3601371
931;4.27178e-15;-62;1457;9537;10131;1;677;-2.14748e+09;-1.42612e+07;-1;0;0;0;-1;0;277916992;278284231;3634291
931;4.23624e-15;-91;1243;9137;10075.5;1;641;-2.14748e+09;-1.42612e+07;-1;0;0;0;-1;0;277916992;278284231;3634291
932;4.27178e-15;-63;1457;9537;10131;1;677;-2.14748e+09;-1.41987e+07;0;0;0;0;0;0;278411530;278783091;3667344
932;4.23624e-15;-92;1243;9137;10075.5;1;641;-2.14748e+09;-1.41987e+07;0;0;0;0;0;0;278411530;278783091;3667344
933;4.27178e-15;-63;1457;9537;10131;1;677;-2.14748e+09;-1.41367e+07;-1;0;0;0;-1;0;278904415;279280332;3700529
933;4.23624e-15;-92;1243;9137;10075.5;1;641;-2.14748e+09;-1.41367e+07;-1;0;0;0;-1;0;278904415;279280332;3700529
934;4.27178e-15;-63;1457;9537;10131;1;677;-2.14748e+09;-1.40752e+07;-1;0;0;0;-1;0;279395655;279775959;3733845
934;4.23624e-15;-93;1243;9137;10075.5;1;641;-2.14748e+09;-1.40752e+07;0;0;0;0;0;0;279395655;279775959;3733845
935;4.27178e-15;-64;1457;9537;10131;1;677;-2.14748e+09;-1.4014e+07;0;0;0;0;0;0;279885258;280269982;3767293
935;4.23624e-15;-93;1243;9137;10075.5;1;641;-2.14748e+09;-1.4014e+07;-1;0;0;0;-1;0;279885258;280269982;3767293
936;4.27178e-15;-64;1457;9537;10131;1;677;-2.14748e+09;-1.39535e+07;-1;0;0;0;-1;0;280373232;280762408;3800871
936;4.23624e-15;-93;1243;9137;10075.5;1;641;-2.14748e+09;-1.39534e+07;-1;0;0;0;-1;0;280373232;280762408;3800871
937;4.27178e-15;-65;1457;9537;10131;1;677;-2.14748e+09;-1.38932e+07;0;0;0;0;0;0;280859584;281253245;3834578
937;4.23624e-15;-94;1243;9137;10075.5;1;641;-2.14748e+09;-1.38932e+07;0;0;0;0;0;0;280859584;281253245;3834578
938;4.27178e-15;-65;1457;9537;10131;1;677;-2.14748e+09;-1.38333e+07;-1;0;0;0;-1;0;281344324;281742501;3868415
938;4.23624e-15;-95;1243;9137;10075.5;1;641;-2.14748e+09;-1.38333e+07;0;0;0;0;0;0;281344324;281742501;3868415
939;4.27178e-15;-66;1457;9537;10131;1;677;-2.14748e+09;-1.37739e+07;0;0;0;0;0;0;281827457;282230183;3902380
939;4.23624e-15;-96;1243;9137;10075.5;1;641;-2.14748e+09;-1.37739e+07;0;0;0;0;0;0;281827457;282230183;3902380
940;4.27178e-15;-66;1457;9537;10131;1;677;-2.14748e+09;-1.3715e+07;-1;0;0;0;-1;0;282308992;282716300;3936473
940;4.23624e-15;-96;1243;9137;10075.5;1;641;-2.14748e+09;-1.3715e+07;-1;0;0;0;-1;0;282308992;282716300;3936473
941;4.27178e-15;-66;1457;9537;10131;1;677;-2.14748e+09;-1.36564e+07;-1;0;0;0;-1;0;282788936;283200858;3970693
941;4.23624e-15;-97;1243;9137;10075.5;1;641;-2.14748e+09;-1.36564e+07;0;0;0;0;0;0;282788936;283200858;3970693
942;4.27178e-15;-66;1457;9537;10131;1;677;-2.14748e+09;-1.35982e+07;-1;0;0;0;-1;0;283267297;283683866;4005040
942;4.23624e-15;-98;1243;9137;10075.5;1;641;-2.14748e+09;-1.35982e+07;0;0;0;0;0;0;283267297;283683866;4005040
943;4.27178e-15;-66;1457;9537;10131;1;677;-2.14748e+09;-1.35405e+07;-1;0;0;0;-1;0;283744082;284165331;4039513
943;4.23624e-15;-99;1243;9137;10075.5;1;641;-2.14748e+09;-1.35405e+07;0;0;0;0;0;0;283744082;284165331;4039513
944;4.27178e-15;-66;1457;9537;10131;1;677;-2.14748e+09;-1.34831e+07;-1;0;0;0;-1;0;284219299;284645260;4074111
944;4.23624e-15;-100;1243;9137;10075.5;1;641;-2.14748e+09;-1.34831e+07;0;0;0;0;0;0;284219299;284645260;4074111
945;4.27178e-15;-66;1457;9537;10131;1;677;-2.14748e+09;-1.34262e+07;-1;0;0;0;-1;0;284692955;285123661;4108834
945;4.23624e-15;-101;1243;9137;10075.5;1;641;-2.14748e+09;-1.34262e+07;0;0;0;0;0;0;284692955;285123661;4108834
946;4.27178e-15;-66;1457;9537;10131;1;677;-2.14748e+09;-1.33696e+07;-1;0;0;0;-1;0;285165058;285600541;4143681
946;4.23624e-15;-102;1243;9137;10075.5;1;641;-2.14748e+09;-1.33696e+07;0;0;0;0;0;0;285165058;285600541;4143681
947;4.27178e-15;-66;1457;9537;10131;1;677;-2.14748e+09;-1.33134e+07;-1;0;0;0;-1;0;285635615;286075908;4178652
947;4.23624e-15;-103;1243;9137;10075.5;1;641;-2.14748e+09;-1.33134e+07;0;0;0;0;0;0;285635615;286075908;4178652
948;4.27178e-15;-67;1457;9537;10131;1;677;-2.14748e+09;-1.32577e+07;0;0;0;0;0;0;286104632;286549770;4213745
948;4.23624e-15;-104;1243;9137;10075.5;1;641;-2.14748e+09;-1.32577e+07;0;0;0;0;0;0;286104632;286549770;4213745
949;4.27178e-15;-67;1457;9537;10131;1;677;-2.14748e+09;-1.32023e+07;-1;0;0;0;-1;0;286572118;287022132;4248960
949;4.23624e-15;-104;1243;9137;10075.5;1;641;-2.14748e+09;-1.32023e+07;-1;0;0;0;-1;0;286572118;287022132;4248960
950;4.27178e-15;-67;1457;9537;10131;1;677;-2.14748e+09;-1.31473e+07;-1;0;0;0;-1;0;287038080;287493003;4284297
950;4.23624e-15;-105;1243;9137;10075.5;1;641;-2.14748e+09;-1.31473e+07;0;0;0;0;0;0;287038080;287493003;4284297
951;4.27178e-15;-67;1457;9537;10131;1;677;-2.14748e+09;-1.30927e+07;-1;0;0;0;-1;0;287502524;287962389;4319755
951;4.23624e-15;-106;1243;9137;10075.5;1;641;-2.14748e+09;-1.30926e+07;0;0;0;0;0;0;287502524;287962389;4319755
952;4.27178e-15;-68;1457;9537;10131;1;677;-2.14748e+09;-1.30385e+07;0;0;0;0;0;0;287965458;288430298;4355333
952;4.23624e-15;-106;1243;9137;10075.5;1;641;-2.14748e+09;-1.30384e+07;-1;0;0;0;-1;0;287965458;288430298;4355333
953;4.27178e-15;-69;1457;9537;10131;1;677;-2.14748e+09;-1.29846e+07;0;0;0;0;0;0;288426888;288896737;4391030
953;4.23624e-15;-107;1243;9137;10075.5;1;641;-2.14748e+09;-1.29846e+07;0;0;0;0;0;0;288426888;288896737;4391030
954;4.27178e-15;-69;1457;9537;10131;1;677;-2.14748e+09;-1.2931e+07;-1;0;0;0;-1;0;288886823;289361713;4426846
954;4.23624e-15;-108;1243;9137;10075.5;1;641;-2.14748e+09;-1.2931e+07;0;0;0;0;0;0;288886823;289361713;4426846
955;4.27178e-15;-70;1457;9537;10131;1;677;-2.14748e+09;-1.28777e+07;0;0;0;0;0;0;289345268;289825233;4462781
955;4.23624e-15;-108;1243;9137;10075.5;1;641;-2.14748e+09;-1.28777e+07;-1;0;0;0;-1;0;289345268;289825233;4462781
956;4.27178e-15;-70;1457;9537;10131;1;677;-2.14748e+09;-1.2825e+07;-1;0;0;0;-1;0;289802231;290287304;4498833
956;4.23624e-15;-109;1243;9137;10075.5;1;641;-2.14748e+09;-1.28249e+07;0;0;0;0;0;0;289802231;290287304;4498833
957;4.27178e-15;-71;1457;9537;10131;1;677;-2.14748e+09;-1.27726e+07;0;0;0;0;0;0;290257718;290747933;4535003
957;4.23624e-15;-109;1243;9137;10075.5;1;641;-2.14748e+09;-1.27725e+07;-1;0;0;0;-1;0;290257718;290747933;4535003
958;4.27178e-15;-72;1457;9537;10131;1;677;-2.14748e+09;-1.27204e+07;0;0;0;0;0;0;290711737;291207126;4571288
958;4.23624e-15;-109;1243;9137;10075.5;1;641;-2.14748e+09;-1.27203e+07;-1;0;0;0;-1;0;290711737;291207126;4571288
959;4.27178e-15;-72;1457;9537;10131;1;677;-2.14748e+09;-1.26686e+07;-1;0;0;0;-1;0;291164294;291664891;4607689
959;4.23624e-15;-109;1243;9137;10075.5;1;641;-2.14748e+09;-1.26686e+07;-1;0;0;0;-1;0;291164294;291664891;4607689
960;4.27178e-15;-72;1457;9537;10131;1;677;-2.14748e+09;-1.26172e+07;-1;0;0;0;-1;0;291615395;292121234;4644206
960;4.23624e-15;-109;1243;9137;10075.5;1;641;-2.14748e+09;-1.26172e+07;-1;0;0;0;-1;0;291615395;292121234;4644206
961;4.27178e-15;-73;1457;9537;10131;1;677;-2.14748e+09;-1.25661e+07;0;0;0;0;0;0;292065049;292576162;4680836
961;4.23624e-15;-109;1243;9137;10075.5;1;641;-2.14748e+09;-1.25661e+07;-1;0;0;0;-1;0;292065049;292576162;4680836
962;4.27178e-15;-74;1457;9537;10131;1;677;-2.14748e+09;-1.25153e+07;0;0;0;0;0;0;292513260;293029682;4717581
962;4.23624e-15;-110;1243;9137;10075.5;1;641;-2.14748e+09;-1.25153e+07;0;0;0;0;0;0;292513260;293029682;4717581
963;4.27178e-15;-75;1457;9537;10131;1;677;-2.14748e+09;-1.24649e+07;0;0;0;0;0;0;292960037;293481800;4754438
963;4.23624e-15;-111;1243;9137;10075.5;1;641;-2.14748e+09;-1.24649e+07;0;0;0;0;0;0;292960037;293481800;4754438
964;4.27178e-15;-75;1457;9537;10131;1;677;-2.14748e+09;-1.24148e+07;-1;0;0;0;-1;0;293405385;293932523;4791408
964;4.23624e-15;-112;1243;9137;10075.5;1;641;-2.14748e+09;-1.24148e+07;0;0;0;0;0;0;293405385;293932523;4791408
965;4.27178e-15;-75;1457;9537;10131;1;677;-2.14748e+09;-1.23652e+07;-1;0;0;0;-1;0;293849312;294381858;4828489
965;4.23624e-15;-112;1243;9137;10075.5;1;641;-2.14748e+09;-1.23652e+07;-1;0;0;0;-1;0;293849312;294381858;4828489
966;4.27178e-15;-75;1457;9537;10131;1;677;-2.14748e+09;-1.23157e+07;-1;0;0;0;-1;0;294291823;294829811;4865682
966;4.23624e-15;-112;1243;9137;10075.5;1;641;-2.14748e+09;-1.23157e+07;-1;0;0;0;-1;0;294291823;294829811;4865682
967;4.27178e-15;-75;1457;9537;10131;1;677;-2.14748e+09;-1.22665e+07;-1;0;0;0;-1;0;294732925;295276388;4902985
967;4.23624e-15;-112;1243;9137;10075.5;1;641;-2.14748e+09;-1.22665e+07;-1;0;0;0;-1;0;294732925;295276388;4902985
968;4.27178e-15;-75;1457;9537;10131;1;677;-2.14748e+09;-1.22179e+07;-1;0;0;0;-1;0;295172624;295721597;4940398
968;4.23624e-15;-113;1243;9137;10075.5;1;641;-2.14748e+09;-1.22179e+07;0;0;0;0;0;0;295172624;295721597;4940398
969;4.27178e-15;-75;1457;9537;10131;1;677;-2.14748e+09;-1.21694e+07;-1;0;0;0;-1;0;295610927;296165443;4977920
969;4.23624e-15;-114;1243;9137;10075.5;1;641;-2.14748e+09;-1.21694e+07;0;0;0;0;0;0;295610927;296165443;4977920
970;4.27178e-15;-76;1457;9537;10131;1;677;-2.14748e+09;-1.21211e+07;0;0;0;0;0;0;296047841;296607934;5015550
970;4.23624e-15;-114;1243;9137;10075.5;1;641;-2.14748e+09;-1.21211e+07;-1;0;0;0;-1;0;296047841;296607933;5015550
971;4.27178e-15;-77;1457;9537;10131;1;677;-2.14748e+09;-1.20733e+07;0;0;0;0;0;0;296483371;297049074;5053288
971;4.23624e-15;-115;1243;9137;10075.5;1;641;-2.14748e+09;-1.20733e+07;0;0;0;0;0;0;296483371;297049074;5053288
972;4.27178e-15;-78;1457;9537;10131;1;677;-2.14748e+09;-1.20257e+07;0;0;0;0;0;0;296917524;297488871;5091134
972;4.23624e-15;-115;1243;9137;10075.5;1;641;-2.14748e+09;-1.20257e+07;-1;0;0;0;-1;0;296917524;297488871;5091134
973;4.27178e-15;-79;1457;9537;10131;1;677;-2.14748e+09;-1.19785e+07;0;0;0;0;0;0;297350307;297927331;5129086
973;4.23624e-15;-115;1243;9137;10075.5;1;641;-2.14748e+09;-1.19785e+07;-1;0;0;0;-1;0;297350307;297927331;5129086
974;4.27178e-15;-80;1457;9537;10131;1;677;-2.14748e+09;-1.19317e+07;0;0;0;0;0;0;297781724;298364459;5167143
974;4.23624e-15;-115;1243;9137;10075.5;1;641;-2.14748e+09;-1.19316e+07;-1;0;0;0;-1;0;297781724;298364459;5167143
975;4.27178e-15;-80;1457;9537;10131;1;677;-2.14748e+09;-1.18849e+07;-1;0;0;0;-1;0;298211783;298800263;5205306
975;4.23624e-15;-115;1243;9137;10075.5;1;641;-2.14748e+09;-1.18849e+07;-1;0;0;0;-1;0;298211783;298800263;5205306
976;4.27178e-15;-80;1457;9537;10131;1;677;-2.14748e+09;-1.18386e+07;-1;0;0;0;-1;0;298640490;299234749;5243574
976;4.23624e-15;-116;1243;9137;10075.5;1;641;-2.14748e+09;-1.18386e+07;0;0;0;0;0;0;298640490;299234749;5243574
977;4.27178e-15;-80;1457;9537;10131;1;677;-2.14748e+09;-1.17926e+07;-1;0;0;0;-1;0;299067850;299667922;5281945
977;4.23624e-15;-117;1243;9137;10075.5;1;641;-2.14748e+09;-1.17926e+07;0;0;0;0;0;0;299067850;299667922;5281945
978;4.27178e-15;-81;1457;9537;10131;1;677;-2.14748e+09;-1.17469e+07;0;0;0;0;0;0;299493870;300099788;5320419
978;4.23624e-15;-118;1243;9137;10075.5;1;641;-2.14748e+09;-1.17468e+07;0;0;0;0;0;0;299493870;300099788;5320419
979;4.27178e-15;-82;1457;9537;10131;1;677;-2.14748e+09;-1.17013e+07;0;0;0;0;0;0;299918556;300530354;5358996
979;4.23624e-15;-119;1243;9137;10075.5;1;641;-2.14748e+09;-1.17013e+07;0;0;0;0;0;0;299918556;300530354;5358996
980;4.27178e-15;-83;1457;9537;10131;1;677;-2.14748e+09;-1.16562e+07;0;0;0;0;0;0;300341913;300959626;5397675
980;4.23624e-15;-119;1243;9137;10075.5;1;641;-2.14748e+09;-1.16562e+07;-1;0;0;0;-1;0;300341913;300959626;5397675
981;4.27178e-15;-84;1457;9537;10131;1;677;-2.14748e+09;-1.16112e+07;0;0;0;0;0;0;300763949;301387609;5436455
981;4.23624e-15;-120;1243;9137;10075.5;1;641;-2.14748e+09;-1.16112e+07;0;0;0;0;0;0;300763949;301387609;5436455
982;4.27178e-15;-85;1457;9537;10131;1;677;-2.14748e+09;-1.15667e+07;0;0;0;0;0;0;301184668;301814310;5475336
982;4.23624e-15;-121;1243;9137;10075.5;1;641;-2.14748e+09;-1.15666e+07;0;0;0;0;0;0;301184668;301814310;5475336
983;4.27178e-15;-85;1457;9537;10131;1;677;-2.14748e+09;-1.15224e+07;-1;0;0;0;-1;0;301604076;302239734;5514317
983;4.23624e-15;-121;1243;9137;10075.5;1;641;-2.14748e+09;-1.15224e+07;-1;0;0;0;-1;0;301604076;302239734;5514317
984;4.27178e-15;-85;1457;9537;10131;1;677;-2.14748e+09;-1.14782e+07;-1;0;0;0;-1;0;302022180;302663887;5553396
984;4.23624e-15;-122;1243;9137;10075.5;1;641;-2.14748e+09;-1.14782e+07;0;0;0;0;0;0;302022180;302663887;5553396
985;4.27178e-15;-86;1457;9537;10131;1;677;-2.14748e+09;-1.14344e+07;0;0;0;0;0;0;302438984;303086775;5592575
985;4.23624e-15;-123;1243;9137;10075.5;1;641;-2.14748e+09;-1.14344e+07;0;0;0;0;0;0;302438984;303086775;5592575
986;4.27178e-15;-86;1457;9537;10131;1;677;-2.14748e+09;-1.13909e+07;-1;0;0;0;-1;0;302854496;303508405;5631851
986;4.23624e-15;-124;1243;9137;10075.5;1;641;-2.14748e+09;-1.13909e+07;0;0;0;0;0;0;302854496;303508405;5631851
987;4.27178e-15;-87;1457;9537;10131;1;677;-2.14748e+09;-1.13476e+07;0;0;0;0;0;0;303268721;303928780;5671225
987;4.23624e-15;-125;1243;9137;10075.5;1;641;-2.14748e+09;-1.13476e+07;0;0;0;0;0;0;303268721;303928780;5671225
988;4.27178e-15;-87;1457;9537;10131;1;677;-2.14748e+09;-1.13046e+07;-1;0;0;0;-1;0;303681663;304347908;5710695
988;4.23624e-15;-125;1243;9137;10075.5;1;641;-2.14748e+09;-1.13046e+07;-1;0;0;0;-1;0;303681663;304347908;5710695
989;4.27178e-15;-88;1457;9537;10131;1;677;-2.14748e+09;-1.12619e+07;0;0;0;0;0;0;304093330;304765794;5750262
989;4.23624e-15;-125;1243;9137;10075.5;1;641;-2.14748e+09;-1.12619e+07;-1;0;0;0;-1;0;304093330;304765794;5750262
990;4.27178e-15;-88;1457;9537;10131;1;677;-2.14748e+09;-1.12195e+07;-1;0;0;0;-1;0;304503727;305182444;5789923
990;4.23624e-15;-125;1243;9137;10075.5;1;641;-2.14748e+09;-1.12194e+07;-1;0;0;0;-1;0;304503727;305182444;5789923
991;4.27178e-15;-89;1457;9537;10131;1;677;-2.14748e+09;-1.11772e+07;0;0;0;0;0;0;304912858;305597862;5829680
991;4.23624e-15;-125;1243;9137;10075.5;1;641;-2.14748e+09;-1.11772e+07;-1;0;0;0;-1;0;304912858;305597862;5829680
992;4.27178e-15;-90;1457;9537;10131;1;677;-2.14748e+09;-1.11352e+07;0;0;0;0;0;0;305320731;306012056;5869530
992;4.23624e-15;-125;1243;9137;10075.5;1;641;-2.14748e+09;-1.11352e+07;-1;0;0;0;-1;0;305320731;306012056;5869530
993;4.27178e-15;-91;1457;9537;10131;1;677;-2.14748e+09;-1.10935e+07;0;0;0;0;0;0;305727349;306425029;5909474
993;4.23624e-15;-125;1243;9137;10075.5;1;641;-2.14748e+09;-1.10935e+07;-1;0;0;0;-1;0;305727349;306425029;5909474
994;4.27178e-15;-91;1457;9537;10131;1;677;-2.14748e+09;-1.10521e+07;-1;0;0;0;-1;0;306132720;306836789;5949510
994;4.23624e-15;-126;1243;9137;10075.5;1;641;-2.14748e+09;-1.10521e+07;0;0;0;0;0;0;306132720;306836789;5949510
995;4.27178e-15;-92;1457;9537;10131;1;677;-2.14748e+09;-1.10109e+07;0;0;0;0;0;0;306536848;307247340;5989639
995;4.23624e-15;-127;1243;9137;10075.5;1;641;-2.14748e+09;-1.10109e+07;0;0;0;0;0;0;306536848;307247340;5989639
996;4.27178e-15;-93;1457;9537;10131;1;677;-2.14748e+09;-1.09699e+07;0;0;0;0;0;0;306939739;307656687;6029859
996;4.23624e-15;-127;1243;9137;10075.5;1;641;-2.14748e+09;-1.09699e+07;-1;0;0;0;-1;0;306939739;307656687;6029859
997;4.27178e-15;-93;1457;9537;10131;1;677;-2.14748e+09;-1.09292e+07;-1;0;0;0;-1;0;307341398;308064837;6070169
997;4.23624e-15;-128;1243;9137;10075.5;1;641;-2.14748e+09;-1.09292e+07;0;0;0;0;0;0;307341398;308064837;6070169
998;4.27178e-15;-94;1457;9537;10131;1;677;-2.14748e+09;-1.08888e+07;0;0;0;0;0;0;307741830;308471794;6110570
998;4.23624e-15;-128;1243;9137;10075.5;1;641;-2.14748e+09;-1.08888e+07;-1;0;0;0;-1;0;307741830;308471794;6110570
999;4.27178e-15;-94;1457;9537;10131;1;677;-2.14748e+09;-1.08486e+07;-1;0;0;0;-1;0;308141042;308877564;6151060
999;4.23624e-15;-128;1243;9137;10075.5;1;641;-2.14748e+09;-1.08486e+07;-1;0;0;0;-1;0;308141042;308877564;6151060
1000;4.27178e-15;-94;1457;9537;10131;1;677;-2.14748e+09;-1.08086e+07;-1;0;0;0;-1;0;308539037;309282152;6191639
1000;4.23624e-15;-128;1243;9137;10075.5;1;641;-2.14748e+09;-1.08086e+07;-1;0;0;0;-1;0;308539037;309282152;6191639
1001;4.27178e-15;-94;1457;9537;10131;1;677;-2.14748e+09;-1.07688e+07;-1;0;0;0;-1;0;308935822;309685563;6232307
1001;4.23624e-15;-128;1243;9137;10075.5;1;641;-2.14748e+09;-1.07688e+07;-1;0;0;0;-1;0;308935822;309685563;6232307
1002;4.27178e-15;-95;1457;9537;10131;1;677;-2.14748e+09;-1.07293e+07;0;0;0;0;0;0;309331402;310087803;6273061
1002;4.23624e-15;-128;1243;9137;10075.5;1;641;-2.14748e+09;-1.07293e+07;-1;0;0;0;-1;0;309331402;310087803;6273061
1003;4.27178e-15;-95;1457;9537;10131;1;677;-2.14748e+09;-1.069e+07;-1;0;0;0;-1;0;309725781;310488877;6313903
1003;4.23624e-15;-128;1243;9137;10075.5;1;641;-2.14748e+09;-1.069e+07;-1;0;0;0;-1;0;309725781;310488877;6313903
1004;4.27178e-15;-95;1457;9537;10131;1;677;-2.14748e+09;-1.0651e+07;-1;0;0;0;-1;0;310118966;310888790;6354831
1004;4.23624e-15;-129;1243;9137;10075.5;1;641;-2.14748e+09;-1.0651e+07;0;0;0;0;0;0;310118966;310888790;6354831
1005;4.27178e-15;-95;1457;9537;10131;1;677;-2.14748e+09;-1.06123e+07;-1;0;0;0;-1;0;310510961;311287548;6395845
1005;4.23624e-15;-129;1243;9137;10075.5;1;641;-2.14748e+09;-1.06122e+07;-1;0;0;0;-1;0;310510961;311287548;6395845
1006;4.27178e-15;-95;1457;9537;10131;1;677;-2.14748e+09;-1.05737e+07;-1;0;0;0;-1;0;310901771;311685154;6436943
1006;4.23624e-15;-129;1243;9137;10075.5;1;641;-2.14748e+09;-1.05736e+07;-1;0;0;0;-1;0;310901771;311685154;6436943
1007;4.27178e-15;-95;1457;9537;10131;1;677;-2.14748e+09;-1.05352e+07;-1;0;0;0;-1;0;311291402;312081615;6478126
1007;4.23624e-15;-130;1243;9137;10075.5;1;641;-2.14748e+09;-1.05352e+07;0;0;0;0;0;0;311291402;312081615;6478126
1008;4.27178e-15;-96;1457;9537;10131;1;677;-2.14748e+09;-1.04971e+07;0;0;0;0;0;0;311679858;312476935;6519392
1008;4.23624e-15;-130;1243;9137;10075.5;1;641;-2.14748e+09;-1.04971e+07;-1;0;0;0;-1;0;311679858;312476935;6519392
1009;4.27178e-15;-97;1457;9537;10131;1;677;-2.14748e+09;-1.04593e+07;0;0;0;0;0;0;312067145;312871120;6560742
1009;4.23624e-15;-130;1243;9137;10075.5;1;641;-2.14748e+09;-1.04593e+07;-1;0;0;0;-1;0;312067145;312871120;6560742
1010;4.27178e-15;-97;1457;9537;10131;1;677;-2.14748e+09;-1.04215e+07;-1;0;0;0;-1;0;312453268;313264174;6602174
1010;4.23624e-15;-130;1243;9137;10075.5;1;641;-2.14748e+09;-1.04215e+07;-1;0;0;0;-1;0;312453268;313264174;6602174
1011;4.27178e-15;-97;1457;9537;10131;1;677;-2.14748e+09;-1.0384e+07;-1;0;0;0;-1;0;312838231;313656102;6643688
1011;4.23624e-15;-130;1243;9137;10075.5;1;641;-2.14748e+09;-1.0384e+07;-1;0;0;0;-1;0;312838231;313656102;6643688
1012;4.27178e-15;-98;1457;9537;10131;1;677;-2.14748e+09;-1.03467e+07;0;0;0;0;0;0;313222039;314046910;6685282
1012;4.23624e-15;-130;1243;9137;10075.5;1;641;-2.14748e+09;-1.03467e+07;-1;0;0;0;-1;0;313222039;314046910;6685282
1013;4.27178e-15;-98;1457;9537;10131;1;677;-2.14748e+09;-1.03096e+07;-1;0;0;0;-1;0;313604698;314436602;6726958
1013;4.23624e-15;-131;1243;9137;10075.5;1;641;-2.14748e+09;-1.03096e+07;0;0;0;0;0;0;313604698;314436602;6726958
1014;4.27178e-15;-98;1457;9537;10131;1;677;-2.14748e+09;-1.02728e+07;-1;0;0;0;-1;0;313986212;314825184;6768713
1014;4.23624e-15;-132;1243;9137;10075.5;1;641;-2.14748e+09;-1.02728e+07;0;0;0;0;0;0;313986212;314825184;6768713
1015;4.27178e-15;-99;1457;9537;10131;1;677;-2.14748e+09;-1.02363e+07;0;0;0;0;0;0;314366587;315212659;6810547
1015;4.23624e-15;-133;1243;9137;10075.5;1;641;-2.14748e+09;-1.02362e+07;0;0;0;0;0;0;314366586;315212659;6810547
1016;4.27178e-15;-99;1457;9537;10131;1;677;-2.14748e+09;-1.01998e+07;-1;0;0;0;-1;0;314745826;315599033;6852460
1016;4.23624e-15;-133;1243;9137;10075.5;1;641;-2.14748e+09;-1.01998e+07;-1;0;0;0;-1;0;314745826;315599033;6852460
1017;4.27178e-15;-100;1457;9537;10131;1;677;-2.14748e+09;-1.01635e+07;0;0;0;0;0;0;315123935;315984310;6894451
1017;4.23624e-15;-133;1243;9137;10075.5;1;641;-2.14748e+09;-1.01635e+07;-1;0;0;0;-1;0;315123935;315984310;6894451
1018;4.27178e-15;-100;1457;9537;10131;1;677;-2.14748e+09;-1.01275e+07;-1;0;0;0;-1;0;315500919;316368496;6936520
1018;4.23624e-15;-134;1243;9137;10075.5;1;641;-2.14748e+09;-1.01275e+07;0;0;0;0;0;0;315500919;316368496;6936520
1019;4.27178e-15;-101;1457;9537;10131;1;677;-2.14748e+09;-1.00917e+07;0;0;0;0;0;0;315876782;316751595;6978665
1019;4.23624e-15;-135;1243;9137;10075.5;1;641;-2.14748e+09;-1.00917e+07;0;0;0;0;0;0;315876782;316751595;6978665
1020;4.27178e-15;-102;1457;9537;10131;1;677;-2.14748e+09;-1.00561e+07;0;0;0;0;0;0;316251529;317133611;7020886
1020;4.23624e-15;-136;1243;9137;10075.5;1;641;-2.14748e+09;-1.00561e+07;0;0;0;0;0;0;316251529;317133611;7020886
1021;4.27178e-15;-103;1457;9537;10131;1;677;-2.14748e+09;-1.00208e+07;0;0;0;0;0;0;316625164;317514550;7063183
1021;4.23624e-15;-136;1243;9137;10075.5;1;641;-2.14748e+09;-1.00207e+07;-1;0;0;0;-1;0;316625164;317514550;7063183
1022;4.27178e-15;-104;1457;9537;10131;1;677;-2.14748e+09;-9.98552e+06;0;0;0;0;0;0;316997693;317894416;7105554
1022;4.23624e-15;-136;1243;9137;10075.5;1;641;-2.14748e+09;-9.98552e+06;-1;0;0;0;-1;0;316997693;317894416;7105554
1023;4.27178e-15;-105;1457;9537;10131;1;677;-2.14748e+09;-9.95051e+06;0;0;0;0;0;0;317369120;318273214;7148000
1023;4.23624e-15;-136;1243;9137;10075.5;1;641;-2.14748e+09;-9.95051e+06;-1;0;0;0;-1;0;317369120;318273214;7148000
1024;4.27178e-15;-105;1457;9537;10131;1;677;-2.14748e+09;-9.9157e+06;-1;0;0;0;-1;0;317739450;318650948;7190519
1024;4.23624e-15;-136;1243;9137;10075.5;1;641;-2.14748e+09;-9.9157e+06;-1;0;0;0;-1;0;317739450;318650948;7190519
1025;4.27178e-15;-106;1457;9537;10131;1;677;-2.14748e+09;-9.88118e+06;0;0;0;0;0;0;318108687;319027623;7233112
1025;4.23624e-15;-136;1243;9137;10075.5;1;641;-2.14748e+09;-9.88108e+06;-1;0;0;0;-1;0;318108687;319027623;7233112
1026;4.27178e-15;-107;1457;9537;10131;1;677;-2.14748e+09;-9.84666e+06;0;0;0;0;0;0;318476836;319403243;7275777
1026;4.23624e-15;-137;1243;9137;10075.5;1;641;-2.14748e+09;-9.84666e+06;0;0;0;0;0;0;318476836;319403243;7275777
1027;4.27178e-15;-108;1457;9537;10131;1;677;-2.14748e+09;-9.81252e+06;0;0;0;0;0;0;318843901;319777813;7318513
1027;4.23624e-15;-138;1243;9137;10075.5;1;641;-2.14748e+09;-9.81252e+06;0;0;0;0;0;0;318843901;319777813;7318513
1028;4.27178e-15;-108;1457;9537;10131;1;677;-2.14748e+09;-9.77838e+06;-1;0;0;0;-1;0;319209887;320151337;7361321
1028;4.23624e-15;-139;1243;9137;10075.5;1;641;-2.14748e+09;-9.77838e+06;0;0;0;0;0;0;319209887;320151337;7361321
1029;4.27178e-15;-109;1457;9537;10131;1;677;-2.14748e+09;-9.74452e+06;0;0;0;0;0;0;319574798;320523820;7404199
1029;4.23624e-15;-139;1243;9137;10075.5;1;641;-2.14748e+09;-9.74452e+06;-1;0;0;0;-1;0;319574798;320523820;7404199
1030;4.27178e-15;-110;1457;9537;10131;1;677;-2.14748e+09;-9.71095e+06;0;0;0;0;0;0;319938639;320895267;7447147
1030;4.23624e-15;-139;1243;9137;10075.5;1;641;-2.14748e+09;-9.71095e+06;-1;0;0;0;-1;0;319938639;320895267;7447147
1031;4.27178e-15;-111;1457;9537;10131;1;677;-2.14748e+09;-9.67736e+06;0;0;0;0;0;0;320301414;321265681;7490164
1031;4.23624e-15;-139;1243;9137;10075.5;1;641;-2.14748e+09;-9.67736e+06;-1;0;0;0;-1;0;320301414;321265681;7490164
1032;4.27178e-15;-111;1457;9537;10131;1;677;-2.14748e+09;-9.64416e+06;-1;0;0;0;-1;0;320663127;321635067;7533251
1032;4.23624e-15;-140;1243;9137;10075.5;1;641;-2.14748e+09;-9.64416e+06;0;0;0;0;0;0;320663127;321635067;7533251
1033;4.27178e-15;-111;1457;9537;10131;1;677;-2.14748e+09;-9.61104e+06;-1;0;0;0;-1;0;321023784;322003429;7576405
1033;4.23624e-15;-140;1243;9137;10075.5;1;641;-2.14748e+09;-9.61104e+06;-1;0;0;0;-1;0;321023784;322003429;7576405
1034;4.27178e-15;-111;1457;9537;10131;1;677;-2.14748e+09;-9.578e+06;-1;0;0;0;-1;0;321383388;322370772;7619627
1034;4.23624e-15;-141;1243;9137;10075.5;1;641;-2.14748e+09;-9.578e+06;0;0;0;0;0;0;321383388;322370772;7619627
1035;4.27178e-15;-112;1457;9537;10131;1;677;-2.14748e+09;-9.54524e+06;0;0;0;0;0;0;321741944;322737100;7662915
1035;4.23624e-15;-141;1243;9137;10075.5;1;641;-2.14748e+09;-9.54524e+06;-1;0;0;0;-1;0;321741944;322737100;7662915
1036;4.27178e-15;-113;1457;9537;10131;1;677;-2.14748e+09;-9.51266e+06;0;0;0;0;0;0;322099455;323102417;7706270
1036;4.23624e-15;-141;1243;9137;10075.5;1;641;-2.14748e+09;-9.51266e+06;-1;0;0;0;-1;0;322099455;323102417;7706270
1037;4.27178e-15;-114;1457;9537;10131;1;677;-2.14748e+09;-9.48035e+06;0;0;0;0;0;0;322455927;323466728;7749691
1037;4.23624e-15;-142;1243;9137;10075.5;1;641;-2.14748e+09;-9.48025e+06;0;0;0;0;0;0;322455927;323466728;7749691
1038;4.27178e-15;-114;1457;9537;10131;1;677;-2.14748e+09;-9.44802e+06;-1;0;0;0;-1;0;322811363;323830036;7793176
1038;4.23624e-15;-143;1243;9137;10075.5;1;641;-2.14748e+09;-9.44802e+06;0;0;0;0;0;0;322811363;323830036;7793176
1039;4.27178e-15;-115;1457;9537;10131;1;677;-2.14748e+09;-9.41606e+06;0;0;0;0;0;0;323165768;324192347;7836727
1039;4.23624e-15;-144;1243;9137;10075.5;1;641;-2.14748e+09;-9.41596e+06;0;0;0;0;0;0;323165768;324192347;7836727
1040;4.27178e-15;-116;1457;9537;10131;1;677;-2.14748e+09;-9.38407e+06;0;0;0;0;0;0;323519146;324553663;7880341
1040;4.23624e-15;-145;1243;9137;10075.5;1;641;-2.14748e+09;-9.38407e+06;0;0;0;0;0;0;323519146;324553663;7880341
1041;4.27178e-15;-116;1457;9537;10131;1;677;-2.14748e+09;-9.35236e+06;-1;0;0;0;-1;0;323871501;324913990;7924018
1041;4.23624e-15;-145;1243;9137;10075.5;1;641;-2.14748e+09;-9.35236e+06;-1;0;0;0;-1;0;323871501;324913990;7924018
1042;4.27178e-15;-116;1457;9537;10131;1;677;-2.14748e+09;-9.32091e+06;-1;0;0;0;-1;0;324222837;325273331;7967758
1042;4.23624e-15;-145;1243;9137;10075.5;1;641;-2.14748e+09;-9.32091e+06;-1;0;0;0;-1;0;324222837;325273331;7967758
1043;4.27178e-15;-116;1457;9537;10131;1;677;-2.14748e+09;-9.28953e+06;-1;0;0;0;-1;0;324573159;325631690;8011560
1043;4.23624e-15;-145;1243;9137;10075.5;1;641;-2.14748e+09;-9.28953e+06;-1;0;0;0;-1;0;324573159;325631690;8011560
1044;4.27178e-15;-116;1457;9537;10131;1;677;-2.14748e+09;-9.25832e+06;-1;0;0;0;-1;0;324922470;325989072;8055424
1044;4.23624e-15;-145;1243;9137;10075.5;1;641;-2.14748e+09;-9.25832e+06;-1;0;0;0;-1;0;324922470;325989072;8055424
1045;4.27178e-15;-116;1457;9537;10131;1;677;-2.14748e+09;-9.22728e+06;-1;0;0;0;-1;0;325270774;326345481;8099349
1045;4.23624e-15;-145;1243;9137;10075.5;1;641;-2.14748e+09;-9.22718e+06;-1;0;0;0;-1;0;325270774;326345481;8099349
1046;4.27178e-15;-117;1457;9537;10131;1;677;-2.14748e+09;-9.1963e+06;0;0;0;0;0;0;325618077;326700920;8143334
1046;4.23624e-15;-146;1243;9137;10075.5;1;641;-2.14748e+09;-9.1963e+06;0;0;0;0;0;0;325618077;326700920;8143334
1047;4.27178e-15;-117;1457;9537;10131;1;677;-2.14748e+09;-9.16558e+06;-1;0;0;0;-1;0;325964381;327055394;8187379
1047;4.23624e-15;-146;1243;9137;10075.5;1;641;-2.14748e+09;-9.16558e+06;-1;0;0;0;-1;0;325964381;327055394;8187379
1048;4.27178e-15;-118;1457;9537;10131;1;677;-2.14748e+09;-9.13502e+06;0;0;0;0;0;0;326309691;327408906;8231483
1048;4.23624e-15;-146;1243;9137;10075.5;1;641;-2.14748e+09;-9.13502e+06;-1;0;0;0;-1;0;326309691;327408906;8231483
1049;4.27178e-15;-119;1457;9537;10131;1;677;-2.14748e+09;-9.10463e+06;0;0;0;0;0;0;326654010;327761461;8275646
1049;4.23624e-15;-147;1243;9137;10075.5;1;641;-2.14748e+09;-9.10463e+06;0;0;0;0;0;0;326654010;327761461;8275646
1050;4.27178e-15;-120;1457;9537;10131;1;677;-2.14748e+09;-9.07439e+06;0;0;0;0;0;0;326997343;328113063;8319866
1050;4.23624e-15;-147;1243;9137;10075.5;1;641;-2.14748e+09;-9.07439e+06;-1;0;0;0;-1;0;326997343;328113063;8319866
1051;4.27178e-15;-120;1457;9537;10131;1;677;-2.14748e+09;-9.04441e+06;-1;0;0;0;-1;0;327339694;328463715;8364145
1051;4.23624e-15;-147;1243;9137;10075.5;1;641;-2.14748e+09;-9.04441e+06;-1;0;0;0;-1;0;327339694;328463715;8364145
1052;4.27178e-15;-120;1457;9537;10131;1;677;-2.14748e+09;-9.01439e+06;-1;0;0;0;-1;0;327681067;328813421;8408480
1052;4.23624e-15;-148;1243;9137;10075.5;1;641;-2.14748e+09;-9.01439e+06;0;0;0;0;0;0;327681067;328813421;8408480
1053;4.27178e-15;-120;1457;9537;10131;1;677;-2.14748e+09;-8.98462e+06;-1;0;0;0;-1;0;328021465;329162185;8452871
1053;4.23624e-15;-148;1243;9137;10075.5;1;641;-2.14748e+09;-8.98462e+06;-1;0;0;0;-1;0;328021465;329162185;8452871
1054;4.27178e-15;-120;1457;9537;10131;1;677;-2.14748e+09;-8.95501e+06;-1;0;0;0;-1;0;328360892;329510012;8497318
1054;4.23624e-15;-149;1243;9137;10075.5;1;641;-2.14748e+09;-8.95501e+06;0;0;0;0;0;0;328360892;329510012;8497318
1055;4.27178e-15;-121;1457;9537;10131;1;677;-2.14748e+09;-8.92556e+06;0;0;0;0;0;0;328699352;329856904;8541821
1055;4.23624e-15;-149;1243;9137;10075.5;1;641;-2.14748e+09;-8.92556e+06;-1;0;0;0;-1;0;328699352;329856904;8541821
1056;4.27178e-15;-122;1457;9537;10131;1;677;-2.14748e+09;-8.89625e+06;0;0;0;0;0;0;329036850;330202866;8586378
1056;4.23624e-15;-150;1243;9137;10075.5;1;641;-2.14748e+09;-8.89625e+06;0;0;0;0;0;0;329036850;330202866;8586378
1057;4.27178e-15;-123;1457;9537;10131;1;677;-2.14748e+09;-8.8671e+06;0;0;0;0;0;0;329373389;330547901;8630989
1057;4.23624e-15;-150;1243;9137;10075.5;1;641;-2.14748e+09;-8.8671e+06;-1;0;0;0;-1;0;329373389;330547901;8630989
1058;4.27178e-15;-124;1457;9537;10131;1;677;-2.14748e+09;-8.83819e+06;0;0;0;0;0;0;329708972;330892014;8675653
1058;4.23624e-15;-150;1243;9137;10075.5;1;641;-2.14748e+09;-8.83809e+06;-1;0;0;0;-1;0;329708972;330892014;8675653
1059;4.27178e-15;-124;1457;9537;10131;1;677;-2.14748e+09;-8.80924e+06;-1;0;0;0;-1;0;330043604;331235207;8720370
1059;4.23624e-15;-150;1243;9137;10075.5;1;641;-2.14748e+09;-8.80924e+06;-1;0;0;0;-1;0;330043604;331235207;8720370
1060;4.27178e-15;-125;1457;9537;10131;1;677;-2.14748e+09;-8.78063e+06;0;0;0;0;0;0;330377288;331577485;8765140
1060;4.23624e-15;-151;1243;9137;10075.5;1;641;-2.14748e+09;-8.78053e+06;0;0;0;0;0;0;330377288;331577485;8765140
1061;4.27178e-15;-125;1457;9537;10131;1;677;-2.14748e+09;-8.75197e+06;-1;0;0;0;-1;0;330710029;331918851;8809962
1061;4.23624e-15;-151;1243;9137;10075.5;1;641;-2.14748e+09;-8.75197e+06;-1;0;0;0;-1;0;330710029;331918851;8809962
1062;4.27178e-15;-126;1457;9537;10131;1;677;-2.14748e+09;-8.72355e+06;0;0;0;0;0;0;331041828;332259309;8854835
1062;4.23624e-15;-151;1243;9137;10075.5;1;641;-2.14748e+09;-8.72355e+06;-1;0;0;0;-1;0;331041828;332259309;8854835
1063;4.27178e-15;-126;1457;9537;10131;1;677;-2.14748e+09;-8.69528e+06;-1;0;0;0;-1;0;331372692;332598863;8899758
1063;4.23624e-15;-152;1243;9137;10075.5;1;641;-2.14748e+09;-8.69528e+06;0;0;0;0;0;0;331372692;332598863;8899758
1064;4.27178e-15;-126;1457;9537;10131;1;677;-2.14748e+09;-8.66725e+06;-1;0;0;0;-1;0;331702622;332937516;8944732
1064;4.23624e-15;-152;1243;9137;10075.5;1;641;-2.14748e+09;-8.66715e+06;-1;0;0;0;-1;0;331702622;332937516;8944732
1065;4.27178e-15;-126;1457;9537;10131;1;677;-2.14748e+09;-8.63917e+06;-1;0;0;0;-1;0;332031624;333275272;8989755
1065;4.23624e-15;-153;1243;9137;10075.5;1;641;-2.14748e+09;-8.63917e+06;0;0;0;0;0;0;332031624;333275272;8989755
1066;4.27178e-15;-127;1457;9537;10131;1;677;-2.14748e+09;-8.61142e+06;0;0;0;0;0;0;332359699;333612135;9034827
1066;4.23624e-15;-153;1243;9137;10075.5;1;641;-2.14748e+09;-8.61132e+06;-1;0;0;0;-1;0;332359699;333612135;9034827
1067;4.27178e-15;-128;1457;9537;10131;1;677;-2.14748e+09;-8.58362e+06;0;0;0;0;0;0;332686853;333948107;9079948
1067;4.23624e-15;-154;1243;9137;10075.5;1;641;-2.14748e+09;-8.58362e+06;0;0;0;0;0;0;332686853;333948107;9079948
1068;4.27178e-15;-129;1457;9537;10131;1;677;-2.14748e+09;-8.55606e+06;0;0;0;0;0;0;333013088;334283193;9125117
1068;4.23624e-15;-154;1243;9137;10075.5;1;641;-2.14748e+09;-8.55606e+06;-1;0;0;0;-1;0;333013088;334283193;9125117
1069;4.27178e-15;-130;1457;9537;10131;1;677;-2.14748e+09;-8.52863e+06;0;0;0;0;0;0;333338409;334617397;9170333
1069;4.23624e-15;-154;1243;9137;10075.5;1;641;-2.14748e+09;-8.52863e+06;-1;0;0;0;-1;0;333338409;334617397;9170333
1070;4.27178e-15;-130;1457;9537;10131;1;677;-2.14748e+09;-8.50144e+06;-1;0;0;0;-1;0;333662818;334950720;9215596
1070;4.23624e-15;-155;1243;9137;10075.5;1;641;-2.14748e+09;-8.50134e+06;0;0;0;0;0;0;333662818;334950720;9215596
1071;4.27178e-15;-130;1457;9537;10131;1;677;-2.14748e+09;-8.47419e+06;-1;0;0;0;-1;0;333986320;335283168;9260905
1071;4.23624e-15;-156;1243;9137;10075.5;1;641;-2.14748e+09;-8.47419e+06;0;0;0;0;0;0;333986320;335283168;9260905
1072;4.27178e-15;-130;1457;9537;10131;1;677;-2.14748e+09;-8.44727e+06;-1;0;0;0;-1;0;334308917;335614744;9306260
1072;4.23624e-15;-157;1243;9137;10075.5;1;641;-2.14748e+09;-8.44717e+06;0;0;0;0;0;0;334308917;335614744;9306260
1073;4.27178e-15;-130;1457;9537;10131;1;677;-2.14748e+09;-8.42028e+06;-1;0;0;0;-1;0;334630614;335945450;9351661
1073;4.23624e-15;-157;1243;9137;10075.5;1;641;-2.14748e+09;-8.42028e+06;-1;0;0;0;-1;0;334630614;335945450;9351661
1074;4.27178e-15;-131;1457;9537;10131;1;677;-2.14748e+09;-8.39354e+06;0;0;0;0;0;0;334951413;336275291;9397106
1074;4.23624e-15;-158;1243;9137;10075.5;1;641;-2.14748e+09;-8.39354e+06;0;0;0;0;0;0;334951413;336275291;9397106
1075;4.27178e-15;-132;1457;9537;10131;1;677;-2.14748e+09;-8.36702e+06;0;0;0;0;0;0;335271319;336604270;9442595
1075;4.23624e-15;-159;1243;9137;10075.5;1;641;-2.14748e+09;-8.36702e+06;0;0;0;0;0;0;335271319;336604270;9442595
1076;4.27178e-15;-132;1457;9537;10131;1;677;-2.14748e+09;-8.34043e+06;-1;0;0;0;-1;0;335590335;336932390;9488128
1076;4.23624e-15;-159;1243;9137;10075.5;1;641;-2.14748e+09;-8.34043e+06;-1;0;0;0;-1;0;335590335;336932390;9488128
1077;4.27178e-15;-132;1457;9537;10131;1;677;-2.14748e+09;-8.31407e+06;-1;0;0;0;-1;0;335908463;337259654;9533704
1077;4.23624e-15;-160;1243;9137;10075.5;1;641;-2.14748e+09;-8.31407e+06;0;0;0;0;0;0;335908463;337259654;9533704
1078;4.27178e-15;-133;1457;9537;10131;1;677;-2.14748e+09;-8.28785e+06;0;0;0;0;0;0;336225709;337586067;9579323
1078;4.23624e-15;-160;1243;9137;10075.5;1;641;-2.14748e+09;-8.28785e+06;-1;0;0;0;-1;0;336225709;337586067;9579323
1079;4.27178e-15;-133;1457;9537;10131;1;677;-2.14748e+09;-8.26185e+06;-1;0;0;0;-1;0;336542074;337911631;9624983
1079;4.23624e-15;-161;1243;9137;10075.5;1;641;-2.14748e+09;-8.26185e+06;0;0;0;0;0;0;336542074;337911631;9624983
1080;4.27178e-15;-133;1457;9537;10131;1;677;-2.14748e+09;-8.23588e+06;-1;0;0;0;-1;0;336857563;338236349;9670686
1080;4.23624e-15;-161;1243;9137;10075.5;1;641;-2.14748e+09;-8.23578e+06;-1;0;0;0;-1;0;336857563;338236349;9670686
1081;4.27178e-15;-133;1457;9537;10131;1;677;-2.14748e+09;-8.20994e+06;-1;0;0;0;-1;0;337172178;338560226;9716429
1081;4.23624e-15;-161;1243;9137;10075.5;1;641;-2.14748e+09;-8.20994e+06;0;0;-1;0;0;-1;337172178;338560226;9716429
1082;4.27178e-15;-133;1457;9537;10131;1;677;-2.14748e+09;-8.18422e+06;0;0;-1;0;0;-1;337485923;338883263;9762213
1082;4.23624e-15;-161;1243;9137;10075.5;1;641;-2.14748e+09;-8.18422e+06;-1;0;0;0;-1;0;337485923;338883263;9762213
1083;4.27178e-15;-134;1457;9537;10131;1;677;-2.14748e+09;-8.15872e+06;0;0;0;0;0;0;337798802;339205465;9808037
1083;4.23624e-15;-162;1243;9137;10075.5;1;641;-2.14748e+09;-8.15862e+06;0;0;0;0;0;0;337798802;339205465;9808037
1084;4.27178e-15;-135;1457;9537;10131;1;677;-2.14748e+09;-8.13326e+06;0;0;0;0;0;0;338110817;339526835;9853900
1084;4.23624e-15;-162;1243;9137;10075.5;1;641;-2.14748e+09;-8.13316e+06;-1;0;0;0;-1;0;338110817;339526835;9853900
1085;4.27178e-15;-136;1457;9537;10131;1;677;-2.14748e+09;-8.10781e+06;0;0;0;0;0;0;338421972;339847375;9899802
1085;4.23624e-15;-163;1243;9137;10075.5;1;641;-2.14748e+09;-8.10781e+06;0;0;0;0;0;0;338421972;339847375;9899802
1086;4.27178e-15;-136;1457;9537;10131;1;677;-2.14748e+09;-8.08268e+06;-1;0;0;0;-1;0;338732271;340167090;9945743
1086;4.23624e-15;-164;1243;9137;10075.5;1;641;-2.14748e+09;-8.08268e+06;0;0;0;0;0;0;338732271;340167090;9945743
1087;4.27178e-15;-137;1457;9537;10131;1;677;-2.14748e+09;-8.05748e+06;0;0;0;0;0;0;339041716;340485982;9991722
1087;4.23624e-15;-164;1243;9137;10075.5;1;641;-2.14748e+09;-8.05748e+06;-1;0;0;0;-1;0;339041716;340485982;9991722
1088;4.27178e-15;-137;1457;9537;10131;1;677;-2.14748e+09;-8.0326e+06;-1;0;0;0;-1;0;339350310;340804054;10037738
1088;4.23624e-15;-165;1243;9137;10075.5;1;641;-2.14748e+09;-8.0326e+06;0;0;0;0;0;0;339350310;340804054;10037738
1089;4.27178e-15;-138;1457;9537;10131;1;677;-2.14748e+09;-8.00774e+06;0;0;0;0;0;0;339658057;341121310;10083791
1089;4.23624e-15;-166;1243;9137;10075.5;1;641;-2.14748e+09;-8.00774e+06;0;0;0;0;0;0;339658057;341121310;10083791
1090;4.27178e-15;-138;1457;9537;10131;1;677;-2.14748e+09;-7.9829e+06;-1;0;0;0;-1;0;339964961;341437753;10129881
1090;4.23624e-15;-167;1243;9137;10075.5;1;641;-2.14748e+09;-7.9829e+06;0;0;0;0;0;0;339964961;341437753;10129881
1091;4.27178e-15;-138;1457;9537;10131;1;677;-2.14748e+09;-7.95827e+06;-1;0;0;0;-1;0;340271024;341753386;10176006
1091;4.23624e-15;-168;1243;9137;10075.5;1;641;-2.14748e+09;-7.95827e+06;0;0;0;0;0;0;340271024;341753386;10176006
1092;4.27178e-15;-138;1457;9537;10131;1;677;-2.14748e+09;-7.93376e+06;0;0;-1;0;0;-1;340576249;342068211;10222167
1092;4.23624e-15;-169;1243;9137;10075.5;1;641;-2.14748e+09;-7.93376e+06;0;0;0;0;0;0;340576249;342068211;10222167
1093;4.27178e-15;-139;1457;9537;10131;1;677;-2.14748e+09;-7.90937e+06;0;0;0;0;0;0;340880640;342382233;10268363
1093;4.23624e-15;-170;1243;9137;10075.5;1;641;-2.14748e+09;-7.90937e+06;0;0;0;0;0;0;340880640;342382233;10268363
1094;4.27178e-15;-140;1457;9537;10131;1;677;-2.14748e+09;-7.8851e+06;0;0;0;0;0;0;341184199;342695454;10314594
1094;4.23624e-15;-170;1243;9137;10075.5;1;641;-2.14748e+09;-7.8851e+06;-1;0;0;0;-1;0;341184199;342695454;10314594
1095;4.27178e-15;-141;1457;9537;10131;1;677;-2.14748e+09;-7.86104e+06;0;0;0;0;0;0;341486930;343007877;10360858
1095;4.23624e-15;-171;1243;9137;10075.5;1;641;-2.14748e+09;-7.86094e+06;0;0;0;0;0;0;341486930;343007877;10360858
1096;4.27178e-15;-141;1457;9537;10131;1;677;-2.14748e+09;-7.83699e+06;-1;0;0;0;-1;0;341788837;343319505;10407156
1096;4.23624e-15;-171;1243;9137;10075.5;1;641;-2.14748e+09;-7.83699e+06;-1;0;0;0;-1;0;341788837;343319505;10407156
1097;4.27178e-15;-141;1457;9537;10131;1;677;-2.14748e+09;-7.81296e+06;-1;0;0;0;-1;0;342089921;343630341;10453487
1097;4.23624e-15;-171;1243;9137;10075.5;1;641;-2.14748e+09;-7.81296e+06;-1;0;0;0;-1;0;342089921;343630341;10453487
1098;4.27178e-15;-141;1457;9537;10131;1;677;-2.14748e+09;-7.78924e+06;-1;0;0;0;-1;0;342390186;343940389;10499850
1098;4.23624e-15;-171;1243;9137;10075.5;1;641;-2.14748e+09;-7.78914e+06;-1;0;0;0;-1;0;342390186;343940389;10499850
1099;4.27178e-15;-141;1457;9537;10131;1;677;-2.14748e+09;-7.76543e+06;-1;0;0;0;-1;0;342689636;344249650;10546245
1099;4.23624e-15;-172;1243;9137;10075.5;1;641;-2.14748e+09;-7.76543e+06;0;0;0;0;0;0;342689636;344249650;10546245
1100;4.27178e-15;-142;1457;9537;10131;1;677;-2.14748e+09;-7.74183e+06;0;0;0;0;0;0;342988272;344558129;10592672
1100;4.23624e-15;-172;1243;9137;10075.5;1;641;-2.14748e+09;-7.74183e+06;-1;0;0;0;-1;0;342988272;344558129;10592672
1101;4.27178e-15;-143;1457;9537;10131;1;677;-2.14748e+09;-7.71844e+06;0;0;0;0;0;0;343286099;344865828;10639130
1101;4.23624e-15;-173;1243;9137;10075.5;1;641;-2.14748e+09;-7.71834e+06;0;0;0;0;0;0;343286099;344865828;10639130
1102;4.27178e-15;-144;1457;9537;10131;1;677;-2.14748e+09;-7.69506e+06;0;0;0;0;0;0;343583119;345172750;10685619
1102;4.23624e-15;-174;1243;9137;10075.5;1;641;-2.14748e+09;-7.69496e+06;0;0;0;0;0;0;343583119;345172750;10685619
1103;4.27178e-15;-145;1457;9537;10131;1;677;-2.14748e+09;-7.67169e+06;0;0;0;0;0;0;343879335;345478898;10732137
1103;4.23624e-15;-175;1243;9137;10075.5;1;641;-2.14748e+09;-7.67169e+06;0;0;0;0;0;0;343879335;345478898;10732137
1104;4.27178e-15;-146;1457;9537;10131;1;677;-2.14748e+09;-7.64853e+06;0;0;0;0;0;0;344174750;345784275;10778685
1104;4.23624e-15;-175;1243;9137;10075.5;1;641;-2.14748e+09;-7.64853e+06;-1;0;0;0;-1;0;344174750;345784275;10778685
1105;4.27178e-15;-147;1457;9537;10131;1;677;-2.14748e+09;-7.62547e+06;0;0;0;0;0;0;344469367;346088884;10825263
1105;4.23624e-15;-175;1243;9137;10075.5;1;641;-2.14748e+09;-7.62547e+06;-1;0;0;0;-1;0;344469367;346088884;10825263
1106;4.27178e-15;-148;1457;9537;10131;1;677;-2.14748e+09;-7.60252e+06;0;0;0;0;0;0;344763189;346392727;10871869
1106;4.23624e-15;-175;1243;9137;10075.5;1;641;-2.14748e+09;-7.60252e+06;-1;0;0;0;-1;0;344763189;346392727;10871869
1107;4.27178e-15;-149;1457;9537;10131;1;677;-2.14748e+09;-7.57968e+06;0;0;0;0;0;0;345056220;346695807;10918503
1107;4.23624e-15;-176;1243;9137;10075.5;1;641;-2.14748e+09;-7.57968e+06;0;0;0;0;0;0;345056220;346695807;10918503
1108;4.27178e-15;-150;1457;9537;10131;1;677;-2.14748e+09;-7.55694e+06;0;0;0;0;0;0;345348461;346998128;10965165
1108;4.23624e-15;-177;1243;9137;10075.5;1;641;-2.14748e+09;-7.55694e+06;0;0;0;0;0;0;345348461;346998128;10965165
1109;4.27178e-15;-151;1457;9537;10131;1;677;-2.14748e+09;-7.53441e+06;0;0;0;0;0;0;345639916;347299692;11011854
1109;4.23624e-15;-178;1243;9137;10075.5;1;641;-2.14748e+09;-7.53431e+06;0;0;0;0;0;0;345639916;347299692;11011854
1110;4.27178e-15;-151;1457;9537;10131;1;677;-2.14748e+09;-7.51178e+06;-1;0;0;0;-1;0;345930587;347600502;11058571
1110;4.23624e-15;-178;1243;9137;10075.5;1;641;-2.14748e+09;-7.51178e+06;-1;0;0;0;-1;0;345930587;347600502;11058571
1111;4.27178e-15;-152;1457;9537;10131;1;677;-2.14748e+09;-7.48936e+06;0;0;0;0;0;0;346220478;347900561;11105313
1111;4.23624e-15;-178;1243;9137;10075.5;1;641;-2.14748e+09;-7.48936e+06;-1;0;0;0;-1;0;346220478;347900561;11105313
1112;4.27178e-15;-152;1457;9537;10131;1;677;-2.14748e+09;-7.46703e+06;-1;0;0;0;-1;0;346509591;348199871;11152081
1112;4.23624e-15;-178;1243;9137;10075.5;1;641;-2.14748e+09;-7.46703e+06;-1;0;0;0;-1;0;346509591;348199871;11152081
1113;4.27178e-15;-153;1457;9537;10131;1;677;-2.14748e+09;-7.44491e+06;0;0;0;0;0;0;346797930;348498436;11198875
1113;4.23624e-15;-178;1243;9137;10075.5;1;641;-2.14748e+09;-7.44481e+06;-1;0;0;0;-1;0;346797930;348498436;11198875
1114;4.27178e-15;-153;1457;9537;10131;1;677;-2.14748e+09;-7.42278e+06;-1;0;0;0;-1;0;347085497;348796257;11245694
1114;4.23624e-15;-179;1243;9137;10075.5;1;641;-2.14748e+09;-7.42278e+06;0;0;0;0;0;0;347085497;348796257;11245694
1115;4.27178e-15;-153;1457;9537;10131;1;677;-2.14748e+09;-7.40076e+06;-1;0;0;0;-1;0;347372294;349093338;11292537
1115;4.23624e-15;-179;1243;9137;10075.5;1;641;-2.14748e+09;-7.40076e+06;-1;0;0;0;-1;0;347372294;349093338;11292537
1116;4.27178e-15;-154;1457;9537;10131;1;677;-2.14748e+09;-7.37874e+06;0;0;0;0;0;0;347658325;349389682;11339405
1116;4.23624e-15;-179;1243;9137;10075.5;1;641;-2.14748e+09;-7.37874e+06;-1;0;0;0;-1;0;347658325;349389682;11339405
1117;4.27178e-15;-155;1457;9537;10131;1;677;-2.14748e+09;-7.35692e+06;0;0;0;0;0;0;347943592;349685291;11386296
1117;4.23624e-15;-180;1243;9137;10075.5;1;641;-2.14748e+09;-7.35692e+06;0;0;0;0;0;0;347943592;349685291;11386296
1118;4.27178e-15;-156;1457;9537;10131;1;677;-2.14748e+09;-7.33529e+06;0;0;0;0;0;0;348228099;349980168;11433210
1118;4.23624e-15;-180;1243;9137;10075.5;1;641;-2.14748e+09;-7.33519e+06;-1;0;0;0;-1;0;348228099;349980168;11433210
1119;4.27178e-15;-156;1457;9537;10131;1;677;-2.14748e+09;-7.31357e+06;-1;0;0;0;-1;0;348511847;350274315;11480147
1119;4.23624e-15;-180;1243;9137;10075.5;1;641;-2.14748e+09;-7.31357e+06;-1;0;0;0;-1;0;348511847;350274315;11480147
1120;4.27178e-15;-156;1457;9537;10131;1;677;-2.14748e+09;-7.29204e+06;-1;0;0;0;-1;0;348794840;350567736;11527107
1120;4.23624e-15;-180;1243;9137;10075.5;1;641;-2.14748e+09;-7.29204e+06;-1;0;0;0;-1;0;348794840;350567736;11527107
1121;4.27178e-15;-156;1457;9537;10131;1;677;-2.14748e+09;-7.2706e+06;-1;0;0;0;-1;0;349077081;350860432;11574088
1121;4.23624e-15;-181;1243;9137;10075.5;1;641;-2.14748e+09;-7.2706e+06;0;0;0;0;0;0;349077081;350860432;11574088
1122;4.27178e-15;-157;1457;9537;10131;1;677;-2.14748e+09;-7.24926e+06;0;0;0;0;0;0;349358571;351152407;11621091
1122;4.23624e-15;-181;1243;9137;10075.5;1;641;-2.14748e+09;-7.24926e+06;-1;0;0;0;-1;0;349358571;351152407;11621091
1123;4.27178e-15;-157;1457;9537;10131;1;677;-2.14748e+09;-7.22802e+06;-1;0;0;0;-1;0;349639315;351443663;11668114
1123;4.23624e-15;-182;1243;9137;10075.5;1;641;-2.14748e+09;-7.22802e+06;0;0;0;0;0;0;349639315;351443663;11668114
1124;4.27178e-15;-157;1457;9537;10131;1;677;-2.14748e+09;-7.20687e+06;-1;0;0;0;-1;0;349919313;351734202;11715158
1124;4.23624e-15;-182;1243;9137;10075.5;1;641;-2.14748e+09;-7.20687e+06;-1;0;0;0;-1;0;349919313;351734202;11715158
1125;4.27178e-15;-158;1457;9537;10131;1;677;-2.14748e+09;-7.18592e+06;0;0;0;0;0;0;350198570;352024028;11762223
1125;4.23624e-15;-183;1243;9137;10075.5;1;641;-2.14748e+09;-7.18582e+06;0;0;0;0;0;0;350198570;352024028;11762223
1126;4.27178e-15;-158;1457;9537;10131;1;677;-2.14748e+09;-7.16485e+06;-1;0;0;0;-1;0;350477088;352313143;11809307
1126;4.23624e-15;-183;1243;9137;10075.5;1;641;-2.14748e+09;-7.16485e+06;-1;0;0;0;-1;0;350477088;352313143;11809307
1127;4.27178e-15;-158;1457;9537;10131;1;677;-2.14748e+09;-7.14398e+06;-1;0;0;0;-1;0;350754869;352601549;11856410
1127;4.23624e-15;-184;1243;9137;10075.5;1;641;-2.14748e+09;-7.14398e+06;0;0;0;0;0;0;350754869;352601549;11856410
1128;4.27178e-15;-159;1457;9537;10131;1;677;-2.14748e+09;-7.12321e+06;0;0;0;0;0;0;351031916;352889249;11903532
1128;4.23624e-15;-184;1243;9137;10075.5;1;641;-2.14748e+09;-7.12321e+06;-1;0;0;0;-1;0;351031916;352889249;11903532
1129;4.27178e-15;-159;1457;9537;10131;1;677;-2.14748e+09;-7.10262e+06;-1;0;0;0;-1;0;351308232;353176246;11950673
1129;4.23624e-15;-185;1243;9137;10075.5;1;641;-2.14748e+09;-7.10252e+06;0;0;0;0;0;0;351308232;353176246;11950673
1130;4.27178e-15;-159;1457;9537;10131;1;677;-2.14748e+09;-7.08193e+06;-1;0;0;0;-1;0;351583819;353462542;11997831
1130;4.23624e-15;-185;1243;9137;10075.5;1;641;-2.14748e+09;-7.08193e+06;-1;0;0;0;-1;0;351583819;353462542;11997831
1131;4.27178e-15;-160;1457;9537;10131;1;677;-2.14748e+09;-7.06142e+06;0;0;0;0;0;0;351858680;353748139;12045007
1131;4.23624e-15;-185;1243;9137;10075.5;1;641;-2.14748e+09;-7.06142e+06;-1;0;0;0;-1;0;351858680;353748139;12045007
1132;4.27178e-15;-160;1457;9537;10131;1;677;-2.14748e+09;-7.04101e+06;-1;0;0;0;-1;0;352132818;354033040;12092200
1132;4.23624e-15;-186;1243;9137;10075.5;1;641;-2.14748e+09;-7.04101e+06;0;0;0;0;0;0;352132818;354033040;12092200
1133;4.27178e-15;-161;1457;9537;10131;1;677;-2.14748e+09;-7.02068e+06;0;0;0;0;0;0;352406234;354317248;12139410
1133;4.23624e-15;-186;1243;9137;10075.5;1;641;-2.14748e+09;-7.02068e+06;-1;0;0;0;-1;0;352406234;354317248;12139410
1134;4.27178e-15;-161;1457;9537;10131;1;677;-2.14748e+09;-7.00044e+06;-1;0;0;0;-1;0;352678932;354600765;12186637
1134;4.23624e-15;-187;1243;9137;10075.5;1;641;-2.14748e+09;-7.00044e+06;0;0;0;0;0;0;352678932;354600765;12186637
1135;4.27178e-15;-161;1457;9537;10131;1;677;-2.14748e+09;-6.98039e+06;-1;0;0;0;-1;0;352950915;354883593;12233879
1135;4.23624e-15;-187;1243;9137;10075.5;1;641;-2.14748e+09;-6.98029e+06;-1;0;0;0;-1;0;352950915;354883593;12233879
1136;4.27178e-15;-161;1457;9537;10131;1;677;-2.14748e+09;-6.96023e+06;-1;0;0;0;-1;0;353222183;355165736;12281136
1136;4.23624e-15;-188;1243;9137;10075.5;1;641;-2.14748e+09;-6.96023e+06;0;0;0;0;0;0;353222183;355165736;12281136
1137;4.27178e-15;-162;1457;9537;10131;1;677;-2.14748e+09;-6.94026e+06;0;0;0;0;0;0;353492741;355447194;12328409
1137;4.23624e-15;-189;1243;9137;10075.5;1;641;-2.14748e+09;-6.94026e+06;0;0;0;0;0;0;353492741;355447194;12328409
1138;4.27178e-15;-163;1457;9537;10131;1;677;-2.14748e+09;-6.92037e+06;0;0;0;0;0;0;353762591;355727971;12375697
1138;4.23624e-15;-189;1243;9137;10075.5;1;641;-2.14748e+09;-6.92037e+06;-1;0;0;0;-1;0;353762591;355727971;12375697
1139;4.27178e-15;-163;1457;9537;10131;1;677;-2.14748e+09;-6.90056e+06;-1;0;0;0;-1;0;354031735;356008070;12422998
1139;4.23624e-15;-189;1243;9137;10075.5;1;641;-2.14748e+09;-6.90056e+06;-1;0;0;0;-1;0;354031735;356008070;12422998
1140;4.27178e-15;-163;1457;9537;10131;1;677;-2.14748e+09;-6.88085e+06;-1;0;0;0;-1;0;354300175;356287492;12470314
1140;4.23624e-15;-189;1243;9137;10075.5;1;641;-2.14748e+09;-6.88085e+06;-1;0;0;0;-1;0;354300175;356287492;12470314
1141;4.27178e-15;-164;1457;9537;10131;1;677;-2.14748e+09;-6.86121e+06;0;0;0;0;0;0;354567914;356566240;12517643
1141;4.23624e-15;-190;1243;9137;10075.5;1;641;-2.14748e+09;-6.86121e+06;0;0;0;0;0;0;354567914;356566240;12517643
1142;4.27178e-15;-164;1457;9537;10131;1;677;-2.14748e+09;-6.84166e+06;-1;0;0;0;-1;0;354834955;356844316;12564985
1142;4.23624e-15;-190;1243;9137;10075.5;1;641;-2.14748e+09;-6.84166e+06;-1;0;0;0;-1;0;354834955;356844316;12564985
1143;4.27178e-15;-165;1457;9537;10131;1;677;-2.14748e+09;-6.8223e+06;0;0;0;0;0;0;355101300;357121723;12612340
1143;4.23624e-15;-190;1243;9137;10075.5;1;641;-2.14748e+09;-6.8222e+06;-1;0;0;0;-1;0;355101300;357121723;12612340
1144;4.27178e-15;-165;1457;9537;10131;1;677;-2.14748e+09;-6.80282e+06;-1;0;0;0;-1;0;355366951;357398463;12659707
1144;4.23624e-15;-191;1243;9137;10075.5;1;641;-2.14748e+09;-6.80282e+06;0;0;0;0;0;0;355366951;357398463;12659707
1145;4.27178e-15;-165;1457;9537;10131;1;677;-2.14748e+09;-6.78352e+06;-1;0;0;0;-1;0;355631911;357674539;12707086
1145;4.23624e-15;-192;1243;9137;10075.5;1;641;-2.14748e+09;-6.78352e+06;0;0;0;0;0;0;355631911;357674539;12707086
1146;4.27178e-15;-166;1457;9537;10131;1;677;-2.14748e+09;-6.7644e+06;0;0;0;0;0;0;355896183;357949952;12754476
1146;4.23624e-15;-192;1243;9137;10075.5;1;641;-2.14748e+09;-6.7643e+06;-1;0;0;0;-1;0;355896183;357949952;12754476
1147;4.27178e-15;-166;1457;9537;10131;1;677;-2.14748e+09;-6.74516e+06;-1;0;0;0;-1;0;356159768;358224705;12801877
1147;4.23624e-15;-193;1243;9137;10075.5;1;641;-2.14748e+09;-6.74516e+06;0;0;0;0;0;0;356159768;358224705;12801877
1148;4.27178e-15;-166;1457;9537;10131;1;677;-2.14748e+09;-6.72611e+06;-1;0;0;0;-1;0;356422668;358498800;12849290
1148;4.23624e-15;-194;1243;9137;10075.5;1;641;-2.14748e+09;-6.72611e+06;0;0;0;0;0;0;356422668;358498800;12849290
1149;4.27178e-15;-166;1457;9537;10131;1;677;-2.14748e+09;-6.70723e+06;-1;0;0;0;-1;0;356684888;358772240;12896712
1149;4.23624e-15;-195;1243;9137;10075.5;1;641;-2.14748e+09;-6.70723e+06;0;0;0;0;0;0;356684888;358772240;12896712
1150;4.27178e-15;-167;1457;9537;10131;1;677;-2.14748e+09;-6.68834e+06;0;0;0;0;0;0;356946428;359045027;12944145
1150;4.23624e-15;-196;1243;9137;10075.5;1;641;-2.14748e+09;-6.68834e+06;0;0;0;0;0;0;356946428;359045027;12944145
1151;4.27178e-15;-168;1457;9537;10131;1;677;-2.14748e+09;-6.66942e+06;0;0;0;0;0;0;357207291;359317163;12991587
1151;4.23624e-15;-197;1243;9137;10075.5;1;641;-2.14748e+09;-6.66942e+06;0;0;0;0;0;0;357207291;359317163;12991587
1152;4.27178e-15;-169;1457;9537;10131;1;677;-2.14748e+09;-6.65069e+06;0;0;0;0;0;0;357467479;359588650;13039038
1152;4.23624e-15;-198;1243;9137;10075.5;1;641;-2.14748e+09;-6.65069e+06;0;0;0;0;0;0;357467479;359588650;13039038
1153;4.27178e-15;-170;1457;9537;10131;1;677;-2.14748e+09;-6.63203e+06;0;0;0;0;0;0;357726996;359859490;13086498
1153;4.23624e-15;-198;1243;9137;10075.5;1;641;-2.14748e+09;-6.63203e+06;-1;0;0;0;-1;0;357726996;359859490;13086498
1154;4.27178e-15;-170;1457;9537;10131;1;677;-2.14748e+09;-6.61345e+06;-1;0;0;0;-1;0;357985842;360129687;13133966
1154;4.23624e-15;-198;1243;9137;10075.5;1;641;-2.14748e+09;-6.61345e+06;-1;0;0;0;-1;0;357985842;360129687;13133966
1155;4.27178e-15;-171;1457;9537;10131;1;677;-2.14748e+09;-6.59495e+06;0;0;0;0;0;0;358244021;360399242;13181442
1155;4.23624e-15;-199;1243;9137;10075.5;1;641;-2.14748e+09;-6.59495e+06;0;0;0;0;0;0;358244021;360399242;13181442
1156;4.27178e-15;-172;1457;9537;10131;1;677;-2.14748e+09;-6.57662e+06;0;0;0;0;0;0;358501534;360668156;13228927
1156;4.23624e-15;-200;1243;9137;10075.5;1;641;-2.14748e+09;-6.57652e+06;0;0;0;0;0;0;358501534;360668156;13228927
1157;4.27178e-15;-172;1457;9537;10131;1;677;-2.14748e+09;-6.55818e+06;-1;0;0;0;-1;0;358758384;360936434;13276418
1157;4.23624e-15;-201;1243;9137;10075.5;1;641;-2.14748e+09;-6.55818e+06;0;0;0;0;0;0;358758384;360936434;13276418
1158;4.27178e-15;-173;1457;9537;10131;1;677;-2.14748e+09;-6.5399e+06;0;0;0;0;0;0;359014574;361204076;13323916
1158;4.23624e-15;-201;1243;9137;10075.5;1;641;-2.14748e+09;-6.5399e+06;-1;0;0;0;-1;0;359014574;361204076;13323916
1159;4.27178e-15;-174;1457;9537;10131;1;677;-2.14748e+09;-6.52181e+06;0;0;0;0;0;0;359270105;361471084;13371421
1159;4.23624e-15;-201;1243;9137;10075.5;1;641;-2.14748e+09;-6.52181e+06;-1;0;0;0;-1;0;359270105;361471084;13371421
1160;4.27178e-15;-174;1457;9537;10131;1;677;-2.14748e+09;-6.50359e+06;-1;0;0;0;-1;0;359524979;361737462;13418932
1160;4.23624e-15;-201;1243;9137;10075.5;1;641;-2.14748e+09;-6.50359e+06;-1;0;0;0;-1;0;359524979;361737462;13418932
1161;4.27178e-15;-175;1457;9537;10131;1;677;-2.14748e+09;-6.48564e+06;0;0;0;0;0;0;359779200;362003211;13466449
1161;4.23624e-15;-201;1243;9137;10075.5;1;641;-2.14748e+09;-6.48564e+06;-1;0;0;0;-1;0;359779200;362003211;13466449
1162;4.27178e-15;-176;1457;9537;10131;1;677;-2.14748e+09;-6.46757e+06;0;0;0;0;0;0;360032769;362268333;13513972
1162;4.23624e-15;-201;1243;9137;10075.5;1;641;-2.14748e+09;-6.46757e+06;-1;0;0;0;-1;0;360032769;362268333;13513972
1163;4.27178e-15;-177;1457;9537;10131;1;677;-2.14748e+09;-6.44967e+06;0;0;0;0;0;0;360285688;362532830;13561499
1163;4.23624e-15;-202;1243;9137;10075.5;1;641;-2.14748e+09;-6.44967e+06;0;0;0;0;0;0;360285688;362532830;13561499
1164;4.27178e-15;-178;1457;9537;10131;1;677;-2.14748e+09;-6.43184e+06;0;0;0;0;0;0;360537959;362796705;13609031
1164;4.23624e-15;-202;1243;9137;10075.5;1;641;-2.14748e+09;-6.43184e+06;-1;0;0;0;-1;0;360537959;362796705;13609031
1165;4.27178e-15;-178;1457;9537;10131;1;677;-2.14748e+09;-6.41419e+06;-1;0;0;0;-1;0;360789586;363059959;13656568
1165;4.23624e-15;-202;1243;9137;10075.5;1;641;-2.14748e+09;-6.41419e+06;-1;0;0;0;-1;0;360789586;363059959;13656568
1166;4.27178e-15;-179;1457;9537;10131;1;677;-2.14748e+09;-6.39642e+06;0;0;0;0;0;0;361040569;363322595;13704109
1166;4.23624e-15;-203;1243;9137;10075.5;1;641;-2.14748e+09;-6.39642e+06;0;0;0;0;0;0;361040569;363322595;13704109
1167;4.27178e-15;-180;1457;9537;10131;1;677;-2.14748e+09;-6.37881e+06;0;0;0;0;0;0;361290912;363584615;13751653
1167;4.23624e-15;-203;1243;9137;10075.5;1;641;-2.14748e+09;-6.37881e+06;-1;0;0;0;-1;0;361290912;363584615;13751653
1168;4.27178e-15;-180;1457;9537;10131;1;677;-2.14748e+09;-6.36127e+06;-1;0;0;0;-1;0;361540616;363846021;13799201
1168;4.23624e-15;-203;1243;9137;10075.5;1;641;-2.14748e+09;-6.36127e+06;-1;0;0;0;-1;0;361540616;363846021;13799201
1169;4.27178e-15;-180;1457;9537;10131;1;677;-2.14748e+09;-6.34381e+06;-1;0;0;0;-1;0;361789684;364106814;13846751
1169;4.23624e-15;-204;1243;9137;10075.5;1;641;-2.14748e+09;-6.34381e+06;0;0;0;0;0;0;361789684;364106814;13846751
1170;4.27178e-15;-180;1457;9537;10131;1;677;-2.14748e+09;-6.32642e+06;-1;0;0;0;-1;0;362038117;364366998;13894305
1170;4.23624e-15;-205;1243;9137;10075.5;1;641;-2.14748e+09;-6.32642e+06;0;0;0;0;0;0;362038117;364366998;13894305
1171;4.27178e-15;-181;1457;9537;10131;1;677;-2.14748e+09;-6.30909e+06;0;0;0;0;0;0;362285918;364626574;13941860
1171;4.23624e-15;-206;1243;9137;10075.5;1;641;-2.14748e+09;-6.30909e+06;0;0;0;0;0;0;362285918;364626574;13941860
1172;4.27178e-15;-181;1457;9537;10131;1;677;-2.14748e+09;-6.29184e+06;-1;0;0;0;-1;0;362533088;364885543;13989418
1172;4.23624e-15;-206;1243;9137;10075.5;1;641;-2.14748e+09;-6.29184e+06;-1;0;0;0;-1;0;362533088;364885543;13989418
1173;4.27178e-15;-181;1457;9537;10131;1;677;-2.14748e+09;-6.27476e+06;-1;0;0;0;-1;0;362779631;365143909;14036977
1173;4.23624e-15;-207;1243;9137;10075.5;1;641;-2.14748e+09;-6.27466e+06;0;0;0;0;0;0;362779631;365143909;14036977
1174;4.27178e-15;-181;1457;9537;10131;1;677;-2.14748e+09;-6.25754e+06;-1;0;0;0;-1;0;363025548;365401673;14084537
1174;4.23624e-15;-208;1243;9137;10075.5;1;641;-2.14748e+09;-6.25754e+06;0;0;0;0;0;0;363025548;365401673;14084537
1175;4.27178e-15;-182;1457;9537;10131;1;677;-2.14748e+09;-6.2405e+06;0;0;0;0;0;0;363270841;365658837;14132099
1175;4.23624e-15;-209;1243;9137;10075.5;1;641;-2.14748e+09;-6.2405e+06;0;0;0;0;0;0;363270841;365658837;14132099
1176;4.27178e-15;-183;1457;9537;10131;1;677;-2.14748e+09;-6.22352e+06;0;0;0;0;0;0;363515512;365915403;14179661
1176;4.23624e-15;-210;1243;9137;10075.5;1;641;-2.14748e+09;-6.22352e+06;0;0;0;0;0;0;363515512;365915403;14179661
1177;4.27178e-15;-183;1457;9537;10131;1;677;-2.14748e+09;-6.20661e+06;-1;0;0;0;-1;0;363759564;366171373;14227223
1177;4.23624e-15;-211;1243;9137;10075.5;1;641;-2.14748e+09;-6.20661e+06;0;0;0;0;0;0;363759564;366171373;14227223
1178;4.27178e-15;-184;1457;9537;10131;1;677;-2.14748e+09;-6.18987e+06;0;0;0;0;0;0;364002998;366426749;14274785
1178;4.23624e-15;-212;1243;9137;10075.5;1;641;-2.14748e+09;-6.18977e+06;0;0;0;0;0;0;364002998;366426749;14274785
1179;4.27178e-15;-184;1457;9537;10131;1;677;-2.14748e+09;-6.173e+06;-1;0;0;0;-1;0;364245816;366681533;14322347
1179;4.23624e-15;-212;1243;9137;10075.5;1;641;-2.14748e+09;-6.173e+06;-1;0;0;0;-1;0;364245816;366681533;14322347
1180;4.27178e-15;-184;1457;9537;10131;1;677;-2.14748e+09;-6.15629e+06;-1;0;0;0;-1;0;364488022;366935727;14369908
1180;4.23624e-15;-213;1243;9137;10075.5;1;641;-2.14748e+09;-6.15629e+06;0;0;0;0;0;0;364488022;366935727;14369908
1181;4.27178e-15;-184;1457;9537;10131;1;677;-2.14748e+09;-6.13965e+06;-1;0;0;0;-1;0;364729615;367189333;14417467
1181;4.23624e-15;-214;1243;9137;10075.5;1;641;-2.14748e+09;-6.13965e+06;0;0;0;0;0;0;364729615;367189333;14417467
1182;4.27178e-15;-185;1457;9537;10131;1;677;-2.14748e+09;-6.12307e+06;0;0;0;0;0;0;364970599;367442353;14465026
1182;4.23624e-15;-215;1243;9137;10075.5;1;641;-2.14748e+09;-6.12307e+06;0;0;0;0;0;0;364970599;367442353;14465026
1183;4.27178e-15;-186;1457;9537;10131;1;677;-2.14748e+09;-6.10656e+06;0;0;0;0;0;0;365210976;367694789;14512583
1183;4.23624e-15;-215;1243;9137;10075.5;1;641;-2.14748e+09;-6.10657e+06;-1;0;0;0;-1;0;365210976;367694789;14512583
1184;4.27178e-15;-186;1457;9537;10131;1;677;-2.14748e+09;-6.09012e+06;-1;0;0;0;-1;0;365450748;367946642;14560138
1184;4.23624e-15;-215;1243;9137;10075.5;1;641;-2.14748e+09;-6.09012e+06;-1;0;0;0;-1;0;365450748;367946642;14560138
1185;4.27178e-15;-186;1457;9537;10131;1;677;-2.14748e+09;-6.07374e+06;-1;0;0;0;-1;0;365689916;368197915;14607690
1185;4.23624e-15;-216;1243;9137;10075.5;1;641;-2.14748e+09;-6.07374e+06;0;0;0;0;0;0;365689916;368197915;14607690
1186;4.27178e-15;-186;1457;9537;10131;1;677;-2.14748e+09;-6.05743e+06;-1;0;0;0;-1;0;365928482;368448610;14655240
1186;4.23624e-15;-216;1243;9137;10075.5;1;641;-2.14748e+09;-6.05743e+06;-1;0;0;0;-1;0;365928482;368448610;14655240
1187;4.27178e-15;-186;1457;9537;10131;1;677;-2.14748e+09;-6.04118e+06;-1;0;0;0;-1;0;366166450;368698728;14702786
1187;4.23624e-15;-217;1243;9137;10075.5;1;641;-2.14748e+09;-6.04118e+06;0;0;0;0;0;0;366166450;368698728;14702786
1188;4.27178e-15;-187;1457;9537;10131;1;677;-2.14748e+09;-6.02509e+06;0;0;0;0;0;0;366403820;368948271;14750330
1188;4.23624e-15;-218;1243;9137;10075.5;1;641;-2.14748e+09;-6.02499e+06;0;0;0;0;0;0;366403820;368948271;14750330
1189;4.27178e-15;-188;1457;9537;10131;1;677;-2.14748e+09;-6.00886e+06;0;0;0;0;0;0;366640594;369197241;14797870
1189;4.23624e-15;-219;1243;9137;10075.5;1;641;-2.14748e+09;-6.00886e+06;0;0;0;0;0;0;366640594;369197241;14797870
1190;4.27178e-15;-188;1457;9537;10131;1;677;-2.14748e+09;-5.9929e+06;-1;0;0;0;-1;0;366876775;369445641;14845405
1190;4.23624e-15;-219;1243;9137;10075.5;1;641;-2.14748e+09;-5.9928e+06;-1;0;0;0;-1;0;366876775;369445641;14845405
1191;4.27178e-15;-188;1457;9537;10131;1;677;-2.14748e+09;-5.97691e+06;-1;0;0;0;-1;0;367112364;369693471;14892937
1191;4.23624e-15;-220;1243;9137;10075.5;1;641;-2.14748e+09;-5.97681e+06;0;0;0;0;0;0;367112364;369693471;14892937
1192;4.27178e-15;-188;1457;9537;10131;1;677;-2.14748e+09;-5.96087e+06;-1;0;0;0;-1;0;367347364;369940734;14940464
1192;4.23624e-15;-220;1243;9137;10075.5;1;641;-2.14748e+09;-5.96087e+06;-1;0;0;0;-1;0;367347364;369940734;14940464
1193;4.27178e-15;-188;1457;9537;10131;1;677;-2.14748e+09;-5.945e+06;-1;0;0;0;-1;0;367581776;370187431;14987986
1193;4.23624e-15;-221;1243;9137;10075.5;1;641;-2.14748e+09;-5.945e+06;0;0;0;0;0;0;367581776;370187431;14987986
1194;4.27178e-15;-188;1457;9537;10131;1;677;-2.14748e+09;-5.92918e+06;-1;0;0;0;-1;0;367815602;370433565;15035503
1194;4.23624e-15;-221;1243;9137;10075.5;1;641;-2.14748e+09;-5.92918e+06;-1;0;0;0;-1;0;367815602;370433565;15035503
1195;4.27178e-15;-188;1457;9537;10131;1;677;-2.14748e+09;-5.91343e+06;-1;0;0;0;-1;0;368048844;370679137;15083015
1195;4.23624e-15;-221;1243;9137;10075.5;1;641;-2.14748e+09;-5.91343e+06;-1;0;0;0;-1;0;368048844;370679137;15083015
1196;4.27178e-15;-189;1457;9537;10131;1;677;-2.14748e+09;-5.89774e+06;0;0;0;0;0;0;368281505;370924149;15130520
1196;4.23624e-15;-221;1243;9137;10075.5;1;641;-2.14748e+09;-5.89774e+06;-1;0;0;0;-1;0;368281505;370924149;15130520
1197;4.27178e-15;-190;1457;9537;10131;1;677;-2.14748e+09;-5.88211e+06;0;0;0;0;0;0;368513585;371168602;15178020
1197;4.23624e-15;-222;1243;9137;10075.5;1;641;-2.14748e+09;-5.88211e+06;0;0;0;0;0;0;368513585;371168602;15178020
1198;4.27178e-15;-190;1457;9537;10131;1;677;-2.14748e+09;-5.86654e+06;-1;0;0;0;-1;0;368745087;371412500;15225513
1198;4.23624e-15;-222;1243;9137;10075.5;1;641;-2.14748e+09;-5.86654e+06;-1;0;0;0;-1;0;368745087;371412500;15225513
1199;4.27178e-15;-191;1457;9537;10131;1;677;-2.14748e+09;-5.85103e+06;0;0;0;0;0;0;368976013;371655843;15273000
1199;4.23624e-15;-223;1243;9137;10075.5;1;641;-2.14748e+09;-5.85103e+06;0;0;0;0;0;0;368976013;371655843;15273000
1200;4.27178e-15;-191;1457;9537;10131;1;677;-2.14748e+09;-5.83558e+06;-1;0;0;0;-1;0;369206364;371898632;15320479
1200;4.23624e-15;-223;1243;9137;10075.5;1;641;-2.14748e+09;-5.83558e+06;-1;0;0;0;-1;0;369206364;371898632;15320479
1201;4.27178e-15;-191;1457;9537;10131;1;677;-2.14748e+09;-5.82029e+06;-1;0;0;0;-1;0;369436143;372140871;15367952
1201;4.23624e-15;-224;1243;9137;10075.5;1;641;-2.14748e+09;-5.82019e+06;0;0;0;0;0;0;369436143;372140871;15367952
1202;4.27178e-15;-192;1457;9537;10131;1;677;-2.14748e+09;-5.80496e+06;0;0;0;0;0;0;369665351;372382561;15415416
1202;4.23624e-15;-225;1243;9137;10075.5;1;641;-2.14748e+09;-5.80496e+06;0;0;0;0;0;0;369665351;372382561;15415416
1203;4.27178e-15;-193;1457;9537;10131;1;677;-2.14748e+09;-5.78968e+06;0;0;0;0;0;0;369893990;372623702;15462873
1203;4.23624e-15;-225;1243;9137;10075.5;1;641;-2.14748e+09;-5.78968e+06;-1;0;0;0;-1;0;369893990;372623702;15462873
1204;4.27178e-15;-194;1457;9537;10131;1;677;-2.14748e+09;-5.77447e+06;0;0;0;0;0;0;370122062;372864299;15510322
1204;4.23624e-15;-226;1243;9137;10075.5;1;641;-2.14748e+09;-5.77447e+06;0;0;0;0;0;0;370122062;372864299;15510322
1205;4.27178e-15;-195;1457;9537;10131;1;677;-2.14748e+09;-5.75921e+06;0;0;0;0;0;0;370349569;373104350;15557762
1205;4.23624e-15;-226;1243;9137;10075.5;1;641;-2.14748e+09;-5.75921e+06;-1;0;0;0;-1;0;370349569;373104350;15557762
1206;4.27178e-15;-196;1457;9537;10131;1;677;-2.14748e+09;-5.74411e+06;0;0;0;0;0;0;370576513;373343860;15605194
1206;4.23624e-15;-226;1243;9137;10075.5;1;641;-2.14748e+09;-5.74411e+06;-1;0;0;0;-1;0;370576513;373343860;15605194
1207;4.27178e-15;-197;1457;9537;10131;1;677;-2.14748e+09;-5.72917e+06;0;0;0;0;0;0;370802895;373582829;15652617
1207;4.23624e-15;-227;1243;9137;10075.5;1;641;-2.14748e+09;-5.72907e+06;0;0;0;0;0;0;370802895;373582829;15652617
1208;4.27178e-15;-198;1457;9537;10131;1;677;-2.14748e+09;-5.71418e+06;0;0;0;0;0;0;371028717;373821259;15700030
1208;4.23624e-15;-228;1243;9137;10075.5;1;641;-2.14748e+09;-5.71418e+06;0;0;0;0;0;0;371028717;373821259;15700030
1209;4.27178e-15;-198;1457;9537;10131;1;677;-2.14748e+09;-5.69915e+06;-1;0;0;0;-1;0;371253981;374059151;15747434
1209;4.23624e-15;-229;1243;9137;10075.5;1;641;-2.14748e+09;-5.69915e+06;0;0;0;0;0;0;371253981;374059151;15747434
1210;4.27178e-15;-198;1457;9537;10131;1;677;-2.14748e+09;-5.68438e+06;-1;0;0;0;-1;0;371478689;374296508;15794828
1210;4.23624e-15;-230;1243;9137;10075.5;1;641;-2.14748e+09;-5.68428e+06;0;0;0;0;0;0;371478689;374296508;15794828
1211;4.27178e-15;-199;1457;9537;10131;1;677;-2.14748e+09;-5.66956e+06;0;0;0;0;0;0;371702842;374533332;15842212
1211;4.23624e-15;-230;1243;9137;10075.5;1;641;-2.14748e+09;-5.66946e+06;-1;0;0;0;-1;0;371702842;374533332;15842212
1212;4.27178e-15;-200;1457;9537;10131;1;677;-2.14748e+09;-5.6547e+06;0;0;0;0;0;0;371926443;374769623;15889585
1212;4.23624e-15;-231;1243;9137;10075.5;1;641;-2.14748e+09;-5.6547e+06;0;0;0;0;0;0;371926443;374769623;15889585
1213;4.27178e-15;-200;1457;9537;10131;1;677;-2.14748e+09;-5.63999e+06;-1;0;0;0;-1;0;372149493;375005383;15936948
1213;4.23624e-15;-232;1243;9137;10075.5;1;641;-2.14748e+09;-5.63999e+06;0;0;0;0;0;0;372149493;375005383;15936948
1214;4.27178e-15;-201;1457;9537;10131;1;677;-2.14748e+09;-5.62534e+06;0;0;0;0;0;0;372371994;375240615;15984300
1214;4.23624e-15;-232;1243;9137;10075.5;1;641;-2.14748e+09;-5.62534e+06;-1;0;0;0;-1;0;372371994;375240615;15984300
1215;4.27178e-15;-202;1457;9537;10131;1;677;-2.14748e+09;-5.61074e+06;0;0;0;0;0;0;372593947;375475319;16031640
1215;4.23624e-15;-233;1243;9137;10075.5;1;641;-2.14748e+09;-5.61074e+06;0;0;0;0;0;0;372593947;375475319;16031640
1216;4.27178e-15;-203;1457;9537;10131;1;677;-2.14748e+09;-5.5962e+06;0;0;0;0;0;0;372815355;375709498;16078969
1216;4.23624e-15;-233;1243;9137;10075.5;1;641;-2.14748e+09;-5.5962e+06;-1;0;0;0;-1;0;372815355;375709498;16078969
1217;4.27178e-15;-203;1457;9537;10131;1;677;-2.14748e+09;-5.58181e+06;-1;0;0;0;-1;0;373036219;375943153;16126287
1217;4.23624e-15;-234;1243;9137;10075.5;1;641;-2.14748e+09;-5.58181e+06;0;0;0;0;0;0;373036219;375943153;16126287
1218;4.27178e-15;-204;1457;9537;10131;1;677;-2.14748e+09;-5.56728e+06;0;0;0;0;0;0;373256540;376176285;16173592
1218;4.23624e-15;-234;1243;9137;10075.5;1;641;-2.14748e+09;-5.56728e+06;-1;0;0;0;-1;0;373256540;376176285;16173592
1219;4.27178e-15;-204;1457;9537;10131;1;677;-2.14748e+09;-5.5529e+06;-1;0;0;0;-1;0;373476321;376408897;16220885
1219;4.23624e-15;-234;1243;9137;10075.5;1;641;-2.14748e+09;-5.5529e+06;-1;0;0;0;-1;0;373476321;376408897;16220885
1220;4.27178e-15;-204;1457;9537;10131;1;677;-2.14748e+09;-5.53857e+06;-1;0;0;0;-1;0;373695564;376640990;16268166
1220;4.23624e-15;-234;1243;9137;10075.5;1;641;-2.14748e+09;-5.53857e+06;-1;0;0;0;-1;0;373695564;376640990;16268166
1221;4.27178e-15;-204;1457;9537;10131;1;677;-2.14748e+09;-5.5244e+06;-1;0;0;0;-1;0;373914269;376872565;16315434
1221;4.23624e-15;-234;1243;9137;10075.5;1;641;-2.14748e+09;-5.5243e+06;-1;0;0;0;-1;0;373914269;376872565;16315434
1222;4.27178e-15;-204;1457;9537;10131;1;677;-2.14748e+09;-5.51007e+06;-1;0;0;0;-1;0;374132439;377103625;16362688
1222;4.23624e-15;-234;1243;9137;10075.5;1;641;-2.14748e+09;-5.51007e+06;-1;0;0;0;-1;0;374132439;377103625;16362688
1223;4.27178e-15;-205;1457;9537;10131;1;677;-2.14748e+09;-5.4959e+06;0;0;0;0;0;0;374350075;377334170;16409929
1223;4.23624e-15;-235;1243;9137;10075.5;1;641;-2.14748e+09;-5.4959e+06;0;0;0;0;0;0;374350075;377334170;16409929
1224;4.27178e-15;-205;1457;9537;10131;1;677;-2.14748e+09;-5.48179e+06;-1;0;0;0;-1;0;374567180;377564203;16457157
1224;4.23624e-15;-236;1243;9137;10075.5;1;641;-2.14748e+09;-5.48179e+06;0;0;0;0;0;0;374567180;377564203;16457157
1225;4.27178e-15;-206;1457;9537;10131;1;677;-2.14748e+09;-5.46772e+06;0;0;0;0;0;0;374783754;377793724;16504371
1225;4.23624e-15;-236;1243;9137;10075.5;1;641;-2.14748e+09;-5.46772e+06;-1;0;0;0;-1;0;374783754;377793724;16504371
1226;4.27178e-15;-207;1457;9537;10131;1;677;-2.14748e+09;-5.45371e+06;0;0;0;0;0;0;374999799;378022736;16551571
1226;4.23624e-15;-236;1243;9137;10075.5;1;641;-2.14748e+09;-5.45371e+06;-1;0;0;0;-1;0;374999799;378022736;16551571
1227;4.27178e-15;-208;1457;9537;10131;1;677;-2.14748e+09;-5.43984e+06;0;0;0;0;0;0;375215317;378251240;16598756
1227;4.23624e-15;-236;1243;9137;10075.5;1;641;-2.14748e+09;-5.43974e+06;-1;0;0;0;-1;0;375215317;378251240;16598756
1228;4.27178e-15;-208;1457;9537;10131;1;677;-2.14748e+09;-5.42583e+06;-1;0;0;0;-1;0;375430310;378479237;16645927
1228;4.23624e-15;-237;1243;9137;10075.5;1;641;-2.14748e+09;-5.42583e+06;0;0;0;0;0;0;375430310;378479237;16645927
1229;4.27178e-15;-208;1457;9537;10131;1;677;-2.14748e+09;-5.41197e+06;-1;0;0;0;-1;0;375644779;378706730;16693083
1229;4.23624e-15;-238;1243;9137;10075.5;1;641;-2.14748e+09;-5.41197e+06;0;0;0;0;0;0;375644779;378706730;16693083
1230;4.27178e-15;-208;1457;9537;10131;1;677;-2.14748e+09;-5.39816e+06;-1;0;0;0;-1;0;375858727;378933719;16740224
1230;4.23624e-15;-238;1243;9137;10075.5;1;641;-2.14748e+09;-5.39816e+06;-1;0;0;0;-1;0;375858727;378933719;16740224
1231;4.27178e-15;-209;1457;9537;10131;1;677;-2.14748e+09;-5.3844e+06;0;0;0;0;0;0;376072153;379160207;16787349
1231;4.23624e-15;-239;1243;9137;10075.5;1;641;-2.14748e+09;-5.3844e+06;0;0;0;0;0;0;376072153;379160207;16787349
1232;4.27178e-15;-209;1457;9537;10131;1;677;-2.14748e+09;-5.37069e+06;-1;0;0;0;-1;0;376285061;379386194;16834459
1232;4.23624e-15;-240;1243;9137;10075.5;1;641;-2.14748e+09;-5.37069e+06;0;0;0;0;0;0;376285061;379386194;16834459
1233;4.27178e-15;-210;1457;9537;10131;1;677;-2.14748e+09;-5.35702e+06;0;0;0;0;0;0;376497452;379611683;16881553
1233;4.23624e-15;-241;1243;9137;10075.5;1;641;-2.14748e+09;-5.35702e+06;0;0;0;0;0;0;376497452;379611683;16881553
1234;4.27178e-15;-210;1457;9537;10131;1;677;-2.14748e+09;-5.34341e+06;-1;0;0;0;-1;0;376709327;379836674;16928631
1234;4.23624e-15;-242;1243;9137;10075.5;1;641;-2.14748e+09;-5.34341e+06;0;0;0;0;0;0;376709327;379836674;16928631
1235;4.27178e-15;-211;1457;9537;10131;1;677;-2.14748e+09;-5.32985e+06;0;0;0;0;0;0;376920689;380061170;16975693
1235;4.23624e-15;-242;1243;9137;10075.5;1;641;-2.14748e+09;-5.32985e+06;-1;0;0;0;-1;0;376920689;380061170;16975693
1236;4.27178e-15;-211;1457;9537;10131;1;677;-2.14748e+09;-5.31634e+06;-1;0;0;0;-1;0;377131537;380285171;17022738
1236;4.23624e-15;-243;1243;9137;10075.5;1;641;-2.14748e+09;-5.31634e+06;0;0;0;0;0;0;377131537;380285171;17022738
1237;4.27178e-15;-211;1457;9537;10131;1;677;-2.14748e+09;-5.30287e+06;-1;0;0;0;-1;0;377341875;380508680;17069767
1237;4.23624e-15;-244;1243;9137;10075.5;1;641;-2.14748e+09;-5.30287e+06;0;0;0;0;0;0;377341875;380508680;17069767
1238;4.27178e-15;-212;1457;9537;10131;1;677;-2.14748e+09;-5.28955e+06;0;0;0;0;0;0;377551704;380731697;17116778
1238;4.23624e-15;-245;1243;9137;10075.5;1;641;-2.14748e+09;-5.28955e+06;0;0;0;0;0;0;377551704;380731697;17116778
1239;4.27178e-15;-212;1457;9537;10131;1;677;-2.14748e+09;-5.27608e+06;-1;0;0;0;-1;0;377761025;380954225;17163772
1239;4.23624e-15;-245;1243;9137;10075.5;1;641;-2.14748e+09;-5.27608e+06;-1;0;0;0;-1;0;377761025;380954225;17163772
1240;4.27178e-15;-212;1457;9537;10131;1;677;-2.14748e+09;-5.26276e+06;-1;0;0;0;-1;0;377969841;381176264;17210748
1240;4.23624e-15;-246;1243;9137;10075.5;1;641;-2.14748e+09;-5.26276e+06;0;0;0;0;0;0;377969841;381176264;17210748
1241;4.27178e-15;-212;1457;9537;10131;1;677;-2.14748e+09;-5.24959e+06;-1;0;0;0;-1;0;378178151;381397817;17257707
1241;4.23624e-15;-246;1243;9137;10075.5;1;641;-2.14748e+09;-5.24959e+06;-1;0;0;0;-1;0;378178151;381397817;17257707
1242;4.27178e-15;-213;1457;9537;10131;1;677;-2.14748e+09;-5.23626e+06;0;0;0;0;0;0;378385959;381618884;17304648
1242;4.23624e-15;-247;1243;9137;10075.5;1;641;-2.14748e+09;-5.23626e+06;0;0;0;0;0;0;378385959;381618884;17304648
1243;4.27178e-15;-213;1457;9537;10131;1;677;-2.14748e+09;-5.22308e+06;-1;0;0;0;-1;0;378593265;381839467;17351570
1243;4.23624e-15;-247;1243;9137;10075.5;1;641;-2.14748e+09;-5.22308e+06;-1;0;0;0;-1;0;378593265;381839467;17351570
1244;4.27178e-15;-214;1457;9537;10131;1;677;-2.14748e+09;-5.21005e+06;0;0;0;0;0;0;378800072;382059568;17398474
1244;4.23624e-15;-247;1243;9137;10075.5;1;641;-2.14748e+09;-5.21005e+06;-1;0;0;0;-1;0;378800072;382059568;17398474
1245;4.27178e-15;-215;1457;9537;10131;1;677;-2.14748e+09;-5.19686e+06;0;0;0;0;0;0;379006380;382279188;17445360
1245;4.23624e-15;-247;1243;9137;10075.5;1;641;-2.14748e+09;-5.19686e+06;-1;0;0;0;-1;0;379006380;382279188;17445360
1246;4.27178e-15;-215;1457;9537;10131;1;677;-2.14748e+09;-5.18392e+06;-1;0;0;0;-1;0;379212191;382498328;17492226
1246;4.23624e-15;-248;1243;9137;10075.5;1;641;-2.14748e+09;-5.18382e+06;0;0;0;0;0;0;379212191;382498328;17492226
1247;4.27178e-15;-216;1457;9537;10131;1;677;-2.14748e+09;-5.17083e+06;0;0;0;0;0;0;379417507;382716991;17539074
1247;4.23624e-15;-249;1243;9137;10075.5;1;641;-2.14748e+09;-5.17083e+06;0;0;0;0;0;0;379417507;382716991;17539074
1248;4.27178e-15;-216;1457;9537;10131;1;677;-2.14748e+09;-5.15788e+06;-1;0;0;0;-1;0;379622330;382935176;17585902
1248;4.23624e-15;-250;1243;9137;10075.5;1;641;-2.14748e+09;-5.15788e+06;0;0;0;0;0;0;379622330;382935176;17585902
1249;4.27178e-15;-217;1457;9537;10131;1;677;-2.14748e+09;-5.14498e+06;0;0;0;0;0;0;379826660;383152886;17632711
1249;4.23624e-15;-250;1243;9137;10075.5;1;641;-2.14748e+09;-5.14498e+06;-1;0;0;0;-1;0;379826660;383152886;17632711
1250;4.27178e-15;-218;1457;9537;10131;1;677;-2.14748e+09;-5.13212e+06;0;0;0;0;0;0;380030499;383370122;17679500
1250;4.23624e-15;-251;1243;9137;10075.5;1;641;-2.14748e+09;-5.13212e+06;0;0;0;0;0;0;380030499;383370122;17679500
1251;4.27178e-15;-219;1457;9537;10131;1;677;-2.14748e+09;-5.11931e+06;0;0;0;0;0;0;380233849;383586886;17726268
1251;4.23624e-15;-252;1243;9137;10075.5;1;641;-2.14748e+09;-5.11931e+06;0;0;0;0;0;0;380233849;383586886;17726268
1252;4.27178e-15;-219;1457;9537;10131;1;677;-2.14748e+09;-5.10655e+06;-1;0;0;0;-1;0;380436712;383803179;17773017
1252;4.23624e-15;-253;1243;9137;10075.5;1;641;-2.14748e+09;-5.10655e+06;0;0;0;0;0;0;380436712;383803179;17773017
1253;4.27178e-15;-220;1457;9537;10131;1;677;-2.14748e+09;-5.09382e+06;0;0;0;0;0;0;380639088;384019002;17819745
1253;4.23624e-15;-253;1243;9137;10075.5;1;641;-2.14748e+09;-5.09382e+06;-1;0;0;0;-1;0;380639088;384019002;17819745
1254;4.27178e-15;-221;1457;9537;10131;1;677;-2.14748e+09;-5.08115e+06;0;0;0;0;0;0;380840979;384234356;17866453
1254;4.23624e-15;-254;1243;9137;10075.5;1;641;-2.14748e+09;-5.08115e+06;0;0;0;0;0;0;380840979;384234356;17866453
1255;4.27178e-15;-222;1457;9537;10131;1;677;-2.14748e+09;-5.06861e+06;0;0;0;0;0;0;381042388;384449244;17913139
1255;4.23624e-15;-255;1243;9137;10075.5;1;641;-2.14748e+09;-5.06861e+06;0;0;0;0;0;0;381042388;384449244;17913139
1256;4.27178e-15;-222;1457;9537;10131;1;677;-2.14748e+09;-5.05593e+06;-1;0;0;0;-1;0;381243314;384663666;17959805
1256;4.23624e-15;-255;1243;9137;10075.5;1;641;-2.14748e+09;-5.05592e+06;-1;0;0;0;-1;0;381243314;384663666;17959805
1257;4.27178e-15;-223;1457;9537;10131;1;677;-2.14748e+09;-5.04338e+06;0;0;0;0;0;0;381443760;384877624;18006449
1257;4.23624e-15;-255;1243;9137;10075.5;1;641;-2.14748e+09;-5.04338e+06;-1;0;0;0;-1;0;381443760;384877624;18006449
1258;4.27178e-15;-224;1457;9537;10131;1;677;-2.14748e+09;-5.03098e+06;0;0;0;0;0;0;381643727;385091119;18053072
1258;4.23624e-15;-255;1243;9137;10075.5;1;641;-2.14748e+09;-5.03098e+06;-1;0;0;0;-1;0;381643727;385091119;18053072
1259;4.27178e-15;-224;1457;9537;10131;1;677;-2.14748e+09;-5.01842e+06;-1;0;0;0;-1;0;381843216;385304152;18099674
1259;4.23624e-15;-255;1243;9137;10075.5;1;641;-2.14748e+09;-5.01842e+06;-1;0;0;0;-1;0;381843216;385304152;18099674
1260;4.27178e-15;-224;1457;9537;10131;1;677;-2.14748e+09;-5.006e+06;-1;0;0;0;-1;0;382042230;385516726;18146253
1260;4.23624e-15;-256;1243;9137;10075.5;1;641;-2.14748e+09;-5.006e+06;0;0;0;0;0;0;382042230;385516726;18146253
1261;4.27178e-15;-225;1457;9537;10131;1;677;-2.14748e+09;-4.99363e+06;0;0;0;0;0;0;382240769;385728840;18192810
1261;4.23624e-15;-257;1243;9137;10075.5;1;641;-2.14748e+09;-4.99363e+06;0;0;0;0;0;0;382240769;385728840;18192810
1262;4.27178e-15;-226;1457;9537;10131;1;677;-2.14748e+09;-4.9813e+06;0;0;0;0;0;0;382438834;385940497;18239345
1262;4.23624e-15;-257;1243;9137;10075.5;1;641;-2.14748e+09;-4.9813e+06;-1;0;0;0;-1;0;382438834;385940497;18239345
1263;4.27178e-15;-227;1457;9537;10131;1;677;-2.14748e+09;-4.96901e+06;0;0;0;0;0;0;382636428;386151698;18285857
1263;4.23624e-15;-257;1243;9137;10075.5;1;641;-2.14748e+09;-4.96901e+06;-1;0;0;0;-1;0;382636428;386151698;18285857
1264;4.27178e-15;-228;1457;9537;10131;1;677;-2.14748e+09;-4.95677e+06;0;0;0;0;0;0;382833552;386362445;18332347
1264;4.23624e-15;-257;1243;9137;10075.5;1;641;-2.14748e+09;-4.95677e+06;-1;0;0;0;-1;0;382833552;386362445;18332347
1265;4.27178e-15;-229;1457;9537;10131;1;677;-2.14748e+09;-4.94456e+06;0;0;0;0;0;0;383030207;386572737;18378814
1265;4.23624e-15;-257;1243;9137;10075.5;1;641;-2.14748e+09;-4.94456e+06;-1;0;0;0;-1;0;383030207;386572737;18378814
1266;4.27178e-15;-230;1457;9537;10131;1;677;-2.14748e+09;-4.9324e+06;0;0;0;0;0;0;383226394;386782578;18425257
1266;4.23624e-15;-258;1243;9137;10075.5;1;641;-2.14748e+09;-4.9324e+06;0;0;0;0;0;0;383226394;386782578;18425257
1267;4.27178e-15;-231;1457;9537;10131;1;677;-2.14748e+09;-4.92028e+06;0;0;0;0;0;0;383422116;386991967;18471678
1267;4.23624e-15;-259;1243;9137;10075.5;1;641;-2.14748e+09;-4.92028e+06;0;0;0;0;0;0;383422116;386991967;18471678
1268;4.27178e-15;-232;1457;9537;10131;1;677;-2.14748e+09;-4.9082e+06;0;0;0;0;0;0;383617372;387200908;18518074
1268;4.23624e-15;-260;1243;9137;10075.5;1;641;-2.14748e+09;-4.9082e+06;0;0;0;0;0;0;383617372;387200908;18518074
1269;4.27178e-15;-232;1457;9537;10131;1;677;-2.14748e+09;-4.89617e+06;-1;0;0;0;-1;0;383812166;387409399;18564448
1269;4.23624e-15;-261;1243;9137;10075.5;1;641;-2.14748e+09;-4.89617e+06;0;0;0;0;0;0;383812166;387409399;18564448
1270;4.27178e-15;-233;1457;9537;10131;1;677;-2.14748e+09;-4.88417e+06;0;0;0;0;0;0;384006497;387617444;18610797
1270;4.23624e-15;-262;1243;9137;10075.5;1;641;-2.14748e+09;-4.88417e+06;0;0;0;0;0;0;384006497;387617444;18610797
1271;4.27178e-15;-233;1457;9537;10131;1;677;-2.14748e+09;-4.87222e+06;-1;0;0;0;-1;0;384200368;387825043;18657122
1271;4.23624e-15;-262;1243;9137;10075.5;1;641;-2.14748e+09;-4.87222e+06;-1;0;0;0;-1;0;384200368;387825043;18657122
1272;4.27178e-15;-234;1457;9537;10131;1;677;-2.14748e+09;-4.8604e+06;0;0;0;0;0;0;384393780;388032198;18703423
1272;4.23624e-15;-262;1243;9137;10075.5;1;641;-2.14748e+09;-4.8603e+06;-1;0;0;0;-1;0;384393780;388032198;18703423
1273;4.27178e-15;-234;1457;9537;10131;1;677;-2.14748e+09;-4.84843e+06;-1;0;0;0;-1;0;384586734;388238910;18749699
1273;4.23624e-15;-263;1243;9137;10075.5;1;641;-2.14748e+09;-4.84843e+06;0;0;0;0;0;0;384586734;388238910;18749699
1274;4.27178e-15;-234;1457;9537;10131;1;677;-2.14748e+09;-4.83659e+06;-1;0;0;0;-1;0;384779231;388445179;18795951
1274;4.23624e-15;-264;1243;9137;10075.5;1;641;-2.14748e+09;-4.83659e+06;0;0;0;0;0;0;384779231;388445179;18795951
1275;4.27178e-15;-234;1457;9537;10131;1;677;-2.14748e+09;-4.8248e+06;-1;0;0;0;-1;0;384971273;388651008;18842178
1275;4.23624e-15;-265;1243;9137;10075.5;1;641;-2.14748e+09;-4.8248e+06;0;0;0;0;0;0;384971273;388651008;18842178
1276;4.27178e-15;-234;1457;9537;10131;1;677;-2.14748e+09;-4.81304e+06;-1;0;0;0;-1;0;385162862;388856398;18888380
1276;4.23624e-15;-266;1243;9137;10075.5;1;641;-2.14748e+09;-4.81304e+06;0;0;0;0;0;0;385162862;388856398;18888380
1277;4.27178e-15;-235;1457;9537;10131;1;677;-2.14748e+09;-4.80133e+06;0;0;0;0;0;0;385353998;389061350;18934557
1277;4.23624e-15;-267;1243;9137;10075.5;1;641;-2.14748e+09;-4.80133e+06;0;0;0;0;0;0;385353998;389061350;18934557
1278;4.27178e-15;-235;1457;9537;10131;1;677;-2.14748e+09;-4.78965e+06;-1;0;0;0;-1;0;385544684;389265865;18980708
1278;4.23624e-15;-268;1243;9137;10075.5;1;641;-2.14748e+09;-4.78965e+06;0;0;0;0;0;0;385544684;389265865;18980708
1279;4.27178e-15;-236;1457;9537;10131;1;677;-2.14748e+09;-4.77812e+06;0;0;0;0;0;0;385734919;389469944;19026834
1279;4.23624e-15;-268;1243;9137;10075.5;1;641;-2.14748e+09;-4.77802e+06;-1;0;0;0;-1;0;385734919;389469944;19026834
1280;4.27178e-15;-236;1457;9537;10131;1;677;-2.14748e+09;-4.76642e+06;-1;0;0;0;-1;0;385924707;389673589;19072933
1280;4.23624e-15;-268;1243;9137;10075.5;1;641;-2.14748e+09;-4.76642e+06;-1;0;0;0;-1;0;385924707;389673589;19072933
1281;4.27178e-15;-236;1457;9537;10131;1;677;-2.14748e+09;-4.75486e+06;-1;0;0;0;-1;0;386114047;389876800;19119007
1281;4.23624e-15;-269;1243;9137;10075.5;1;641;-2.14748e+09;-4.75486e+06;0;0;0;0;0;0;386114047;389876800;19119007
1282;4.27178e-15;-237;1457;9537;10131;1;677;-2.14748e+09;-4.74344e+06;0;0;0;0;0;0;386302942;390079580;19165055
1282;4.23624e-15;-270;1243;9137;10075.5;1;641;-2.14748e+09;-4.74334e+06;0;0;0;0;0;0;386302942;390079580;19165055
1283;4.27178e-15;-238;1457;9537;10131;1;677;-2.14748e+09;-4.73186e+06;0;0;0;0;0;0;386491392;390281929;19211077
1283;4.23624e-15;-271;1243;9137;10075.5;1;641;-2.14748e+09;-4.73186e+06;0;0;0;0;0;0;386491392;390281929;19211077
1284;4.27178e-15;-238;1457;9537;10131;1;677;-2.14748e+09;-4.72042e+06;-1;0;0;0;-1;0;386679399;390483849;19257072
1284;4.23624e-15;-271;1243;9137;10075.5;1;641;-2.14748e+09;-4.72042e+06;-1;0;0;0;-1;0;386679399;390483849;19257072
1285;4.27178e-15;-238;1457;9537;10131;1;677;-2.14748e+09;-4.70901e+06;-1;0;0;0;-1;0;386866964;390685340;19303041
1285;4.23624e-15;-272;1243;9137;10075.5;1;641;-2.14748e+09;-4.70901e+06;0;0;0;0;0;0;386866964;390685340;19303041
1286;4.27178e-15;-238;1457;9537;10131;1;677;-2.14748e+09;-4.69764e+06;-1;0;0;0;-1;0;387054089;390886405;19348982
1286;4.23624e-15;-273;1243;9137;10075.5;1;641;-2.14748e+09;-4.69764e+06;0;0;0;0;0;0;387054089;390886404;19348982
1287;4.27178e-15;-239;1457;9537;10131;1;677;-2.14748e+09;-4.68631e+06;0;0;0;0;0;0;387240775;391087043;19394897
1287;4.23624e-15;-274;1243;9137;10075.5;1;641;-2.14748e+09;-4.68631e+06;0;0;0;0;0;0;387240775;391087043;19394897
1288;4.27178e-15;-240;1457;9537;10131;1;677;-2.14748e+09;-4.67512e+06;0;0;0;0;0;0;387427022;391287257;19440784
1288;4.23624e-15;-275;1243;9137;10075.5;1;641;-2.14748e+09;-4.67512e+06;0;0;0;0;0;0;387427022;391287257;19440784
1289;4.27178e-15;-240;1457;9537;10131;1;677;-2.14748e+09;-4.66377e+06;-1;0;0;0;-1;0;387612833;391487047;19486644
1289;4.23624e-15;-275;1243;9137;10075.5;1;641;-2.14748e+09;-4.66377e+06;-1;0;0;0;-1;0;387612833;391487047;19486644
1290;4.27178e-15;-240;1457;9537;10131;1;677;-2.14748e+09;-4.65255e+06;-1;0;0;0;-1;0;387798209;391686415;19532477
1290;4.23624e-15;-275;1243;9137;10075.5;1;641;-2.14748e+09;-4.65255e+06;-1;0;0;0;-1;0;387798209;391686415;19532477
1291;4.27178e-15;-240;1457;9537;10131;1;677;-2.14748e+09;-4.64137e+06;-1;0;0;0;-1;0;387983151;391885362;19578282
1291;4.23624e-15;-276;1243;9137;10075.5;1;641;-2.14748e+09;-4.64137e+06;0;0;0;0;0;0;387983151;391885362;19578282
1292;4.27178e-15;-241;1457;9537;10131;1;677;-2.14748e+09;-4.63022e+06;0;0;0;0;0;0;388167660;392083889;19624059
1292;4.23624e-15;-276;1243;9137;10075.5;1;641;-2.14748e+09;-4.63022e+06;-1;0;0;0;-1;0;388167660;392083889;19624059
1293;4.27178e-15;-241;1457;9537;10131;1;677;-2.14748e+09;-4.61912e+06;-1;0;0;0;-1;0;388351737;392281997;19669808
1293;4.23624e-15;-277;1243;9137;10075.5;1;641;-2.14748e+09;-4.61912e+06;0;0;0;0;0;0;388351737;392281997;19669808
1294;4.27178e-15;-242;1457;9537;10131;1;677;-2.14748e+09;-4.60815e+06;0;0;0;0;0;0;388535384;392479688;19715529
1294;4.23624e-15;-277;1243;9137;10075.5;1;641;-2.14748e+09;-4.60805e+06;-1;0;0;0;-1;0;388535384;392479688;19715529
1295;4.27178e-15;-242;1457;9537;10131;1;677;-2.14748e+09;-4.59701e+06;-1;0;0;0;-1;0;388718602;392676962;19761222
1295;4.23624e-15;-277;1243;9137;10075.5;1;641;-2.14748e+09;-4.59701e+06;-1;0;0;0;-1;0;388718602;392676962;19761222
1296;4.27178e-15;-242;1457;9537;10131;1;677;-2.14748e+09;-4.58601e+06;-1;0;0;0;-1;0;388901393;392873821;19806886
1296;4.23624e-15;-277;1243;9137;10075.5;1;641;-2.14748e+09;-4.58601e+06;-1;0;0;0;-1;0;388901393;392873821;19806886
1297;4.27178e-15;-242;1457;9537;10131;1;677;-2.14748e+09;-4.57505e+06;-1;0;0;0;-1;0;389083757;393070266;19852521
1297;4.23624e-15;-277;1243;9137;10075.5;1;641;-2.14748e+09;-4.57505e+06;-1;0;0;0;-1;0;389083757;393070266;19852521
1298;4.27178e-15;-242;1457;9537;10131;1;677;-2.14748e+09;-4.56422e+06;-1;0;0;0;-1;0;389265695;393266298;19898128
1298;4.23624e-15;-277;1243;9137;10075.5;1;641;-2.14748e+09;-4.56412e+06;-1;0;0;0;-1;0;389265695;393266298;19898128
1299;4.27178e-15;-243;1457;9537;10131;1;677;-2.14748e+09;-4.55333e+06;0;0;0;0;0;0;389447210;393461918;19943706
1299;4.23624e-15;-278;1243;9137;10075.5;1;641;-2.14748e+09;-4.55323e+06;0;0;0;0;0;0;389447210;393461918;19943706
1300;4.27178e-15;-243;1457;9537;10131;1;677;-2.14748e+09;-4.54238e+06;-1;0;0;0;-1;0;389628301;393657127;19989254
1300;4.23624e-15;-278;1243;9137;10075.5;1;641;-2.14748e+09;-4.54238e+06;-1;0;0;0;-1;0;389628301;393657127;19989254
1301;4.27178e-15;-244;1457;9537;10131;1;677;-2.14748e+09;-4.53166e+06;0;0;0;0;0;0;389808971;393851927;20034774
1301;4.23624e-15;-278;1243;9137;10075.5;1;641;-2.14748e+09;-4.53156e+06;-1;0;0;0;-1;0;389808971;393851927;20034774
1302;4.27178e-15;-244;1457;9537;10131;1;677;-2.14748e+09;-4.52077e+06;-1;0;0;0;-1;0;389989221;394046318;20080263
1302;4.23624e-15;-279;1243;9137;10075.5;1;641;-2.14748e+09;-4.52077e+06;0;0;0;0;0;0;389989221;394046318;20080263
1303;4.27178e-15;-244;1457;9537;10131;1;677;-2.14748e+09;-4.51002e+06;-1;0;0;0;-1;0;390169052;394240303;20125724
1303;4.23624e-15;-280;1243;9137;10075.5;1;641;-2.14748e+09;-4.51002e+06;0;0;0;0;0;0;390169052;394240303;20125724
1304;4.27178e-15;-245;1457;9537;10131;1;677;-2.14748e+09;-4.4993e+06;0;0;0;0;0;0;390348464;394433880;20171154
1304;4.23624e-15;-280;1243;9137;10075.5;1;641;-2.14748e+09;-4.4993e+06;-1;0;0;0;-1;0;390348464;394433880;20171154
1305;4.27178e-15;-245;1457;9537;10131;1;677;-2.14748e+09;-4.48862e+06;-1;0;0;0;-1;0;390527460;394627053;20216554
1305;4.23624e-15;-281;1243;9137;10075.5;1;641;-2.14748e+09;-4.48862e+06;0;0;0;0;0;0;390527460;394627053;20216554
1306;4.27178e-15;-246;1457;9537;10131;1;677;-2.14748e+09;-4.47798e+06;0;0;0;0;0;0;390706040;394819822;20261925
1306;4.23624e-15;-282;1243;9137;10075.5;1;641;-2.14748e+09;-4.47798e+06;0;0;0;0;0;0;390706040;394819822;20261925
1307;4.27178e-15;-247;1457;9537;10131;1;677;-2.14748e+09;-4.46746e+06;0;0;0;0;0;0;390884206;395012188;20307265
1307;4.23624e-15;-282;1243;9137;10075.5;1;641;-2.14748e+09;-4.46746e+06;-1;0;0;0;-1;0;390884206;395012188;20307265
1308;4.27178e-15;-248;1457;9537;10131;1;677;-2.14748e+09;-4.45678e+06;0;0;0;0;0;0;391061959;395204152;20352575
1308;4.23624e-15;-282;1243;9137;10075.5;1;641;-2.14748e+09;-4.45678e+06;-1;0;0;0;-1;0;391061959;395204152;20352575
1309;4.27178e-15;-248;1457;9537;10131;1;677;-2.14748e+09;-4.44624e+06;-1;0;0;0;-1;0;391239300;395395716;20397855
1309;4.23624e-15;-283;1243;9137;10075.5;1;641;-2.14748e+09;-4.44624e+06;0;0;0;0;0;0;391239300;395395716;20397855
1310;4.27178e-15;-248;1457;9537;10131;1;677;-2.14748e+09;-4.43573e+06;-1;0;0;0;-1;0;391416230;395586880;20443103
1310;4.23624e-15;-283;1243;9137;10075.5;1;641;-2.14748e+09;-4.43573e+06;-1;0;0;0;-1;0;391416230;395586880;20443103
1311;4.27178e-15;-249;1457;9537;10131;1;677;-2.14748e+09;-4.42525e+06;0;0;0;0;0;0;391592750;395777646;20488321
1311;4.23624e-15;-284;1243;9137;10075.5;1;641;-2.14748e+09;-4.42525e+06;0;0;0;0;0;0;391592750;395777646;20488321
1312;4.27178e-15;-249;1457;9537;10131;1;677;-2.14748e+09;-4.41491e+06;-1;0;0;0;-1;0;391768862;395968014;20533508
1312;4.23624e-15;-285;1243;9137;10075.5;1;641;-2.14748e+09;-4.41481e+06;0;0;0;0;0;0;391768862;395968014;20533508
1313;4.27178e-15;-249;1457;9537;10131;1;677;-2.14748e+09;-4.4044e+06;-1;0;0;0;-1;0;391944567;396157985;20578664
1313;4.23624e-15;-286;1243;9137;10075.5;1;641;-2.14748e+09;-4.4044e+06;0;0;0;0;0;0;391944567;396157985;20578664
1314;4.27178e-15;-249;1457;9537;10131;1;677;-2.14748e+09;-4.39412e+06;-1;0;0;0;-1;0;392119866;396347562;20623789
1314;4.23624e-15;-287;1243;9137;10075.5;1;641;-2.14748e+09;-4.39412e+06;0;0;0;0;0;0;392119866;396347562;20623789
1315;4.27178e-15;-250;1457;9537;10131;1;677;-2.14748e+09;-4.38378e+06;0;0;0;0;0;0;392294760;396536744;20668882
1315;4.23624e-15;-287;1243;9137;10075.5;1;641;-2.14748e+09;-4.38378e+06;-1;0;0;0;-1;0;392294760;396536744;20668882
1316;4.27178e-15;-251;1457;9537;10131;1;677;-2.14748e+09;-4.37336e+06;0;0;0;0;0;0;392469249;396725534;20713944
1316;4.23624e-15;-288;1243;9137;10075.5;1;641;-2.14748e+09;-4.37336e+06;0;0;0;0;0;0;392469249;396725534;20713944
1317;4.27178e-15;-251;1457;9537;10131;1;677;-2.14748e+09;-4.36308e+06;-1;0;0;0;-1;0;392643337;396913931;20758974
1317;4.23624e-15;-288;1243;9137;10075.5;1;641;-2.14748e+09;-4.36308e+06;-1;0;0;0;-1;0;392643337;396913931;20758974
1318;4.27178e-15;-252;1457;9537;10131;1;677;-2.14748e+09;-4.35284e+06;0;0;0;0;0;0;392817023;397101937;20803972
1318;4.23624e-15;-289;1243;9137;10075.5;1;641;-2.14748e+09;-4.35284e+06;0;0;0;0;0;0;392817023;397101937;20803972
1319;4.27178e-15;-253;1457;9537;10131;1;677;-2.14748e+09;-4.34272e+06;0;0;0;0;0;0;392990308;397289553;20848939
1319;4.23624e-15;-290;1243;9137;10075.5;1;641;-2.14748e+09;-4.34272e+06;0;0;0;0;0;0;392990308;397289553;20848939
1320;4.27178e-15;-253;1457;9537;10131;1;677;-2.14748e+09;-4.33244e+06;-1;0;0;0;-1;0;393163194;397476781;20893873
1320;4.23624e-15;-290;1243;9137;10075.5;1;641;-2.14748e+09;-4.33244e+06;-1;0;0;0;-1;0;393163194;397476781;20893873
1321;4.27178e-15;-254;1457;9537;10131;1;677;-2.14748e+09;-4.32229e+06;0;0;0;0;0;0;393335683;397663620;20938775
1321;4.23624e-15;-290;1243;9137;10075.5;1;641;-2.14748e+09;-4.32229e+06;-1;0;0;0;-1;0;393335683;397663620;20938775
1322;4.27178e-15;-254;1457;9537;10131;1;677;-2.14748e+09;-4.31218e+06;-1;0;0;0;-1;0;393507774;397850073;20983645
1322;4.23624e-15;-290;1243;9137;10075.5;1;641;-2.14748e+09;-4.31218e+06;-1;0;0;0;-1;0;393507774;397850073;20983645
1323;4.27178e-15;-255;1457;9537;10131;1;677;-2.14748e+09;-4.30209e+06;0;0;0;0;0;0;393679469;398036140;21028482
1323;4.23624e-15;-290;1243;9137;10075.5;1;641;-2.14748e+09;-4.30209e+06;-1;0;0;0;-1;0;393679469;398036140;21028482
1324;4.27178e-15;-256;1457;9537;10131;1;677;-2.14748e+09;-4.29214e+06;0;0;0;0;0;0;393850770;398221823;21073287
1324;4.23624e-15;-290;1243;9137;10075.5;1;641;-2.14748e+09;-4.29204e+06;-1;0;0;0;-1;0;393850770;398221823;21073287
1325;4.27178e-15;-256;1457;9537;10131;1;677;-2.14748e+09;-4.28201e+06;-1;0;0;0;-1;0;394021677;398407121;21118059
1325;4.23624e-15;-290;1243;9137;10075.5;1;641;-2.14748e+09;-4.28201e+06;-1;0;0;0;-1;0;394021677;398407121;21118059
1326;4.27178e-15;-257;1457;9537;10131;1;677;-2.14748e+09;-4.27202e+06;0;0;0;0;0;0;394192192;398592037;21162798
1326;4.23624e-15;-290;1243;9137;10075.5;1;641;-2.14748e+09;-4.27202e+06;-1;0;0;0;-1;0;394192192;398592037;21162798
1327;4.27178e-15;-258;1457;9537;10131;1;677;-2.14748e+09;-4.26206e+06;0;0;0;0;0;0;394362315;398776571;21207504
1327;4.23624e-15;-290;1243;9137;10075.5;1;641;-2.14748e+09;-4.26206e+06;-1;0;0;0;-1;0;394362315;398776571;21207504
1328;4.27178e-15;-258;1457;9537;10131;1;677;-2.14748e+09;-4.25213e+06;-1;0;0;0;-1;0;394532048;398960725;21252178
1328;4.23624e-15;-290;1243;9137;10075.5;1;641;-2.14748e+09;-4.25213e+06;-1;0;0;0;-1;0;394532048;398960725;21252178
1329;4.27178e-15;-259;1457;9537;10131;1;677;-2.14748e+09;-4.24224e+06;0;0;0;0;0;0;394701392;399144499;21296817
1329;4.23624e-15;-290;1243;9137;10075.5;1;641;-2.14748e+09;-4.24224e+06;-1;0;0;0;-1;0;394701392;399144499;21296817
1330;4.27178e-15;-260;1457;9537;10131;1;677;-2.14748e+09;-4.23247e+06;0;0;0;0;0;0;394870348;399327894;21341424
1330;4.23624e-15;-291;1243;9137;10075.5;1;641;-2.14748e+09;-4.23237e+06;0;0;0;0;0;0;394870348;399327894;21341424
1331;4.27178e-15;-261;1457;9537;10131;1;677;-2.14748e+09;-4.22253e+06;0;0;0;0;0;0;395038917;399510912;21385997
1331;4.23624e-15;-291;1243;9137;10075.5;1;641;-2.14748e+09;-4.22253e+06;-1;0;0;0;-1;0;395038917;399510912;21385997
1332;4.27178e-15;-261;1457;9537;10131;1;677;-2.14748e+09;-4.21272e+06;-1;0;0;0;-1;0;395207100;399693553;21430536
1332;4.23624e-15;-291;1243;9137;10075.5;1;641;-2.14748e+09;-4.21272e+06;-1;0;0;0;-1;0;395207100;399693553;21430536
1333;4.27178e-15;-262;1457;9537;10131;1;677;-2.14748e+09;-4.20295e+06;0;0;0;0;0;0;395374899;399875819;21475041
1333;4.23624e-15;-291;1243;9137;10075.5;1;641;-2.14748e+09;-4.20295e+06;-1;0;0;0;-1;0;395374899;399875819;21475041
1334;4.27178e-15;-262;1457;9537;10131;1;677;-2.14748e+09;-4.1932e+06;-1;0;0;0;-1;0;395542313;400057709;21519513
1334;4.23624e-15;-292;1243;9137;10075.5;1;641;-2.14748e+09;-4.1932e+06;0;0;0;0;0;0;395542313;400057709;21519513
1335;4.27178e-15;-262;1457;9537;10131;1;677;-2.14748e+09;-4.18359e+06;-1;0;0;0;-1;0;395709345;400239227;21563951
1335;4.23624e-15;-293;1243;9137;10075.5;1;641;-2.14748e+09;-4.18359e+06;0;0;0;0;0;0;395709345;400239227;21563951
1336;4.27178e-15;-262;1457;9537;10131;1;677;-2.14748e+09;-4.1738e+06;-1;0;0;0;-1;0;395875996;400420371;21608354
1336;4.23624e-15;-294;1243;9137;10075.5;1;641;-2.14748e+09;-4.1738e+06;0;0;0;0;0;0;395875996;400420371;21608354
1337;4.27178e-15;-262;1457;9537;10131;1;677;-2.14748e+09;-4.16425e+06;-1;0;0;0;-1;0;396042265;400601144;21652724
1337;4.23624e-15;-295;1243;9137;10075.5;1;641;-2.14748e+09;-4.16415e+06;0;0;0;0;0;0;396042265;400601144;21652724
1338;4.27178e-15;-262;1457;9537;10131;1;677;-2.14748e+09;-4.15452e+06;-1;0;0;0;-1;0;396208156;400781546;21697059
1338;4.23624e-15;-296;1243;9137;10075.5;1;641;-2.14748e+09;-4.15452e+06;0;0;0;0;0;0;396208156;400781546;21697059
1339;4.27178e-15;-263;1457;9537;10131;1;677;-2.14748e+09;-4.14502e+06;0;0;0;0;0;0;396373668;400961579;21741359
1339;4.23624e-15;-296;1243;9137;10075.5;1;641;-2.14748e+09;-4.14502e+06;-1;0;0;0;-1;0;396373668;400961579;21741359
1340;4.27178e-15;-263;1457;9537;10131;1;677;-2.14748e+09;-4.13536e+06;-1;0;0;0;-1;0;396538803;401141242;21785625
1340;4.23624e-15;-297;1243;9137;10075.5;1;641;-2.14748e+09;-4.13536e+06;0;0;0;0;0;0;396538803;401141242;21785625
1341;4.27178e-15;-264;1457;9537;10131;1;677;-2.14748e+09;-4.12592e+06;0;0;0;0;0;0;396703561;401320538;21829856
1341;4.23624e-15;-297;1243;9137;10075.5;1;641;-2.14748e+09;-4.12592e+06;-1;0;0;0;-1;0;396703561;401320538;21829856
1342;4.27178e-15;-264;1457;9537;10131;1;677;-2.14748e+09;-4.11631e+06;-1;0;0;0;-1;0;396867944;401499467;21874053
1342;4.23624e-15;-298;1243;9137;10075.5;1;641;-2.14748e+09;-4.11631e+06;0;0;0;0;0;0;396867944;401499467;21874053
1343;4.27178e-15;-264;1457;9537;10131;1;677;-2.14748e+09;-4.10683e+06;-1;0;0;0;-1;0;397031954;401678030;21918214
1343;4.23624e-15;-299;1243;9137;10075.5;1;641;-2.14748e+09;-4.10683e+06;0;0;0;0;0;0;397031954;401678030;21918214
1344;4.27178e-15;-265;1457;9537;10131;1;677;-2.14748e+09;-4.09738e+06;0;0;0;0;0;0;397195590;401856229;21962340
1344;4.23624e-15;-299;1243;9137;10075.5;1;641;-2.14748e+09;-4.09738e+06;-1;0;0;0;-1;0;397195590;401856229;21962340
1345;4.27178e-15;-265;1457;9537;10131;1;677;-2.14748e+09;-4.08806e+06;-1;0;0;0;-1;0;397358854;402034063;22006432
1345;4.23624e-15;-299;1243;9137;10075.5;1;641;-2.14748e+09;-4.08796e+06;-1;0;0;0;-1;0;397358853;402034063;22006432
1346;4.27178e-15;-265;1457;9537;10131;1;677;-2.14748e+09;-4.07857e+06;-1;0;0;0;-1;0;397521746;402211534;22050488
1346;4.23624e-15;-300;1243;9137;10075.5;1;641;-2.14748e+09;-4.07857e+06;0;0;0;0;0;0;397521746;402211534;22050488
1347;4.27178e-15;-265;1457;9537;10131;1;677;-2.14748e+09;-4.0693e+06;-1;0;0;0;-1;0;397684269;402388643;22094508
1347;4.23624e-15;-301;1243;9137;10075.5;1;641;-2.14748e+09;-4.0693e+06;0;0;0;0;0;0;397684269;402388643;22094508
1348;4.27178e-15;-265;1457;9537;10131;1;677;-2.14748e+09;-4.05997e+06;-1;0;0;0;-1;0;397846423;402565391;22138493
1348;4.23624e-15;-301;1243;9137;10075.5;1;641;-2.14748e+09;-4.05997e+06;-1;0;0;0;-1;0;397846423;402565391;22138493
1349;4.27178e-15;-265;1457;9537;10131;1;677;-2.14748e+09;-4.05056e+06;-1;0;0;0;-1;0;398008209;402741779;22182443
1349;4.23624e-15;-302;1243;9137;10075.5;1;641;-2.14748e+09;-4.05056e+06;0;0;0;0;0;0;398008209;402741779;22182443
1350;4.27178e-15;-266;1457;9537;10131;1;677;-2.14748e+09;-4.04138e+06;0;0;0;0;0;0;398169628;402917808;22226356
1350;4.23624e-15;-302;1243;9137;10075.5;1;641;-2.14748e+09;-4.04128e+06;-1;0;0;0;-1;0;398169628;402917808;22226356
1351;4.27178e-15;-267;1457;9537;10131;1;677;-2.14748e+09;-4.03213e+06;0;0;0;0;0;0;398330681;403093478;22270234
1351;4.23624e-15;-302;1243;9137;10075.5;1;641;-2.14748e+09;-4.03203e+06;-1;0;0;0;-1;0;398330681;403093478;22270234
1352;4.27178e-15;-267;1457;9537;10131;1;677;-2.14748e+09;-4.02281e+06;-1;0;0;0;-1;0;398491369;403268791;22314076
1352;4.23624e-15;-303;1243;9137;10075.5;1;641;-2.14748e+09;-4.02281e+06;0;0;0;0;0;0;398491369;403268791;22314076
1353;4.27178e-15;-268;1457;9537;10131;1;677;-2.14748e+09;-4.01371e+06;0;0;0;0;0;0;398651693;403443747;22357882
1353;4.23624e-15;-304;1243;9137;10075.5;1;641;-2.14748e+09;-4.01361e+06;0;0;0;0;0;0;398651693;403443747;22357882
1354;4.27178e-15;-269;1457;9537;10131;1;677;-2.14748e+09;-4.00454e+06;0;0;0;0;0;0;398811654;403618348;22401652
1354;4.23624e-15;-305;1243;9137;10075.5;1;641;-2.14748e+09;-4.00444e+06;0;0;0;0;0;0;398811654;403618348;22401652
1355;4.27178e-15;-270;1457;9537;10131;1;677;-2.14748e+09;-3.9953e+06;0;0;0;0;0;0;398971253;403792594;22445386
1355;4.23624e-15;-306;1243;9137;10075.5;1;641;-2.14748e+09;-3.9953e+06;0;0;0;0;0;0;398971253;403792594;22445386
1356;4.27178e-15;-271;1457;9537;10131;1;677;-2.14748e+09;-3.98629e+06;0;0;0;0;0;0;399130491;403966486;22489083
1356;4.23624e-15;-306;1243;9137;10075.5;1;641;-2.14748e+09;-3.98619e+06;-1;0;0;0;-1;0;399130491;403966486;22489083
1357;4.27178e-15;-272;1457;9537;10131;1;677;-2.14748e+09;-3.9772e+06;0;0;0;0;0;0;399289370;404140026;22532744
1357;4.23624e-15;-307;1243;9137;10075.5;1;641;-2.14748e+09;-3.9772e+06;0;0;0;0;0;0;399289370;404140026;22532744
1358;4.27178e-15;-272;1457;9537;10131;1;677;-2.14748e+09;-3.96815e+06;-1;0;0;0;-1;0;399447889;404313214;22576368
1358;4.23624e-15;-308;1243;9137;10075.5;1;641;-2.14748e+09;-3.96815e+06;0;0;0;0;0;0;399447889;404313214;22576368
1359;4.27178e-15;-273;1457;9537;10131;1;677;-2.14748e+09;-3.95912e+06;0;0;0;0;0;0;399606050;404486050;22619956
1359;4.23624e-15;-308;1243;9137;10075.5;1;641;-2.14748e+09;-3.95912e+06;-1;0;0;0;-1;0;399606050;404486050;22619956
1360;4.27178e-15;-274;1457;9537;10131;1;677;-2.14748e+09;-3.95001e+06;0;0;0;0;0;0;399763855;404658537;22663507
1360;4.23624e-15;-309;1243;9137;10075.5;1;641;-2.14748e+09;-3.95001e+06;0;0;0;0;0;0;399763855;404658537;22663507
1361;4.27178e-15;-275;1457;9537;10131;1;677;-2.14748e+09;-3.94113e+06;0;0;0;0;0;0;399921303;404830674;22707021
1361;4.23624e-15;-309;1243;9137;10075.5;1;641;-2.14748e+09;-3.94103e+06;-1;0;0;0;-1;0;399921303;404830674;22707021
1362;4.27178e-15;-275;1457;9537;10131;1;677;-2.14748e+09;-3.93218e+06;-1;0;0;0;-1;0;400078397;405002463;22750498
1362;4.23624e-15;-310;1243;9137;10075.5;1;641;-2.14748e+09;-3.93218e+06;0;0;0;0;0;0;400078397;405002463;22750498
1363;4.27178e-15;-275;1457;9537;10131;1;677;-2.14748e+09;-3.92316e+06;-1;0;0;0;-1;0;400235136;405173904;22793938
1363;4.23624e-15;-311;1243;9137;10075.5;1;641;-2.14748e+09;-3.92316e+06;0;0;0;0;0;0;400235136;405173904;22793938
1364;4.27178e-15;-276;1457;9537;10131;1;677;-2.14748e+09;-3.91436e+06;0;0;0;0;0;0;400391522;405344999;22837341
1364;4.23624e-15;-312;1243;9137;10075.5;1;641;-2.14748e+09;-3.91436e+06;0;0;0;0;0;0;400391522;405344999;22837341
1365;4.27178e-15;-276;1457;9537;10131;1;677;-2.14748e+09;-3.90549e+06;-1;0;0;0;-1;0;400547556;405515748;22880707
1365;4.23624e-15;-312;1243;9137;10075.5;1;641;-2.14748e+09;-3.90539e+06;-1;0;0;0;-1;0;400547556;405515748;22880707
1366;4.27178e-15;-277;1457;9537;10131;1;677;-2.14748e+09;-3.89665e+06;0;0;0;0;0;0;400703239;405686152;22924036
1366;4.23624e-15;-312;1243;9137;10075.5;1;641;-2.14748e+09;-3.89655e+06;-1;0;0;0;-1;0;400703239;405686152;22924036
1367;4.27178e-15;-278;1457;9537;10131;1;677;-2.14748e+09;-3.88783e+06;0;0;0;0;0;0;400858572;405856213;22967327
1367;4.23624e-15;-312;1243;9137;10075.5;1;641;-2.14748e+09;-3.88783e+06;-1;0;0;0;-1;0;400858572;405856213;22967327
1368;4.27178e-15;-278;1457;9537;10131;1;677;-2.14748e+09;-3.87893e+06;-1;0;0;0;-1;0;401013555;406025930;23010580
1368;4.23624e-15;-312;1243;9137;10075.5;1;641;-2.14748e+09;-3.87893e+06;-1;0;0;0;-1;0;401013555;406025930;23010580
1369;4.27178e-15;-278;1457;9537;10131;1;677;-2.14748e+09;-3.87027e+06;-1;0;0;0;-1;0;401168190;406195305;23053796
1369;4.23624e-15;-312;1243;9137;10075.5;1;641;-2.14748e+09;-3.87027e+06;-1;0;0;0;-1;0;401168190;406195305;23053796
1370;4.27178e-15;-279;1457;9537;10131;1;677;-2.14748e+09;-3.86153e+06;0;0;0;0;0;0;401322478;406364339;23096974
1370;4.23624e-15;-312;1243;9137;10075.5;1;641;-2.14748e+09;-3.86153e+06;-1;0;0;0;-1;0;401322478;406364339;23096974
1371;4.27178e-15;-280;1457;9537;10131;1;677;-2.14748e+09;-3.85281e+06;0;0;0;0;0;0;401476419;406533032;23140115
1371;4.23624e-15;-312;1243;9137;10075.5;1;641;-2.14748e+09;-3.85271e+06;-1;0;0;0;-1;0;401476419;406533032;23140115
1372;4.27178e-15;-280;1457;9537;10131;1;677;-2.14748e+09;-3.84412e+06;-1;0;0;0;-1;0;401630015;406701386;23183217
1372;4.23624e-15;-312;1243;9137;10075.5;1;641;-2.14748e+09;-3.84412e+06;-1;0;0;0;-1;0;401630015;406701386;23183217
1373;4.27178e-15;-281;1457;9537;10131;1;677;-2.14748e+09;-3.83546e+06;0;0;0;0;0;0;401783267;406869401;23226282
1373;4.23624e-15;-313;1243;9137;10075.5;1;641;-2.14748e+09;-3.83536e+06;0;0;0;0;0;0;401783267;406869401;23226282
1374;4.27178e-15;-281;1457;9537;10131;1;677;-2.14748e+09;-3.82682e+06;-1;0;0;0;-1;0;401936174;407037078;23269309
1374;4.23624e-15;-314;1243;9137;10075.5;1;641;-2.14748e+09;-3.82672e+06;0;0;0;0;0;0;401936174;407037078;23269309
1375;4.27178e-15;-281;1457;9537;10131;1;677;-2.14748e+09;-3.81811e+06;-1;0;0;0;-1;0;402088739;407204418;23312297
1375;4.23624e-15;-315;1243;9137;10075.5;1;641;-2.14748e+09;-3.81811e+06;0;0;0;0;0;0;402088739;407204418;23312297
1376;4.27178e-15;-282;1457;9537;10131;1;677;-2.14748e+09;-3.80952e+06;0;0;0;0;0;0;402240963;407371421;23355247
1376;4.23624e-15;-315;1243;9137;10075.5;1;641;-2.14748e+09;-3.80952e+06;-1;0;0;0;-1;0;402240963;407371421;23355247
1377;4.27178e-15;-282;1457;9537;10131;1;677;-2.14748e+09;-3.80096e+06;-1;0;0;0;-1;0;402392845;407538090;23398159
1377;4.23624e-15;-315;1243;9137;10075.5;1;641;-2.14748e+09;-3.80096e+06;-1;0;0;0;-1;0;402392845;407538090;23398159
1378;4.27178e-15;-282;1457;9537;10131;1;677;-2.14748e+09;-3.79242e+06;-1;0;0;0;-1;0;402544388;407704424;23441033
1378;4.23624e-15;-315;1243;9137;10075.5;1;641;-2.14748e+09;-3.79242e+06;-1;0;0;0;-1;0;402544388;407704424;23441033
1379;4.27178e-15;-282;1457;9537;10131;1;677;-2.14748e+09;-3.7839e+06;-1;0;0;0;-1;0;402695591;407870424;23483868
1379;4.23624e-15;-315;1243;9137;10075.5;1;641;-2.14748e+09;-3.7839e+06;-1;0;0;0;-1;0;402695591;407870424;23483868
1380;4.27178e-15;-283;1457;9537;10131;1;677;-2.14748e+09;-3.77542e+06;0;0;0;0;0;0;402846457;408036091;23526664
1380;4.23624e-15;-316;1243;9137;10075.5;1;641;-2.14748e+09;-3.77542e+06;0;0;0;0;0;0;402846457;408036091;23526664
1381;4.27178e-15;-284;1457;9537;10131;1;677;-2.14748e+09;-3.76695e+06;0;0;0;0;0;0;402996985;408201426;23569422
1381;4.23624e-15;-316;1243;9137;10075.5;1;641;-2.14748e+09;-3.76695e+06;-1;0;0;0;-1;0;402996985;408201426;23569422
1382;4.27178e-15;-284;1457;9537;10131;1;677;-2.14748e+09;-3.75851e+06;-1;0;0;0;-1;0;403147177;408366431;23612141
1382;4.23624e-15;-316;1243;9137;10075.5;1;641;-2.14748e+09;-3.75851e+06;-1;0;0;0;-1;0;403147177;408366431;23612141
1383;4.27178e-15;-285;1457;9537;10131;1;677;-2.14748e+09;-3.7501e+06;0;0;0;0;0;0;403297034;408531104;23654822
1383;4.23624e-15;-317;1243;9137;10075.5;1;641;-2.14748e+09;-3.7501e+06;0;0;0;0;0;0;403297034;408531104;23654822
1384;4.27178e-15;-286;1457;9537;10131;1;677;-2.14748e+09;-3.74171e+06;0;0;0;0;0;0;403446556;408695448;23697463
1384;4.23624e-15;-318;1243;9137;10075.5;1;641;-2.14748e+09;-3.74171e+06;0;0;0;0;0;0;403446556;408695448;23697463
1385;4.27178e-15;-287;1457;9537;10131;1;677;-2.14748e+09;-3.73334e+06;0;0;0;0;0;0;403595745;408859464;23740065
1385;4.23624e-15;-318;1243;9137;10075.5;1;641;-2.14748e+09;-3.73334e+06;-1;0;0;0;-1;0;403595745;408859464;23740065
1386;4.27178e-15;-287;1457;9537;10131;1;677;-2.14748e+09;-3.725e+06;-1;0;0;0;-1;0;403744601;409023151;23782629
1386;4.23624e-15;-318;1243;9137;10075.5;1;641;-2.14748e+09;-3.725e+06;-1;0;0;0;-1;0;403744601;409023151;23782629
1387;4.27178e-15;-288;1457;9537;10131;1;677;-2.14748e+09;-3.71668e+06;0;0;0;0;0;0;403893125;409186512;23825153
1387;4.23624e-15;-318;1243;9137;10075.5;1;641;-2.14748e+09;-3.71668e+06;-1;0;0;0;-1;0;403893125;409186512;23825153
1388;4.27178e-15;-289;1457;9537;10131;1;677;-2.14748e+09;-3.70839e+06;0;0;0;0;0;0;404041318;409349546;23867638
1388;4.23624e-15;-319;1243;9137;10075.5;1;641;-2.14748e+09;-3.70839e+06;0;0;0;0;0;0;404041318;409349546;23867638
1389;4.27178e-15;-290;1457;9537;10131;1;677;-2.14748e+09;-3.70012e+06;0;0;0;0;0;0;404189181;409512255;23910084
1389;4.23624e-15;-320;1243;9137;10075.5;1;641;-2.14748e+09;-3.70012e+06;0;0;0;0;0;0;404189181;409512255;23910084
1390;4.27178e-15;-291;1457;9537;10131;1;677;-2.14748e+09;-3.69197e+06;0;0;0;0;0;0;404336716;409674639;23952491
1390;4.23624e-15;-321;1243;9137;10075.5;1;641;-2.14748e+09;-3.69197e+06;0;0;0;0;0;0;404336716;409674639;23952491
1391;4.27178e-15;-292;1457;9537;10131;1;677;-2.14748e+09;-3.68365e+06;0;0;0;0;0;0;404483922;409836699;23994858
1391;4.23624e-15;-321;1243;9137;10075.5;1;641;-2.14748e+09;-3.68365e+06;-1;0;0;0;-1;0;404483922;409836699;23994858
1392;4.27178e-15;-293;1457;9537;10131;1;677;-2.14748e+09;-3.67545e+06;0;0;0;0;0;0;404630800;409998436;24037185
1392;4.23624e-15;-322;1243;9137;10075.5;1;641;-2.14748e+09;-3.67545e+06;0;0;0;0;0;0;404630800;409998436;24037185
1393;4.27178e-15;-294;1457;9537;10131;1;677;-2.14748e+09;-3.66738e+06;0;0;0;0;0;0;404777352;410159850;24079473
1393;4.23624e-15;-322;1243;9137;10075.5;1;641;-2.14748e+09;-3.66728e+06;-1;0;0;0;-1;0;404777352;410159850;24079473
1394;4.27178e-15;-295;1457;9537;10131;1;677;-2.14748e+09;-3.65922e+06;0;0;0;0;0;0;404923579;410320944;24121722
1394;4.23624e-15;-322;1243;9137;10075.5;1;641;-2.14748e+09;-3.65922e+06;-1;0;0;0;-1;0;404923579;410320944;24121722
1395;4.27178e-15;-296;1457;9537;10131;1;677;-2.14748e+09;-3.651e+06;0;0;0;0;0;0;405069481;410481716;24163930
1395;4.23624e-15;-322;1243;9137;10075.5;1;641;-2.14748e+09;-3.651e+06;-1;0;0;0;-1;0;405069481;410481716;24163930
1396;4.27178e-15;-296;1457;9537;10131;1;677;-2.14748e+09;-3.64289e+06;-1;0;0;0;-1;0;405215059;410642169;24206099
1396;4.23624e-15;-323;1243;9137;10075.5;1;641;-2.14748e+09;-3.64289e+06;0;0;0;0;0;0;405215059;410642169;24206099
1397;4.27178e-15;-297;1457;9537;10131;1;677;-2.14748e+09;-3.63481e+06;0;0;0;0;0;0;405360313;410802302;24248228
1397;4.23624e-15;-323;1243;9137;10075.5;1;641;-2.14748e+09;-3.63481e+06;-1;0;0;0;-1;0;405360313;410802302;24248228
1398;4.27178e-15;-298;1457;9537;10131;1;677;-2.14748e+09;-3.62685e+06;0;0;0;0;0;0;405505246;410962117;24290317
1398;4.23624e-15;-324;1243;9137;10075.5;1;641;-2.14748e+09;-3.62675e+06;0;0;0;0;0;0;405505246;410962117;24290317
1399;4.27178e-15;-298;1457;9537;10131;1;677;-2.14748e+09;-3.61881e+06;-1;0;0;0;-1;0;405649858;411121615;24332366
1399;4.23624e-15;-324;1243;9137;10075.5;1;641;-2.14748e+09;-3.61871e+06;-1;0;0;0;-1;0;405649858;411121615;24332366
1400;4.27178e-15;-299;1457;9537;10131;1;677;-2.14748e+09;-3.6107e+06;0;0;0;0;0;0;405794149;411280795;24374376
1400;4.23624e-15;-325;1243;9137;10075.5;1;641;-2.14748e+09;-3.6107e+06;0;0;0;0;0;0;405794149;411280795;24374376
1401;4.27178e-15;-300;1457;9537;10131;1;677;-2.14748e+09;-3.60281e+06;0;0;0;0;0;0;405938120;411439660;24416344
1401;4.23624e-15;-325;1243;9137;10075.5;1;641;-2.14748e+09;-3.60271e+06;-1;0;0;0;-1;0;405938120;411439660;24416344
1402;4.27178e-15;-300;1457;9537;10131;1;677;-2.14748e+09;-3.59484e+06;-1;0;0;0;-1;0;406081772;411598210;24458273
1402;4.23624e-15;-326;1243;9137;10075.5;1;641;-2.14748e+09;-3.59474e+06;0;0;0;0;0;0;406081772;411598210;24458273
1403;4.27178e-15;-300;1457;9537;10131;1;677;-2.14748e+09;-3.58679e+06;-1;0;0;0;-1;0;406225107;411756444;24500161
1403;4.23624e-15;-327;1243;9137;10075.5;1;641;-2.14748e+09;-3.58679e+06;0;0;0;0;0;0;406225107;411756444;24500161
1404;4.27178e-15;-301;1457;9537;10131;1;677;-2.14748e+09;-3.57897e+06;0;0;0;0;0;0;406368125;411914366;24542010
1404;4.23624e-15;-328;1243;9137;10075.5;1;641;-2.14748e+09;-3.57897e+06;0;0;0;0;0;0;406368125;411914366;24542010
1405;4.27178e-15;-301;1457;9537;10131;1;677;-2.14748e+09;-3.57107e+06;-1;0;0;0;-1;0;406510826;412071974;24583817
1405;4.23624e-15;-328;1243;9137;10075.5;1;641;-2.14748e+09;-3.57097e+06;-1;0;0;0;-1;0;406510826;412071974;24583817
1406;4.27178e-15;-301;1457;9537;10131;1;677;-2.14748e+09;-3.56309e+06;-1;0;0;0;-1;0;406653212;412229270;24625584
1406;4.23624e-15;-328;1243;9137;10075.5;1;641;-2.14748e+09;-3.56309e+06;-1;0;0;0;-1;0;406653212;412229270;24625584
1407;4.27178e-15;-302;1457;9537;10131;1;677;-2.14748e+09;-3.55533e+06;0;0;0;0;0;0;406795283;412386255;24667311
1407;4.23624e-15;-328;1243;9137;10075.5;1;641;-2.14748e+09;-3.55533e+06;-1;0;0;0;-1;0;406795283;412386255;24667311
1408;4.27178e-15;-302;1457;9537;10131;1;677;-2.14748e+09;-3.5475e+06;-1;0;0;0;-1;0;406937041;412542929;24708997
1408;4.23624e-15;-328;1243;9137;10075.5;1;641;-2.14748e+09;-3.5474e+06;-1;0;0;0;-1;0;406937041;412542929;24708997
1409;4.27178e-15;-302;1457;9537;10131;1;677;-2.14748e+09;-3.53959e+06;-1;0;0;0;-1;0;407078485;412699293;24750643
1409;4.23624e-15;-329;1243;9137;10075.5;1;641;-2.14748e+09;-3.53959e+06;0;0;0;0;0;0;407078485;412699293;24750643
1410;4.27178e-15;-302;1457;9537;10131;1;677;-2.14748e+09;-3.5318e+06;-1;0;0;0;-1;0;407219618;412855348;24792247
1410;4.23624e-15;-330;1243;9137;10075.5;1;641;-2.14748e+09;-3.5318e+06;0;0;0;0;0;0;407219618;412855348;24792247
1411;4.27178e-15;-302;1457;9537;10131;1;677;-2.14748e+09;-3.52403e+06;-1;0;0;0;-1;0;407360439;413011094;24833811
1411;4.23624e-15;-330;1243;9137;10075.5;1;641;-2.14748e+09;-3.52403e+06;-1;0;0;0;-1;0;407360439;413011094;24833811
1412;4.27178e-15;-303;1457;9537;10131;1;677;-2.14748e+09;-3.51628e+06;0;0;0;0;0;0;407500950;413166533;24875334
1412;4.23624e-15;-331;1243;9137;10075.5;1;641;-2.14748e+09;-3.51628e+06;0;0;0;0;0;0;407500950;413166533;24875334
1413;4.27178e-15;-304;1457;9537;10131;1;677;-2.14748e+09;-3.50866e+06;0;0;0;0;0;0;407641151;413321665;24916816
1413;4.23624e-15;-332;1243;9137;10075.5;1;641;-2.14748e+09;-3.50866e+06;0;0;0;0;0;0;407641151;413321665;24916816
1414;4.27178e-15;-304;1457;9537;10131;1;677;-2.14748e+09;-3.50085e+06;-1;0;0;0;-1;0;407781044;413476490;24958258
1414;4.23624e-15;-333;1243;9137;10075.5;1;641;-2.14748e+09;-3.50085e+06;0;0;0;0;0;0;407781044;413476490;24958258
1415;4.27178e-15;-304;1457;9537;10131;1;677;-2.14748e+09;-3.49317e+06;-1;0;0;0;-1;0;407920628;413631010;24999658
1415;4.23624e-15;-333;1243;9137;10075.5;1;641;-2.14748e+09;-3.49317e+06;-1;0;0;0;-1;0;407920628;413631010;24999658
1416;4.27178e-15;-304;1457;9537;10131;1;677;-2.14748e+09;-3.48551e+06;-1;0;0;0;-1;0;408059905;413785226;25041017
1416;4.23624e-15;-334;1243;9137;10075.5;1;641;-2.14748e+09;-3.48551e+06;0;0;0;0;0;0;408059905;413785226;25041017
1417;4.27178e-15;-305;1457;9537;10131;1;677;-2.14748e+09;-3.47787e+06;0;0;0;0;0;0;408198876;413939137;25082335
1417;4.23624e-15;-334;1243;9137;10075.5;1;641;-2.14748e+09;-3.47787e+06;-1;0;0;0;-1;0;408198876;413939137;25082335
1418;4.27178e-15;-306;1457;9537;10131;1;677;-2.14748e+09;-3.47025e+06;0;0;0;0;0;0;408337541;414092745;25123612
1418;4.23624e-15;-334;1243;9137;10075.5;1;641;-2.14748e+09;-3.47025e+06;-1;0;0;0;-1;0;408337541;414092745;25123612
1419;4.27178e-15;-307;1457;9537;10131;1;677;-2.14748e+09;-3.46265e+06;0;0;0;0;0;0;408475901;414246050;25164847
1419;4.23624e-15;-335;1243;9137;10075.5;1;641;-2.14748e+09;-3.46265e+06;0;0;0;0;0;0;408475901;414246050;25164847
1420;4.27178e-15;-308;1457;9537;10131;1;677;-2.14748e+09;-3.45508e+06;0;0;0;0;0;0;408613957;414399054;25206042
1420;4.23624e-15;-335;1243;9137;10075.5;1;641;-2.14748e+09;-3.45508e+06;-1;0;0;0;-1;0;408613957;414399054;25206042
1421;4.27178e-15;-308;1457;9537;10131;1;677;-2.14748e+09;-3.44752e+06;-1;0;0;0;-1;0;408751711;414551757;25247195
1421;4.23624e-15;-336;1243;9137;10075.5;1;641;-2.14748e+09;-3.44752e+06;0;0;0;0;0;0;408751711;414551757;25247195
1422;4.27178e-15;-309;1457;9537;10131;1;677;-2.14748e+09;-3.44009e+06;0;0;0;0;0;0;408889161;414704159;25288306
1422;4.23624e-15;-336;1243;9137;10075.5;1;641;-2.14748e+09;-3.44009e+06;-1;0;0;0;-1;0;408889161;414704159;25288306
1423;4.27178e-15;-310;1457;9537;10131;1;677;-2.14748e+09;-3.43248e+06;0;0;0;0;0;0;409026310;414856261;25329376
1423;4.23624e-15;-337;1243;9137;10075.5;1;641;-2.14748e+09;-3.43248e+06;0;0;0;0;0;0;409026310;414856261;25329376
1424;4.27178e-15;-311;1457;9537;10131;1;677;-2.14748e+09;-3.42508e+06;0;0;0;0;0;0;409163158;415008065;25370405
1424;4.23624e-15;-338;1243;9137;10075.5;1;641;-2.14748e+09;-3.42508e+06;0;0;0;0;0;0;409163158;415008065;25370405
1425;4.27178e-15;-311;1457;9537;10131;1;677;-2.14748e+09;-3.41751e+06;-1;0;0;0;-1;0;409299706;415159570;25411392
1425;4.23624e-15;-339;1243;9137;10075.5;1;641;-2.14748e+09;-3.41751e+06;0;0;0;0;0;0;409299706;415159570;25411392
1426;4.27178e-15;-312;1457;9537;10131;1;677;-2.14748e+09;-3.41016e+06;0;0;0;0;0;0;409435955;415310778;25452337
1426;4.23624e-15;-339;1243;9137;10075.5;1;641;-2.14748e+09;-3.41016e+06;-1;0;0;0;-1;0;409435955;415310778;25452337
1427;4.27178e-15;-312;1457;9537;10131;1;677;-2.14748e+09;-3.40263e+06;-1;0;0;0;-1;0;409571905;415461689;25493241
1427;4.23624e-15;-340;1243;9137;10075.5;1;641;-2.14748e+09;-3.40263e+06;0;0;0;0;0;0;409571905;415461689;25493241
1428;4.27178e-15;-313;1457;9537;10131;1;677;-2.14748e+09;-3.39522e+06;0;0;0;0;0;0;409707558;415612303;25534103
1428;4.23624e-15;-340;1243;9137;10075.5;1;641;-2.14748e+09;-3.39522e+06;-1;0;0;0;-1;0;409707558;415612303;25534103
1429;4.27178e-15;-314;1457;9537;10131;1;677;-2.14748e+09;-3.38783e+06;0;0;0;0;0;0;409842913;415762623;25574923
1429;4.23624e-15;-341;1243;9137;10075.5;1;641;-2.14748e+09;-3.38783e+06;0;0;0;0;0;0;409842913;415762623;25574923
1430;4.27178e-15;-314;1457;9537;10131;1;677;-2.14748e+09;-3.38056e+06;-1;0;0;0;-1;0;409977973;415912647;25615701
1430;4.23624e-15;-342;1243;9137;10075.5;1;641;-2.14748e+09;-3.38056e+06;0;0;0;0;0;0;409977973;415912647;25615701
1431;4.27178e-15;-315;1457;9537;10131;1;677;-2.14748e+09;-3.37321e+06;0;0;0;0;0;0;410112737;416062378;25656437
1431;4.23624e-15;-342;1243;9137;10075.5;1;641;-2.14748e+09;-3.37311e+06;-1;0;0;0;-1;0;410112737;416062378;25656437
1432;4.27178e-15;-315;1457;9537;10131;1;677;-2.14748e+09;-3.36578e+06;-1;0;0;0;-1;0;410247206;416211815;25697132
1432;4.23624e-15;-343;1243;9137;10075.5;1;641;-2.14748e+09;-3.36578e+06;0;0;0;0;0;0;410247206;416211815;25697132
1433;4.27178e-15;-316;1457;9537;10131;1;677;-2.14748e+09;-3.35847e+06;0;0;0;0;0;0;410381381;416360960;25737785
1433;4.23624e-15;-344;1243;9137;10075.5;1;641;-2.14748e+09;-3.35847e+06;0;0;0;0;0;0;410381381;416360960;25737785
1434;4.27178e-15;-317;1457;9537;10131;1;677;-2.14748e+09;-3.35128e+06;0;0;0;0;0;0;410515263;416509812;25778395
1434;4.23624e-15;-345;1243;9137;10075.5;1;641;-2.14748e+09;-3.35128e+06;0;0;0;0;0;0;410515263;416509812;25778395
1435;4.27178e-15;-318;1457;9537;10131;1;677;-2.14748e+09;-3.34401e+06;0;0;0;0;0;0;410648853;416658373;25818964
1435;4.23624e-15;-345;1243;9137;10075.5;1;641;-2.14748e+09;-3.34391e+06;-1;0;0;0;-1;0;410648853;416658373;25818964
1436;4.27178e-15;-319;1457;9537;10131;1;677;-2.14748e+09;-3.33666e+06;0;0;0;0;0;0;410782151;416806644;25859490
1436;4.23624e-15;-345;1243;9137;10075.5;1;641;-2.14748e+09;-3.33666e+06;-1;0;0;0;-1;0;410782151;416806644;25859490
1437;4.27178e-15;-319;1457;9537;10131;1;677;-2.14748e+09;-3.32943e+06;-1;0;0;0;-1;0;410915159;416954625;25899974
1437;4.23624e-15;-345;1243;9137;10075.5;1;641;-2.14748e+09;-3.32943e+06;-1;0;0;0;-1;0;410915159;416954625;25899974
1438;4.27178e-15;-319;1457;9537;10131;1;677;-2.14748e+09;-3.32222e+06;-1;0;0;0;-1;0;411047876;417102317;25940416
1438;4.23624e-15;-345;1243;9137;10075.5;1;641;-2.14748e+09;-3.32222e+06;-1;0;0;0;-1;0;411047876;417102317;25940416
1439;4.27178e-15;-320;1457;9537;10131;1;677;-2.14748e+09;-3.31503e+06;0;0;0;0;0;0;411180304;417249720;25980816
1439;4.23624e-15;-345;1243;9137;10075.5;1;641;-2.14748e+09;-3.31503e+06;-1;0;0;0;-1;0;411180304;417249720;25980816
1440;4.27178e-15;-320;1457;9537;10131;1;677;-2.14748e+09;-3.30796e+06;-1;0;0;0;-1;0;411312443;417396835;26021174
1440;4.23624e-15;-346;1243;9137;10075.5;1;641;-2.14748e+09;-3.30786e+06;0;0;0;0;0;0;411312443;417396835;26021174
1441;4.27178e-15;-321;1457;9537;10131;1;677;-2.14748e+09;-3.3007e+06;0;0;0;0;0;0;411444294;417543663;26061489
1441;4.23624e-15;-347;1243;9137;10075.5;1;641;-2.14748e+09;-3.3007e+06;0;0;0;0;0;0;411444294;417543663;26061489
1442;4.27178e-15;-322;1457;9537;10131;1;677;-2.14748e+09;-3.29357e+06;0;0;0;0;0;0;411575858;417690204;26101762
1442;4.23624e-15;-348;1243;9137;10075.5;1;641;-2.14748e+09;-3.29357e+06;0;0;0;0;0;0;411575858;417690204;26101762
1443;4.27178e-15;-323;1457;9537;10131;1;677;-2.14748e+09;-3.28646e+06;0;0;0;0;0;0;411707136;417836460;26141992
1443;4.23624e-15;-349;1243;9137;10075.5;1;641;-2.14748e+09;-3.28646e+06;0;0;0;0;0;0;411707136;417836460;26141992
1444;4.27178e-15;-323;1457;9537;10131;1;677;-2.14748e+09;-3.27946e+06;-1;0;0;0;-1;0;411838128;417982431;26182180
1444;4.23624e-15;-349;1243;9137;10075.5;1;641;-2.14748e+09;-3.27946e+06;-1;0;0;0;-1;0;411838128;417982431;26182180
1445;4.27178e-15;-324;1457;9537;10131;1;677;-2.14748e+09;-3.27229e+06;0;0;0;0;0;0;411968835;418128116;26222325
1445;4.23624e-15;-349;1243;9137;10075.5;1;641;-2.14748e+09;-3.27229e+06;-1;0;0;0;-1;0;411968835;418128116;26222325
1446;4.27178e-15;-324;1457;9537;10131;1;677;-2.14748e+09;-3.26533e+06;-1;0;0;0;-1;0;412099258;418273519;26262428
1446;4.23624e-15;-350;1243;9137;10075.5;1;641;-2.14748e+09;-3.26533e+06;0;0;0;0;0;0;412099258;418273519;26262428
1447;4.27178e-15;-325;1457;9537;10131;1;677;-2.14748e+09;-3.2583e+06;0;0;0;0;0;0;412229397;418418638;26302488
1447;4.23624e-15;-350;1243;9137;10075.5;1;641;-2.14748e+09;-3.2582e+06;-1;0;0;0;-1;0;412229397;418418638;26302488
1448;4.27178e-15;-325;1457;9537;10131;1;677;-2.14748e+09;-3.25128e+06;-1;0;0;0;-1;0;412359254;418563474;26342506
1448;4.23624e-15;-350;1243;9137;10075.5;1;641;-2.14748e+09;-3.25128e+06;-1;0;0;0;-1;0;412359254;418563474;26342506
1449;4.27178e-15;-325;1457;9537;10131;1;677;-2.14748e+09;-3.24428e+06;-1;0;0;0;-1;0;412488828;418708028;26382481
1449;4.23624e-15;-351;1243;9137;10075.5;1;641;-2.14748e+09;-3.24428e+06;0;0;0;0;0;0;412488828;418708028;26382481
1450;4.27178e-15;-326;1457;9537;10131;1;677;-2.14748e+09;-3.2373e+06;0;0;0;0;0;0;412618121;418852302;26422414
1450;4.23624e-15;-351;1243;9137;10075.5;1;641;-2.14748e+09;-3.2373e+06;-1;0;0;0;-1;0;412618121;418852302;26422414
1451;4.27178e-15;-326;1457;9537;10131;1;677;-2.14748e+09;-3.23024e+06;-1;0;0;0;-1;0;412747134;418996294;26462303
1451;4.23624e-15;-351;1243;9137;10075.5;1;641;-2.14748e+09;-3.23024e+06;-1;0;0;0;-1;0;412747134;418996294;26462303
1452;4.27178e-15;-327;1457;9537;10131;1;677;-2.14748e+09;-3.22339e+06;0;0;0;0;0;0;412875867;419140007;26502150
1452;4.23624e-15;-351;1243;9137;10075.5;1;641;-2.14748e+09;-3.22339e+06;-1;0;0;0;-1;0;412875867;419140007;26502150
1453;4.27178e-15;-328;1457;9537;10131;1;677;-2.14748e+09;-3.21647e+06;0;0;0;0;0;0;413004320;419283441;26541954
1453;4.23624e-15;-351;1243;9137;10075.5;1;641;-2.14748e+09;-3.21647e+06;-1;0;0;0;-1;0;413004320;419283441;26541954
1454;4.27178e-15;-329;1457;9537;10131;1;677;-2.14748e+09;-3.20956e+06;0;0;0;0;0;0;413132495;419426595;26581715
1454;4.23624e-15;-352;1243;9137;10075.5;1;641;-2.14748e+09;-3.20956e+06;0;0;0;0;0;0;413132495;419426595;26581715
1455;4.27178e-15;-329;1457;9537;10131;1;677;-2.14748e+09;-3.20257e+06;-1;0;0;0;-1;0;413260392;419569472;26621434
1455;4.23624e-15;-353;1243;9137;10075.5;1;641;-2.14748e+09;-3.20257e+06;0;0;0;0;0;0;413260392;419569472;26621434
1456;4.27178e-15;-330;1457;9537;10131;1;677;-2.14748e+09;-3.1957e+06;0;0;0;0;0;0;413388013;419712072;26661109
1456;4.23624e-15;-353;1243;9137;10075.5;1;641;-2.14748e+09;-3.1957e+06;-1;0;0;0;-1;0;413388013;419712072;26661109
1457;4.27178e-15;-330;1457;9537;10131;1;677;-2.14748e+09;-3.18885e+06;-1;0;0;0;-1;0;413515357;419854395;26700742
1457;4.23624e-15;-354;1243;9137;10075.5;1;641;-2.14748e+09;-3.18885e+06;0;0;0;0;0;0;413515357;419854395;26700742
1458;4.27178e-15;-331;1457;9537;10131;1;677;-2.14748e+09;-3.18202e+06;0;0;0;0;0;0;413642425;419996442;26740331
1458;4.23624e-15;-354;1243;9137;10075.5;1;641;-2.14748e+09;-3.18202e+06;-1;0;0;0;-1;0;413642425;419996442;26740331
1459;4.27178e-15;-331;1457;9537;10131;1;677;-2.14748e+09;-3.1752e+06;-1;0;0;0;-1;0;413769218;420138213;26779878
1459;4.23624e-15;-355;1243;9137;10075.5;1;641;-2.14748e+09;-3.1752e+06;0;0;0;0;0;0;413769218;420138213;26779878
1460;4.27178e-15;-331;1457;9537;10131;1;677;-2.14748e+09;-3.16841e+06;-1;0;0;0;-1;0;413895737;420279709;26819381
1460;4.23624e-15;-356;1243;9137;10075.5;1;641;-2.14748e+09;-3.16841e+06;0;0;0;0;0;0;413895737;420279709;26819381
1461;4.27178e-15;-331;1457;9537;10131;1;677;-2.14748e+09;-3.16163e+06;-1;0;0;0;-1;0;414021983;420420932;26858841
1461;4.23624e-15;-356;1243;9137;10075.5;1;641;-2.14748e+09;-3.16163e+06;-1;0;0;0;-1;0;414021983;420420932;26858841
1462;4.27178e-15;-332;1457;9537;10131;1;677;-2.14748e+09;-3.15487e+06;0;0;0;0;0;0;414147955;420561880;26898259
1462;4.23624e-15;-356;1243;9137;10075.5;1;641;-2.14748e+09;-3.15487e+06;-1;0;0;0;-1;0;414147955;420561880;26898259
1463;4.27178e-15;-332;1457;9537;10131;1;677;-2.14748e+09;-3.14812e+06;-1;0;0;0;-1;0;414273656;420702556;26937633
1463;4.23624e-15;-357;1243;9137;10075.5;1;641;-2.14748e+09;-3.14812e+06;0;0;0;0;0;0;414273656;420702556;26937633
1464;4.27178e-15;-333;1457;9537;10131;1;677;-2.14748e+09;-3.1414e+06;0;0;0;0;0;0;414399085;420842960;26976964
1464;4.23624e-15;-357;1243;9137;10075.5;1;641;-2.14748e+09;-3.1414e+06;-1;0;0;0;-1;0;414399085;420842960;26976964
1465;4.27178e-15;-334;1457;9537;10131;1;677;-2.14748e+09;-3.13479e+06;0;0;0;0;0;0;414524243;420983092;27016252
1465;4.23624e-15;-358;1243;9137;10075.5;1;641;-2.14748e+09;-3.13479e+06;0;0;0;0;0;0;414524243;420983092;27016252
1466;4.27178e-15;-334;1457;9537;10131;1;677;-2.14748e+09;-3.128e+06;-1;0;0;0;-1;0;414649131;421122953;27055496
1466;4.23624e-15;-359;1243;9137;10075.5;1;641;-2.14748e+09;-3.128e+06;0;0;0;0;0;0;414649131;421122953;27055496
1467;4.27178e-15;-335;1457;9537;10131;1;677;-2.14748e+09;-3.12143e+06;0;0;0;0;0;0;414773750;421262544;27094697
1467;4.23624e-15;-360;1243;9137;10075.5;1;641;-2.14748e+09;-3.12133e+06;0;0;0;0;0;0;414773750;421262544;27094697
1468;4.27178e-15;-336;1457;9537;10131;1;677;-2.14748e+09;-3.11478e+06;0;0;0;0;0;0;414898099;421401864;27133855
1468;4.23624e-15;-361;1243;9137;10075.5;1;641;-2.14748e+09;-3.11468e+06;0;0;0;0;0;0;414898099;421401864;27133855
1469;4.27178e-15;-336;1457;9537;10131;1;677;-2.14748e+09;-3.10804e+06;-1;0;0;0;-1;0;415022181;421540916;27172970
1469;4.23624e-15;-362;1243;9137;10075.5;1;641;-2.14748e+09;-3.10804e+06;0;0;0;0;0;0;415022181;421540916;27172970
1470;4.27178e-15;-336;1457;9537;10131;1;677;-2.14748e+09;-3.10152e+06;-1;0;0;0;-1;0;415145996;421679699;27212041
1470;4.23624e-15;-362;1243;9137;10075.5;1;641;-2.14748e+09;-3.10152e+06;-1;0;0;0;-1;0;415145996;421679699;27212041
1471;4.27178e-15;-337;1457;9537;10131;1;677;-2.14748e+09;-3.09482e+06;0;0;0;0;0;0;415269543;421818214;27251069
1471;4.23624e-15;-362;1243;9137;10075.5;1;641;-2.14748e+09;-3.09482e+06;-1;0;0;0;-1;0;415269543;421818214;27251069
1472;4.27178e-15;-337;1457;9537;10131;1;677;-2.14748e+09;-3.08823e+06;-1;0;0;0;-1;0;415392825;421956461;27290054
1472;4.23624e-15;-362;1243;9137;10075.5;1;641;-2.14748e+09;-3.08823e+06;-1;0;0;0;-1;0;415392825;421956461;27290054
1473;4.27178e-15;-338;1457;9537;10131;1;677;-2.14748e+09;-3.08166e+06;0;0;0;0;0;0;415515841;422094442;27328995
1473;4.23624e-15;-362;1243;9137;10075.5;1;641;-2.14748e+09;-3.08166e+06;-1;0;0;0;-1;0;415515841;422094442;27328995
1474;4.27178e-15;-339;1457;9537;10131;1;677;-2.14748e+09;-3.07521e+06;0;0;0;0;0;0;415638593;422232157;27367892
1474;4.23624e-15;-363;1243;9137;10075.5;1;641;-2.14748e+09;-3.07511e+06;0;0;0;0;0;0;415638593;422232157;27367892
1475;4.27178e-15;-340;1457;9537;10131;1;677;-2.14748e+09;-3.06868e+06;0;0;0;0;0;0;415761080;422369606;27406746
1475;4.23624e-15;-363;1243;9137;10075.5;1;641;-2.14748e+09;-3.06868e+06;-1;0;0;0;-1;0;415761080;422369606;27406746
1476;4.27178e-15;-341;1457;9537;10131;1;677;-2.14748e+09;-3.06206e+06;0;0;0;0;0;0;415883305;422506790;27445557
1476;4.23624e-15;-363;1243;9137;10075.5;1;641;-2.14748e+09;-3.06206e+06;-1;0;0;0;-1;0;415883305;422506790;27445557
1477;4.27178e-15;-342;1457;9537;10131;1;677;-2.14748e+09;-3.05566e+06;0;0;0;0;0;0;416005266;422643710;27484324
1477;4.23624e-15;-363;1243;9137;10075.5;1;641;-2.14748e+09;-3.05566e+06;-1;0;0;0;-1;0;416005266;422643710;27484324
1478;4.27178e-15;-343;1457;9537;10131;1;677;-2.14748e+09;-3.04908e+06;0;0;0;0;0;0;416126965;422780366;27523048
1478;4.23624e-15;-363;1243;9137;10075.5;1;641;-2.14748e+09;-3.04908e+06;-1;0;0;0;-1;0;416126965;422780366;27523048
1479;4.27178e-15;-344;1457;9537;10131;1;677;-2.14748e+09;-3.04262e+06;0;0;0;0;0;0;416248403;422916759;27561728
1479;4.23624e-15;-363;1243;9137;10075.5;1;641;-2.14748e+09;-3.04262e+06;-1;0;0;0;-1;0;416248403;422916759;27561728
1480;4.27178e-15;-344;1457;9537;10131;1;677;-2.14748e+09;-3.03617e+06;-1;0;0;0;-1;0;416369581;423052890;27600364
1480;4.23624e-15;-364;1243;9137;10075.5;1;641;-2.14748e+09;-3.03617e+06;0;0;0;0;0;0;416369581;423052890;27600364
1481;4.27178e-15;-345;1457;9537;10131;1;677;-2.14748e+09;-3.02974e+06;0;0;0;0;0;0;416490498;423188758;27638957
1481;4.23624e-15;-364;1243;9137;10075.5;1;641;-2.14748e+09;-3.02974e+06;-1;0;0;0;-1;0;416490498;423188758;27638957
1482;4.27178e-15;-345;1457;9537;10131;1;677;-2.14748e+09;-3.02332e+06;-1;0;0;0;-1;0;416611155;423324365;27677506
1482;4.23624e-15;-364;1243;9137;10075.5;1;641;-2.14748e+09;-3.02332e+06;-1;0;0;0;-1;0;416611155;423324365;27677506
1483;4.27178e-15;-346;1457;9537;10131;1;677;-2.14748e+09;-3.01702e+06;0;0;0;0;0;0;416731554;423459712;27716011
1483;4.23624e-15;-364;1243;9137;10075.5;1;641;-2.14748e+09;-3.01692e+06;-1;0;0;0;-1;0;416731554;423459712;27716011
1484;4.27178e-15;-346;1457;9537;10131;1;677;-2.14748e+09;-3.01054e+06;-1;0;0;0;-1;0;416851695;423594798;27754473
1484;4.23624e-15;-365;1243;9137;10075.5;1;641;-2.14748e+09;-3.01054e+06;0;0;0;0;0;0;416851695;423594798;27754473
1485;4.27178e-15;-347;1457;9537;10131;1;677;-2.14748e+09;-3.00427e+06;0;0;0;0;0;0;416971578;423729625;27792891
1485;4.23624e-15;-365;1243;9137;10075.5;1;641;-2.14748e+09;-3.00417e+06;-1;0;0;0;-1;0;416971578;423729625;27792891
1486;4.27178e-15;-347;1457;9537;10131;1;677;-2.14748e+09;-2.99782e+06;-1;0;0;0;-1;0;417091204;423864192;27831265
1486;4.23624e-15;-365;1243;9137;10075.5;1;641;-2.14748e+09;-2.99782e+06;-1;0;0;0;-1;0;417091204;423864192;27831265
1487;4.27178e-15;-347;1457;9537;10131;1;677;-2.14748e+09;-2.99159e+06;-1;0;0;0;-1;0;417210574;423998501;27869596
1487;4.23624e-15;-365;1243;9137;10075.5;1;641;-2.14748e+09;-2.99159e+06;-1;0;0;0;-1;0;417210574;423998501;27869596
1488;4.27178e-15;-347;1457;9537;10131;1;677;-2.14748e+09;-2.98518e+06;-1;0;0;0;-1;0;417329689;424132552;27907882
1488;4.23624e-15;-365;1243;9137;10075.5;1;641;-2.14748e+09;-2.98518e+06;-1;0;0;0;-1;0;417329689;424132552;27907882
1489;4.27178e-15;-348;1457;9537;10131;1;677;-2.14748e+09;-2.97898e+06;0;0;0;0;0;0;417448548;424266346;27946125
1489;4.23624e-15;-366;1243;9137;10075.5;1;641;-2.14748e+09;-2.97898e+06;0;0;0;0;0;0;417448548;424266346;27946125
1490;4.27178e-15;-348;1457;9537;10131;1;677;-2.14748e+09;-2.97259e+06;-1;0;0;0;-1;0;417567153;424399884;27984324
1490;4.23624e-15;-366;1243;9137;10075.5;1;641;-2.14748e+09;-2.97259e+06;-1;0;0;0;-1;0;417567153;424399884;27984324
1491;4.27178e-15;-348;1457;9537;10131;1;677;-2.14748e+09;-2.96632e+06;-1;0;0;0;-1;0;417685505;424533165;28022480
1491;4.23624e-15;-367;1243;9137;10075.5;1;641;-2.14748e+09;-2.96632e+06;0;0;0;0;0;0;417685505;424533165;28022480
1492;4.27178e-15;-348;1457;9537;10131;1;677;-2.14748e+09;-2.96007e+06;-1;0;0;0;-1;0;417803603;424666190;28060591
1492;4.23624e-15;-367;1243;9137;10075.5;1;641;-2.14748e+09;-2.96007e+06;-1;0;0;0;-1;0;417803603;424666190;28060591
1493;4.27178e-15;-348;1457;9537;10131;1;677;-2.14748e+09;-2.95384e+06;-1;0;0;0;-1;0;417921449;424798961;28098659
1493;4.23624e-15;-368;1243;9137;10075.5;1;641;-2.14748e+09;-2.95384e+06;0;0;0;0;0;0;417921449;424798961;28098659
1494;4.27178e-15;-348;1457;9537;10131;1;677;-2.14748e+09;-2.94762e+06;-1;0;0;0;-1;0;418039043;424931477;28136682
1494;4.23624e-15;-369;1243;9137;10075.5;1;641;-2.14748e+09;-2.94762e+06;0;0;0;0;0;0;418039043;424931477;28136682
1495;4.27178e-15;-348;1457;9537;10131;1;677;-2.14748e+09;-2.94151e+06;-1;0;0;0;-1;0;418156386;425063739;28174662
1495;4.23624e-15;-370;1243;9137;10075.5;1;641;-2.14748e+09;-2.94151e+06;0;0;0;0;0;0;418156386;425063739;28174662
1496;4.27178e-15;-348;1457;9537;10131;1;677;-2.14748e+09;-2.93522e+06;-1;0;0;0;-1;0;418273479;425195748;28212598
1496;4.23624e-15;-371;1243;9137;10075.5;1;641;-2.14748e+09;-2.93522e+06;0;0;0;0;0;0;418273479;425195748;28212598
1497;4.27178e-15;-348;1457;9537;10131;1;677;-2.14748e+09;-2.92905e+06;-1;0;0;0;-1;0;418390321;425327505;28250490
1497;4.23624e-15;-371;1243;9137;10075.5;1;641;-2.14748e+09;-2.92905e+06;-1;0;0;0;-1;0;418390321;425327505;28250490
1498;4.27178e-15;-349;1457;9537;10131;1;677;-2.14748e+09;-2.923e+06;0;0;0;0;0;0;418506914;425459009;28288338
1498;4.23624e-15;-372;1243;9137;10075.5;1;641;-2.14748e+09;-2.9229e+06;0;0;0;0;0;0;418506914;425459009;28288338
1499;4.27178e-15;-349;1457;9537;10131;1;677;-2.14748e+09;-2.91676e+06;-1;0;0;0;-1;0;418623259;425590261;28326142
1499;4.23624e-15;-373;1243;9137;10075.5;1;641;-2.14748e+09;-2.91676e+06;0;0;0;0;0;0;418623259;425590261;28326142
1500;4.27178e-15;-350;1457;9537;10131;1;677;-2.14748e+09;-2.91073e+06;0;0;0;0;0;0;418739355;425721262;28363902
1500;4.23624e-15;-373;1243;9137;10075.5;1;641;-2.14748e+09;-2.91063e+06;-1;0;0;0;-1;0;418739355;425721262;28363902
1501;4.27178e-15;-351;1457;9537;10131;1;677;-2.14748e+09;-2.90462e+06;0;0;0;0;0;0;418855204;425852013;28401618
1501;4.23624e-15;-374;1243;9137;10075.5;1;641;-2.14748e+09;-2.90452e+06;0;0;0;0;0;0;418855204;425852013;28401618
1502;4.27178e-15;-351;1457;9537;10131;1;677;-2.14748e+09;-2.89843e+06;-1;0;0;0;-1;0;418970806;425982514;28439290
1502;4.23624e-15;-374;1243;9137;10075.5;1;641;-2.14748e+09;-2.89843e+06;-1;0;0;0;-1;0;418970806;425982514;28439290
1503;4.27178e-15;-351;1457;9537;10131;1;677;-2.14748e+09;-2.89235e+06;-1;0;0;0;-1;0;419086162;426112766;28476918
1503;4.23624e-15;-374;1243;9137;10075.5;1;641;-2.14748e+09;-2.89235e+06;-1;0;0;0;-1;0;419086162;426112766;28476918
1504;4.27178e-15;-351;1457;9537;10131;1;677;-2.14748e+09;-2.88629e+06;-1;0;0;0;-1;0;419201272;426242769;28514502
1504;4.23624e-15;-375;1243;9137;10075.5;1;641;-2.14748e+09;-2.88629e+06;0;0;0;0;0;0;419201272;426242769;28514502
1505;4.27178e-15;-351;1457;9537;10131;1;677;-2.14748e+09;-2.88024e+06;-1;0;0;0;-1;0;419316137;426372523;28552042
1505;4.23624e-15;-375;1243;9137;10075.5;1;641;-2.14748e+09;-2.88024e+06;-1;0;0;0;-1;0;419316137;426372523;28552042
1506;4.27178e-15;-352;1457;9537;10131;1;677;-2.14748e+09;-2.87431e+06;0;0;0;0;0;0;419430758;426502030;28589538
1506;4.23624e-15;-376;1243;9137;10075.5;1;641;-2.14748e+09;-2.87431e+06;0;0;0;0;0;0;419430758;426502030;28589538
1507;4.27178e-15;-353;1457;9537;10131;1;677;-2.14748e+09;-2.86829e+06;0;0;0;0;0;0;419545134;426631290;28626989
1507;4.23624e-15;-377;1243;9137;10075.5;1;641;-2.14748e+09;-2.86829e+06;0;0;0;0;0;0;419545134;426631290;28626989
1508;4.27178e-15;-354;1457;9537;10131;1;677;-2.14748e+09;-2.86219e+06;0;0;0;0;0;0;419659268;426760303;28664397
1508;4.23624e-15;-377;1243;9137;10075.5;1;641;-2.14748e+09;-2.86219e+06;-1;0;0;0;-1;0;419659268;426760303;28664397
1509;4.27178e-15;-355;1457;9537;10131;1;677;-2.14748e+09;-2.8562e+06;0;0;0;0;0;0;419773159;426889069;28701761
1509;4.23624e-15;-377;1243;9137;10075.5;1;641;-2.14748e+09;-2.8562e+06;-1;0;0;0;-1;0;419773159;426889069;28701761
1510;4.27178e-15;-356;1457;9537;10131;1;677;-2.14748e+09;-2.85033e+06;0;0;0;0;0;0;419886808;427017591;28739080
1510;4.23624e-15;-377;1243;9137;10075.5;1;641;-2.14748e+09;-2.85033e+06;-1;0;0;0;-1;0;419886808;427017591;28739080
1511;4.27178e-15;-357;1457;9537;10131;1;677;-2.14748e+09;-2.84427e+06;0;0;0;0;0;0;420000215;427145867;28776355
1511;4.23624e-15;-377;1243;9137;10075.5;1;641;-2.14748e+09;-2.84427e+06;-1;0;0;0;-1;0;420000215;427145867;28776355
1512;4.27178e-15;-358;1457;9537;10131;1;677;-2.14748e+09;-2.83833e+06;0;0;0;0;0;0;420113382;427273899;28813587
1512;4.23624e-15;-377;1243;9137;10075.5;1;641;-2.14748e+09;-2.83833e+06;-1;0;0;0;-1;0;420113382;427273899;28813587
1513;4.27178e-15;-358;1457;9537;10131;1;677;-2.14748e+09;-2.8324e+06;-1;0;0;0;-1;0;420226308;427401687;28850774
1513;4.23624e-15;-378;1243;9137;10075.5;1;641;-2.14748e+09;-2.8324e+06;0;0;0;0;0;0;420226308;427401687;28850774
1514;4.27178e-15;-359;1457;9537;10131;1;677;-2.14748e+09;-2.82659e+06;0;0;0;0;0;0;420338994;427529231;28887917
1514;4.23624e-15;-378;1243;9137;10075.5;1;641;-2.14748e+09;-2.82659e+06;-1;0;0;0;-1;0;420338994;427529231;28887917
1515;4.27178e-15;-360;1457;9537;10131;1;677;-2.14748e+09;-2.8206e+06;0;0;0;0;0;0;420451442;427656533;28925015
1515;4.23624e-15;-379;1243;9137;10075.5;1;641;-2.14748e+09;-2.8206e+06;0;0;0;0;0;0;420451442;427656533;28925015
1516;4.27178e-15;-361;1457;9537;10131;1;677;-2.14748e+09;-2.81472e+06;0;0;0;0;0;0;420563651;427783592;28962070
1516;4.23624e-15;-379;1243;9137;10075.5;1;641;-2.14748e+09;-2.81472e+06;-1;0;0;0;-1;0;420563651;427783592;28962070
1517;4.27178e-15;-362;1457;9537;10131;1;677;-2.14748e+09;-2.80895e+06;0;0;0;0;0;0;420675622;427910409;28999081
1517;4.23624e-15;-380;1243;9137;10075.5;1;641;-2.14748e+09;-2.80895e+06;0;0;0;0;0;0;420675622;427910409;28999081
1518;4.27178e-15;-362;1457;9537;10131;1;677;-2.14748e+09;-2.803e+06;-1;0;0;0;-1;0;420787355;428036985;29036047
1518;4.23624e-15;-381;1243;9137;10075.5;1;641;-2.14748e+09;-2.803e+06;0;0;0;0;0;0;420787355;428036985;29036047
1519;4.27178e-15;-362;1457;9537;10131;1;677;-2.14748e+09;-2.79726e+06;-1;0;0;0;-1;0;420898852;428163321;29072969
1519;4.23624e-15;-381;1243;9137;10075.5;1;641;-2.14748e+09;-2.79716e+06;-1;0;0;0;-1;0;420898852;428163321;29072969
1520;4.27178e-15;-362;1457;9537;10131;1;677;-2.14748e+09;-2.79144e+06;-1;0;0;0;-1;0;421010113;428289416;29109847
1520;4.23624e-15;-381;1243;9137;10075.5;1;641;-2.14748e+09;-2.79134e+06;-1;0;0;0;-1;0;421010113;428289416;29109847
1521;4.27178e-15;-362;1457;9537;10131;1;677;-2.14748e+09;-2.78553e+06;-1;0;0;0;-1;0;421121138;428415271;29146680
1521;4.23624e-15;-381;1243;9137;10075.5;1;641;-2.14748e+09;-2.78553e+06;-1;0;0;0;-1;0;421121138;428415271;29146680
1522;4.27178e-15;-362;1457;9537;10131;1;677;-2.14748e+09;-2.77983e+06;-1;0;0;0;-1;0;421231928;428540887;29183470
1522;4.23624e-15;-382;1243;9137;10075.5;1;641;-2.14748e+09;-2.77983e+06;0;0;0;0;0;0;421231928;428540887;29183470
1523;4.27178e-15;-363;1457;9537;10131;1;677;-2.14748e+09;-2.77395e+06;0;0;0;0;0;0;421342484;428666265;29220215
1523;4.23624e-15;-382;1243;9137;10075.5;1;641;-2.14748e+09;-2.77395e+06;-1;0;0;0;-1;0;421342484;428666265;29220215
1524;4.27178e-15;-363;1457;9537;10131;1;677;-2.14748e+09;-2.76819e+06;-1;0;0;0;-1;0;421452805;428791404;29256916
1524;4.23624e-15;-383;1243;9137;10075.5;1;641;-2.14748e+09;-2.76819e+06;0;0;0;0;0;0;421452805;428791404;29256916
1525;4.27178e-15;-363;1457;9537;10131;1;677;-2.14748e+09;-2.76254e+06;-1;0;0;0;-1;0;421562894;428916306;29293573
1525;4.23624e-15;-384;1243;9137;10075.5;1;641;-2.14748e+09;-2.76244e+06;0;0;0;0;0;0;421562894;428916306;29293573
1526;4.27178e-15;-364;1457;9537;10131;1;677;-2.14748e+09;-2.7567e+06;0;0;0;0;0;0;421672750;429040971;29330186
1526;4.23624e-15;-385;1243;9137;10075.5;1;641;-2.14748e+09;-2.7567e+06;0;0;0;0;0;0;421672750;429040971;29330186
1527;4.27178e-15;-365;1457;9537;10131;1;677;-2.14748e+09;-2.75108e+06;0;0;0;0;0;0;421782373;429165399;29366754
1527;4.23624e-15;-385;1243;9137;10075.5;1;641;-2.14748e+09;-2.75108e+06;-1;0;0;0;-1;0;421782373;429165399;29366754
1528;4.27178e-15;-366;1457;9537;10131;1;677;-2.14748e+09;-2.74527e+06;0;0;0;0;0;0;421891765;429289591;29403278
1528;4.23624e-15;-386;1243;9137;10075.5;1;641;-2.14748e+09;-2.74527e+06;0;0;0;0;0;0;421891765;429289591;29403278
1529;4.27178e-15;-367;1457;9537;10131;1;677;-2.14748e+09;-2.73968e+06;0;0;0;0;0;0;422000926;429413548;29439758
1529;4.23624e-15;-386;1243;9137;10075.5;1;641;-2.14748e+09;-2.73968e+06;-1;0;0;0;-1;0;422000926;429413548;29439758
1530;4.27178e-15;-367;1457;9537;10131;1;677;-2.14748e+09;-2.734e+06;-1;0;0;0;-1;0;422109856;429537269;29476193
1530;4.23624e-15;-386;1243;9137;10075.5;1;641;-2.14748e+09;-2.734e+06;-1;0;0;0;-1;0;422109856;429537269;29476193
1531;4.27178e-15;-367;1457;9537;10131;1;677;-2.14748e+09;-2.72833e+06;-1;0;0;0;-1;0;422218556;429660756;29512585
1531;4.23624e-15;-387;1243;9137;10075.5;1;641;-2.14748e+09;-2.72833e+06;0;0;0;0;0;0;422218556;429660756;29512585
1532;4.27178e-15;-368;1457;9537;10131;1;677;-2.14748e+09;-2.72258e+06;0;0;0;0;0;0;422327027;429784009;29548932
1532;4.23624e-15;-388;1243;9137;10075.5;1;641;-2.14748e+09;-2.72258e+06;0;0;0;0;0;0;422327027;429784009;29548932
1533;4.27178e-15;-369;1457;9537;10131;1;677;-2.14748e+09;-2.71694e+06;0;0;0;0;0;0;422435269;429907028;29585235
1533;4.23624e-15;-389;1243;9137;10075.5;1;641;-2.14748e+09;-2.71694e+06;0;0;0;0;0;0;422435269;429907028;29585235
1534;4.27178e-15;-370;1457;9537;10131;1;677;-2.14748e+09;-2.71132e+06;0;0;0;0;0;0;422543283;430029814;29621493
1534;4.23624e-15;-389;1243;9137;10075.5;1;641;-2.14748e+09;-2.71132e+06;-1;0;0;0;-1;0;422543283;430029814;29621493
1535;4.27178e-15;-371;1457;9537;10131;1;677;-2.14748e+09;-2.70571e+06;0;0;0;0;0;0;422651069;430152368;29657707
1535;4.23624e-15;-389;1243;9137;10075.5;1;641;-2.14748e+09;-2.70571e+06;-1;0;0;0;-1;0;422651069;430152368;29657707
1536;4.27178e-15;-372;1457;9537;10131;1;677;-2.14748e+09;-2.70021e+06;0;0;0;0;0;0;422758628;430274690;29693877
1536;4.23624e-15;-390;1243;9137;10075.5;1;641;-2.14748e+09;-2.70011e+06;0;0;0;0;0;0;422758628;430274690;29693877
1537;4.27178e-15;-372;1457;9537;10131;1;677;-2.14748e+09;-2.69453e+06;-1;0;0;0;-1;0;422865960;430396780;29730003
1537;4.23624e-15;-390;1243;9137;10075.5;1;641;-2.14748e+09;-2.69453e+06;-1;0;0;0;-1;0;422865960;430396780;29730003
1538;4.27178e-15;-372;1457;9537;10131;1;677;-2.14748e+09;-2.68896e+06;-1;0;0;0;-1;0;422973066;430518639;29766085
1538;4.23624e-15;-391;1243;9137;10075.5;1;641;-2.14748e+09;-2.68896e+06;0;0;0;0;0;0;422973066;430518639;29766085
1539;4.27178e-15;-373;1457;9537;10131;1;677;-2.14748e+09;-2.68351e+06;0;0;0;0;0;0;423079947;430640268;29802122
1539;4.23624e-15;-392;1243;9137;10075.5;1;641;-2.14748e+09;-2.68341e+06;0;0;0;0;0;0;423079947;430640268;29802122
1540;4.27178e-15;-374;1457;9537;10131;1;677;-2.14748e+09;-2.67786e+06;0;0;0;0;0;0;423186602;430761666;29838115
1540;4.23624e-15;-392;1243;9137;10075.5;1;641;-2.14748e+09;-2.67786e+06;-1;0;0;0;-1;0;423186602;430761666;29838115
1541;4.27178e-15;-374;1457;9537;10131;1;677;-2.14748e+09;-2.67244e+06;-1;0;0;0;-1;0;423293034;430882835;29874064
1541;4.23624e-15;-393;1243;9137;10075.5;1;641;-2.14748e+09;-2.67234e+06;0;0;0;0;0;0;423293034;430882835;29874064
1542;4.27178e-15;-375;1457;9537;10131;1;677;-2.14748e+09;-2.66682e+06;0;0;0;0;0;0;423399241;431003776;29909968
1542;4.23624e-15;-394;1243;9137;10075.5;1;641;-2.14748e+09;-2.66682e+06;0;0;0;0;0;0;423399241;431003776;29909968
1543;4.27178e-15;-376;1457;9537;10131;1;677;-2.14748e+09;-2.66142e+06;0;0;0;0;0;0;423505225;431124487;29945828
1543;4.23624e-15;-395;1243;9137;10075.5;1;641;-2.14748e+09;-2.66132e+06;0;0;0;0;0;0;423505225;431124487;29945828
1544;4.27178e-15;-376;1457;9537;10131;1;677;-2.14748e+09;-2.65584e+06;-1;0;0;0;-1;0;423610986;431244970;29981644
1544;4.23624e-15;-396;1243;9137;10075.5;1;641;-2.14748e+09;-2.65584e+06;0;0;0;0;0;0;423610986;431244970;29981644
1545;4.27178e-15;-376;1457;9537;10131;1;677;-2.14748e+09;-2.65036e+06;-1;0;0;0;-1;0;423716525;431365226;30017416
1545;4.23624e-15;-396;1243;9137;10075.5;1;641;-2.14748e+09;-2.65036e+06;-1;0;0;0;-1;0;423716525;431365226;30017416
1546;4.27178e-15;-376;1457;9537;10131;1;677;-2.14748e+09;-2.6449e+06;-1;0;0;0;-1;0;423821842;431485255;30053143
1546;4.23624e-15;-396;1243;9137;10075.5;1;641;-2.14748e+09;-2.6449e+06;-1;0;0;0;-1;0;423821842;431485255;30053143
1547;4.27178e-15;-377;1457;9537;10131;1;677;-2.14748e+09;-2.63946e+06;0;0;0;0;0;0;423926938;431605057;30088826
1547;4.23624e-15;-397;1243;9137;10075.5;1;641;-2.14748e+09;-2.63946e+06;0;0;0;0;0;0;423926938;431605057;30088826
1548;4.27178e-15;-378;1457;9537;10131;1;677;-2.14748e+09;-2.63402e+06;0;0;0;0;0;0;424031813;431724633;30124465
1548;4.23624e-15;-398;1243;9137;10075.5;1;641;-2.14748e+09;-2.63402e+06;0;0;0;0;0;0;424031813;431724633;30124465
1549;4.27178e-15;-379;1457;9537;10131;1;677;-2.14748e+09;-2.6287e+06;0;0;0;0;0;0;424136468;431843983;30160060
1549;4.23624e-15;-399;1243;9137;10075.5;1;641;-2.14748e+09;-2.6286e+06;0;0;0;0;0;0;424136468;431843983;30160060
1550;4.27178e-15;-379;1457;9537;10131;1;677;-2.14748e+09;-2.62329e+06;-1;0;0;0;-1;0;424240903;431963109;30195610
1550;4.23624e-15;-400;1243;9137;10075.5;1;641;-2.14748e+09;-2.62319e+06;0;0;0;0;0;0;424240903;431963109;30195610
1551;4.27178e-15;-380;1457;9537;10131;1;677;-2.14748e+09;-2.6179e+06;0;0;0;0;0;0;424345119;432082009;30231116
1551;4.23624e-15;-401;1243;9137;10075.5;1;641;-2.14748e+09;-2.6178e+06;0;0;0;0;0;0;424345119;432082009;30231116
1552;4.27178e-15;-381;1457;9537;10131;1;677;-2.14748e+09;-2.61242e+06;0;0;0;0;0;0;424449117;432200685;30266578
1552;4.23624e-15;-402;1243;9137;10075.5;1;641;-2.14748e+09;-2.61242e+06;0;0;0;0;0;0;424449117;432200685;30266578
1553;4.27178e-15;-382;1457;9537;10131;1;677;-2.14748e+09;-2.60705e+06;0;0;0;0;0;0;424552897;432319138;30301995
1553;4.23624e-15;-403;1243;9137;10075.5;1;641;-2.14748e+09;-2.60705e+06;0;0;0;0;0;0;424552897;432319138;30301995
1554;4.27178e-15;-382;1457;9537;10131;1;677;-2.14748e+09;-2.6017e+06;-1;0;0;0;-1;0;424656459;432437367;30337369
1554;4.23624e-15;-404;1243;9137;10075.5;1;641;-2.14748e+09;-2.6017e+06;0;0;0;0;0;0;424656459;432437367;30337369
1555;4.27178e-15;-383;1457;9537;10131;1;677;-2.14748e+09;-2.59636e+06;0;0;0;0;0;0;424759804;432555374;30372698
1555;4.23624e-15;-405;1243;9137;10075.5;1;641;-2.14748e+09;-2.59636e+06;0;0;0;0;0;0;424759804;432555374;30372698
1556;4.27178e-15;-383;1457;9537;10131;1;677;-2.14748e+09;-2.59113e+06;-1;0;0;0;-1;0;424862932;432673158;30407983
1556;4.23624e-15;-406;1243;9137;10075.5;1;641;-2.14748e+09;-2.59103e+06;0;0;0;0;0;0;424862932;432673158;30407983
1557;4.27178e-15;-384;1457;9537;10131;1;677;-2.14748e+09;-2.58581e+06;0;0;0;0;0;0;424965845;432790721;30443223
1557;4.23624e-15;-407;1243;9137;10075.5;1;641;-2.14748e+09;-2.58571e+06;0;0;0;0;0;0;424965845;432790721;30443223
1558;4.27178e-15;-384;1457;9537;10131;1;677;-2.14748e+09;-2.58041e+06;-1;0;0;0;-1;0;425068542;432908062;30478420
1558;4.23624e-15;-407;1243;9137;10075.5;1;641;-2.14748e+09;-2.58041e+06;-1;0;0;0;-1;0;425068542;432908062;30478420
1559;4.27178e-15;-385;1457;9537;10131;1;677;-2.14748e+09;-2.57512e+06;0;0;0;0;0;0;425171024;433025182;30513572
1559;4.23624e-15;-408;1243;9137;10075.5;1;641;-2.14748e+09;-2.57512e+06;0;0;0;0;0;0;425171024;433025182;30513572
1560;4.27178e-15;-386;1457;9537;10131;1;677;-2.14748e+09;-2.56984e+06;0;0;0;0;0;0;425273291;433142082;30548680
1560;4.23624e-15;-408;1243;9137;10075.5;1;641;-2.14748e+09;-2.56984e+06;-1;0;0;0;-1;0;425273291;433142082;30548680
1561;4.27178e-15;-387;1457;9537;10131;1;677;-2.14748e+09;-2.56458e+06;0;0;0;0;0;0;425375345;433258762;30583744
1561;4.23624e-15;-409;1243;9137;10075.5;1;641;-2.14748e+09;-2.56458e+06;0;0;0;0;0;0;425375345;433258762;30583744
1562;4.27178e-15;-387;1457;9537;10131;1;677;-2.14748e+09;-2.55932e+06;-1;0;0;0;-1;0;425477185;433375222;30618763
1562;4.23624e-15;-409;1243;9137;10075.5;1;641;-2.14748e+09;-2.55932e+06;-1;0;0;0;-1;0;425477185;433375222;30618763
1563;4.27178e-15;-387;1457;9537;10131;1;677;-2.14748e+09;-2.55408e+06;-1;0;0;0;-1;0;425578813;433491464;30653739
1563;4.23624e-15;-410;1243;9137;10075.5;1;641;-2.14748e+09;-2.55408e+06;0;0;0;0;0;0;425578813;433491464;30653739
1564;4.27178e-15;-387;1457;9537;10131;1;677;-2.14748e+09;-2.54886e+06;-1;0;0;0;-1;0;425680228;433607487;30688670
1564;4.23624e-15;-411;1243;9137;10075.5;1;641;-2.14748e+09;-2.54886e+06;0;0;0;0;0;0;425680228;433607487;30688670
1565;4.27178e-15;-387;1457;9537;10131;1;677;-2.14748e+09;-2.54364e+06;-1;0;0;0;-1;0;425781431;433723292;30723557
1565;4.23624e-15;-411;1243;9137;10075.5;1;641;-2.14748e+09;-2.54364e+06;-1;0;0;0;-1;0;425781431;433723292;30723557
1566;4.27178e-15;-387;1457;9537;10131;1;677;-2.14748e+09;-2.53854e+06;-1;0;0;0;-1;0;425882423;433838879;30758400
1566;4.23624e-15;-412;1243;9137;10075.5;1;641;-2.14748e+09;-2.53854e+06;0;0;0;0;0;0;425882423;433838879;30758400
1567;4.27178e-15;-387;1457;9537;10131;1;677;-2.14748e+09;-2.53325e+06;-1;0;0;0;-1;0;425983204;433954249;30793199
1567;4.23624e-15;-412;1243;9137;10075.5;1;641;-2.14748e+09;-2.53325e+06;-1;0;0;0;-1;0;425983204;433954249;30793199
1568;4.27178e-15;-388;1457;9537;10131;1;677;-2.14748e+09;-2.52818e+06;0;0;0;0;0;0;426083774;434069402;30827953
1568;4.23624e-15;-412;1243;9137;10075.5;1;641;-2.14748e+09;-2.52808e+06;-1;0;0;0;-1;0;426083774;434069402;30827953
1569;4.27178e-15;-388;1457;9537;10131;1;677;-2.14748e+09;-2.52301e+06;-1;0;0;0;-1;0;426184134;434184339;30862664
1569;4.23624e-15;-413;1243;9137;10075.5;1;641;-2.14748e+09;-2.52291e+06;0;0;0;0;0;0;426184134;434184339;30862664
1570;4.27178e-15;-389;1457;9537;10131;1;677;-2.14748e+09;-2.51786e+06;0;0;0;0;0;0;426284286;434299060;30897330
1570;4.23624e-15;-414;1243;9137;10075.5;1;641;-2.14748e+09;-2.51776e+06;0;0;0;0;0;0;426284286;434299060;30897330
1571;4.27178e-15;-390;1457;9537;10131;1;677;-2.14748e+09;-2.51272e+06;0;0;0;0;0;0;426384228;434413566;30931952
1571;4.23624e-15;-415;1243;9137;10075.5;1;641;-2.14748e+09;-2.51262e+06;0;0;0;0;0;0;426384228;434413566;30931952
1572;4.27178e-15;-390;1457;9537;10131;1;677;-2.14748e+09;-2.5075e+06;-1;0;0;0;-1;0;426483962;434527857;30966530
1572;4.23624e-15;-415;1243;9137;10075.5;1;641;-2.14748e+09;-2.5075e+06;-1;0;0;0;-1;0;426483962;434527857;30966530
1573;4.27178e-15;-390;1457;9537;10131;1;677;-2.14748e+09;-2.50238e+06;-1;0;0;0;-1;0;426583488;434641934;31001064
1573;4.23624e-15;-416;1243;9137;10075.5;1;641;-2.14748e+09;-2.50238e+06;0;0;0;0;0;0;426583488;434641934;31001064
1574;4.27178e-15;-390;1457;9537;10131;1;677;-2.14748e+09;-2.49728e+06;-1;0;0;0;-1;0;426682806;434755796;31035554
1574;4.23624e-15;-417;1243;9137;10075.5;1;641;-2.14748e+09;-2.49728e+06;0;0;0;0;0;0;426682806;434755796;31035554
1575;4.27178e-15;-391;1457;9537;10131;1;677;-2.14748e+09;-2.49219e+06;0;0;0;0;0;0;426781918;434869445;31070000
1575;4.23624e-15;-418;1243;9137;10075.5;1;641;-2.14748e+09;-2.49219e+06;0;0;0;0;0;0;426781918;434869445;31070000
1576;4.27178e-15;-391;1457;9537;10131;1;677;-2.14748e+09;-2.48711e+06;-1;0;0;0;-1;0;426880823;434982881;31104401
1576;4.23624e-15;-419;1243;9137;10075.5;1;641;-2.14748e+09;-2.48711e+06;0;0;0;0;0;0;426880823;434982881;31104401
1577;4.27178e-15;-391;1457;9537;10131;1;677;-2.14748e+09;-2.48204e+06;-1;0;0;0;-1;0;426979522;435096104;31138759
1577;4.23624e-15;-420;1243;9137;10075.5;1;641;-2.14748e+09;-2.48204e+06;0;0;0;0;0;0;426979522;435096104;31138759
1578;4.27178e-15;-391;1457;9537;10131;1;677;-2.14748e+09;-2.47699e+06;-1;0;0;0;-1;0;427078016;435209115;31173072
1578;4.23624e-15;-420;1243;9137;10075.5;1;641;-2.14748e+09;-2.47699e+06;-1;0;0;0;-1;0;427078016;435209115;31173072
1579;4.27178e-15;-392;1457;9537;10131;1;677;-2.14748e+09;-2.47205e+06;0;0;0;0;0;0;427176305;435321915;31207342
1579;4.23624e-15;-421;1243;9137;10075.5;1;641;-2.14748e+09;-2.47195e+06;0;0;0;0;0;0;427176305;435321915;31207342
1580;4.27178e-15;-393;1457;9537;10131;1;677;-2.14748e+09;-2.46692e+06;0;0;0;0;0;0;427274389;435434503;31241567
1580;4.23624e-15;-422;1243;9137;10075.5;1;641;-2.14748e+09;-2.46692e+06;0;0;0;0;0;0;427274389;435434503;31241567
1581;4.27178e-15;-393;1457;9537;10131;1;677;-2.14748e+09;-2.4619e+06;-1;0;0;0;-1;0;427372269;435546880;31275748
1581;4.23624e-15;-422;1243;9137;10075.5;1;641;-2.14748e+09;-2.4619e+06;-1;0;0;0;-1;0;427372269;435546880;31275748
1582;4.27178e-15;-393;1457;9537;10131;1;677;-2.14748e+09;-2.45689e+06;-1;0;0;0;-1;0;427469946;435659046;31309886
1582;4.23624e-15;-423;1243;9137;10075.5;1;641;-2.14748e+09;-2.45689e+06;0;0;0;0;0;0;427469946;435659046;31309886
1583;4.27178e-15;-393;1457;9537;10131;1;677;-2.14748e+09;-2.452e+06;-1;0;0;0;-1;0;427567419;435771003;31343979
1583;4.23624e-15;-424;1243;9137;10075.5;1;641;-2.14748e+09;-2.4519e+06;0;0;0;0;0;0;427567419;435771003;31343979
1584;4.27178e-15;-393;1457;9537;10131;1;677;-2.14748e+09;-2.44702e+06;-1;0;0;0;-1;0;427664691;435882750;31378029
1584;4.23624e-15;-424;1243;9137;10075.5;1;641;-2.14748e+09;-2.44692e+06;-1;0;0;0;-1;0;427664690;435882750;31378029
1585;4.27178e-15;-393;1457;9537;10131;1;677;-2.14748e+09;-2.44194e+06;-1;0;0;0;-1;0;427761759;435994288;31412034
1585;4.23624e-15;-424;1243;9137;10075.5;1;641;-2.14748e+09;-2.44194e+06;-1;0;0;0;-1;0;427761759;435994288;31412034
1586;4.27178e-15;-394;1457;9537;10131;1;677;-2.14748e+09;-2.43699e+06;0;0;0;0;0;0;427858627;436105618;31445995
1586;4.23624e-15;-424;1243;9137;10075.5;1;641;-2.14748e+09;-2.43699e+06;-1;0;0;0;-1;0;427858627;436105618;31445995
1587;4.27178e-15;-394;1457;9537;10131;1;677;-2.14748e+09;-2.43204e+06;-1;0;0;0;-1;0;427955293;436216739;31479913
1587;4.23624e-15;-425;1243;9137;10075.5;1;641;-2.14748e+09;-2.43204e+06;0;0;0;0;0;0;427955293;436216739;31479913
1588;4.27178e-15;-394;1457;9537;10131;1;677;-2.14748e+09;-2.4272e+06;-1;0;0;0;-1;0;428051759;436327652;31513786
1588;4.23624e-15;-425;1243;9137;10075.5;1;641;-2.14748e+09;-2.4272e+06;-1;0;0;0;-1;0;428051759;436327652;31513786
1589;4.27178e-15;-395;1457;9537;10131;1;677;-2.14748e+09;-2.42218e+06;0;0;0;0;0;0;428148024;436438358;31547616
1589;4.23624e-15;-426;1243;9137;10075.5;1;641;-2.14748e+09;-2.42218e+06;0;0;0;0;0;0;428148024;436438358;31547616
1590;4.27178e-15;-396;1457;9537;10131;1;677;-2.14748e+09;-2.41737e+06;0;0;0;0;0;0;428244090;436548857;31581402
1590;4.23624e-15;-426;1243;9137;10075.5;1;641;-2.14748e+09;-2.41727e+06;-1;0;0;0;-1;0;428244090;436548857;31581402
1591;4.27178e-15;-396;1457;9537;10131;1;677;-2.14748e+09;-2.41237e+06;-1;0;0;0;-1;0;428339956;436659149;31615143
1591;4.23624e-15;-427;1243;9137;10075.5;1;641;-2.14748e+09;-2.41237e+06;0;0;0;0;0;0;428339956;436659149;31615143
1592;4.27178e-15;-397;1457;9537;10131;1;677;-2.14748e+09;-2.40748e+06;0;0;0;0;0;0;428435623;436769235;31648841
1592;4.23624e-15;-428;1243;9137;10075.5;1;641;-2.14748e+09;-2.40748e+06;0;0;0;0;0;0;428435623;436769235;31648841
1593;4.27178e-15;-398;1457;9537;10131;1;677;-2.14748e+09;-2.4027e+06;0;0;0;0;0;0;428531093;436879116;31682495
1593;4.23624e-15;-429;1243;9137;10075.5;1;641;-2.14748e+09;-2.4026e+06;0;0;0;0;0;0;428531093;436879116;31682495
1594;4.27178e-15;-398;1457;9537;10131;1;677;-2.14748e+09;-2.39784e+06;-1;0;0;0;-1;0;428626364;436988791;31716105
1594;4.23624e-15;-429;1243;9137;10075.5;1;641;-2.14748e+09;-2.39784e+06;-1;0;0;0;-1;0;428626364;436988791;31716105
1595;4.27178e-15;-399;1457;9537;10131;1;677;-2.14748e+09;-2.39298e+06;0;0;0;0;0;0;428721438;437098262;31749672
1595;4.23624e-15;-430;1243;9137;10075.5;1;641;-2.14748e+09;-2.39288e+06;0;0;0;0;0;0;428721438;437098262;31749672
1596;4.27178e-15;-400;1457;9537;10131;1;677;-2.14748e+09;-2.38804e+06;0;0;0;0;0;0;428816315;437207528;31783194
1596;4.23624e-15;-430;1243;9137;10075.5;1;641;-2.14748e+09;-2.38804e+06;-1;0;0;0;-1;0;428816315;437207528;31783194
1597;4.27178e-15;-400;1457;9537;10131;1;677;-2.14748e+09;-2.38331e+06;-1;0;0;0;-1;0;428910996;437316590;31816673
1597;4.23624e-15;-431;1243;9137;10075.5;1;641;-2.14748e+09;-2.38331e+06;0;0;0;0;0;0;428910996;437316590;31816673
1598;4.27178e-15;-400;1457;9537;10131;1;677;-2.14748e+09;-2.37838e+06;-1;0;0;0;-1;0;429005480;437425449;31850108
1598;4.23624e-15;-432;1243;9137;10075.5;1;641;-2.14748e+09;-2.37838e+06;0;0;0;0;0;0;429005480;437425449;31850108
1599;4.27178e-15;-400;1457;9537;10131;1;677;-2.14748e+09;-2.37368e+06;-1;0;0;0;-1;0;429099769;437534105;31883499
1599;4.23624e-15;-432;1243;9137;10075.5;1;641;-2.14748e+09;-2.37368e+06;-1;0;0;0;-1;0;429099769;437534105;31883499
1600;4.27178e-15;-400;1457;9537;10131;1;677;-2.14748e+09;-2.36878e+06;-1;0;0;0;-1;0;429193863;437642557;31916846
1600;4.23624e-15;-432;1243;9137;10075.5;1;641;-2.14748e+09;-2.36878e+06;-1;0;0;0;-1;0;429193863;437642557;31916846
1601;4.27178e-15;-400;1457;9537;10131;1;677;-2.14748e+09;-2.36399e+06;-1;0;0;0;-1;0;429287762;437750808;31950150
1601;4.23624e-15;-433;1243;9137;10075.5;1;641;-2.14748e+09;-2.36399e+06;0;0;0;0;0;0;429287762;437750808;31950150
1602;4.27178e-15;-401;1457;9537;10131;1;677;-2.14748e+09;-2.35922e+06;0;0;0;0;0;0;429381467;437858857;31983409
1602;4.23624e-15;-433;1243;9137;10075.5;1;641;-2.14748e+09;-2.35922e+06;-1;0;0;0;-1;0;429381467;437858857;31983409
1603;4.27178e-15;-402;1457;9537;10131;1;677;-2.14748e+09;-2.35455e+06;0;0;0;0;0;0;429474978;437966704;32016626
1603;4.23624e-15;-434;1243;9137;10075.5;1;641;-2.14748e+09;-2.35445e+06;0;0;0;0;0;0;429474978;437966704;32016626
1604;4.27178e-15;-403;1457;9537;10131;1;677;-2.14748e+09;-2.3497e+06;0;0;0;0;0;0;429568296;438074350;32049798
1604;4.23624e-15;-435;1243;9137;10075.5;1;641;-2.14748e+09;-2.3497e+06;0;0;0;0;0;0;429568296;438074350;32049798
1605;4.27178e-15;-403;1457;9537;10131;1;677;-2.14748e+09;-2.34506e+06;-1;0;0;0;-1;0;429661421;438181796;32082927
1605;4.23624e-15;-435;1243;9137;10075.5;1;641;-2.14748e+09;-2.34496e+06;-1;0;0;0;-1;0;429661421;438181796;32082927
1606;4.27178e-15;-403;1457;9537;10131;1;677;-2.14748e+09;-2.34023e+06;-1;0;0;0;-1;0;429754354;438289041;32116012
1606;4.23624e-15;-435;1243;9137;10075.5;1;641;-2.14748e+09;-2.34023e+06;-1;0;0;0;-1;0;429754354;438289041;32116012
1607;4.27178e-15;-404;1457;9537;10131;1;677;-2.14748e+09;-2.33551e+06;0;0;0;0;0;0;429847095;438396087;32149053
1607;4.23624e-15;-436;1243;9137;10075.5;1;641;-2.14748e+09;-2.33551e+06;0;0;0;0;0;0;429847095;438396087;32149053
1608;4.27178e-15;-404;1457;9537;10131;1;677;-2.14748e+09;-2.3309e+06;-1;0;0;0;-1;0;429939644;438502933;32182051
1608;4.23624e-15;-437;1243;9137;10075.5;1;641;-2.14748e+09;-2.3308e+06;0;0;0;0;0;0;429939644;438502933;32182051
1609;4.27178e-15;-405;1457;9537;10131;1;677;-2.14748e+09;-2.3261e+06;0;0;0;0;0;0;430032002;438609580;32215005
1609;4.23624e-15;-438;1243;9137;10075.5;1;641;-2.14748e+09;-2.3261e+06;0;0;0;0;0;0;430032002;438609580;32215005
1610;4.27178e-15;-406;1457;9537;10131;1;677;-2.14748e+09;-2.32141e+06;0;0;0;0;0;0;430124170;438716028;32247916
1610;4.23624e-15;-439;1243;9137;10075.5;1;641;-2.14748e+09;-2.32141e+06;0;0;0;0;0;0;430124170;438716028;32247916
1611;4.27178e-15;-407;1457;9537;10131;1;677;-2.14748e+09;-2.31674e+06;0;0;0;0;0;0;430216148;438822279;32280783
1611;4.23624e-15;-440;1243;9137;10075.5;1;641;-2.14748e+09;-2.31674e+06;0;0;0;0;0;0;430216148;438822279;32280783
1612;4.27178e-15;-407;1457;9537;10131;1;677;-2.14748e+09;-2.31217e+06;-1;0;0;0;-1;0;430307935;438928332;32313606
1612;4.23624e-15;-441;1243;9137;10075.5;1;641;-2.14748e+09;-2.31207e+06;0;0;0;0;0;0;430307935;438928331;32313606
1613;4.27178e-15;-407;1457;9537;10131;1;677;-2.14748e+09;-2.30752e+06;-1;0;0;0;-1;0;430399534;439034187;32346386
1613;4.23624e-15;-442;1243;9137;10075.5;1;641;-2.14748e+09;-2.30742e+06;0;0;0;0;0;0;430399534;439034187;32346386
1614;4.27178e-15;-408;1457;9537;10131;1;677;-2.14748e+09;-2.30287e+06;0;0;0;0;0;0;430490943;439139845;32379122
1614;4.23624e-15;-443;1243;9137;10075.5;1;641;-2.14748e+09;-2.30277e+06;0;0;0;0;0;0;430490943;439139845;32379122
1615;4.27178e-15;-409;1457;9537;10131;1;677;-2.14748e+09;-2.29814e+06;0;0;0;0;0;0;430582165;439245307;32411815
1615;4.23624e-15;-443;1243;9137;10075.5;1;641;-2.14748e+09;-2.29814e+06;-1;0;0;0;-1;0;430582165;439245307;32411815
1616;4.27178e-15;-409;1457;9537;10131;1;677;-2.14748e+09;-2.29362e+06;-1;0;0;0;-1;0;430673198;439350573;32444464
1616;4.23624e-15;-444;1243;9137;10075.5;1;641;-2.14748e+09;-2.29362e+06;0;0;0;0;0;0;430673198;439350573;32444464
1617;4.27178e-15;-409;1457;9537;10131;1;677;-2.14748e+09;-2.28891e+06;-1;0;0;0;-1;0;430764044;439455643;32477070
1617;4.23624e-15;-445;1243;9137;10075.5;1;641;-2.14748e+09;-2.28891e+06;0;0;0;0;0;0;430764044;439455643;32477070
1618;4.27178e-15;-410;1457;9537;10131;1;677;-2.14748e+09;-2.28431e+06;0;0;0;0;0;0;430854702;439560517;32509633
1618;4.23624e-15;-446;1243;9137;10075.5;1;641;-2.14748e+09;-2.28431e+06;0;0;0;0;0;0;430854702;439560517;32509633
1619;4.27178e-15;-410;1457;9537;10131;1;677;-2.14748e+09;-2.27972e+06;-1;0;0;0;-1;0;430945174;439665197;32542152
1619;4.23624e-15;-447;1243;9137;10075.5;1;641;-2.14748e+09;-2.27972e+06;0;0;0;0;0;0;430945174;439665197;32542152
1620;4.27178e-15;-410;1457;9537;10131;1;677;-2.14748e+09;-2.27524e+06;-1;0;0;0;-1;0;431035460;439769682;32574627
1620;4.23624e-15;-448;1243;9137;10075.5;1;641;-2.14748e+09;-2.27514e+06;0;0;0;0;0;0;431035460;439769682;32574627
1621;4.27178e-15;-411;1457;9537;10131;1;677;-2.14748e+09;-2.27057e+06;0;0;0;0;0;0;431125560;439873973;32607059
1621;4.23624e-15;-449;1243;9137;10075.5;1;641;-2.14748e+09;-2.27057e+06;0;0;0;0;0;0;431125560;439873973;32607059
1622;4.27178e-15;-412;1457;9537;10131;1;677;-2.14748e+09;-2.26611e+06;0;0;0;0;0;0;431215475;439978071;32639448
1622;4.23624e-15;-449;1243;9137;10075.5;1;641;-2.14748e+09;-2.26601e+06;-1;0;0;0;-1;0;431215475;439978071;32639448
1623;4.27178e-15;-413;1457;9537;10131;1;677;-2.14748e+09;-2.26146e+06;0;0;0;0;0;0;431305204;440081974;32671794
1623;4.23624e-15;-450;1243;9137;10075.5;1;641;-2.14748e+09;-2.26146e+06;0;0;0;0;0;0;431305204;440081974;32671794
1624;4.27178e-15;-414;1457;9537;10131;1;677;-2.14748e+09;-2.25692e+06;0;0;0;0;0;0;431394749;440185685;32704096
1624;4.23624e-15;-450;1243;9137;10075.5;1;641;-2.14748e+09;-2.25692e+06;-1;0;0;0;-1;0;431394749;440185685;32704096
1625;4.27178e-15;-414;1457;9537;10131;1;677;-2.14748e+09;-2.2524e+06;-1;0;0;0;-1;0;431484110;440289204;32736355
1625;4.23624e-15;-450;1243;9137;10075.5;1;641;-2.14748e+09;-2.2524e+06;-1;0;0;0;-1;0;431484110;440289204;32736355
1626;4.27178e-15;-415;1457;9537;10131;1;677;-2.14748e+09;-2.24788e+06;0;0;0;0;0;0;431573288;440392530;32768570
1626;4.23624e-15;-450;1243;9137;10075.5;1;641;-2.14748e+09;-2.24788e+06;-1;0;0;0;-1;0;431573288;440392530;32768570
1627;4.27178e-15;-415;1457;9537;10131;1;677;-2.14748e+09;-2.24347e+06;-1;0;0;0;-1;0;431662282;440495664;32800743
1627;4.23624e-15;-451;1243;9137;10075.5;1;641;-2.14748e+09;-2.24347e+06;0;0;0;0;0;0;431662282;440495664;32800743
1628;4.27178e-15;-416;1457;9537;10131;1;677;-2.14748e+09;-2.23888e+06;0;0;0;0;0;0;431751093;440598607;32832872
1628;4.23624e-15;-451;1243;9137;10075.5;1;641;-2.14748e+09;-2.23888e+06;-1;0;0;0;-1;0;431751093;440598607;32832872
1629;4.27178e-15;-417;1457;9537;10131;1;677;-2.14748e+09;-2.23439e+06;0;0;0;0;0;0;431839722;440701359;32864958
1629;4.23624e-15;-452;1243;9137;10075.5;1;641;-2.14748e+09;-2.23439e+06;0;0;0;0;0;0;431839722;440701359;32864958
1630;4.27178e-15;-417;1457;9537;10131;1;677;-2.14748e+09;-2.22992e+06;-1;0;0;0;-1;0;431928169;440803920;32897000
1630;4.23624e-15;-452;1243;9137;10075.5;1;641;-2.14748e+09;-2.22992e+06;-1;0;0;0;-1;0;431928169;440803920;32897000
1631;4.27178e-15;-418;1457;9537;10131;1;677;-2.14748e+09;-2.22545e+06;0;0;0;0;0;0;432016434;440906292;32929000
1631;4.23624e-15;-453;1243;9137;10075.5;1;641;-2.14748e+09;-2.22545e+06;0;0;0;0;0;0;432016434;440906292;32929000
1632;4.27178e-15;-419;1457;9537;10131;1;677;-2.14748e+09;-2.2211e+06;0;0;0;0;0;0;432104518;441008473;32960956
1632;4.23624e-15;-454;1243;9137;10075.5;1;641;-2.14748e+09;-2.2211e+06;0;0;0;0;0;0;432104518;441008473;32960956
1633;4.27178e-15;-420;1457;9537;10131;1;677;-2.14748e+09;-2.21655e+06;0;0;0;0;0;0;432192422;441110465;32992869
1633;4.23624e-15;-454;1243;9137;10075.5;1;641;-2.14748e+09;-2.21655e+06;-1;0;0;0;-1;0;432192422;441110465;32992869
1634;4.27178e-15;-420;1457;9537;10131;1;677;-2.14748e+09;-2.21222e+06;-1;0;0;0;-1;0;432280145;441212268;33024740
1634;4.23624e-15;-454;1243;9137;10075.5;1;641;-2.14748e+09;-2.21212e+06;-1;0;0;0;-1;0;432280145;441212268;33024740
1635;4.27178e-15;-421;1457;9537;10131;1;677;-2.14748e+09;-2.2077e+06;0;0;0;0;0;0;432367688;441313882;33056567
1635;4.23624e-15;-454;1243;9137;10075.5;1;641;-2.14748e+09;-2.2077e+06;-1;0;0;0;-1;0;432367688;441313882;33056567
1636;4.27178e-15;-422;1457;9537;10131;1;677;-2.14748e+09;-2.20328e+06;0;0;0;0;0;0;432455052;441415307;33088351
1636;4.23624e-15;-454;1243;9137;10075.5;1;641;-2.14748e+09;-2.20328e+06;-1;0;0;0;-1;0;432455052;441415307;33088351
1637;4.27178e-15;-423;1457;9537;10131;1;677;-2.14748e+09;-2.19898e+06;0;0;0;0;0;0;432542236;441516545;33120091
1637;4.23624e-15;-454;1243;9137;10075.5;1;641;-2.14748e+09;-2.19898e+06;-1;0;0;0;-1;0;432542236;441516545;33120091
1638;4.27178e-15;-423;1457;9537;10131;1;677;-2.14748e+09;-2.19448e+06;-1;0;0;0;-1;0;432629242;441617595;33151789
1638;4.23624e-15;-454;1243;9137;10075.5;1;641;-2.14748e+09;-2.19448e+06;-1;0;0;0;-1;0;432629242;441617595;33151789
1639;4.27178e-15;-423;1457;9537;10131;1;677;-2.14748e+09;-2.1901e+06;-1;0;0;0;-1;0;432716070;441718458;33183444
1639;4.23624e-15;-454;1243;9137;10075.5;1;641;-2.14748e+09;-2.1901e+06;-1;0;0;0;-1;0;432716070;441718458;33183444
1640;4.27178e-15;-424;1457;9537;10131;1;677;-2.14748e+09;-2.18572e+06;0;0;0;0;0;0;432802720;441819135;33215056
1640;4.23624e-15;-455;1243;9137;10075.5;1;641;-2.14748e+09;-2.18572e+06;0;0;0;0;0;0;432802720;441819135;33215056
1641;4.27178e-15;-425;1457;9537;10131;1;677;-2.14748e+09;-2.18136e+06;0;0;0;0;0;0;432889192;441919625;33246625
1641;4.23624e-15;-455;1243;9137;10075.5;1;641;-2.14748e+09;-2.18136e+06;-1;0;0;0;-1;0;432889192;441919625;33246625
1642;4.27178e-15;-426;1457;9537;10131;1;677;-2.14748e+09;-2.17701e+06;0;0;0;0;0;0;432975488;442019928;33278151
1642;4.23624e-15;-456;1243;9137;10075.5;1;641;-2.14748e+09;-2.17701e+06;0;0;0;0;0;0;432975488;442019928;33278151
1643;4.27178e-15;-427;1457;9537;10131;1;677;-2.14748e+09;-2.17266e+06;0;0;0;0;0;0;433061607;442120047;33309634
1643;4.23624e-15;-456;1243;9137;10075.5;1;641;-2.14748e+09;-2.17266e+06;-1;0;0;0;-1;0;433061607;442120047;33309634
1644;4.27178e-15;-427;1457;9537;10131;1;677;-2.14748e+09;-2.16833e+06;-1;0;0;0;-1;0;433147549;442219979;33341075
1644;4.23624e-15;-456;1243;9137;10075.5;1;641;-2.14748e+09;-2.16833e+06;-1;0;0;0;-1;0;433147549;442219979;33341075
1645;4.27178e-15;-428;1457;9537;10131;1;677;-2.14748e+09;-2.164e+06;0;0;0;0;0;0;433233316;442319727;33372472
1645;4.23624e-15;-456;1243;9137;10075.5;1;641;-2.14748e+09;-2.164e+06;-1;0;0;0;-1;0;433233316;442319727;33372472
1646;4.27178e-15;-428;1457;9537;10131;1;677;-2.14748e+09;-2.15969e+06;-1;0;0;0;-1;0;433318907;442419291;33403827
1646;4.23624e-15;-456;1243;9137;10075.5;1;641;-2.14748e+09;-2.15969e+06;-1;0;0;0;-1;0;433318907;442419291;33403827
1647;4.27178e-15;-429;1457;9537;10131;1;677;-2.14748e+09;-2.15548e+06;0;0;0;0;0;0;433404324;442518670;33435139
1647;4.23624e-15;-456;1243;9137;10075.5;1;641;-2.14748e+09;-2.15538e+06;-1;0;0;0;-1;0;433404324;442518670;33435139
1648;4.27178e-15;-429;1457;9537;10131;1;677;-2.14748e+09;-2.15109e+06;-1;0;0;0;-1;0;433489565;442617865;33466408
1648;4.23624e-15;-457;1243;9137;10075.5;1;641;-2.14748e+09;-2.15109e+06;0;0;0;0;0;0;433489565;442617865;33466408
1649;4.27178e-15;-430;1457;9537;10131;1;677;-2.14748e+09;-2.1468e+06;0;0;0;0;0;0;433574633;442716877;33497634
1649;4.23624e-15;-458;1243;9137;10075.5;1;641;-2.14748e+09;-2.1468e+06;0;0;0;0;0;0;433574633;442716877;33497634
1650;4.27178e-15;-430;1457;9537;10131;1;677;-2.14748e+09;-2.14253e+06;-1;0;0;0;-1;0;433659527;442815706;33528818
1650;4.23624e-15;-458;1243;9137;10075.5;1;641;-2.14748e+09;-2.14253e+06;-1;0;0;0;-1;0;433659527;442815706;33528818
1651;4.27178e-15;-431;1457;9537;10131;1;677;-2.14748e+09;-2.13836e+06;0;0;0;0;0;0;433744247;442914352;33559959
1651;4.23624e-15;-459;1243;9137;10075.5;1;641;-2.14748e+09;-2.13826e+06;0;0;0;0;0;0;433744247;442914352;33559959
1652;4.27178e-15;-432;1457;9537;10131;1;677;-2.14748e+09;-2.13401e+06;0;0;0;0;0;0;433828794;443012816;33591057
1652;4.23624e-15;-459;1243;9137;10075.5;1;641;-2.14748e+09;-2.13401e+06;-1;0;0;0;-1;0;433828794;443012816;33591057
1653;4.27178e-15;-432;1457;9537;10131;1;677;-2.14748e+09;-2.12976e+06;-1;0;0;0;-1;0;433913168;443111098;33622112
1653;4.23624e-15;-460;1243;9137;10075.5;1;641;-2.14748e+09;-2.12976e+06;0;0;0;0;0;0;433913168;443111098;33622112
1654;4.27178e-15;-433;1457;9537;10131;1;677;-2.14748e+09;-2.12552e+06;0;0;0;0;0;0;433997371;443209198;33653125
1654;4.23624e-15;-460;1243;9137;10075.5;1;641;-2.14748e+09;-2.12552e+06;-1;0;0;0;-1;0;433997371;443209198;33653125
1655;4.27178e-15;-434;1457;9537;10131;1;677;-2.14748e+09;-2.1213e+06;0;0;0;0;0;0;434081401;443307117;33684096
1655;4.23624e-15;-460;1243;9137;10075.5;1;641;-2.14748e+09;-2.1213e+06;-1;0;0;0;-1;0;434081401;443307117;33684096
1656;4.27178e-15;-434;1457;9537;10131;1;677;-2.14748e+09;-2.11708e+06;-1;0;0;0;-1;0;434165260;443404855;33715023
1656;4.23624e-15;-460;1243;9137;10075.5;1;641;-2.14748e+09;-2.11708e+06;-1;0;0;0;-1;0;434165260;443404855;33715023
1657;4.27178e-15;-434;1457;9537;10131;1;677;-2.14748e+09;-2.11297e+06;-1;0;0;0;-1;0;434248948;443502413;33745909
1657;4.23624e-15;-460;1243;9137;10075.5;1;641;-2.14748e+09;-2.11287e+06;-1;0;0;0;-1;0;434248948;443502413;33745909
1658;4.27178e-15;-434;1457;9537;10131;1;677;-2.14748e+09;-2.10867e+06;-1;0;0;0;-1;0;434332466;443599791;33776751
1658;4.23624e-15;-461;1243;9137;10075.5;1;641;-2.14748e+09;-2.10867e+06;0;0;0;0;0;0;434332466;443599791;33776751
1659;4.27178e-15;-434;1457;9537;10131;1;677;-2.14748e+09;-2.10448e+06;-1;0;0;0;-1;0;434415813;443696988;33807552
1659;4.23624e-15;-461;1243;9137;10075.5;1;641;-2.14748e+09;-2.10448e+06;-1;0;0;0;-1;0;434415813;443696988;33807552
1660;4.27178e-15;-434;1457;9537;10131;1;677;-2.14748e+09;-2.1004e+06;-1;0;0;0;-1;0;434498990;443794007;33838309
1660;4.23624e-15;-461;1243;9137;10075.5;1;641;-2.14748e+09;-2.1003e+06;-1;0;0;0;-1;0;434498990;443794007;33838309
1661;4.27178e-15;-434;1457;9537;10131;1;677;-2.14748e+09;-2.09623e+06;-1;0;0;0;-1;0;434581997;443890846;33869025
1661;4.23624e-15;-462;1243;9137;10075.5;1;641;-2.14748e+09;-2.09623e+06;0;0;0;0;0;0;434581997;443890846;33869025
1662;4.27178e-15;-434;1457;9537;10131;1;677;-2.14748e+09;-2.09197e+06;-1;0;0;0;-1;0;434664835;443987506;33899698
1662;4.23624e-15;-463;1243;9137;10075.5;1;641;-2.14748e+09;-2.09197e+06;0;0;0;0;0;0;434664835;443987506;33899698
1663;4.27178e-15;-435;1457;9537;10131;1;677;-2.14748e+09;-2.08782e+06;0;0;0;0;0;0;434747505;444083988;33930328
1663;4.23624e-15;-464;1243;9137;10075.5;1;641;-2.14748e+09;-2.08782e+06;0;0;0;0;0;0;434747505;444083988;33930328
1664;4.27178e-15;-436;1457;9537;10131;1;677;-2.14748e+09;-2.08367e+06;0;0;0;0;0;0;434830006;444180292;33960916
1664;4.23624e-15;-464;1243;9137;10075.5;1;641;-2.14748e+09;-2.08367e+06;-1;0;0;0;-1;0;434830006;444180292;33960916
1665;4.27178e-15;-437;1457;9537;10131;1;677;-2.14748e+09;-2.07964e+06;0;0;0;0;0;0;434912340;444276419;33991462
1665;4.23624e-15;-465;1243;9137;10075.5;1;641;-2.14748e+09;-2.07964e+06;0;0;0;0;0;0;434912340;444276419;33991462
1666;4.27178e-15;-438;1457;9537;10131;1;677;-2.14748e+09;-2.07542e+06;0;0;0;0;0;0;434994505;444372368;34021966
1666;4.23624e-15;-466;1243;9137;10075.5;1;641;-2.14748e+09;-2.07542e+06;0;0;0;0;0;0;434994505;444372368;34021966
1667;4.27178e-15;-438;1457;9537;10131;1;677;-2.14748e+09;-2.0713e+06;-1;0;0;0;-1;0;435076504;444468140;34052427
1667;4.23624e-15;-467;1243;9137;10075.5;1;641;-2.14748e+09;-2.0713e+06;0;0;0;0;0;0;435076504;444468140;34052427
1668;4.27178e-15;-439;1457;9537;10131;1;677;-2.14748e+09;-2.0673e+06;0;0;0;0;0;0;435158335;444563736;34082846
1668;4.23624e-15;-468;1243;9137;10075.5;1;641;-2.14748e+09;-2.0672e+06;0;0;0;0;0;0;435158335;444563736;34082846
1669;4.27178e-15;-439;1457;9537;10131;1;677;-2.14748e+09;-2.0631e+06;-1;0;0;0;-1;0;435240000;444659155;34113223
1669;4.23624e-15;-468;1243;9137;10075.5;1;641;-2.14748e+09;-2.0631e+06;-1;0;0;0;-1;0;435240000;444659155;34113223
1670;4.27178e-15;-439;1457;9537;10131;1;677;-2.14748e+09;-2.05901e+06;-1;0;0;0;-1;0;435321499;444754399;34143558
1670;4.23624e-15;-469;1243;9137;10075.5;1;641;-2.14748e+09;-2.05901e+06;0;0;0;0;0;0;435321499;444754399;34143558
1671;4.27178e-15;-440;1457;9537;10131;1;677;-2.14748e+09;-2.05503e+06;0;0;0;0;0;0;435402833;444849467;34173850
1671;4.23624e-15;-469;1243;9137;10075.5;1;641;-2.14748e+09;-2.05493e+06;-1;0;0;0;-1;0;435402833;444849467;34173850
1672;4.27178e-15;-440;1457;9537;10131;1;677;-2.14748e+09;-2.05086e+06;-1;0;0;0;-1;0;435484001;444944359;34204101
1672;4.23624e-15;-470;1243;9137;10075.5;1;641;-2.14748e+09;-2.05086e+06;0;0;0;0;0;0;435484001;444944359;34204101
1673;4.27178e-15;-441;1457;9537;10131;1;677;-2.14748e+09;-2.0469e+06;0;0;0;0;0;0;435565004;445039077;34234309
1673;4.23624e-15;-471;1243;9137;10075.5;1;641;-2.14748e+09;-2.0468e+06;0;0;0;0;0;0;435565004;445039077;34234309
1674;4.27178e-15;-442;1457;9537;10131;1;677;-2.14748e+09;-2.04285e+06;0;0;0;0;0;0;435645842;445133621;34264475
1674;4.23624e-15;-472;1243;9137;10075.5;1;641;-2.14748e+09;-2.04275e+06;0;0;0;0;0;0;435645842;445133621;34264475
1675;4.27178e-15;-442;1457;9537;10131;1;677;-2.14748e+09;-2.03881e+06;-1;0;0;0;-1;0;435726516;445227990;34294599
1675;4.23624e-15;-472;1243;9137;10075.5;1;641;-2.14748e+09;-2.03881e+06;-1;0;0;0;-1;0;435726516;445227990;34294599
1676;4.27178e-15;-442;1457;9537;10131;1;677;-2.14748e+09;-2.03468e+06;-1;0;0;0;-1;0;435807027;445322185;34324681
1676;4.23624e-15;-472;1243;9137;10075.5;1;641;-2.14748e+09;-2.03468e+06;-1;0;0;0;-1;0;435807027;445322185;34324681
1677;4.27178e-15;-442;1457;9537;10131;1;677;-2.14748e+09;-2.03076e+06;-1;0;0;0;-1;0;435887373;445416207;34354721
1677;4.23624e-15;-473;1243;9137;10075.5;1;641;-2.14748e+09;-2.03076e+06;0;0;0;0;0;0;435887373;445416207;34354721
1678;4.27178e-15;-443;1457;9537;10131;1;677;-2.14748e+09;-2.02664e+06;0;0;0;0;0;0;435967557;445510056;34384720
1678;4.23624e-15;-473;1243;9137;10075.5;1;641;-2.14748e+09;-2.02664e+06;-1;0;0;0;-1;0;435967557;445510056;34384720
1679;4.27178e-15;-443;1457;9537;10131;1;677;-2.14748e+09;-2.02263e+06;-1;0;0;0;-1;0;436047578;445603732;34414676
1679;4.23624e-15;-473;1243;9137;10075.5;1;641;-2.14748e+09;-2.02263e+06;-1;0;0;0;-1;0;436047578;445603732;34414676
1680;4.27178e-15;-443;1457;9537;10131;1;677;-2.14748e+09;-2.01864e+06;-1;0;0;0;-1;0;436127436;445697236;34444590
1680;4.23624e-15;-473;1243;9137;10075.5;1;641;-2.14748e+09;-2.01864e+06;-1;0;0;0;-1;0;436127436;445697236;34444590
1681;4.27178e-15;-444;1457;9537;10131;1;677;-2.14748e+09;-2.01465e+06;0;0;0;0;0;0;436207133;445790568;34474463
1681;4.23624e-15;-473;1243;9137;10075.5;1;641;-2.14748e+09;-2.01465e+06;-1;0;0;0;-1;0;436207133;445790568;34474463
1682;4.27178e-15;-445;1457;9537;10131;1;677;-2.14748e+09;-2.01067e+06;0;0;0;0;0;0;436286668;445883728;34504293
1682;4.23624e-15;-474;1243;9137;10075.5;1;641;-2.14748e+09;-2.01067e+06;0;0;0;0;0;0;436286668;445883728;34504293
1683;4.27178e-15;-446;1457;9537;10131;1;677;-2.14748e+09;-2.0068e+06;0;0;0;0;0;0;436366041;445976716;34534082
1683;4.23624e-15;-475;1243;9137;10075.5;1;641;-2.14748e+09;-2.0067e+06;0;0;0;0;0;0;436366041;445976716;34534082
1684;4.27178e-15;-447;1457;9537;10131;1;677;-2.14748e+09;-2.00274e+06;0;0;0;0;0;0;436445254;446069533;34563829
1684;4.23624e-15;-475;1243;9137;10075.5;1;641;-2.14748e+09;-2.00274e+06;-1;0;0;0;-1;0;436445254;446069533;34563829
1685;4.27178e-15;-448;1457;9537;10131;1;677;-2.14748e+09;-1.99878e+06;0;0;0;0;0;0;436524306;446162180;34593535
1685;4.23624e-15;-476;1243;9137;10075.5;1;641;-2.14748e+09;-1.99878e+06;0;0;0;0;0;0;436524306;446162180;34593535
1686;4.27178e-15;-449;1457;9537;10131;1;677;-2.14748e+09;-1.99484e+06;0;0;0;0;0;0;436603198;446254656;34623198
1686;4.23624e-15;-476;1243;9137;10075.5;1;641;-2.14748e+09;-1.99484e+06;-1;0;0;0;-1;0;436603198;446254656;34623198
1687;4.27178e-15;-450;1457;9537;10131;1;677;-2.14748e+09;-1.9909e+06;0;0;0;0;0;0;436681930;446346962;34652820
1687;4.23624e-15;-477;1243;9137;10075.5;1;641;-2.14748e+09;-1.9909e+06;0;0;0;0;0;0;436681930;446346962;34652820
1688;4.27178e-15;-451;1457;9537;10131;1;677;-2.14748e+09;-1.98698e+06;0;0;0;0;0;0;436760502;446439099;34682400
1688;4.23624e-15;-477;1243;9137;10075.5;1;641;-2.14748e+09;-1.98698e+06;-1;0;0;0;-1;0;436760502;446439099;34682400
1689;4.27178e-15;-451;1457;9537;10131;1;677;-2.14748e+09;-1.98306e+06;-1;0;0;0;-1;0;436838916;446531066;34711939
1689;4.23624e-15;-477;1243;9137;10075.5;1;641;-2.14748e+09;-1.98306e+06;-1;0;0;0;-1;0;436838916;446531066;34711939
1690;4.27178e-15;-452;1457;9537;10131;1;677;-2.14748e+09;-1.97915e+06;0;0;0;0;0;0;436917170;446622864;34741436
1690;4.23624e-15;-478;1243;9137;10075.5;1;641;-2.14748e+09;-1.97915e+06;0;0;0;0;0;0;436917170;446622864;34741436
1691;4.27178e-15;-452;1457;9537;10131;1;677;-2.14748e+09;-1.97535e+06;-1;0;0;0;-1;0;436995267;446714493;34770892
1691;4.23624e-15;-479;1243;9137;10075.5;1;641;-2.14748e+09;-1.97525e+06;0;0;0;0;0;0;436995267;446714493;34770892
1692;4.27178e-15;-453;1457;9537;10131;1;677;-2.14748e+09;-1.97146e+06;0;0;0;0;0;0;437073205;446805954;34800305
1692;4.23624e-15;-480;1243;9137;10075.5;1;641;-2.14748e+09;-1.97136e+06;0;0;0;0;0;0;437073205;446805954;34800305
1693;4.27178e-15;-453;1457;9537;10131;1;677;-2.14748e+09;-1.96757e+06;-1;0;0;0;-1;0;437150985;446897247;34829678
1693;4.23624e-15;-481;1243;9137;10075.5;1;641;-2.14748e+09;-1.96747e+06;0;0;0;0;0;0;437150985;446897247;34829678
1694;4.27178e-15;-453;1457;9537;10131;1;677;-2.14748e+09;-1.9637e+06;-1;0;0;0;-1;0;437228608;446988372;34859009
1694;4.23624e-15;-482;1243;9137;10075.5;1;641;-2.14748e+09;-1.9637e+06;0;0;0;0;0;0;437228608;446988372;34859009
1695;4.27178e-15;-454;1457;9537;10131;1;677;-2.14748e+09;-1.95983e+06;0;0;0;0;0;0;437306074;447079330;34888298
1695;4.23624e-15;-483;1243;9137;10075.5;1;641;-2.14748e+09;-1.95983e+06;0;0;0;0;0;0;437306074;447079330;34888298
1696;4.27178e-15;-455;1457;9537;10131;1;677;-2.14748e+09;-1.95598e+06;0;0;0;0;0;0;437383383;447170120;34917547
1696;4.23624e-15;-484;1243;9137;10075.5;1;641;-2.14748e+09;-1.95598e+06;0;0;0;0;0;0;437383383;447170120;34917547
1697;4.27178e-15;-456;1457;9537;10131;1;677;-2.14748e+09;-1.95213e+06;0;0;0;0;0;0;437460536;447260744;34946753
1697;4.23624e-15;-485;1243;9137;10075.5;1;641;-2.14748e+09;-1.95203e+06;0;0;0;0;0;0;437460536;447260744;34946753
1698;4.27178e-15;-456;1457;9537;10131;1;677;-2.14748e+09;-1.94818e+06;-1;0;0;0;-1;0;437537534;447351202;34975919
1698;4.23624e-15;-485;1243;9137;10075.5;1;641;-2.14748e+09;-1.94818e+06;-1;0;0;0;-1;0;437537534;447351202;34975919
1699;4.27178e-15;-457;1457;9537;10131;1;677;-2.14748e+09;-1.94445e+06;0;0;0;0;0;0;437614375;447441493;35005043
1699;4.23624e-15;-486;1243;9137;10075.5;1;641;-2.14748e+09;-1.94445e+06;0;0;0;0;0;0;437614375;447441493;35005043
1700;4.27178e-15;-457;1457;9537;10131;1;677;-2.14748e+09;-1.94053e+06;-1;0;0;0;-1;0;437691061;447531619;35034126
1700;4.23624e-15;-486;1243;9137;10075.5;1;641;-2.14748e+09;-1.94053e+06;-1;0;0;0;-1;0;437691061;447531619;35034126
1701;4.27178e-15;-457;1457;9537;10131;1;677;-2.14748e+09;-1.93671e+06;-1;0;0;0;-1;0;437767593;447621579;35063167
1701;4.23624e-15;-486;1243;9137;10075.5;1;641;-2.14748e+09;-1.93671e+06;-1;0;0;0;-1;0;437767593;447621579;35063167
1702;4.27178e-15;-458;1457;9537;10131;1;677;-2.14748e+09;-1.93291e+06;0;0;0;0;0;0;437843969;447711374;35092167
1702;4.23624e-15;-486;1243;9137;10075.5;1;641;-2.14748e+09;-1.93291e+06;-1;0;0;0;-1;0;437843969;447711374;35092167
1703;4.27178e-15;-458;1457;9537;10131;1;677;-2.14748e+09;-1.92911e+06;-1;0;0;0;-1;0;437920192;447801005;35121127
1703;4.23624e-15;-486;1243;9137;10075.5;1;641;-2.14748e+09;-1.92911e+06;-1;0;0;0;-1;0;437920192;447801005;35121127
1704;4.27178e-15;-458;1457;9537;10131;1;677;-2.14748e+09;-1.92532e+06;-1;0;0;0;-1;0;437996261;447890470;35150045
1704;4.23624e-15;-487;1243;9137;10075.5;1;641;-2.14748e+09;-1.92531e+06;0;0;0;0;0;0;437996261;447890470;35150045
1705;4.27178e-15;-459;1457;9537;10131;1;677;-2.14748e+09;-1.92153e+06;0;0;0;0;0;0;438072176;447979772;35178921
1705;4.23624e-15;-487;1243;9137;10075.5;1;641;-2.14748e+09;-1.92153e+06;-1;0;0;0;-1;0;438072176;447979772;35178921
1706;4.27178e-15;-460;1457;9537;10131;1;677;-2.14748e+09;-1.91786e+06;0;0;0;0;0;0;438147938;448068910;35207757
1706;4.23624e-15;-487;1243;9137;10075.5;1;641;-2.14748e+09;-1.91776e+06;-1;0;0;0;-1;0;438147938;448068910;35207757
1707;4.27178e-15;-460;1457;9537;10131;1;677;-2.14748e+09;-1.91409e+06;-1;0;0;0;-1;0;438223547;448157884;35236552
1707;4.23624e-15;-488;1243;9137;10075.5;1;641;-2.14748e+09;-1.91409e+06;0;0;0;0;0;0;438223547;448157884;35236552
1708;4.27178e-15;-460;1457;9537;10131;1;677;-2.14748e+09;-1.91024e+06;-1;0;0;0;-1;0;438299003;448246696;35265306
1708;4.23624e-15;-488;1243;9137;10075.5;1;641;-2.14748e+09;-1.91024e+06;-1;0;0;0;-1;0;438299003;448246696;35265306
1709;4.27178e-15;-461;1457;9537;10131;1;677;-2.14748e+09;-1.90649e+06;0;0;0;0;0;0;438374308;448335344;35294018
1709;4.23624e-15;-488;1243;9137;10075.5;1;641;-2.14748e+09;-1.90649e+06;-1;0;0;0;-1;0;438374308;448335344;35294018
1710;4.27178e-15;-462;1457;9537;10131;1;677;-2.14748e+09;-1.90274e+06;0;0;0;0;0;0;438449460;448423830;35322690
1710;4.23624e-15;-488;1243;9137;10075.5;1;641;-2.14748e+09;-1.90275e+06;-1;0;0;0;-1;0;438449460;448423830;35322690
1711;4.27178e-15;-463;1457;9537;10131;1;677;-2.14748e+09;-1.89911e+06;0;0;0;0;0;0;438524461;448512153;35351321
1711;4.23624e-15;-489;1243;9137;10075.5;1;641;-2.14748e+09;-1.89911e+06;0;0;0;0;0;0;438524461;448512153;35351321
1712;4.27178e-15;-464;1457;9537;10131;1;677;-2.14748e+09;-1.89529e+06;0;0;0;0;0;0;438599311;448600315;35379911
1712;4.23624e-15;-490;1243;9137;10075.5;1;641;-2.14748e+09;-1.89529e+06;0;0;0;0;0;0;438599311;448600315;35379911
1713;4.27178e-15;-464;1457;9537;10131;1;677;-2.14748e+09;-1.89157e+06;-1;0;0;0;-1;0;438674010;448688315;35408460
1713;4.23624e-15;-490;1243;9137;10075.5;1;641;-2.14748e+09;-1.89157e+06;-1;0;0;0;-1;0;438674010;448688315;35408460
1714;4.27178e-15;-465;1457;9537;10131;1;677;-2.14748e+09;-1.88786e+06;0;0;0;0;0;0;438748559;448776154;35436968
1714;4.23624e-15;-491;1243;9137;10075.5;1;641;-2.14748e+09;-1.88786e+06;0;0;0;0;0;0;438748559;448776154;35436968
1715;4.27178e-15;-466;1457;9537;10131;1;677;-2.14748e+09;-1.88416e+06;0;0;0;0;0;0;438822957;448863832;35465436
1715;4.23624e-15;-491;1243;9137;10075.5;1;641;-2.14748e+09;-1.88416e+06;-1;0;0;0;-1;0;438822957;448863832;35465436
1716;4.27178e-15;-466;1457;9537;10131;1;677;-2.14748e+09;-1.88047e+06;-1;0;0;0;-1;0;438897206;448951349;35493863
1716;4.23624e-15;-491;1243;9137;10075.5;1;641;-2.14748e+09;-1.88047e+06;-1;0;0;0;-1;0;438897206;448951349;35493863
1717;4.27178e-15;-467;1457;9537;10131;1;677;-2.14748e+09;-1.87678e+06;0;0;0;0;0;0;438971305;449038706;35522249
1717;4.23624e-15;-491;1243;9137;10075.5;1;641;-2.14748e+09;-1.87678e+06;-1;0;0;0;-1;0;438971305;449038706;35522249
1718;4.27178e-15;-468;1457;9537;10131;1;677;-2.14748e+09;-1.87321e+06;0;0;0;0;0;0;439045255;449125903;35550594
1718;4.23624e-15;-492;1243;9137;10075.5;1;641;-2.14748e+09;-1.87311e+06;0;0;0;0;0;0;439045255;449125903;35550594
1719;4.27178e-15;-468;1457;9537;10131;1;677;-2.14748e+09;-1.86944e+06;-1;0;0;0;-1;0;439119056;449212940;35578899
1719;4.23624e-15;-493;1243;9137;10075.5;1;641;-2.14748e+09;-1.86944e+06;0;0;0;0;0;0;439119056;449212940;35578899
1720;4.27178e-15;-468;1457;9537;10131;1;677;-2.14748e+09;-1.86578e+06;-1;0;0;0;-1;0;439192709;449299818;35607163
1720;4.23624e-15;-494;1243;9137;10075.5;1;641;-2.14748e+09;-1.86578e+06;0;0;0;0;0;0;439192709;449299818;35607163
1721;4.27178e-15;-469;1457;9537;10131;1;677;-2.14748e+09;-1.86213e+06;0;0;0;0;0;0;439266213;449386536;35635386
1721;4.23624e-15;-494;1243;9137;10075.5;1;641;-2.14748e+09;-1.86213e+06;-1;0;0;0;-1;0;439266213;449386536;35635386
1722;4.27178e-15;-469;1457;9537;10131;1;677;-2.14748e+09;-1.85858e+06;-1;0;0;0;-1;0;439339570;449473096;35663569
1722;4.23624e-15;-495;1243;9137;10075.5;1;641;-2.14748e+09;-1.85848e+06;0;0;0;0;0;0;439339570;449473096;35663569
1723;4.27178e-15;-470;1457;9537;10131;1;677;-2.14748e+09;-1.85495e+06;0;0;0;0;0;0;439412779;449559498;35691711
1723;4.23624e-15;-495;1243;9137;10075.5;1;641;-2.14748e+09;-1.85495e+06;-1;0;0;0;-1;0;439412779;449559498;35691711
1724;4.27178e-15;-471;1457;9537;10131;1;677;-2.14748e+09;-1.85122e+06;0;0;0;0;0;0;439485841;449645741;35719813
1724;4.23624e-15;-496;1243;9137;10075.5;1;641;-2.14748e+09;-1.85122e+06;0;0;0;0;0;0;439485841;449645741;35719813
1725;4.27178e-15;-471;1457;9537;10131;1;677;-2.14748e+09;-1.8476e+06;-1;0;0;0;-1;0;439558756;449731826;35747875
1725;4.23624e-15;-496;1243;9137;10075.5;1;641;-2.14748e+09;-1.8476e+06;-1;0;0;0;-1;0;439558756;449731826;35747875
1726;4.27178e-15;-472;1457;9537;10131;1;677;-2.14748e+09;-1.84398e+06;0;0;0;0;0;0;439631524;449817754;35775896
1726;4.23624e-15;-496;1243;9137;10075.5;1;641;-2.14748e+09;-1.84398e+06;-1;0;0;0;-1;0;439631524;449817754;35775896
1727;4.27178e-15;-472;1457;9537;10131;1;677;-2.14748e+09;-1.84038e+06;-1;0;0;0;-1;0;439704146;449903525;35803876
1727;4.23624e-15;-497;1243;9137;10075.5;1;641;-2.14748e+09;-1.84038e+06;0;0;0;0;0;0;439704146;449903525;35803876
1728;4.27178e-15;-473;1457;9537;10131;1;677;-2.14748e+09;-1.83678e+06;0;0;0;0;0;0;439776623;449989138;35831817
1728;4.23624e-15;-497;1243;9137;10075.5;1;641;-2.14748e+09;-1.83678e+06;-1;0;0;0;-1;0;439776623;449989138;35831817
1729;4.27178e-15;-474;1457;9537;10131;1;677;-2.14748e+09;-1.83319e+06;0;0;0;0;0;0;439848954;450074595;35859717
1729;4.23624e-15;-497;1243;9137;10075.5;1;641;-2.14748e+09;-1.83319e+06;-1;0;0;0;-1;0;439848954;450074595;35859717
1730;4.27178e-15;-475;1457;9537;10131;1;677;-2.14748e+09;-1.82971e+06;0;0;0;0;0;0;439921139;450159896;35887576
1730;4.23624e-15;-497;1243;9137;10075.5;1;641;-2.14748e+09;-1.82971e+06;-1;0;0;0;-1;0;439921139;450159896;35887576
1731;4.27178e-15;-475;1457;9537;10131;1;677;-2.14748e+09;-1.82604e+06;-1;0;0;0;-1;0;439993180;450245041;35915396
1731;4.23624e-15;-497;1243;9137;10075.5;1;641;-2.14748e+09;-1.82604e+06;-1;0;0;0;-1;0;439993180;450245041;35915396
1732;4.27178e-15;-476;1457;9537;10131;1;677;-2.14748e+09;-1.82247e+06;0;0;0;0;0;0;440065076;450330030;35943175
1732;4.23624e-15;-498;1243;9137;10075.5;1;641;-2.14748e+09;-1.82247e+06;0;0;0;0;0;0;440065076;450330030;35943175
1733;4.27178e-15;-476;1457;9537;10131;1;677;-2.14748e+09;-1.81891e+06;-1;0;0;0;-1;0;440136828;450414863;35970914
1733;4.23624e-15;-499;1243;9137;10075.5;1;641;-2.14748e+09;-1.81891e+06;0;0;0;0;0;0;440136828;450414863;35970914
1734;4.27178e-15;-476;1457;9537;10131;1;677;-2.14748e+09;-1.81536e+06;-1;0;0;0;-1;0;440208435;450499542;35998613
1734;4.23624e-15;-499;1243;9137;10075.5;1;641;-2.14748e+09;-1.81536e+06;-1;0;0;0;-1;0;440208435;450499542;35998613
1735;4.27178e-15;-477;1457;9537;10131;1;677;-2.14748e+09;-1.81182e+06;0;0;0;0;0;0;440279899;450584065;36026272
1735;4.23624e-15;-499;1243;9137;10075.5;1;641;-2.14748e+09;-1.81182e+06;-1;0;0;0;-1;0;440279899;450584065;36026272
1736;4.27178e-15;-477;1457;9537;10131;1;677;-2.14748e+09;-1.80828e+06;-1;0;0;0;-1;0;440351220;450668434;36053891
1736;4.23624e-15;-500;1243;9137;10075.5;1;641;-2.14748e+09;-1.80828e+06;0;0;0;0;0;0;440351220;450668434;36053891
1737;4.27178e-15;-478;1457;9537;10131;1;677;-2.14748e+09;-1.80475e+06;0;0;0;0;0;0;440422398;450752649;36081469
1737;4.23624e-15;-500;1243;9137;10075.5;1;641;-2.14748e+09;-1.80476e+06;-1;0;0;0;-1;0;440422398;450752649;36081469
1738;4.27178e-15;-479;1457;9537;10131;1;677;-2.14748e+09;-1.80133e+06;0;0;0;0;0;0;440493433;450836710;36109008
1738;4.23624e-15;-500;1243;9137;10075.5;1;641;-2.14748e+09;-1.80123e+06;-1;0;0;0;-1;0;440493433;450836710;36109008
1739;4.27178e-15;-479;1457;9537;10131;1;677;-2.14748e+09;-1.79772e+06;-1;0;0;0;-1;0;440564326;450920617;36136507
1739;4.23624e-15;-501;1243;9137;10075.5;1;641;-2.14748e+09;-1.79772e+06;0;0;0;0;0;0;440564326;450920617;36136507
1740;4.27178e-15;-480;1457;9537;10131;1;677;-2.14748e+09;-1.79432e+06;0;0;0;0;0;0;440635076;451004371;36163966
1740;4.23624e-15;-501;1243;9137;10075.5;1;641;-2.14748e+09;-1.79422e+06;-1;0;0;0;-1;0;440635076;451004371;36163966
1741;4.27178e-15;-481;1457;9537;10131;1;677;-2.14748e+09;-1.79072e+06;0;0;0;0;0;0;440705685;451087972;36191385
1741;4.23624e-15;-501;1243;9137;10075.5;1;641;-2.14748e+09;-1.79072e+06;-1;0;0;0;-1;0;440705685;451087972;36191385
1742;4.27178e-15;-481;1457;9537;10131;1;677;-2.14748e+09;-1.78723e+06;-1;0;0;0;-1;0;440776152;451171421;36218764
1742;4.23624e-15;-502;1243;9137;10075.5;1;641;-2.14748e+09;-1.78723e+06;0;0;0;0;0;0;440776152;451171421;36218764
1743;4.27178e-15;-482;1457;9537;10131;1;677;-2.14748e+09;-1.78375e+06;0;0;0;0;0;0;440846479;451254716;36246103
1743;4.23624e-15;-503;1243;9137;10075.5;1;641;-2.14748e+09;-1.78375e+06;0;0;0;0;0;0;440846479;451254716;36246103
1744;4.27178e-15;-483;1457;9537;10131;1;677;-2.14748e+09;-1.78037e+06;0;0;0;0;0;0;440916664;451337860;36273402
1744;4.23624e-15;-503;1243;9137;10075.5;1;641;-2.14748e+09;-1.78037e+06;-1;0;0;0;-1;0;440916664;451337860;36273402
1745;4.27178e-15;-483;1457;9537;10131;1;677;-2.14748e+09;-1.7768e+06;-1;0;0;0;-1;0;440986709;451420852;36300662
1745;4.23624e-15;-503;1243;9137;10075.5;1;641;-2.14748e+09;-1.7768e+06;-1;0;0;0;-1;0;440986709;451420852;36300662
1746;4.27178e-15;-483;1457;9537;10131;1;677;-2.14748e+09;-1.77344e+06;-1;0;0;0;-1;0;441056613;451503692;36327882
1746;4.23624e-15;-504;1243;9137;10075.5;1;641;-2.14748e+09;-1.77344e+06;0;0;0;0;0;0;441056613;451503692;36327882
1747;4.27178e-15;-484;1457;9537;10131;1;677;-2.14748e+09;-1.76989e+06;0;0;0;0;0;0;441126378;451586381;36355063
1747;4.23624e-15;-504;1243;9137;10075.5;1;641;-2.14748e+09;-1.76989e+06;-1;0;0;0;-1;0;441126378;451586381;36355063
1748;4.27178e-15;-484;1457;9537;10131;1;677;-2.14748e+09;-1.76644e+06;-1;0;0;0;-1;0;441196003;451668919;36382203
1748;4.23624e-15;-505;1243;9137;10075.5;1;641;-2.14748e+09;-1.76644e+06;0;0;0;0;0;0;441196003;451668919;36382203
1749;4.27178e-15;-484;1457;9537;10131;1;677;-2.14748e+09;-1.76301e+06;-1;0;0;0;-1;0;441265489;451751306;36409304
1749;4.23624e-15;-506;1243;9137;10075.5;1;641;-2.14748e+09;-1.76301e+06;0;0;0;0;0;0;441265489;451751306;36409304
1750;4.27178e-15;-485;1457;9537;10131;1;677;-2.14748e+09;-1.75968e+06;0;0;0;0;0;0;441334836;451833543;36436366
1750;4.23624e-15;-507;1243;9137;10075.5;1;641;-2.14748e+09;-1.75958e+06;0;0;0;0;0;0;441334836;451833543;36436366
1751;4.27178e-15;-485;1457;9537;10131;1;677;-2.14748e+09;-1.75625e+06;-1;0;0;0;-1;0;441404044;451915629;36463388
1751;4.23624e-15;-507;1243;9137;10075.5;1;641;-2.14748e+09;-1.75615e+06;-1;0;0;0;-1;0;441404044;451915629;36463388
1752;4.27178e-15;-485;1457;9537;10131;1;677;-2.14748e+09;-1.75274e+06;-1;0;0;0;-1;0;441473114;451997566;36490371
1752;4.23624e-15;-507;1243;9137;10075.5;1;641;-2.14748e+09;-1.75274e+06;-1;0;0;0;-1;0;441473114;451997566;36490371
1753;4.27178e-15;-486;1457;9537;10131;1;677;-2.14748e+09;-1.74933e+06;0;0;0;0;0;0;441542045;452079354;36517314
1753;4.23624e-15;-508;1243;9137;10075.5;1;641;-2.14748e+09;-1.74933e+06;0;0;0;0;0;0;441542045;452079354;36517314
1754;4.27178e-15;-487;1457;9537;10131;1;677;-2.14748e+09;-1.74593e+06;0;0;0;0;0;0;441610839;452160992;36544217
1754;4.23624e-15;-508;1243;9137;10075.5;1;641;-2.14748e+09;-1.74593e+06;-1;0;0;0;-1;0;441610839;452160992;36544217
1755;4.27178e-15;-487;1457;9537;10131;1;677;-2.14748e+09;-1.74263e+06;-1;0;0;0;-1;0;441679496;452242481;36571082
1755;4.23624e-15;-509;1243;9137;10075.5;1;641;-2.14748e+09;-1.74253e+06;0;0;0;0;0;0;441679496;452242481;36571082
1756;4.27178e-15;-488;1457;9537;10131;1;677;-2.14748e+09;-1.73924e+06;0;0;0;0;0;0;441748015;452323821;36597907
1756;4.23624e-15;-509;1243;9137;10075.5;1;641;-2.14748e+09;-1.73924e+06;-1;0;0;0;-1;0;441748015;452323821;36597907
1757;4.27178e-15;-489;1457;9537;10131;1;677;-2.14748e+09;-1.73576e+06;0;0;0;0;0;0;441816397;452405014;36624692
1757;4.23624e-15;-510;1243;9137;10075.5;1;641;-2.14748e+09;-1.73576e+06;0;0;0;0;0;0;441816397;452405014;36624692
1758;4.27178e-15;-489;1457;9537;10131;1;677;-2.14748e+09;-1.73239e+06;-1;0;0;0;-1;0;441884643;452486058;36651439
1758;4.23624e-15;-510;1243;9137;10075.5;1;641;-2.14748e+09;-1.73239e+06;-1;0;0;0;-1;0;441884643;452486058;36651439
1759;4.27178e-15;-489;1457;9537;10131;1;677;-2.14748e+09;-1.72903e+06;-1;0;0;0;-1;0;441952752;452566954;36678146
1759;4.23624e-15;-510;1243;9137;10075.5;1;641;-2.14748e+09;-1.72903e+06;-1;0;0;0;-1;0;441952752;452566954;36678146
1760;4.27178e-15;-490;1457;9537;10131;1;677;-2.14748e+09;-1.72577e+06;0;0;0;0;0;0;442020726;452647702;36704814
1760;4.23624e-15;-510;1243;9137;10075.5;1;641;-2.14748e+09;-1.72567e+06;-1;0;0;0;-1;0;442020726;452647702;36704814
1761;4.27178e-15;-490;1457;9537;10131;1;677;-2.14748e+09;-1.72232e+06;-1;0;0;0;-1;0;442088564;452728304;36731442
1761;4.23624e-15;-510;1243;9137;10075.5;1;641;-2.14748e+09;-1.72232e+06;-1;0;0;0;-1;0;442088564;452728304;36731442
1762;4.27178e-15;-490;1457;9537;10131;1;677;-2.14748e+09;-1.71898e+06;-1;0;0;0;-1;0;442156266;452808758;36758032
1762;4.23624e-15;-511;1243;9137;10075.5;1;641;-2.14748e+09;-1.71898e+06;0;0;0;0;0;0;442156266;452808758;36758032
1763;4.27178e-15;-490;1457;9537;10131;1;677;-2.14748e+09;-1.71564e+06;-1;0;0;0;-1;0;442223833;452889066;36784583
1763;4.23624e-15;-512;1243;9137;10075.5;1;641;-2.14748e+09;-1.71564e+06;0;0;0;0;0;0;442223833;452889066;36784583
1764;4.27178e-15;-491;1457;9537;10131;1;677;-2.14748e+09;-1.71231e+06;0;0;0;0;0;0;442291266;452969227;36811094
1764;4.23624e-15;-513;1243;9137;10075.5;1;641;-2.14748e+09;-1.71231e+06;0;0;0;0;0;0;442291266;452969227;36811094
1765;4.27178e-15;-492;1457;9537;10131;1;677;-2.14748e+09;-1.70909e+06;0;0;0;0;0;0;442358564;453049243;36837567
1765;4.23624e-15;-513;1243;9137;10075.5;1;641;-2.14748e+09;-1.70909e+06;-1;0;0;0;-1;0;442358564;453049243;36837567
1766;4.27178e-15;-492;1457;9537;10131;1;677;-2.14748e+09;-1.70567e+06;-1;0;0;0;-1;0;442425728;453129112;36864000
1766;4.23624e-15;-514;1243;9137;10075.5;1;641;-2.14748e+09;-1.70567e+06;0;0;0;0;0;0;442425728;453129112;36864000
1767;4.27178e-15;-492;1457;9537;10131;1;677;-2.14748e+09;-1.70246e+06;-1;0;0;0;-1;0;442492758;453208836;36890395
1767;4.23624e-15;-514;1243;9137;10075.5;1;641;-2.14748e+09;-1.70246e+06;-1;0;0;0;-1;0;442492758;453208836;36890395
1768;4.27178e-15;-493;1457;9537;10131;1;677;-2.14748e+09;-1.69906e+06;0;0;0;0;0;0;442559654;453288414;36916750
1768;4.23624e-15;-514;1243;9137;10075.5;1;641;-2.14748e+09;-1.69906e+06;-1;0;0;0;-1;0;442559654;453288414;36916750
1769;4.27178e-15;-493;1457;9537;10131;1;677;-2.14748e+09;-1.69587e+06;-1;0;0;0;-1;0;442626417;453367848;36943067
1769;4.23624e-15;-515;1243;9137;10075.5;1;641;-2.14748e+09;-1.69587e+06;0;0;0;0;0;0;442626417;453367848;36943067
1770;4.27178e-15;-494;1457;9537;10131;1;677;-2.14748e+09;-1.69258e+06;0;0;0;0;0;0;442693046;453447137;36969345
1770;4.23624e-15;-515;1243;9137;10075.5;1;641;-2.14748e+09;-1.69248e+06;-1;0;0;0;-1;0;442693046;453447137;36969345
1771;4.27178e-15;-494;1457;9537;10131;1;677;-2.14748e+09;-1.6892e+06;-1;0;0;0;-1;0;442759543;453526281;36995584
1771;4.23624e-15;-516;1243;9137;10075.5;1;641;-2.14748e+09;-1.6892e+06;0;0;0;0;0;0;442759543;453526281;36995584
1772;4.27178e-15;-495;1457;9537;10131;1;677;-2.14748e+09;-1.68602e+06;0;0;0;0;0;0;442825908;453605281;37021785
1772;4.23624e-15;-517;1243;9137;10075.5;1;641;-2.14748e+09;-1.68592e+06;0;0;0;0;0;0;442825908;453605281;37021785
1773;4.27178e-15;-495;1457;9537;10131;1;677;-2.14748e+09;-1.68266e+06;-1;0;0;0;-1;0;442892140;453684138;37047947
1773;4.23624e-15;-517;1243;9137;10075.5;1;641;-2.14748e+09;-1.68266e+06;-1;0;0;0;-1;0;442892140;453684138;37047947
1774;4.27178e-15;-496;1457;9537;10131;1;677;-2.14748e+09;-1.6795e+06;0;0;0;0;0;0;442958241;453762850;37074070
1774;4.23624e-15;-517;1243;9137;10075.5;1;641;-2.14748e+09;-1.6795e+06;-1;0;0;0;-1;0;442958241;453762850;37074070
1775;4.27178e-15;-497;1457;9537;10131;1;677;-2.14748e+09;-1.67625e+06;0;0;0;0;0;0;443024210;453841420;37100154
1775;4.23624e-15;-517;1243;9137;10075.5;1;641;-2.14748e+09;-1.67625e+06;-1;0;0;0;-1;0;443024210;453841420;37100154
1776;4.27178e-15;-497;1457;9537;10131;1;677;-2.14748e+09;-1.6729e+06;-1;0;0;0;-1;0;443090047;453919846;37126200
1776;4.23624e-15;-518;1243;9137;10075.5;1;641;-2.14748e+09;-1.6729e+06;0;0;0;0;0;0;443090047;453919846;37126200
1777;4.27178e-15;-498;1457;9537;10131;1;677;-2.14748e+09;-1.66976e+06;0;0;0;0;0;0;443155754;453998129;37152207
1777;4.23624e-15;-519;1243;9137;10075.5;1;641;-2.14748e+09;-1.66976e+06;0;0;0;0;0;0;443155754;453998129;37152207
1778;4.27178e-15;-499;1457;9537;10131;1;677;-2.14748e+09;-1.66643e+06;0;0;0;0;0;0;443221330;454076270;37178176
1778;4.23624e-15;-520;1243;9137;10075.5;1;641;-2.14748e+09;-1.66643e+06;0;0;0;0;0;0;443221330;454076270;37178176
1779;4.27178e-15;-499;1457;9537;10131;1;677;-2.14748e+09;-1.6633e+06;-1;0;0;0;-1;0;443286775;454154269;37204106
1779;4.23624e-15;-520;1243;9137;10075.5;1;641;-2.14748e+09;-1.6633e+06;-1;0;0;0;-1;0;443286775;454154269;37204106
1780;4.27178e-15;-499;1457;9537;10131;1;677;-2.14748e+09;-1.66009e+06;-1;0;0;0;-1;0;443352090;454232125;37229998
1780;4.23624e-15;-520;1243;9137;10075.5;1;641;-2.14748e+09;-1.66009e+06;-1;0;0;0;-1;0;443352090;454232125;37229998
1781;4.27178e-15;-500;1457;9537;10131;1;677;-2.14748e+09;-1.65677e+06;0;0;0;0;0;0;443417275;454309840;37255851
1781;4.23624e-15;-521;1243;9137;10075.5;1;641;-2.14748e+09;-1.65677e+06;0;0;0;0;0;0;443417275;454309840;37255851
1782;4.27178e-15;-501;1457;9537;10131;1;677;-2.14748e+09;-1.65357e+06;0;0;0;0;0;0;443482331;454387414;37281666
1782;4.23624e-15;-521;1243;9137;10075.5;1;641;-2.14748e+09;-1.65357e+06;-1;0;0;0;-1;0;443482331;454387414;37281666
1783;4.27178e-15;-501;1457;9537;10131;1;677;-2.14748e+09;-1.65047e+06;-1;0;0;0;-1;0;443547257;454464846;37307443
1783;4.23624e-15;-521;1243;9137;10075.5;1;641;-2.14748e+09;-1.65037e+06;-1;0;0;0;-1;0;443547257;454464846;37307443
1784;4.27178e-15;-501;1457;9537;10131;1;677;-2.14748e+09;-1.64718e+06;-1;0;0;0;-1;0;443612054;454542137;37333182
1784;4.23624e-15;-522;1243;9137;10075.5;1;641;-2.14748e+09;-1.64718e+06;0;0;0;0;0;0;443612054;454542137;37333182
1785;4.27178e-15;-502;1457;9537;10131;1;677;-2.14748e+09;-1.644e+06;0;0;0;0;0;0;443676723;454619288;37358882
1785;4.23624e-15;-523;1243;9137;10075.5;1;641;-2.14748e+09;-1.644e+06;0;0;0;0;0;0;443676723;454619288;37358882
1786;4.27178e-15;-502;1457;9537;10131;1;677;-2.14748e+09;-1.64082e+06;-1;0;0;0;-1;0;443741263;454696298;37384544
1786;4.23624e-15;-524;1243;9137;10075.5;1;641;-2.14748e+09;-1.64082e+06;0;0;0;0;0;0;443741263;454696298;37384544
1787;4.27178e-15;-502;1457;9537;10131;1;677;-2.14748e+09;-1.63765e+06;-1;0;0;0;-1;0;443805674;454773168;37410167
1787;4.23624e-15;-524;1243;9137;10075.5;1;641;-2.14748e+09;-1.63765e+06;-1;0;0;0;-1;0;443805674;454773168;37410167
1788;4.27178e-15;-503;1457;9537;10131;1;677;-2.14748e+09;-1.63458e+06;0;0;0;0;0;0;443869958;454849899;37435753
1788;4.23624e-15;-524;1243;9137;10075.5;1;641;-2.14748e+09;-1.63448e+06;-1;0;0;0;-1;0;443869958;454849899;37435753
1789;4.27178e-15;-503;1457;9537;10131;1;677;-2.14748e+09;-1.63132e+06;-1;0;0;0;-1;0;443934114;454926490;37461301
1789;4.23624e-15;-525;1243;9137;10075.5;1;641;-2.14748e+09;-1.63132e+06;0;0;0;0;0;0;443934114;454926490;37461301
1790;4.27178e-15;-503;1457;9537;10131;1;677;-2.14748e+09;-1.62817e+06;-1;0;0;0;-1;0;443998142;455002941;37486810
1790;4.23624e-15;-526;1243;9137;10075.5;1;641;-2.14748e+09;-1.62817e+06;0;0;0;0;0;0;443998142;455002941;37486810
1791;4.27178e-15;-503;1457;9537;10131;1;677;-2.14748e+09;-1.62503e+06;-1;0;0;0;-1;0;444062044;455079253;37512282
1791;4.23624e-15;-526;1243;9137;10075.5;1;641;-2.14748e+09;-1.62503e+06;-1;0;0;0;-1;0;444062044;455079253;37512282
1792;4.27178e-15;-504;1457;9537;10131;1;677;-2.14748e+09;-1.62199e+06;0;0;0;0;0;0;444125819;455155427;37537715
1792;4.23624e-15;-527;1243;9137;10075.5;1;641;-2.14748e+09;-1.62189e+06;0;0;0;0;0;0;444125819;455155427;37537715
1793;4.27178e-15;-504;1457;9537;10131;1;677;-2.14748e+09;-1.61886e+06;-1;0;0;0;-1;0;444189467;455231462;37563111
1793;4.23624e-15;-528;1243;9137;10075.5;1;641;-2.14748e+09;-1.61886e+06;0;0;0;0;0;0;444189467;455231462;37563111
1794;4.27178e-15;-505;1457;9537;10131;1;677;-2.14748e+09;-1.61563e+06;0;0;0;0;0;0;444252988;455307359;37588468
1794;4.23624e-15;-529;1243;9137;10075.5;1;641;-2.14748e+09;-1.61563e+06;0;0;0;0;0;0;444252988;455307359;37588468
1795;4.27178e-15;-506;1457;9537;10131;1;677;-2.14748e+09;-1.61252e+06;0;0;0;0;0;0;444316384;455383118;37613788
1795;4.23624e-15;-530;1243;9137;10075.5;1;641;-2.14748e+09;-1.61252e+06;0;0;0;0;0;0;444316384;455383118;37613788
1796;4.27178e-15;-507;1457;9537;10131;1;677;-2.14748e+09;-1.6095e+06;0;0;0;0;0;0;444379654;455458739;37639070
1796;4.23624e-15;-530;1243;9137;10075.5;1;641;-2.14748e+09;-1.6094e+06;-1;0;0;0;-1;0;444379654;455458739;37639070
1797;4.27178e-15;-507;1457;9537;10131;1;677;-2.14748e+09;-1.6063e+06;-1;0;0;0;-1;0;444442799;455534223;37664314
1797;4.23624e-15;-531;1243;9137;10075.5;1;641;-2.14748e+09;-1.6063e+06;0;0;0;0;0;0;444442799;455534223;37664314
1798;4.27178e-15;-508;1457;9537;10131;1;677;-2.14748e+09;-1.6032e+06;0;0;0;0;0;0;444505818;455609569;37689520
1798;4.23624e-15;-531;1243;9137;10075.5;1;641;-2.14748e+09;-1.6032e+06;-1;0;0;0;-1;0;444505818;455609569;37689520
1799;4.27178e-15;-508;1457;9537;10131;1;677;-2.14748e+09;-1.60011e+06;-1;0;0;0;-1;0;444568712;455684779;37714689
1799;4.23624e-15;-531;1243;9137;10075.5;1;641;-2.14748e+09;-1.60011e+06;-1;0;0;0;-1;0;444568712;455684779;37714689
1800;4.27178e-15;-508;1457;9537;10131;1;677;-2.14748e+09;-1.59712e+06;-1;0;0;0;-1;0;444631482;455759852;37739820
1800;4.23624e-15;-532;1243;9137;10075.5;1;641;-2.14748e+09;-1.59702e+06;0;0;0;0;0;0;444631482;455759852;37739820
1801;4.27178e-15;-508;1457;9537;10131;1;677;-2.14748e+09;-1.59394e+06;-1;0;0;0;-1;0;444694127;455834788;37764913
1801;4.23624e-15;-533;1243;9137;10075.5;1;641;-2.14748e+09;-1.59394e+06;0;0;0;0;0;0;444694127;455834788;37764913
1802;4.27178e-15;-509;1457;9537;10131;1;677;-2.14748e+09;-1.59097e+06;0;0;0;0;0;0;444756648;455909588;37789969
1802;4.23624e-15;-534;1243;9137;10075.5;1;641;-2.14748e+09;-1.59097e+06;0;0;0;0;0;0;444756648;455909588;37789969
1803;4.27178e-15;-509;1457;9537;10131;1;677;-2.14748e+09;-1.5879e+06;-1;0;0;0;-1;0;444819045;455984253;37814987
1803;4.23624e-15;-534;1243;9137;10075.5;1;641;-2.14748e+09;-1.5879e+06;-1;0;0;0;-1;0;444819045;455984253;37814987
1804;4.27178e-15;-509;1457;9537;10131;1;677;-2.14748e+09;-1.58474e+06;-1;0;0;0;-1;0;444881319;456058781;37839968
1804;4.23624e-15;-534;1243;9137;10075.5;1;641;-2.14748e+09;-1.58474e+06;-1;0;0;0;-1;0;444881319;456058781;37839968
1805;4.27178e-15;-509;1457;9537;10131;1;677;-2.14748e+09;-1.58179e+06;-1;0;0;0;-1;0;444943469;456133175;37864911
1805;4.23624e-15;-535;1243;9137;10075.5;1;641;-2.14748e+09;-1.58169e+06;0;0;0;0;0;0;444943469;456133175;37864911
1806;4.27178e-15;-509;1457;9537;10131;1;677;-2.14748e+09;-1.57874e+06;-1;0;0;0;-1;0;445005496;456207433;37889817
1806;4.23624e-15;-536;1243;9137;10075.5;1;641;-2.14748e+09;-1.57864e+06;0;0;0;0;0;0;445005496;456207433;37889817
1807;4.27178e-15;-509;1457;9537;10131;1;677;-2.14748e+09;-1.5756e+06;-1;0;0;0;-1;0;445067400;456281556;37914685
1807;4.23624e-15;-537;1243;9137;10075.5;1;641;-2.14748e+09;-1.5756e+06;0;0;0;0;0;0;445067400;456281556;37914685
1808;4.27178e-15;-510;1457;9537;10131;1;677;-2.14748e+09;-1.57257e+06;0;0;0;0;0;0;445129182;456355544;37939516
1808;4.23624e-15;-538;1243;9137;10075.5;1;641;-2.14748e+09;-1.57257e+06;0;0;0;0;0;0;445129182;456355544;37939516
1809;4.27178e-15;-510;1457;9537;10131;1;677;-2.14748e+09;-1.56954e+06;-1;0;0;0;-1;0;445190842;456429399;37964310
1809;4.23624e-15;-538;1243;9137;10075.5;1;641;-2.14748e+09;-1.56954e+06;-1;0;0;0;-1;0;445190842;456429399;37964310
1810;4.27178e-15;-510;1457;9537;10131;1;677;-2.14748e+09;-1.56662e+06;-1;0;0;0;-1;0;445252379;456503119;37989067
1810;4.23624e-15;-539;1243;9137;10075.5;1;641;-2.14748e+09;-1.56652e+06;0;0;0;0;0;0;445252379;456503119;37989067
1811;4.27178e-15;-510;1457;9537;10131;1;677;-2.14748e+09;-1.5636e+06;-1;0;0;0;-1;0;445313795;456576705;38013786
1811;4.23624e-15;-539;1243;9137;10075.5;1;641;-2.14748e+09;-1.5635e+06;-1;0;0;0;-1;0;445313795;456576705;38013786
1812;4.27178e-15;-510;1457;9537;10131;1;677;-2.14748e+09;-1.56049e+06;-1;0;0;0;-1;0;445375089;456650158;38038468
1812;4.23624e-15;-539;1243;9137;10075.5;1;641;-2.14748e+09;-1.56049e+06;-1;0;0;0;-1;0;445375089;456650158;38038468
1813;4.27178e-15;-511;1457;9537;10131;1;677;-2.14748e+09;-1.55749e+06;0;0;0;0;0;0;445436262;456723477;38063113
1813;4.23624e-15;-540;1243;9137;10075.5;1;641;-2.14748e+09;-1.55749e+06;0;0;0;0;0;0;445436262;456723477;38063113
1814;4.27178e-15;-511;1457;9537;10131;1;677;-2.14748e+09;-1.55459e+06;-1;0;0;0;-1;0;445497314;456796663;38087720
1814;4.23624e-15;-540;1243;9137;10075.5;1;641;-2.14748e+09;-1.55449e+06;-1;0;0;0;-1;0;445497314;456796663;38087720
1815;4.27178e-15;-512;1457;9537;10131;1;677;-2.14748e+09;-1.5515e+06;0;0;0;0;0;0;445558245;456869716;38112291
1815;4.23624e-15;-540;1243;9137;10075.5;1;641;-2.14748e+09;-1.5515e+06;-1;0;0;0;-1;0;445558245;456869716;38112291
1816;4.27178e-15;-513;1457;9537;10131;1;677;-2.14748e+09;-1.54852e+06;0;0;0;0;0;0;445619056;456942637;38136825
1816;4.23624e-15;-541;1243;9137;10075.5;1;641;-2.14748e+09;-1.54852e+06;0;0;0;0;0;0;445619056;456942637;38136825
1817;4.27178e-15;-514;1457;9537;10131;1;677;-2.14748e+09;-1.54554e+06;0;0;0;0;0;0;445679747;457015425;38161321
1817;4.23624e-15;-541;1243;9137;10075.5;1;641;-2.14748e+09;-1.54554e+06;-1;0;0;0;-1;0;445679747;457015425;38161321
1818;4.27178e-15;-514;1457;9537;10131;1;677;-2.14748e+09;-1.54267e+06;-1;0;0;0;-1;0;445740318;457088081;38185781
1818;4.23624e-15;-542;1243;9137;10075.5;1;641;-2.14748e+09;-1.54257e+06;0;0;0;0;0;0;445740318;457088081;38185781
1819;4.27178e-15;-515;1457;9537;10131;1;677;-2.14748e+09;-1.5396e+06;0;0;0;0;0;0;445800768;457160605;38210203
1819;4.23624e-15;-542;1243;9137;10075.5;1;641;-2.14748e+09;-1.5396e+06;-1;0;0;0;-1;0;445800768;457160605;38210203
1820;4.27178e-15;-515;1457;9537;10131;1;677;-2.14748e+09;-1.53664e+06;-1;0;0;0;-1;0;445861100;457232998;38234589
1820;4.23624e-15;-543;1243;9137;10075.5;1;641;-2.14748e+09;-1.53664e+06;0;0;0;0;0;0;445861100;457232998;38234589
1821;4.27178e-15;-515;1457;9537;10131;1;677;-2.14748e+09;-1.53379e+06;-1;0;0;0;-1;0;445921312;457305259;38258938
1821;4.23624e-15;-543;1243;9137;10075.5;1;641;-2.14748e+09;-1.53379e+06;-1;0;0;0;-1;0;445921312;457305259;38258938
1822;4.27178e-15;-516;1457;9537;10131;1;677;-2.14748e+09;-1.53074e+06;0;0;0;0;0;0;445981406;457377390;38283250
1822;4.23624e-15;-543;1243;9137;10075.5;1;641;-2.14748e+09;-1.53074e+06;-1;0;0;0;-1;0;445981406;457377390;38283250
1823;4.27178e-15;-517;1457;9537;10131;1;677;-2.14748e+09;-1.5279e+06;0;0;0;0;0;0;446041381;457449389;38307526
1823;4.23624e-15;-544;1243;9137;10075.5;1;641;-2.14748e+09;-1.5278e+06;0;0;0;0;0;0;446041381;457449389;38307526
1824;4.27178e-15;-517;1457;9537;10131;1;677;-2.14748e+09;-1.52497e+06;-1;0;0;0;-1;0;446101237;457521258;38331764
1824;4.23624e-15;-545;1243;9137;10075.5;1;641;-2.14748e+09;-1.52497e+06;0;0;0;0;0;0;446101237;457521258;38331764
1825;4.27178e-15;-517;1457;9537;10131;1;677;-2.14748e+09;-1.52194e+06;-1;0;0;0;-1;0;446160975;457592996;38355966
1825;4.23624e-15;-545;1243;9137;10075.5;1;641;-2.14748e+09;-1.52194e+06;-1;0;0;0;-1;0;446160975;457592996;38355966
1826;4.27178e-15;-518;1457;9537;10131;1;677;-2.14748e+09;-1.51912e+06;0;0;0;0;0;0;446220595;457664604;38380132
1826;4.23624e-15;-545;1243;9137;10075.5;1;641;-2.14748e+09;-1.51902e+06;-1;0;0;0;-1;0;446220595;457664604;38380132
1827;4.27178e-15;-519;1457;9537;10131;1;677;-2.14748e+09;-1.5161e+06;0;0;0;0;0;0;446280098;457736082;38404261
1827;4.23624e-15;-545;1243;9137;10075.5;1;641;-2.14748e+09;-1.5161e+06;-1;0;0;0;-1;0;446280098;457736082;38404261
1828;4.27178e-15;-519;1457;9537;10131;1;677;-2.14748e+09;-1.51319e+06;-1;0;0;0;-1;0;446339483;457807431;38428353
1828;4.23624e-15;-546;1243;9137;10075.5;1;641;-2.14748e+09;-1.51319e+06;0;0;0;0;0;0;446339483;457807431;38428353
1829;4.27178e-15;-519;1457;9537;10131;1;677;-2.14748e+09;-1.51038e+06;-1;0;0;0;-1;0;446398751;457878650;38452408
1829;4.23624e-15;-547;1243;9137;10075.5;1;641;-2.14748e+09;-1.51028e+06;0;0;0;0;0;0;446398751;457878650;38452408
1830;4.27178e-15;-519;1457;9537;10131;1;677;-2.14748e+09;-1.50738e+06;-1;0;0;0;-1;0;446457902;457949740;38476428
1830;4.23624e-15;-547;1243;9137;10075.5;1;641;-2.14748e+09;-1.50738e+06;-1;0;0;0;-1;0;446457902;457949740;38476428
1831;4.27178e-15;-519;1457;9537;10131;1;677;-2.14748e+09;-1.50449e+06;-1;0;0;0;-1;0;446516937;458020702;38500410
1831;4.23624e-15;-547;1243;9137;10075.5;1;641;-2.14748e+09;-1.50449e+06;-1;0;0;0;-1;0;446516937;458020702;38500410
1832;4.27178e-15;-519;1457;9537;10131;1;677;-2.14748e+09;-1.50161e+06;-1;0;0;0;-1;0;446575855;458091534;38524357
1832;4.23624e-15;-548;1243;9137;10075.5;1;641;-2.14748e+09;-1.5016e+06;0;0;0;0;0;0;446575855;458091534;38524357
1833;4.27178e-15;-519;1457;9537;10131;1;677;-2.14748e+09;-1.49872e+06;-1;0;0;0;-1;0;446634657;458162238;38548267
1833;4.23624e-15;-548;1243;9137;10075.5;1;641;-2.14748e+09;-1.49872e+06;-1;0;0;0;-1;0;446634657;458162238;38548267
1834;4.27178e-15;-520;1457;9537;10131;1;677;-2.14748e+09;-1.49595e+06;0;0;0;0;0;0;446693343;458232814;38572140
1834;4.23624e-15;-549;1243;9137;10075.5;1;641;-2.14748e+09;-1.49585e+06;0;0;0;0;0;0;446693343;458232814;38572140
1835;4.27178e-15;-520;1457;9537;10131;1;677;-2.14748e+09;-1.49298e+06;-1;0;0;0;-1;0;446751913;458303262;38595978
1835;4.23624e-15;-549;1243;9137;10075.5;1;641;-2.14748e+09;-1.49298e+06;-1;0;0;0;-1;0;446751913;458303262;38595978
1836;4.27178e-15;-520;1457;9537;10131;1;677;-2.14748e+09;-1.49012e+06;-1;0;0;0;-1;0;446810368;458373582;38619779
1836;4.23624e-15;-550;1243;9137;10075.5;1;641;-2.14748e+09;-1.49012e+06;0;0;0;0;0;0;446810368;458373582;38619779
1837;4.27178e-15;-521;1457;9537;10131;1;677;-2.14748e+09;-1.48726e+06;0;0;0;0;0;0;446868708;458443775;38643544
1837;4.23624e-15;-550;1243;9137;10075.5;1;641;-2.14748e+09;-1.48726e+06;-1;0;0;0;-1;0;446868708;458443775;38643544
1838;4.27178e-15;-522;1457;9537;10131;1;677;-2.14748e+09;-1.48441e+06;0;0;0;0;0;0;446926932;458513840;38667272
1838;4.23624e-15;-551;1243;9137;10075.5;1;641;-2.14748e+09;-1.48441e+06;0;0;0;0;0;0;446926932;458513840;38667272
1839;4.27178e-15;-523;1457;9537;10131;1;677;-2.14748e+09;-1.48166e+06;0;0;0;0;0;0;446985042;458583779;38690965
1839;4.23624e-15;-552;1243;9137;10075.5;1;641;-2.14748e+09;-1.48156e+06;0;0;0;0;0;0;446985042;458583779;38690965
1840;4.27178e-15;-524;1457;9537;10131;1;677;-2.14748e+09;-1.47872e+06;0;0;0;0;0;0;447043038;458653591;38714622
1840;4.23624e-15;-552;1243;9137;10075.5;1;641;-2.14748e+09;-1.47872e+06;-1;0;0;0;-1;0;447043038;458653591;38714622
1841;4.27178e-15;-525;1457;9537;10131;1;677;-2.14748e+09;-1.47599e+06;0;0;0;0;0;0;447100920;458723276;38738242
1841;4.23624e-15;-552;1243;9137;10075.5;1;641;-2.14748e+09;-1.47599e+06;-1;0;0;0;-1;0;447100920;458723276;38738242
1842;4.27178e-15;-525;1457;9537;10131;1;677;-2.14748e+09;-1.47306e+06;-1;0;0;0;-1;0;447158687;458792835;38761827
1842;4.23624e-15;-552;1243;9137;10075.5;1;641;-2.14748e+09;-1.47306e+06;-1;0;0;0;-1;0;447158687;458792835;38761827
1843;4.27178e-15;-526;1457;9537;10131;1;677;-2.14748e+09;-1.47034e+06;0;0;0;0;0;0;447216341;458862268;38785375
1843;4.23624e-15;-552;1243;9137;10075.5;1;641;-2.14748e+09;-1.47024e+06;-1;0;0;0;-1;0;447216341;458862268;38785375
1844;4.27178e-15;-526;1457;9537;10131;1;677;-2.14748e+09;-1.46752e+06;-1;0;0;0;-1;0;447273881;458931575;38808888
1844;4.23624e-15;-552;1243;9137;10075.5;1;641;-2.14748e+09;-1.46752e+06;-1;0;0;0;-1;0;447273881;458931575;38808888
1845;4.27178e-15;-527;1457;9537;10131;1;677;-2.14748e+09;-1.46472e+06;0;0;0;0;0;0;447331308;459000756;38832365
1845;4.23624e-15;-552;1243;9137;10075.5;1;641;-2.14748e+09;-1.46462e+06;-1;0;0;0;-1;0;447331308;459000756;38832365
1846;4.27178e-15;-527;1457;9537;10131;1;677;-2.14748e+09;-1.46191e+06;-1;0;0;0;-1;0;447388622;459069813;38855806
1846;4.23624e-15;-553;1243;9137;10075.5;1;641;-2.14748e+09;-1.46191e+06;0;0;0;0;0;0;447388622;459069813;38855806
1847;4.27178e-15;-527;1457;9537;10131;1;677;-2.14748e+09;-1.45911e+06;-1;0;0;0;-1;0;447445824;459138744;38879211
1847;4.23624e-15;-553;1243;9137;10075.5;1;641;-2.14748e+09;-1.45911e+06;-1;0;0;0;-1;0;447445824;459138744;38879211
1848;4.27178e-15;-527;1457;9537;10131;1;677;-2.14748e+09;-1.45622e+06;-1;0;0;0;-1;0;447502912;459207550;38902580
1848;4.23624e-15;-553;1243;9137;10075.5;1;641;-2.14748e+09;-1.45622e+06;-1;0;0;0;-1;0;447502912;459207550;38902580
1849;4.27178e-15;-527;1457;9537;10131;1;677;-2.14748e+09;-1.45353e+06;-1;0;0;0;-1;0;447559889;459276232;38925914
1849;4.23624e-15;-554;1243;9137;10075.5;1;641;-2.14748e+09;-1.45353e+06;0;0;0;0;0;0;447559889;459276232;38925914
1850;4.27178e-15;-528;1457;9537;10131;1;677;-2.14748e+09;-1.45075e+06;0;0;0;0;0;0;447616753;459344789;38949212
1850;4.23624e-15;-555;1243;9137;10075.5;1;641;-2.14748e+09;-1.45075e+06;0;0;0;0;0;0;447616753;459344789;38949212
1851;4.27178e-15;-528;1457;9537;10131;1;677;-2.14748e+09;-1.44787e+06;-1;0;0;0;-1;0;447673506;459413222;38972474
1851;4.23624e-15;-555;1243;9137;10075.5;1;641;-2.14748e+09;-1.44787e+06;-1;0;0;0;-1;0;447673506;459413222;38972474
1852;4.27178e-15;-529;1457;9537;10131;1;677;-2.14748e+09;-1.4451e+06;0;0;0;0;0;0;447730147;459481531;38995701
1852;4.23624e-15;-556;1243;9137;10075.5;1;641;-2.14748e+09;-1.4451e+06;0;0;0;0;0;0;447730147;459481531;38995701
1853;4.27178e-15;-529;1457;9537;10131;1;677;-2.14748e+09;-1.44244e+06;-1;0;0;0;-1;0;447786677;459549716;39018892
1853;4.23624e-15;-556;1243;9137;10075.5;1;641;-2.14748e+09;-1.44234e+06;-1;0;0;0;-1;0;447786677;459549716;39018892
1854;4.27178e-15;-530;1457;9537;10131;1;677;-2.14748e+09;-1.43958e+06;0;0;0;0;0;0;447843096;459617778;39042048
1854;4.23624e-15;-557;1243;9137;10075.5;1;641;-2.14748e+09;-1.43958e+06;0;0;0;0;0;0;447843096;459617778;39042048
1855;4.27178e-15;-530;1457;9537;10131;1;677;-2.14748e+09;-1.43693e+06;-1;0;0;0;-1;0;447899404;459685717;39065168
1855;4.23624e-15;-558;1243;9137;10075.5;1;641;-2.14748e+09;-1.43683e+06;0;0;0;0;0;0;447899404;459685717;39065168
1856;4.27178e-15;-530;1457;9537;10131;1;677;-2.14748e+09;-1.43408e+06;-1;0;0;0;-1;0;447955601;459753533;39088253
1856;4.23624e-15;-558;1243;9137;10075.5;1;641;-2.14748e+09;-1.43408e+06;-1;0;0;0;-1;0;447955601;459753533;39088253
1857;4.27178e-15;-530;1457;9537;10131;1;677;-2.14748e+09;-1.43144e+06;-1;0;0;0;-1;0;448011688;459821226;39111302
1857;4.23624e-15;-558;1243;9137;10075.5;1;641;-2.14748e+09;-1.43144e+06;-1;0;0;0;-1;0;448011688;459821226;39111302
1858;4.27178e-15;-530;1457;9537;10131;1;677;-2.14748e+09;-1.4287e+06;-1;0;0;0;-1;0;448067664;459888796;39134316
1858;4.23624e-15;-559;1243;9137;10075.5;1;641;-2.14748e+09;-1.4287e+06;0;0;0;0;0;0;448067664;459888796;39134316
1859;4.27178e-15;-531;1457;9537;10131;1;677;-2.14748e+09;-1.42587e+06;0;0;0;0;0;0;448123531;459956244;39157295
1859;4.23624e-15;-560;1243;9137;10075.5;1;641;-2.14748e+09;-1.42587e+06;0;0;0;0;0;0;448123531;459956244;39157295
1860;4.27178e-15;-532;1457;9537;10131;1;677;-2.14748e+09;-1.42315e+06;0;0;0;0;0;0;448179288;460023570;39180238
1860;4.23624e-15;-561;1243;9137;10075.5;1;641;-2.14748e+09;-1.42315e+06;0;0;0;0;0;0;448179288;460023570;39180238
1861;4.27178e-15;-532;1457;9537;10131;1;677;-2.14748e+09;-1.42043e+06;-1;0;0;0;-1;0;448234936;460090774;39203146
1861;4.23624e-15;-562;1243;9137;10075.5;1;641;-2.14748e+09;-1.42043e+06;0;0;0;0;0;0;448234936;460090774;39203146
1862;4.27178e-15;-533;1457;9537;10131;1;677;-2.14748e+09;-1.41781e+06;0;0;0;0;0;0;448290474;460157857;39226019
1862;4.23624e-15;-562;1243;9137;10075.5;1;641;-2.14748e+09;-1.41771e+06;-1;0;0;0;-1;0;448290474;460157857;39226019
1863;4.27178e-15;-534;1457;9537;10131;1;677;-2.14748e+09;-1.41501e+06;0;0;0;0;0;0;448345904;460224818;39248857
1863;4.23624e-15;-563;1243;9137;10075.5;1;641;-2.14748e+09;-1.41501e+06;0;0;0;0;0;0;448345904;460224818;39248857
1864;4.27178e-15;-535;1457;9537;10131;1;677;-2.14748e+09;-1.4124e+06;0;0;0;0;0;0;448401224;460291657;39271660
1864;4.23624e-15;-564;1243;9137;10075.5;1;641;-2.14748e+09;-1.4123e+06;0;0;0;0;0;0;448401224;460291657;39271660
1865;4.27178e-15;-536;1457;9537;10131;1;677;-2.14748e+09;-1.40971e+06;0;0;0;0;0;0;448456437;460358376;39294428
1865;4.23624e-15;-565;1243;9137;10075.5;1;641;-2.14748e+09;-1.40961e+06;0;0;0;0;0;0;448456437;460358376;39294428
1866;4.27178e-15;-536;1457;9537;10131;1;677;-2.14748e+09;-1.40701e+06;-1;0;0;0;-1;0;448511540;460424974;39317160
1866;4.23624e-15;-565;1243;9137;10075.5;1;641;-2.14748e+09;-1.40691e+06;-1;0;0;0;-1;0;448511540;460424974;39317160
1867;4.27178e-15;-537;1457;9537;10131;1;677;-2.14748e+09;-1.40423e+06;0;0;0;0;0;0;448566536;460491452;39339858
1867;4.23624e-15;-566;1243;9137;10075.5;1;641;-2.14748e+09;-1.40423e+06;0;0;0;0;0;0;448566536;460491452;39339858
1868;4.27178e-15;-538;1457;9537;10131;1;677;-2.14748e+09;-1.40165e+06;0;0;0;0;0;0;448621424;460557810;39362521
1868;4.23624e-15;-566;1243;9137;10075.5;1;641;-2.14748e+09;-1.40165e+06;-1;0;0;0;-1;0;448621424;460557810;39362521
1869;4.27178e-15;-539;1457;9537;10131;1;677;-2.14748e+09;-1.39897e+06;0;0;0;0;0;0;448676204;460624047;39385149
1869;4.23624e-15;-566;1243;9137;10075.5;1;641;-2.14748e+09;-1.39897e+06;-1;0;0;0;-1;0;448676204;460624047;39385149
1870;4.27178e-15;-539;1457;9537;10131;1;677;-2.14748e+09;-1.3962e+06;-1;0;0;0;-1;0;448730877;460690164;39407742
1870;4.23624e-15;-567;1243;9137;10075.5;1;641;-2.14748e+09;-1.3962e+06;0;0;0;0;0;0;448730877;460690164;39407742
1871;4.27178e-15;-539;1457;9537;10131;1;677;-2.14748e+09;-1.39364e+06;-1;0;0;0;-1;0;448785443;460756162;39430300
1871;4.23624e-15;-568;1243;9137;10075.5;1;641;-2.14748e+09;-1.39364e+06;0;0;0;0;0;0;448785443;460756162;39430300
1872;4.27178e-15;-540;1457;9537;10131;1;677;-2.14748e+09;-1.39098e+06;0;0;0;0;0;0;448839902;460822041;39452823
1872;4.23624e-15;-569;1243;9137;10075.5;1;641;-2.14748e+09;-1.39098e+06;0;0;0;0;0;0;448839902;460822041;39452823
1873;4.27178e-15;-540;1457;9537;10131;1;677;-2.14748e+09;-1.38823e+06;-1;0;0;0;-1;0;448894254;460887800;39475312
1873;4.23624e-15;-569;1243;9137;10075.5;1;641;-2.14748e+09;-1.38823e+06;-1;0;0;0;-1;0;448894254;460887800;39475312
1874;4.27178e-15;-540;1457;9537;10131;1;677;-2.14748e+09;-1.38558e+06;-1;0;0;0;-1;0;448948499;460953440;39497766
1874;4.23624e-15;-570;1243;9137;10075.5;1;641;-2.14748e+09;-1.38558e+06;0;0;0;0;0;0;448948499;460953440;39497766
1875;4.27178e-15;-541;1457;9537;10131;1;677;-2.14748e+09;-1.38293e+06;0;0;0;0;0;0;449002638;461018962;39520185
1875;4.23624e-15;-570;1243;9137;10075.5;1;641;-2.14748e+09;-1.38294e+06;-1;0;0;0;-1;0;449002638;461018962;39520185
1876;4.27178e-15;-542;1457;9537;10131;1;677;-2.14748e+09;-1.3803e+06;0;0;0;0;0;0;449056672;461084365;39542570
1876;4.23624e-15;-570;1243;9137;10075.5;1;641;-2.14748e+09;-1.3803e+06;-1;0;0;0;-1;0;449056672;461084365;39542570
1877;4.27178e-15;-542;1457;9537;10131;1;677;-2.14748e+09;-1.37767e+06;-1;0;0;0;-1;0;449110599;461149650;39564920
1877;4.23624e-15;-571;1243;9137;10075.5;1;641;-2.14748e+09;-1.37767e+06;0;0;0;0;0;0;449110599;461149650;39564920
1878;4.27178e-15;-543;1457;9537;10131;1;677;-2.14748e+09;-1.37514e+06;0;0;0;0;0;0;449164421;461214817;39587235
1878;4.23624e-15;-571;1243;9137;10075.5;1;641;-2.14748e+09;-1.37514e+06;-1;0;0;0;-1;0;449164421;461214817;39587235
1879;4.27178e-15;-543;1457;9537;10131;1;677;-2.14748e+09;-1.37242e+06;-1;0;0;0;-1;0;449218137;461279866;39609516
1879;4.23624e-15;-571;1243;9137;10075.5;1;641;-2.14748e+09;-1.37242e+06;-1;0;0;0;-1;0;449218137;461279866;39609516
1880;4.27178e-15;-544;1457;9537;10131;1;677;-2.14748e+09;-1.3698e+06;0;0;0;0;0;0;449271749;461344797;39631763
1880;4.23624e-15;-572;1243;9137;10075.5;1;641;-2.14748e+09;-1.3698e+06;0;0;0;0;0;0;449271749;461344797;39631763
1881;4.27178e-15;-544;1457;9537;10131;1;677;-2.14748e+09;-1.36729e+06;-1;0;0;0;-1;0;449325255;461409611;39653975
1881;4.23624e-15;-572;1243;9137;10075.5;1;641;-2.14748e+09;-1.36729e+06;-1;0;0;0;-1;0;449325255;461409611;39653975
1882;4.27178e-15;-545;1457;9537;10131;1;677;-2.14748e+09;-1.36469e+06;0;0;0;0;0;0;449378657;461474307;39676153
1882;4.23624e-15;-573;1243;9137;10075.5;1;641;-2.14748e+09;-1.36469e+06;0;0;0;0;0;0;449378657;461474307;39676153
1883;4.27178e-15;-545;1457;9537;10131;1;677;-2.14748e+09;-1.36209e+06;-1;0;0;0;-1;0;449431954;461538887;39698296
1883;4.23624e-15;-573;1243;9137;10075.5;1;641;-2.14748e+09;-1.36209e+06;-1;0;0;0;-1;0;449431954;461538887;39698296
1884;4.27178e-15;-546;1457;9537;10131;1;677;-2.14748e+09;-1.35939e+06;0;0;0;0;0;0;449485147;461603350;39720406
1884;4.23624e-15;-573;1243;9137;10075.5;1;641;-2.14748e+09;-1.35939e+06;-1;0;0;0;-1;0;449485147;461603350;39720406
1885;4.27178e-15;-546;1457;9537;10131;1;677;-2.14748e+09;-1.3569e+06;-1;0;0;0;-1;0;449538236;461667697;39742481
1885;4.23624e-15;-573;1243;9137;10075.5;1;641;-2.14748e+09;-1.3569e+06;-1;0;0;0;-1;0;449538236;461667697;39742481
1886;4.27178e-15;-547;1457;9537;10131;1;677;-2.14748e+09;-1.35422e+06;0;0;0;0;0;0;449591221;461731927;39764521
1886;4.23624e-15;-573;1243;9137;10075.5;1;641;-2.14748e+09;-1.35422e+06;-1;0;0;0;-1;0;449591221;461731927;39764521
1887;4.27178e-15;-548;1457;9537;10131;1;677;-2.14748e+09;-1.35174e+06;0;0;0;0;0;0;449644102;461796041;39786528
1887;4.23624e-15;-573;1243;9137;10075.5;1;641;-2.14748e+09;-1.35164e+06;-1;0;0;0;-1;0;449644102;461796041;39786528
1888;4.27178e-15;-549;1457;9537;10131;1;677;-2.14748e+09;-1.34917e+06;0;0;0;0;0;0;449696880;461860039;39808500
1888;4.23624e-15;-573;1243;9137;10075.5;1;641;-2.14748e+09;-1.34917e+06;-1;0;0;0;-1;0;449696880;461860039;39808500
1889;4.27178e-15;-549;1457;9537;10131;1;677;-2.14748e+09;-1.3466e+06;-1;0;0;0;-1;0;449749555;461923921;39830439
1889;4.23624e-15;-573;1243;9137;10075.5;1;641;-2.14748e+09;-1.3466e+06;-1;0;0;0;-1;0;449749555;461923921;39830439
1890;4.27178e-15;-549;1457;9537;10131;1;677;-2.14748e+09;-1.34393e+06;-1;0;0;0;-1;0;449802126;461987688;39852343
1890;4.23624e-15;-574;1243;9137;10075.5;1;641;-2.14748e+09;-1.34393e+06;0;0;0;0;0;0;449802126;461987688;39852343
1891;4.27178e-15;-550;1457;9537;10131;1;677;-2.14748e+09;-1.34138e+06;0;0;0;0;0;0;449854596;462051340;39874213
1891;4.23624e-15;-575;1243;9137;10075.5;1;641;-2.14748e+09;-1.34138e+06;0;0;0;0;0;0;449854596;462051340;39874213
1892;4.27178e-15;-550;1457;9537;10131;1;677;-2.14748e+09;-1.33882e+06;-1;0;0;0;-1;0;449906962;462114877;39896050
1892;4.23624e-15;-576;1243;9137;10075.5;1;641;-2.14748e+09;-1.33882e+06;0;0;0;0;0;0;449906962;462114877;39896050
1893;4.27178e-15;-551;1457;9537;10131;1;677;-2.14748e+09;-1.33638e+06;0;0;0;0;0;0;449959226;462178299;39917852
1893;4.23624e-15;-576;1243;9137;10075.5;1;641;-2.14748e+09;-1.33628e+06;-1;0;0;0;-1;0;449959226;462178299;39917852
1894;4.27178e-15;-551;1457;9537;10131;1;677;-2.14748e+09;-1.33383e+06;-1;0;0;0;-1;0;450011388;462241606;39939621
1894;4.23624e-15;-576;1243;9137;10075.5;1;641;-2.14748e+09;-1.33373e+06;-1;0;0;0;-1;0;450011388;462241606;39939621
1895;4.27178e-15;-551;1457;9537;10131;1;677;-2.14748e+09;-1.3313e+06;-1;0;0;0;-1;0;450063449;462304799;39961355
1895;4.23624e-15;-577;1243;9137;10075.5;1;641;-2.14748e+09;-1.3313e+06;0;0;0;0;0;0;450063449;462304799;39961355
1896;4.27178e-15;-551;1457;9537;10131;1;677;-2.14748e+09;-1.32866e+06;-1;0;0;0;-1;0;450115407;462367878;39983056
1896;4.23624e-15;-577;1243;9137;10075.5;1;641;-2.14748e+09;-1.32866e+06;-1;0;0;0;-1;0;450115407;462367878;39983056
1897;4.27178e-15;-551;1457;9537;10131;1;677;-2.14748e+09;-1.32614e+06;-1;0;0;0;-1;0;450167264;462430843;40004723
1897;4.23624e-15;-578;1243;9137;10075.5;1;641;-2.14748e+09;-1.32614e+06;0;0;0;0;0;0;450167264;462430843;40004723
1898;4.27178e-15;-551;1457;9537;10131;1;677;-2.14748e+09;-1.32361e+06;-1;0;0;0;-1;0;450219020;462493694;40026357
1898;4.23624e-15;-578;1243;9137;10075.5;1;641;-2.14748e+09;-1.32361e+06;-1;0;0;0;-1;0;450219020;462493694;40026357
1899;4.27178e-15;-552;1457;9537;10131;1;677;-2.14748e+09;-1.3211e+06;0;0;0;0;0;0;450270675;462556431;40047957
1899;4.23624e-15;-579;1243;9137;10075.5;1;641;-2.14748e+09;-1.3211e+06;0;0;0;0;0;0;450270675;462556431;40047957
1900;4.27178e-15;-553;1457;9537;10131;1;677;-2.14748e+09;-1.31858e+06;0;0;0;0;0;0;450322229;462619055;40069523
1900;4.23624e-15;-579;1243;9137;10075.5;1;641;-2.14748e+09;-1.31859e+06;-1;0;0;0;-1;0;450322229;462619055;40069523
1901;4.27178e-15;-554;1457;9537;10131;1;677;-2.14748e+09;-1.31618e+06;0;0;0;0;0;0;450373682;462681566;40091055
1901;4.23624e-15;-580;1243;9137;10075.5;1;641;-2.14748e+09;-1.31608e+06;0;0;0;0;0;0;450373682;462681566;40091055
1902;4.27178e-15;-554;1457;9537;10131;1;677;-2.14748e+09;-1.31358e+06;-1;0;0;0;-1;0;450425035;462743964;40112554
1902;4.23624e-15;-580;1243;9137;10075.5;1;641;-2.14748e+09;-1.31358e+06;-1;0;0;0;-1;0;450425035;462743964;40112554
1903;4.27178e-15;-554;1457;9537;10131;1;677;-2.14748e+09;-1.31108e+06;-1;0;0;0;-1;0;450476288;462806250;40134020
1903;4.23624e-15;-580;1243;9137;10075.5;1;641;-2.14748e+09;-1.31108e+06;-1;0;0;0;-1;0;450476288;462806250;40134020
1904;4.27178e-15;-554;1456;9537;10131;1;677;-2.14748e+09;-1.30869e+06;0;0;0;0;0;0;450527440;462868423;40155452
1904;4.23624e-15;-580;1243;9137;10075.5;1;641;-2.14748e+09;-1.30869e+06;-1;0;0;0;-1;0;450527440;462868423;40155452
1905;4.27178e-15;-554;1456;9537;10131;1;677;-2.14748e+09;-1.3061e+06;-1;0;0;0;-1;0;450578493;462930483;40176850
1905;4.23624e-15;-580;1243;9137;10075.5;1;641;-2.14748e+09;-1.3061e+06;-1;0;0;0;-1;0;450578493;462930483;40176850
1906;4.27178e-15;-554;1456;9537;10131;1;677;-2.14748e+09;-1.30372e+06;-1;0;0;0;-1;0;450629447;462992432;40198215
1906;4.23624e-15;-580;1243;9137;10075.5;1;641;-2.14748e+09;-1.30362e+06;-1;0;0;0;-1;0;450629447;462992432;40198215
1907;4.27178e-15;-554;1456;9537;10131;1;677;-2.14748e+09;-1.30124e+06;-1;0;0;0;-1;0;450680301;463054269;40219547
1907;4.23624e-15;-581;1243;9137;10075.5;1;641;-2.14748e+09;-1.30114e+06;0;0;0;0;0;0;450680300;463054269;40219547
1908;4.27178e-15;-554;1456;9537;10131;1;677;-2.14748e+09;-1.29867e+06;-1;0;0;0;-1;0;450731055;463115993;40240846
1908;4.23624e-15;-582;1243;9137;10075.5;1;641;-2.14748e+09;-1.29867e+06;0;0;0;0;0;0;450731055;463115993;40240846
1909;4.27178e-15;-554;1456;9537;10131;1;677;-2.14748e+09;-1.2962e+06;-1;0;0;0;-1;0;450781711;463177607;40262111
1909;4.23624e-15;-582;1243;9137;10075.5;1;641;-2.14748e+09;-1.2962e+06;-1;0;0;0;-1;0;450781711;463177607;40262111
1910;4.27178e-15;-554;1456;9537;10131;1;677;-2.14748e+09;-1.29374e+06;-1;0;0;0;-1;0;450832268;463239109;40283343
1910;4.23624e-15;-582;1243;9137;10075.5;1;641;-2.14748e+09;-1.29374e+06;-1;0;0;0;-1;0;450832268;463239109;40283343
1911;4.27178e-15;-555;1456;9537;10131;1;677;-2.14748e+09;-1.29139e+06;0;0;0;0;0;0;450882727;463300501;40304542
1911;4.23624e-15;-582;1243;9137;10075.5;1;641;-2.14748e+09;-1.29129e+06;-1;0;0;0;-1;0;450882727;463300501;40304542
1912;4.27178e-15;-556;1456;9537;10131;1;677;-2.14748e+09;-1.28894e+06;0;0;0;0;0;0;450933087;463361781;40325707
1912;4.23624e-15;-582;1243;9137;10075.5;1;641;-2.14748e+09;-1.28894e+06;-1;0;0;0;-1;0;450933087;463361781;40325707
1913;4.27178e-15;-557;1456;9537;10131;1;677;-2.14748e+09;-1.28639e+06;0;0;0;0;0;0;450983349;463422951;40346840
1913;4.23624e-15;-583;1243;9137;10075.5;1;641;-2.14748e+09;-1.28639e+06;0;0;0;0;0;0;450983349;463422951;40346840
1914;4.27178e-15;-557;1456;9537;10131;1;677;-2.14748e+09;-1.28395e+06;-1;0;0;0;-1;0;451033513;463484010;40367940
1914;4.23624e-15;-584;1243;9137;10075.5;1;641;-2.14748e+09;-1.28395e+06;0;0;0;0;0;0;451033513;463484010;40367940
1915;4.27178e-15;-557;1456;9537;10131;1;677;-2.14748e+09;-1.28161e+06;-1;0;0;0;-1;0;451083580;463544959;40389006
1915;4.23624e-15;-584;1243;9137;10075.5;1;641;-2.14748e+09;-1.28151e+06;-1;0;0;0;-1;0;451083580;463544959;40389006
1916;4.27178e-15;-557;1456;9537;10131;1;677;-2.14748e+09;-1.27918e+06;-1;0;0;0;-1;0;451133549;463605798;40410040
1916;4.23624e-15;-584;1243;9137;10075.5;1;641;-2.14748e+09;-1.27918e+06;-1;0;0;0;-1;0;451133549;463605798;40410040
1917;4.27178e-15;-557;1456;9537;10131;1;677;-2.14748e+09;-1.27665e+06;-1;0;0;0;-1;0;451183420;463666527;40431040
1917;4.23624e-15;-585;1243;9137;10075.5;1;641;-2.14748e+09;-1.27665e+06;0;0;0;0;0;0;451183420;463666527;40431040
1918;4.27178e-15;-558;1456;9537;10131;1;677;-2.14748e+09;-1.27433e+06;0;0;0;0;0;0;451233195;463727147;40452008
1918;4.23624e-15;-585;1243;9137;10075.5;1;641;-2.14748e+09;-1.27423e+06;-1;0;0;0;-1;0;451233195;463727147;40452008
1919;4.27178e-15;-558;1456;9537;10131;1;677;-2.14748e+09;-1.27181e+06;-1;0;0;0;-1;0;451282873;463787657;40472943
1919;4.23624e-15;-585;1243;9137;10075.5;1;641;-2.14748e+09;-1.27181e+06;-1;0;0;0;-1;0;451282873;463787657;40472943
1920;4.27178e-15;-558;1456;9537;10131;1;677;-2.14748e+09;-1.2695e+06;-1;0;0;0;-1;0;451332453;463848058;40493845
1920;4.23624e-15;-585;1243;9137;10075.5;1;641;-2.14748e+09;-1.2694e+06;-1;0;0;0;-1;0;451332453;463848058;40493845
1921;4.27178e-15;-559;1456;9537;10131;1;677;-2.14748e+09;-1.26709e+06;0;0;0;0;0;0;451381938;463908350;40514714
1921;4.23624e-15;-585;1243;9137;10075.5;1;641;-2.14748e+09;-1.26699e+06;-1;0;0;0;-1;0;451381938;463908350;40514714
1922;4.27178e-15;-559;1456;9537;10131;1;677;-2.14748e+09;-1.26469e+06;-1;0;0;0;-1;0;451431326;463968533;40535551
1922;4.23624e-15;-585;1243;9137;10075.5;1;641;-2.14748e+09;-1.26459e+06;-1;0;0;0;-1;0;451431326;463968533;40535551
1923;4.27178e-15;-560;1456;9537;10131;1;677;-2.14748e+09;-1.26219e+06;0;0;0;0;0;0;451480618;464028608;40556354
1923;4.23624e-15;-585;1243;9137;10075.5;1;641;-2.14748e+09;-1.26219e+06;-1;0;0;0;-1;0;451480618;464028608;40556354
1924;4.27178e-15;-560;1456;9537;10131;1;677;-2.14748e+09;-1.2598e+06;-1;0;0;0;-1;0;451529814;464088574;40577126
1924;4.23624e-15;-586;1243;9137;10075.5;1;641;-2.14748e+09;-1.2598e+06;0;0;0;0;0;0;451529814;464088574;40577126
1925;4.27178e-15;-560;1456;9537;10131;1;677;-2.14748e+09;-1.25741e+06;-1;0;0;0;-1;0;451578914;464148432;40597864
1925;4.23624e-15;-586;1243;9137;10075.5;1;641;-2.14748e+09;-1.25741e+06;-1;0;0;0;-1;0;451578914;464148432;40597864
1926;4.27178e-15;-560;1456;9537;10131;1;677;-2.14748e+09;-1.25512e+06;-1;0;0;0;-1;0;451627919;464208181;40618570
1926;4.23624e-15;-587;1243;9137;10075.5;1;641;-2.14748e+09;-1.25502e+06;0;0;0;0;0;0;451627919;464208181;40618570
1927;4.27178e-15;-560;1456;9537;10131;1;677;-2.14748e+09;-1.25275e+06;-1;0;0;0;-1;0;451676829;464267823;40639244
1927;4.23624e-15;-587;1243;9137;10075.5;1;641;-2.14748e+09;-1.25265e+06;-1;0;0;0;-1;0;451676829;464267823;40639244
1928;4.27178e-15;-560;1456;9537;10131;1;677;-2.14748e+09;-1.25027e+06;-1;0;0;0;-1;0;451725643;464327358;40659885
1928;4.23624e-15;-587;1243;9137;10075.5;1;641;-2.14748e+09;-1.25027e+06;-1;0;0;0;-1;0;451725643;464327358;40659885
1929;4.27178e-15;-560;1456;9537;10131;1;677;-2.14748e+09;-1.2479e+06;-1;0;0;0;-1;0;451774362;464386785;40680493
1929;4.23624e-15;-587;1243;9137;10075.5;1;641;-2.14748e+09;-1.2479e+06;-1;0;0;0;-1;0;451774362;464386785;40680493
1930;4.27178e-15;-561;1456;9537;10131;1;677;-2.14748e+09;-1.24564e+06;0;0;0;0;0;0;451822987;464446105;40701069
1930;4.23624e-15;-587;1243;9137;10075.5;1;641;-2.14748e+09;-1.24554e+06;-1;0;0;0;-1;0;451822987;464446105;40701069
1931;4.27178e-15;-562;1456;9537;10131;1;677;-2.14748e+09;-1.24318e+06;0;0;0;0;0;0;451871517;464505317;40721613
1931;4.23624e-15;-587;1243;9137;10075.5;1;641;-2.14748e+09;-1.24318e+06;-1;0;0;0;-1;0;451871517;464505317;40721613
1932;4.27178e-15;-562;1456;9537;10131;1;677;-2.14748e+09;-1.24092e+06;-1;0;0;0;-1;0;451919953;464564423;40742125
1932;4.23624e-15;-587;1243;9137;10075.5;1;641;-2.14748e+09;-1.24082e+06;-1;0;0;0;-1;0;451919953;464564423;40742125
1933;4.27178e-15;-563;1456;9537;10131;1;677;-2.14748e+09;-1.23857e+06;0;0;0;0;0;0;451968295;464623423;40762604
1933;4.23624e-15;-588;1243;9137;10075.5;1;641;-2.14748e+09;-1.23847e+06;0;0;0;0;0;0;451968295;464623423;40762604
1934;4.27178e-15;-563;1456;9537;10131;1;677;-2.14748e+09;-1.23623e+06;-1;0;0;0;-1;0;452016543;464682316;40783051
1934;4.23624e-15;-589;1243;9137;10075.5;1;641;-2.14748e+09;-1.23623e+06;0;0;0;0;0;0;452016543;464682316;40783051
1935;4.27178e-15;-563;1456;9537;10131;1;677;-2.14748e+09;-1.23378e+06;-1;0;0;0;-1;0;452064697;464741102;40803465
1935;4.23624e-15;-590;1243;9137;10075.5;1;641;-2.14748e+09;-1.23378e+06;0;0;0;0;0;0;452064697;464741102;40803465
1936;4.27178e-15;-564;1456;9537;10131;1;677;-2.14748e+09;-1.23145e+06;0;0;0;0;0;0;452112758;464799783;40823848
1936;4.23624e-15;-590;1243;9137;10075.5;1;641;-2.14748e+09;-1.23145e+06;-1;0;0;0;-1;0;452112758;464799783;40823848
1937;4.27178e-15;-565;1456;9537;10131;1;677;-2.14748e+09;-1.22922e+06;0;0;0;0;0;0;452160725;464858358;40844198
1937;4.23624e-15;-590;1243;9137;10075.5;1;641;-2.14748e+09;-1.22912e+06;-1;0;0;0;-1;0;452160725;464858358;40844198
1938;4.27178e-15;-565;1456;9537;10131;1;677;-2.14748e+09;-1.22679e+06;-1;0;0;0;-1;0;452208599;464916827;40864517
1938;4.23624e-15;-591;1243;9137;10075.5;1;641;-2.14748e+09;-1.22679e+06;0;0;0;0;0;0;452208599;464916827;40864517
1939;4.27178e-15;-565;1456;9537;10131;1;677;-2.14748e+09;-1.22447e+06;-1;0;0;0;-1;0;452256380;464975190;40884803
1939;4.23624e-15;-592;1243;9137;10075.5;1;641;-2.14748e+09;-1.22447e+06;0;0;0;0;0;0;452256380;464975190;40884803
1940;4.27178e-15;-566;1456;9537;10131;1;677;-2.14748e+09;-1.22215e+06;0;0;0;0;0;0;452304068;465033449;40905057
1940;4.23624e-15;-593;1243;9137;10075.5;1;641;-2.14748e+09;-1.22215e+06;0;0;0;0;0;0;452304068;465033449;40905057
1941;4.27178e-15;-567;1456;9537;10131;1;677;-2.14748e+09;-1.21984e+06;0;0;0;0;0;0;452351664;465091602;40925280
1941;4.23624e-15;-593;1243;9137;10075.5;1;641;-2.14748e+09;-1.21984e+06;-1;0;0;0;-1;0;452351664;465091602;40925280
1942;4.27178e-15;-568;1456;9537;10131;1;677;-2.14748e+09;-1.21763e+06;0;0;0;0;0;0;452399167;465149650;40945470
1942;4.23624e-15;-593;1243;9137;10075.5;1;641;-2.14748e+09;-1.21763e+06;-1;0;0;0;-1;0;452399167;465149650;40945470
1943;4.27178e-15;-568;1456;9537;10131;1;677;-2.14748e+09;-1.21522e+06;-1;0;0;0;-1;0;452446578;465207594;40965629
1943;4.23624e-15;-594;1243;9137;10075.5;1;641;-2.14748e+09;-1.21522e+06;0;0;0;0;0;0;452446578;465207594;40965629
1944;4.27178e-15;-569;1456;9537;10131;1;677;-2.14748e+09;-1.21293e+06;0;0;0;0;0;0;452493897;465265434;40985755
1944;4.23624e-15;-594;1243;9137;10075.5;1;641;-2.14748e+09;-1.21293e+06;-1;0;0;0;-1;0;452493897;465265434;40985755
1945;4.27178e-15;-569;1456;9537;10131;1;677;-2.14748e+09;-1.21063e+06;-1;0;0;0;-1;0;452541125;465323168;41005850
1945;4.23624e-15;-594;1243;9137;10075.5;1;641;-2.14748e+09;-1.21063e+06;-1;0;0;0;-1;0;452541125;465323168;41005850
1946;4.27178e-15;-570;1456;9537;10131;1;677;-2.14748e+09;-1.20834e+06;0;0;0;0;0;0;452588260;465380799;41025914
1946;4.23624e-15;-595;1243;9137;10075.5;1;641;-2.14748e+09;-1.20834e+06;0;0;0;0;0;0;452588260;465380799;41025914
1947;4.27178e-15;-570;1456;9537;10131;1;677;-2.14748e+09;-1.20616e+06;-1;0;0;0;-1;0;452635305;465438326;41045945
1947;4.23624e-15;-596;1243;9137;10075.5;1;641;-2.14748e+09;-1.20616e+06;0;0;0;0;0;0;452635305;465438326;41045945
1948;4.27178e-15;-571;1456;9537;10131;1;677;-2.14748e+09;-1.20387e+06;0;0;0;0;0;0;452682258;465495749;41065945
1948;4.23624e-15;-597;1243;9137;10075.5;1;641;-2.14748e+09;-1.20377e+06;0;0;0;0;0;0;452682258;465495749;41065945
1949;4.27178e-15;-572;1456;9537;10131;1;677;-2.14748e+09;-1.2016e+06;0;0;0;0;0;0;452729119;465553069;41085913
1949;4.23624e-15;-597;1243;9137;10075.5;1;641;-2.14748e+09;-1.2015e+06;-1;0;0;0;-1;0;452729119;465553069;41085913
1950;4.27178e-15;-573;1456;9537;10131;1;677;-2.14748e+09;-1.19923e+06;0;0;0;0;0;0;452775890;465610286;41105850
1950;4.23624e-15;-597;1243;9137;10075.5;1;641;-2.14748e+09;-1.19923e+06;-1;0;0;0;-1;0;452775890;465610286;41105850
1951;4.27178e-15;-573;1456;9537;10131;1;677;-2.14748e+09;-1.19696e+06;-1;0;0;0;-1;0;452822571;465667399;41125755
1951;4.23624e-15;-597;1243;9137;10075.5;1;641;-2.14748e+09;-1.19696e+06;-1;0;0;0;-1;0;452822571;465667399;41125755
1952;4.27178e-15;-574;1456;9537;10131;1;677;-2.14748e+09;-1.1947e+06;0;0;0;0;0;0;452869161;465724409;41145628
1952;4.23624e-15;-597;1243;9137;10075.5;1;641;-2.14748e+09;-1.1947e+06;-1;0;0;0;-1;0;452869161;465724409;41145628
1953;4.27178e-15;-574;1456;9537;10131;1;677;-2.14748e+09;-1.19254e+06;-1;0;0;0;-1;0;452915660;465781316;41165470
1953;4.23624e-15;-597;1243;9137;10075.5;1;641;-2.14748e+09;-1.19244e+06;-1;0;0;0;-1;0;452915660;465781316;41165470
1954;4.27178e-15;-574;1456;9537;10131;1;677;-2.14748e+09;-1.19028e+06;-1;0;0;0;-1;0;452962070;465838121;41185281
1954;4.23624e-15;-598;1243;9137;10075.5;1;641;-2.14748e+09;-1.19028e+06;0;0;0;0;0;0;452962070;465838121;41185281
1955;4.27178e-15;-575;1456;9537;10131;1;677;-2.14748e+09;-1.18803e+06;0;0;0;0;0;0;453008389;465894824;41205060
1955;4.23624e-15;-598;1243;9137;10075.5;1;641;-2.14748e+09;-1.18793e+06;-1;0;0;0;-1;0;453008389;465894824;41205060
1956;4.27178e-15;-576;1456;9537;10131;1;677;-2.14748e+09;-1.18569e+06;0;0;0;0;0;0;453054619;465951424;41224808
1956;4.23624e-15;-599;1243;9137;10075.5;1;641;-2.14748e+09;-1.18569e+06;0;0;0;0;0;0;453054619;465951424;41224808
1957;4.27178e-15;-576;1456;9537;10131;1;677;-2.14748e+09;-1.18345e+06;-1;0;0;0;-1;0;453100759;466007922;41244525
1957;4.23624e-15;-600;1243;9137;10075.5;1;641;-2.14748e+09;-1.18345e+06;0;0;0;0;0;0;453100759;466007922;41244525
1958;4.27178e-15;-576;1456;9537;10131;1;677;-2.14748e+09;-1.18121e+06;-1;0;0;0;-1;0;453146809;466064319;41264210
1958;4.23624e-15;-600;1243;9137;10075.5;1;641;-2.14748e+09;-1.18121e+06;-1;0;0;0;-1;0;453146809;466064319;41264210
1959;4.27178e-15;-577;1456;9537;10131;1;677;-2.14748e+09;-1.17898e+06;0;0;0;0;0;0;453192771;466120613;41283864
1959;4.23624e-15;-600;1243;9137;10075.5;1;641;-2.14748e+09;-1.17898e+06;-1;0;0;0;-1;0;453192771;466120613;41283864
1960;4.27178e-15;-577;1456;9537;10131;1;677;-2.14748e+09;-1.17675e+06;-1;0;0;0;-1;0;453238644;466176807;41303487
1960;4.23624e-15;-600;1243;9137;10075.5;1;641;-2.14748e+09;-1.17675e+06;-1;0;0;0;-1;0;453238644;466176807;41303487
1961;4.27178e-15;-578;1456;9537;10131;1;677;-2.14748e+09;-1.17453e+06;0;0;0;0;0;0;453284427;466232899;41323079
1961;4.23624e-15;-601;1243;9137;10075.5;1;641;-2.14748e+09;-1.17453e+06;0;0;0;0;0;0;453284427;466232899;41323079
1962;4.27178e-15;-578;1456;9537;10131;1;677;-2.14748e+09;-1.17231e+06;-1;0;0;0;-1;0;453330122;466288889;41342639
1962;4.23624e-15;-601;1243;9137;10075.5;1;641;-2.14748e+09;-1.17231e+06;-1;0;0;0;-1;0;453330122;466288889;41342639
1963;4.27178e-15;-579;1456;9537;10131;1;677;-2.14748e+09;-1.1701e+06;0;0;0;0;0;0;453375729;466344779;41362169
1963;4.23624e-15;-602;1243;9137;10075.5;1;641;-2.14748e+09;-1.1701e+06;0;0;0;0;0;0;453375729;466344779;41362169
1964;4.27178e-15;-579;1456;9537;10131;1;677;-2.14748e+09;-1.16789e+06;-1;0;0;0;-1;0;453421247;466400569;41381668
1964;4.23624e-15;-602;1243;9137;10075.5;1;641;-2.14748e+09;-1.16789e+06;-1;0;0;0;-1;0;453421247;466400569;41381668
1965;4.27178e-15;-579;1456;9537;10131;1;677;-2.14748e+09;-1.16568e+06;-1;0;0;0;-1;0;453466677;466456258;41401135
1965;4.23624e-15;-602;1243;9137;10075.5;1;641;-2.14748e+09;-1.16568e+06;-1;0;0;0;-1;0;453466677;466456258;41401135
1966;4.27178e-15;-580;1456;9537;10131;1;677;-2.14748e+09;-1.16348e+06;0;0;0;0;0;0;453512020;466511846;41420572
1966;4.23624e-15;-603;1243;9137;10075.5;1;641;-2.14748e+09;-1.16348e+06;0;0;0;0;0;0;453512020;466511846;41420572
1967;4.27178e-15;-580;1456;9537;10131;1;677;-2.14748e+09;-1.16129e+06;-1;0;0;0;-1;0;453557274;466567334;41439978
1967;4.23624e-15;-604;1243;9137;10075.5;1;641;-2.14748e+09;-1.16129e+06;0;0;0;0;0;0;453557274;466567334;41439978
1968;4.27178e-15;-581;1456;9537;10131;1;677;-2.14748e+09;-1.1591e+06;0;0;0;0;0;0;453602441;466622722;41459353
1968;4.23624e-15;-604;1243;9137;10075.5;1;641;-2.14748e+09;-1.1591e+06;-1;0;0;0;-1;0;453602441;466622722;41459353
1969;4.27178e-15;-582;1456;9537;10131;1;677;-2.14748e+09;-1.15691e+06;0;0;0;0;0;0;453647521;466678011;41478697
1969;4.23624e-15;-604;1243;9137;10075.5;1;641;-2.14748e+09;-1.15691e+06;-1;0;0;0;-1;0;453647521;466678011;41478697
1970;4.27178e-15;-583;1456;9537;10131;1;677;-2.14748e+09;-1.15472e+06;0;0;0;0;0;0;453692513;466733200;41498010
1970;4.23624e-15;-604;1243;9137;10075.5;1;641;-2.14748e+09;-1.15472e+06;-1;0;0;0;-1;0;453692513;466733200;41498010
1971;4.27178e-15;-584;1456;9537;10131;1;677;-2.14748e+09;-1.15265e+06;0;0;0;0;0;0;453737418;466788289;41517292
1971;4.23624e-15;-605;1243;9137;10075.5;1;641;-2.14748e+09;-1.15255e+06;0;0;0;0;0;0;453737418;466788289;41517292
1972;4.27178e-15;-585;1456;9537;10131;1;677;-2.14748e+09;-1.15047e+06;0;0;0;0;0;0;453782237;466843279;41536544
1972;4.23624e-15;-606;1243;9137;10075.5;1;641;-2.14748e+09;-1.15047e+06;0;0;0;0;0;0;453782237;466843279;41536544
1973;4.27178e-15;-586;1456;9537;10131;1;677;-2.14748e+09;-1.1482e+06;0;0;0;0;0;0;453826968;466898170;41555766
1973;4.23624e-15;-607;1243;9137;10075.5;1;641;-2.14748e+09;-1.1482e+06;0;0;0;0;0;0;453826968;466898170;41555766
1974;4.27178e-15;-586;1456;9537;10131;1;677;-2.14748e+09;-1.14604e+06;-1;0;0;0;-1;0;453871614;466952962;41574956
1974;4.23624e-15;-608;1243;9137;10075.5;1;641;-2.14748e+09;-1.14604e+06;0;0;0;0;0;0;453871614;466952962;41574956
1975;4.27178e-15;-587;1456;9537;10131;1;677;-2.14748e+09;-1.14397e+06;0;0;0;0;0;0;453916173;467007656;41594116
1975;4.23624e-15;-609;1243;9137;10075.5;1;641;-2.14748e+09;-1.14387e+06;0;0;0;0;0;0;453916173;467007656;41594116
1976;4.27178e-15;-587;1456;9537;10131;1;677;-2.14748e+09;-1.14172e+06;-1;0;0;0;-1;0;453960646;467062251;41613246
1976;4.23624e-15;-610;1243;9137;10075.5;1;641;-2.14748e+09;-1.14172e+06;0;0;0;0;0;0;453960646;467062251;41613246
1977;4.27178e-15;-588;1456;9537;10131;1;677;-2.14748e+09;-1.13956e+06;0;0;0;0;0;0;454005033;467116747;41632345
1977;4.23624e-15;-610;1243;9137;10075.5;1;641;-2.14748e+09;-1.13956e+06;-1;0;0;0;-1;0;454005033;467116747;41632345
1978;4.27178e-15;-588;1456;9537;10131;1;677;-2.14748e+09;-1.13751e+06;-1;0;0;0;-1;0;454049334;467171146;41651413
1978;4.23624e-15;-610;1243;9137;10075.5;1;641;-2.14748e+09;-1.13751e+06;-1;0;0;0;-1;0;454049334;467171146;41651413
1979;4.27178e-15;-588;1456;9537;10131;1;677;-2.14748e+09;-1.13527e+06;-1;0;0;0;-1;0;454093549;467225446;41670451
1979;4.23624e-15;-610;1243;9137;10075.5;1;641;-2.14748e+09;-1.13527e+06;-1;0;0;0;-1;0;454093549;467225446;41670451
1980;4.27178e-15;-588;1456;9537;10131;1;677;-2.14748e+09;-1.13323e+06;-1;0;0;0;-1;0;454137679;467279649;41689459
1980;4.23624e-15;-610;1243;9137;10075.5;1;641;-2.14748e+09;-1.13323e+06;-1;0;0;0;-1;0;454137679;467279649;41689459
1981;4.27178e-15;-588;1456;9537;10131;1;677;-2.14748e+09;-1.13099e+06;-1;0;0;0;-1;0;454181724;467333754;41708436
1981;4.23624e-15;-610;1243;9137;10075.5;1;641;-2.14748e+09;-1.13099e+06;-1;0;0;0;-1;0;454181724;467333754;41708436
1982;4.27178e-15;-588;1456;9537;10131;1;677;-2.14748e+09;-1.12886e+06;-1;0;0;0;-1;0;454225684;467387761;41727384
1982;4.23624e-15;-611;1243;9137;10075.5;1;641;-2.14748e+09;-1.12886e+06;0;0;0;0;0;0;454225684;467387761;41727384
1983;4.27178e-15;-589;1456;9537;10131;1;677;-2.14748e+09;-1.12683e+06;0;0;0;0;0;0;454269559;467441672;41746300
1983;4.23624e-15;-611;1243;9137;10075.5;1;641;-2.14748e+09;-1.12673e+06;-1;0;0;0;-1;0;454269559;467441672;41746300
1984;4.27178e-15;-590;1456;9537;10131;1;677;-2.14748e+09;-1.12461e+06;0;0;0;0;0;0;454313349;467495485;41765187
1984;4.23624e-15;-612;1243;9137;10075.5;1;641;-2.14748e+09;-1.12461e+06;0;0;0;0;0;0;454313349;467495485;41765187
1985;4.27178e-15;-590;1456;9537;10131;1;677;-2.14748e+09;-1.12259e+06;-1;0;0;0;-1;0;454357054;467549201;41784044
1985;4.23624e-15;-612;1243;9137;10075.5;1;641;-2.14748e+09;-1.12249e+06;-1;0;0;0;-1;0;454357054;467549201;41784044
1986;4.27178e-15;-591;1456;9537;10131;1;677;-2.14748e+09;-1.12037e+06;0;0;0;0;0;0;454400675;467602821;41802870
1986;4.23624e-15;-613;1243;9137;10075.5;1;641;-2.14748e+09;-1.12037e+06;0;0;0;0;0;0;454400675;467602821;41802870
1987;4.27178e-15;-592;1456;9537;10131;1;677;-2.14748e+09;-1.11836e+06;0;0;0;0;0;0;454444212;467656343;41821666
1987;4.23624e-15;-613;1243;9137;10075.5;1;641;-2.14748e+09;-1.11826e+06;-1;0;0;0;-1;0;454444212;467656343;41821666
1988;4.27178e-15;-593;1456;9537;10131;1;677;-2.14748e+09;-1.11626e+06;0;0;0;0;0;0;454487665;467709770;41840432
1988;4.23624e-15;-613;1243;9137;10075.5;1;641;-2.14748e+09;-1.11616e+06;-1;0;0;0;-1;0;454487665;467709770;41840432
1989;4.27178e-15;-594;1456;9537;10131;1;677;-2.14748e+09;-1.11415e+06;0;0;0;0;0;0;454531034;467763100;41859169
1989;4.23624e-15;-614;1243;9137;10075.5;1;641;-2.14748e+09;-1.11405e+06;0;0;0;0;0;0;454531034;467763100;41859169
1990;4.27178e-15;-595;1456;9537;10131;1;677;-2.14748e+09;-1.11206e+06;0;0;0;0;0;0;454574320;467816335;41877875
1990;4.23624e-15;-615;1243;9137;10075.5;1;641;-2.14748e+09;-1.11196e+06;0;0;0;0;0;0;454574320;467816335;41877875
1991;4.27178e-15;-596;1456;9537;10131;1;677;-2.14748e+09;-1.10986e+06;0;0;0;0;0;0;454617521;467869473;41896551
1991;4.23624e-15;-616;1243;9137;10075.5;1;641;-2.14748e+09;-1.10986e+06;0;0;0;0;0;0;454617521;467869473;41896551
1992;4.27178e-15;-597;1456;9537;10131;1;677;-2.14748e+09;-1.10777e+06;0;0;0;0;0;0;454660640;467922516;41915197
1992;4.23624e-15;-616;1243;9137;10075.5;1;641;-2.14748e+09;-1.10777e+06;-1;0;0;0;-1;0;454660640;467922516;41915197
1993;4.27178e-15;-598;1456;9537;10131;1;677;-2.14748e+09;-1.10568e+06;0;0;0;0;0;0;454703675;467975463;41933814
1993;4.23624e-15;-617;1243;9137;10075.5;1;641;-2.14748e+09;-1.10568e+06;0;0;0;0;0;0;454703675;467975463;41933814
1994;4.27178e-15;-598;1456;9537;10131;1;677;-2.14748e+09;-1.1036e+06;-1;0;0;0;-1;0;454746627;468028315;41952401
1994;4.23624e-15;-617;1243;9137;10075.5;1;641;-2.14748e+09;-1.1036e+06;-1;0;0;0;-1;0;454746627;468028315;41952401
1995;4.27178e-15;-598;1456;9537;10131;1;677;-2.14748e+09;-1.10162e+06;-1;0;0;0;-1;0;454789497;468081072;41970957
1995;4.23624e-15;-617;1243;9137;10075.5;1;641;-2.14748e+09;-1.10162e+06;-1;0;0;0;-1;0;454789497;468081072;41970957
1996;4.27178e-15;-599;1456;9537;10131;1;677;-2.14748e+09;-1.09945e+06;0;0;0;0;0;0;454832283;468133734;41989485
1996;4.23624e-15;-618;1243;9137;10075.5;1;641;-2.14748e+09;-1.09945e+06;0;0;0;0;0;0;454832283;468133734;41989485
1997;4.27178e-15;-600;1456;9537;10131;1;677;-2.14748e+09;-1.09738e+06;0;0;0;0;0;0;454874988;468186300;42007982
1997;4.23624e-15;-618;1243;9137;10075.5;1;641;-2.14748e+09;-1.09738e+06;-1;0;0;0;-1;0;454874988;468186300;42007982
1998;4.27178e-15;-601;1456;9537;10131;1;677;-2.14748e+09;-1.09532e+06;0;0;0;0;0;0;454917609;468238773;42026450
1998;4.23624e-15;-618;1243;9137;10075.5;1;641;-2.14748e+09;-1.09532e+06;-1;0;0;0;-1;0;454917609;468238773;42026450
1999;4.27178e-15;-601;1456;9537;10131;1;677;-2.14748e+09;-1.09325e+06;-1;0;0;0;-1;0;454960149;468291151;42044888
1999;4.23624e-15;-618;1243;9137;10075.5;1;641;-2.14748e+09;-1.09325e+06;-1;0;0;0;-1;0;454960149;468291151;42044888
