step;volume;A_0;B_0;C;L;p;Compl;Aext;Bext;A_ingresso;A_uscita;B_ingresso;B_uscita;A_netto;B_netto;Avicino;Amedio;Alontano
409;4.18816e-15;74;545;13200;10036;1;2;631;3502;441;120;477;137;321;340;96;91;3
409;4.18816e-15;74;545;13200;10036;1;0;615;3502;474;149;467;126;325;341;96;91;3
410;4.21154e-15;169;1255;13114;10122;1;93;551;3502;315;65;1770;515;250;1255;96;92;3
410;4.21154e-15;141;1327;13121;10123;1;85;539;3502;310;71;1805;545;239;1260;96;92;3
411;4.26606e-15;157;1586;13046;10188;1;188;536;3503;270;75;1692;708;195;984;95;91;3
411;4.2667e-15;147;1557;13062;10210;1;165;526;3503;270;65;1725;709;205;1016;95;91;3
412;4.30743e-15;169;1648;13026;10263;1;249;587;3503;299;78;1678;845;221;833;95;92;3
412;4.3221e-15;160;1638;13011;10281;1;243;559;3503;279;88;1705;777;191;928;95;91;3
413;4.35596e-15;176;1711;13002;10326;1;323;517;3504;283;83;1701;830;200;871;95;90;3
413;4.36684e-15;165;1654;12991;10360;1;314;509;3504;249;93;1810;885;156;925;95;90;3
414;4.39633e-15;151;1665;13024;10400;1;371;541;3504;256;68;1749;837;188;912;95;90;3
414;4.41817e-15;150;1653;12988;10436;1;378;532;3504;256;86;1765;836;170;929;95;90;3
415;4.44391e-15;139;1653;13060;10481;1;416;503;3505;265;68;1807;760;197;1047;95;90;3
415;4.46712e-15;144;1725;13044;10513;1;399;494;3505;269;88;1745;838;181;907;95;90;3
416;4.49618e-15;149;1617;13127;10558;1;432;536;3505;263;86;1756;809;177;947;94;90;3
416;4.51689e-15;157;1702;13073;10585;1;430;509;3505;247;68;1820;958;179;862;94;90;3
417;4.54607e-15;151;1640;13179;10620;1;462;491;3505;256;87;1753;835;169;918;94;89;3
417;4.5636e-15;152;1686;13125;10647;1;458;483;3505;235;75;1793;810;160;983;94;89;3
418;4.58571e-15;148;1633;13243;10684;1;481;512;3506;270;72;1793;847;198;946;93;89;3
418;4.60395e-15;152;1681;13195;10714;1;471;495;3506;237;74;1770;798;163;972;93;89;3
419;4.62809e-15;129;1632;13308;10756;1;501;480;3506;259;69;1706;820;190;886;93;89;3
419;4.64769e-15;148;1632;13241;10769;1;506;472;3506;216;66;1787;814;150;973;93;89;3
420;4.67518e-15;141;1654;13368;10827;1;524;520;3507;228;66;1680;817;162;863;93;89;3
420;4.6837e-15;111;1678;13303;10838;1;526;494;3507;265;71;1711;833;194;878;93;89;3
421;4.72177e-15;158;1593;13414;10900;1;560;478;3507;273;65;1760;841;208;919;93;88;3
421;4.729e-15;152;1631;13384;10898;1;527;470;3507;235;56;1724;852;179;872;93;88;3
422;4.76983e-15;148;1613;13476;10960;1;587;475;3507;231;68;1694;794;163;900;94;89;3
422;4.76852e-15;134;1697;13452;10962;1;550;468;3507;216;66;1758;834;150;924;94;89;3
423;4.80946e-15;144;1631;13561;11042;1;591;515;3508;232;75;1815;813;157;1002;93;89;3
423;4.81079e-15;138;1730;13544;11024;1;548;497;3508;272;85;1782;773;187;1009;93;89;3
424;4.8638e-15;160;1653;13678;11112;1;584;485;3508;254;68;1724;803;186;921;94;89;3
424;4.85185e-15;139;1695;13603;11089;1;580;470;3508;226;79;1735;855;147;880;94;89;3
425;4.91034e-15;137;1650;13782;11181;1;589;491;3509;253;64;1759;830;189;929;93;90;3
425;4.89503e-15;132;1666;13683;11165;1;592;482;3509;245;57;1707;830;188;877;93;90;3
426;4.95637e-15;141;1617;13918;11240;1;571;509;3509;228;73;1785;804;155;981;93;89;3
426;4.94568e-15;140;1595;13796;11232;1;584;491;3509;212;59;1776;820;153;956;93;89;3
427;4.99584e-15;149;1654;14010;11306;1;570;503;3509;252;70;1821;840;182;981;93;90;3
427;4.99048e-15;130;1628;13861;11310;1;604;475;3509;245;70;1857;853;175;1004;93;90;3
428;5.04011e-15;149;1616;14096;11371;1;573;523;3510;252;68;1758;835;184;923;93;90;3
428;5.0428e-15;154;1640;13947;11377;1;603;499;3510;222;70;1739;765;152;974;93;90;3
429;5.08385e-15;158;1681;14170;11444;1;586;478;3510;274;77;1691;797;197;894;92;88;3
429;5.08789e-15;162;1591;14036;11449;1;610;470;3510;232;74;1843;838;158;1005;92;88;3
430;5.13311e-15;135;1704;14218;11507;1;615;503;3511;242;76;1673;824;166;849;91;88;3
430;5.13649e-15;121;1605;14139;11519;1;610;484;3511;250;71;1739;831;179;908;91;88;3
431;5.17576e-15;137;1684;14300;11579;1;629;475;3511;279;81;1677;827;198;850;91;87;3
431;5.18389e-15;147;1605;14223;11599;1;616;466;3511;231;54;1771;771;177;1000;91;87;3
432;5.22464e-15;163;1674;14408;11640;1;623;474;3511;229;69;1702;825;160;877;91;87;3
432;5.23824e-15;147;1707;14331;11682;1;613;467;3511;208;77;1790;852;131;938;91;87;3
433;5.26617e-15;126;1637;14482;11696;1;639;474;3512;252;66;1765;854;186;911;91;87;3
433;5.29483e-15;142;1663;14402;11758;1;634;467;3512;190;62;1796;882;128;914;91;87;3
434;5.3044e-15;134;1690;14602;11766;1;628;484;3512;243;72;1765;868;171;897;91;87;4
434;5.34683e-15;141;1635;14511;11830;1;633;475;3512;238;73;1767;852;165;915;91;87;4
435;5.35231e-15;153;1648;14710;11835;1;620;521;3513;239;73;1841;859;166;982;91;86;4
435;5.39624e-15;155;1675;14636;11886;1;622;494;3513;233;67;1717;774;166;943;91;86;4
436;5.39968e-15;190;1653;14830;11910;1;607;501;3513;265;74;1726;806;191;920;90;86;4
436;5.43478e-15;136;1641;14701;11948;1;641;484;3513;246;71;1737;839;175;898;90;86;4
437;5.45132e-15;171;1640;14891;11981;1;626;510;3513;234;107;1751;826;127;925;91;86;4
437;5.47755e-15;153;1663;14805;12024;1;631;501;3513;234;65;1828;816;169;1012;91;86;4
438;5.50037e-15;166;1660;15000;12041;1;618;485;3514;234;77;1778;837;157;941;90;85;4
438;5.53014e-15;154;1663;14876;12090;1;652;478;3514;230;71;1764;867;159;897;90;85;4
439;5.54193e-15;162;1746;15103;12109;1;620;496;3514;230;84;1702;815;146;887;90;86;4
439;5.57594e-15;146;1687;14983;12148;1;643;478;3514;246;89;1743;827;157;916;90;85;4
440;5.58915e-15;145;1703;15197;12183;1;626;491;3514;274;73;1734;827;201;907;90;84;4
440;5.6163e-15;134;1690;15071;12217;1;649;474;3514;224;70;1772;803;154;969;90;84;4
441;5.6407e-15;123;1685;15287;12258;1;627;491;3515;233;76;1800;839;157;961;89;85;4
441;5.66444e-15;144;1629;15162;12282;1;656;471;3515;262;80;1747;828;182;919;89;85;4
442;5.6931e-15;137;1613;15383;12319;1;621;517;3515;250;57;1734;845;193;889;90;84;4
442;5.70991e-15;161;1621;15276;12356;1;637;509;3515;228;65;1657;844;163;813;90;84;4
443;5.73585e-15;150;1609;15484;12382;1;619;511;3516;269;65;1741;792;204;949;90;84;4
443;5.76182e-15;157;1665;15357;12421;1;647;503;3516;231;66;1726;797;165;929;90;84;4
444;5.7801e-15;153;1689;15584;12445;1;622;476;3516;258;75;1768;795;183;973;90;84;4
444;5.80756e-15;161;1648;15431;12497;1;657;467;3516;254;81;1810;853;173;957;90;84;4
445;5.82447e-15;135;1590;15670;12517;1;629;497;3516;244;89;1766;830;155;936;90;83;4
445;5.86118e-15;137;1618;15504;12561;1;669;470;3516;259;83;1750;803;176;947;90;83;4
446;5.87532e-15;162;1657;15754;12582;1;634;475;3517;231;72;1722;784;159;938;89;83;4
446;5.90646e-15;148;1637;15598;12631;1;659;466;3517;239;61;1728;830;178;898;89;83;4
447;5.92135e-15;142;1631;15812;12640;1;658;514;3517;246;65;1817;846;181;971;89;83;4
447;5.95613e-15;139;1620;15700;12708;1;652;497;3517;236;61;1732;835;175;897;89;83;4
448;5.96252e-15;158;1634;15893;12707;1;668;498;3517;232;69;1769;824;163;945;89;82;4
448;6.01092e-15;165;1658;15783;12780;1;658;472;3517;239;73;1839;789;166;1050;89;82;4
449;6.01021e-15;145;1691;15990;12801;1;669;477;3518;232;83;1732;834;149;898;88;81;4
449;6.0623e-15;159;1705;15856;12831;1;670;471;3518;215;85;1764;830;130;934;88;81;4
450;6.07732e-15;167;1706;16091;12872;1;668;508;3518;235;64;1746;840;171;906;88;81;4
450;6.09879e-15;145;1686;15951;12893;1;675;471;3518;243;82;1696;847;161;849;88;81;4
451;6.12817e-15;162;1697;16129;12945;1;704;474;3519;257;67;1724;830;190;894;88;81;4
451;6.14324e-15;131;1684;16032;12939;1;681;466;3519;224;59;1785;782;165;1003;88;81;4
452;6.18061e-15;150;1644;16187;13008;1;722;513;3519;253;85;1753;815;168;938;87;81;4
452;6.17629e-15;141;1638;16134;12992;1;668;495;3519;239;58;1732;782;181;950;87;80;4
453;6.22598e-15;148;1675;16279;13059;1;726;486;3519;259;68;1800;808;191;992;86;80;4
453;6.21445e-15;137;1568;16215;13069;1;675;477;3519;253;72;1806;839;181;967;86;80;4
454;6.26279e-15;154;1676;16374;13121;1;730;479;3520;240;83;1710;822;157;888;86;80;4
454;6.27002e-15;135;1697;16292;13138;1;688;469;3520;269;60;1759;807;209;952;86;80;4
455;6.30764e-15;152;1677;16451;13184;1;743;475;3520;247;68;1730;858;179;872;87;79;4
455;6.31996e-15;146;1699;16378;13205;1;693;466;3520;243;63;1657;829;180;828;87;79;4
456;6.35333e-15;156;1654;16572;13243;1;723;479;3520;232;78;1820;837;154;983;86;79;4
456;6.36858e-15;147;1597;16500;13268;1;674;470;3520;244;75;1733;876;169;857;86;79;4
457;6.39621e-15;166;1619;16658;13308;1;730;500;3521;225;70;1708;864;155;844;85;80;4
457;6.41441e-15;131;1626;16543;13336;1;705;483;3521;219;78;1760;806;141;954;85;80;4
458;6.44356e-15;168;1670;16748;13360;1;730;479;3521;240;84;1697;821;156;876;84;80;4
458;6.464e-15;134;1705;16605;13397;1;724;471;3521;233;73;1710;820;160;890;84;80;4
459;6.48153e-15;140;1693;16843;13406;1;728;477;3521;252;80;1718;863;172;855;85;79;4
459;6.50859e-15;152;1642;16756;13463;1;684;469;3521;220;70;1771;884;150;887;85;79;4
460;6.51518e-15;156;1669;16931;13463;1;729;501;3522;252;60;1753;847;192;906;85;79;4
460;6.55696e-15;158;1704;16823;13521;1;696;484;3522;229;67;1737;852;162;885;85;79;4
461;6.55696e-15;155;1654;16991;13527;1;750;477;3522;245;81;1771;838;164;933;85;78;4
461;6.59956e-15;169;1702;16934;13591;1;684;468;3522;245;81;1761;848;164;913;85;78;4
462;6.60397e-15;135;1665;17079;13595;1;757;488;3523;224;75;1783;838;149;945;85;78;4
462;6.65109e-15;158;1719;17023;13657;1;689;481;3523;219;79;1719;903;140;816;85;78;4
463;6.65404e-15;137;1723;17192;13655;1;753;479;3523;256;63;1793;816;193;977;84;78;4
463;6.69981e-15;135;1722;17108;13718;1;695;470;3523;258;82;1712;803;176;909;84;78;4
464;6.69833e-15;170;1689;17269;13719;1;760;506;3523;233;84;1764;859;149;905;84;79;4
464;6.74494e-15;142;1690;17194;13778;1;695;486;3523;256;61;1686;857;195;829;84;79;4
465;6.74568e-15;157;1632;17379;13778;1;758;495;3524;282;93;1744;868;189;876;84;78;4
465;6.78943e-15;169;1678;17298;13851;1;691;478;3524;240;69;1771;853;171;918;84;78;4
466;6.78943e-15;145;1649;17466;13829;1;768;496;3524;251;67;1706;840;184;866;83;78;4
466;6.84369e-15;149;1678;17363;13924;1;705;478;3524;235;77;1807;869;158;938;83;78;4
467;6.82732e-15;146;1654;17562;13892;1;764;486;3524;253;59;1733;858;194;875;83;78;4
467;6.8981e-15;147;1683;17424;13987;1;726;467;3524;255;75;1758;854;180;904;83;78;4
468;6.87423e-15;131;1702;17618;13952;1;791;480;3525;216;70;1752;833;146;919;83;77;4
468;6.94517e-15;135;1712;17503;14044;1;737;473;3525;219;86;1762;819;133;943;83;77;4
469;6.919e-15;142;1659;17738;14030;1;769;482;3525;229;68;1799;847;161;952;83;77;4
469;6.98784e-15;130;1677;17645;14110;1;711;473;3525;243;69;1669;824;174;845;83;77;4
470;6.97735e-15;151;1658;17814;14105;1;779;491;3525;241;63;1747;844;178;903;82;77;4
470;7.03737e-15;146;1692;17713;14174;1;726;474;3525;220;69;1773;809;151;964;82;77;4
471;7.03361e-15;146;1642;17882;14162;1;797;490;3526;240;62;1711;829;178;882;83;77;4
471;7.08551e-15;129;1597;17805;14241;1;725;483;3526;228;85;1775;880;143;895;83;77;4
472;7.07647e-15;155;1657;17970;14217;1;800;482;3526;243;78;1766;820;165;946;83;77;4
472;7.13602e-15;150;1637;17867;14302;1;736;473;3526;253;84;1790;801;169;989;83;77;4
473;7.11791e-15;164;1654;18065;14289;1;800;481;3526;234;66;1724;845;168;879;83;76;4
473;7.18211e-15;135;1662;17926;14359;1;753;472;3526;249;71;1748;869;178;879;83;76;4
474;7.17228e-15;142;1642;18157;14351;1;806;517;3527;246;87;1768;829;159;939;83;77;4
474;7.22527e-15;153;1690;17990;14420;1;765;500;3527;225;62;1780;801;163;979;83;77;4
475;7.2192e-15;172;1659;18241;14403;1;811;482;3527;278;73;1711;792;205;919;83;76;4
475;7.27155e-15;172;1664;18044;14490;1;793;473;3527;258;79;1750;820;179;930;83;76;4
476;7.25864e-15;161;1631;18344;14464;1;810;481;3527;264;89;1795;809;175;986;83;76;4
476;7.32478e-15;147;1703;18131;14564;1;803;473;3527;252;83;1763;878;169;885;83;76;4
477;7.305e-15;167;1632;18412;14529;1;832;493;3528;229;72;1729;840;157;889;82;75;4
477;7.3812e-15;156;1615;18231;14627;1;799;486;3528;205;66;1705;856;139;849;82;75;4
478;7.3545e-15;125;1725;18510;14581;1;834;482;3528;233;78;1783;791;155;992;82;75;4
478;7.42935e-15;149;1668;18329;14692;1;796;473;3528;266;89;1733;807;177;926;82;75;4
479;7.39418e-15;145;1701;18605;14659;1;830;511;3528;244;77;1780;840;167;940;81;75;4
479;7.47913e-15;166;1649;18434;14742;1;787;474;3528;240;69;1640;884;171;756;81;75;4
480;7.45384e-15;162;1620;18699;14716;1;825;482;3529;266;85;1749;839;181;910;81;75;4
480;7.5175e-15;152;1684;18492;14798;1;805;474;3529;236;68;1738;816;168;922;81;75;4
481;7.49754e-15;158;1643;18768;14794;1;844;472;3529;242;72;1737;822;170;915;80;74;4
481;7.56055e-15;160;1699;18592;14845;1;803;455;3529;231;72;1770;843;159;927;80;74;4
482;7.5567e-15;137;1631;18854;14842;1;851;509;3529;236;89;1748;834;147;914;80;75;4
482;7.59675e-15;142;1693;18679;14904;1;809;492;3529;205;86;1688;862;119;826;80;75;4
483;7.59444e-15;161;1649;18943;14908;1;858;452;3530;262;60;1814;841;202;973;80;74;4
483;7.64227e-15;159;1712;18794;14969;1;804;443;3530;256;65;1741;791;191;950;80;74;4
484;7.64536e-15;157;1667;19021;14966;1;863;456;3530;219;78;1729;823;141;906;80;73;5
484;7.69252e-15;155;1744;18919;15029;1;785;451;3530;185;78;1680;826;107;854;80;73;5
485;7.6902e-15;133;1620;19096;15037;1;865;455;3530;218;72;1735;824;146;911;79;74;5
485;7.73901e-15;136;1688;18973;15091;1;806;447;3530;238;75;1766;909;163;857;79;74;5
486;7.74521e-15;139;1639;19175;15089;1;867;491;3531;217;73;1777;808;144;969;80;73;5
486;7.78714e-15;127;1770;19065;15157;1;802;460;3531;231;69;1746;811;162;935;80;73;5
487;7.78559e-15;148;1644;19272;15144;1;856;398;3431;231;67;1777;880;164;897;81;74;5
487;7.83849e-15;139;1700;19122;15218;1;821;383;3431;226;60;1796;855;166;941;81;73;5
488;7.82837e-15;122;1617;19373;15205;1;848;480;3531;179;54;1731;840;125;891;80;74;5
488;7.88605e-15;126;1658;19208;15281;1;818;456;3531;169;78;1709;856;91;853;80;72;5
489;7.87591e-15;153;1676;19473;15273;1;841;453;3532;228;72;1734;802;156;932;79;73;5
489;7.93527e-15;155;1732;19309;15338;1;812;436;3532;226;57;1741;795;169;946;79;73;5
490;7.92902e-15;148;1676;19567;15342;1;840;491;3532;226;71;1710;816;155;894;79;73;5
490;7.97989e-15;137;1652;19373;15407;1;822;455;3532;213;60;1747;906;153;841;79;73;5
491;7.98303e-15;158;1696;19673;15397;1;834;498;3532;228;70;1806;834;158;972;79;73;5
491;8.03402e-15;132;1683;19449;15465;1;823;479;3532;235;53;1792;828;182;964;79;72;5
492;8.02617e-15;168;1721;19709;15456;1;866;386;3433;248;62;1733;856;186;877;80;72;5
492;8.07961e-15;130;1707;19550;15527;1;820;470;3533;243;70;1808;848;173;960;79;72;5
493;8.07253e-15;125;1669;19815;15531;1;857;389;3433;177;60;1688;869;117;819;80;72;5
493;8.12845e-15;155;1687;19632;15590;1;823;444;3533;222;67;1684;847;155;837;78;72;5
494;8.1316e-15;126;1658;19915;15594;1;839;391;3433;201;50;1714;901;151;813;79;73;5
494;8.17817e-15;144;1688;19718;15652;1;827;383;3433;234;79;1797;831;155;966;79;73;5
495;8.18054e-15;117;1724;19997;15655;1;833;394;3434;186;62;1722;829;124;893;79;71;5
495;8.2272e-15;122;1690;19786;15724;1;834;456;3534;206;56;1754;848;150;906;78;71;5
496;8.22957e-15;125;1662;20119;15720;1;806;480;3534;174;64;1735;828;110;907;78;71;5
496;8.28426e-15;143;1742;19833;15782;1;860;463;3534;236;63;1742;856;173;886;78;71;5
497;8.28108e-15;148;1682;20234;15782;1;789;457;3534;209;76;1795;858;133;937;78;71;5
497;8.33032e-15;137;1729;19861;15844;1;902;443;3534;224;60;1761;844;164;917;78;71;5
498;8.33032e-15;160;1652;20289;15848;1;804;487;3535;252;83;1752;832;169;920;78;70;5
498;8.37886e-15;123;1675;19928;15910;1;912;426;3535;211;72;1771;860;139;911;78;70;5
499;8.38284e-15;148;1679;20365;15908;1;810;496;3535;239;92;1775;864;147;911;78;71;5
499;8.43227e-15;143;1666;20058;15966;1;882;488;3535;224;70;1807;825;154;982;78;70;5
500;8.43068e-15;145;1664;20459;15955;1;815;492;3535;244;69;1781;799;175;982;78;69;5
500;8.47701e-15;153;1666;20151;16025;1;875;468;3535;250;74;1764;841;176;923;78;69;5
501;8.46822e-15;149;1699;20511;16017;1;840;469;3536;244;54;1802;808;190;994;77;68;5
501;8.52423e-15;157;1676;20230;16083;1;879;453;3536;233;73;1714;776;160;938;77;68;5
502;8.51782e-15;145;1708;20575;16076;1;857;387;3436;247;66;1735;817;181;918;78;68;5
502;8.57073e-15;157;1673;20305;16151;1;891;369;3436;236;71;1733;799;165;934;78;68;5
503;8.56512e-15;126;1635;20688;16140;1;843;484;3536;193;51;1701;870;142;831;77;69;5
503;8.62536e-15;121;1678;20376;16214;1;896;478;3536;182;62;1702;837;120;865;77;69;5
504;8.61652e-15;141;1657;20762;16182;1;840;390;3437;238;73;1756;895;165;861;78;68;5
504;8.67527e-15;128;1688;20478;16275;1;885;373;3437;249;82;1699;831;167;868;78;68;5
505;8.6503e-15;114;1670;20855;16247;1;834;434;3537;214;60;1701;785;154;916;77;69;5
505;8.72447e-15;109;1723;20570;16350;1;881;421;3537;167;64;1695;829;103;866;77;69;5
506;8.70268e-15;148;1676;20934;16298;1;836;467;3537;230;76;1829;830;154;999;77;68;5
506;8.7859e-15;120;1715;20655;16412;1;874;460;3537;214;72;1780;813;142;967;77;68;5
507;8.74304e-15;163;1630;20998;16355;1;847;474;3537;233;70;1801;854;163;947;77;68;5
507;8.83612e-15;131;1726;20739;16469;1;871;449;3537;239;68;1828;846;171;982;77;68;5
508;8.78994e-15;156;1629;21054;16420;1;863;412;3538;257;87;1769;812;170;957;76;68;5
508;8.88237e-15;159;1694;20825;16531;1;868;390;3538;223;66;1786;815;157;971;76;68;5
509;8.8426e-15;135;1740;21135;16492;1;868;416;3538;219;76;1702;805;143;897;75;68;5
509;8.93277e-15;134;1655;20871;16591;1;887;392;3538;213;73;1698;797;140;901;75;68;5
510;8.90105e-15;129;1707;21229;16572;1;852;390;3538;195;73;1772;859;122;913;74;67;5
510;8.98164e-15;126;1632;20938;16659;1;893;364;3538;188;65;1794;843;123;951;74;67;5
511;8.96615e-15;100;1614;21312;16627;1;852;385;3539;192;66;1809;876;126;933;74;67;5
511;9.03713e-15;135;1625;21037;16707;1;880;373;3539;214;60;1750;799;154;951;74;67;5
512;9.011e-15;102;1684;21409;16683;1;842;398;3539;180;53;1728;762;127;966;74;68;5
512;9.07636e-15;136;1712;21139;16757;1;865;384;3539;200;50;1795;785;150;1010;74;68;5
513;9.05674e-15;139;1646;21489;16737;1;828;415;3539;197;54;1703;844;143;859;74;68;5
513;9.1173e-15;131;1687;21220;16812;1;862;385;3539;191;61;1760;801;130;959;74;68;5
514;9.10092e-15;147;1677;21567;16792;1;834;377;3540;193;63;1766;863;130;903;74;69;5
514;9.1624e-15;112;1623;21338;16861;1;839;371;3540;186;80;1784;849;106;935;74;69;5
515;9.14599e-15;123;1663;21641;16849;1;835;397;3540;173;71;1782;889;102;893;74;69;5
515;9.20264e-15;111;1650;21399;16900;1;844;384;3540;187;60;1746;840;127;906;74;69;5
516;9.19278e-15;127;1710;21720;16905;1;827;384;3540;185;59;1737;882;126;855;73;69;5
516;9.23471e-15;111;1653;21463;16956;1;847;362;3540;192;49;1791;854;143;937;73;69;5
517;9.23882e-15;136;1733;21803;16960;1;824;343;3541;187;47;1786;845;140;941;73;70;5
517;9.28082e-15;118;1688;21557;17007;1;833;337;3541;178;55;1753;827;123;926;73;70;5
518;9.28412e-15;112;1789;21850;17016;1;839;354;3541;168;52;1709;825;116;884;73;70;5
518;9.32289e-15;109;1663;21627;17069;1;838;342;3541;168;59;1753;813;109;940;73;70;5
519;9.33032e-15;114;1739;21947;17069;1;818;343;3541;189;61;1708;891;128;817;73;70;5
519;9.37411e-15;102;1621;21748;17134;1;798;323;3541;179;61;1731;837;118;894;73;70;5
520;9.37411e-15;105;1798;22052;17119;1;795;335;3541;164;56;1789;833;108;956;73;70;5
520;9.42791e-15;95;1682;21851;17191;1;768;324;3541;159;60;1770;791;99;979;73;70;5
521;9.41549e-15;96;1796;22114;17178;1;798;327;3542;166;53;1748;904;113;844;73;69;5
521;9.47518e-15;90;1753;21906;17247;1;778;312;3542;161;55;1789;827;106;962;73;69;5
522;9.46439e-15;100;1789;22191;17245;1;786;337;3542;162;55;1806;879;107;927;73;69;5
522;9.52169e-15;103;1687;21978;17314;1;769;326;3542;165;50;1836;837;115;999;73;69;5
523;9.52003e-15;113;1832;22267;17310;1;775;343;3542;162;48;1836;828;114;1008;73;68;5
523;9.57744e-15;100;1660;22050;17383;1;762;337;3542;174;57;1735;871;117;864;73;68;5
524;9.57411e-15;90;1753;22386;17359;1;746;370;3543;168;49;1688;932;119;756;73;68;5
524;9.63497e-15;111;1741;22104;17434;1;767;352;3543;160;44;1711;829;116;882;73;68;5
525;9.61495e-15;100;1724;22427;17420;1;757;337;3543;166;52;1775;880;114;895;73;69;5
525;9.67756e-15;94;1654;22174;17504;1;765;331;3543;176;60;1658;851;116;807;73;69;5
526;9.66586e-15;92;1658;22511;17476;1;742;349;3543;176;59;1758;922;117;836;72;69;5
526;9.73613e-15;101;1723;22238;17565;1;763;344;3543;158;54;1742;861;104;881;72;69;5
527;9.71269e-15;117;1737;22579;17530;1;734;348;3544;157;62;1797;825;95;972;72;68;5
527;9.78726e-15;92;1655;22359;17619;1;727;329;3544;178;54;1746;861;124;885;72;68;5
528;9.75791e-15;101;1744;22628;17589;1;742;341;3544;178;69;1723;860;109;863;72;68;5
528;9.8326e-15;99;1635;22411;17681;1;732;326;3544;162;47;1749;846;115;903;72;68;5
529;9.8074e-15;111;1780;22700;17654;1;733;336;3544;174;57;1850;862;117;988;72;68;5
529;9.88474e-15;111;1728;22497;17734;1;714;331;3544;149;50;1727;832;99;895;72;68;5
530;9.86202e-15;105;1695;22766;17710;1;731;347;3544;150;68;1787;850;82;937;72;67;5
530;9.92939e-15;104;1766;22552;17794;1;718;335;3544;174;57;1765;886;117;879;72;67;5
531;9.90916e-15;123;1726;22844;17761;1;727;353;3545;179;48;1845;847;131;998;70;67;5
531;9.98001e-15;99;1732;22597;17854;1;723;334;3545;161;50;1824;883;111;941;70;67;5
532;9.95216e-15;117;1685;22906;17812;1;732;351;3545;182;57;1784;890;125;894;71;66;5
532;1.00307e-14;99;1678;22669;17908;1;711;340;3545;160;62;1779;874;98;905;71;66;5
533;9.99521e-15;118;1676;22989;17861;1;723;314;3545;166;64;1798;868;102;930;70;67;5
533;1.00764e-14;99;1699;22745;17957;1;697;276;3545;195;51;1821;833;144;988;70;67;5
534;1.00366e-14;106;1714;23045;17929;1;729;300;3546;160;55;1814;857;105;957;70;67;5
534;1.0118e-14;83;1695;22816;18010;1;683;295;3546;135;47;1775;874;88;901;70;67;5
535;1.00942e-14;99;1712;23096;17987;1;735;326;3546;152;50;1763;874;102;889;70;66;5
535;1.0163e-14;92;1701;22900;18069;1;662;314;3546;147;35;1767;856;112;911;70;66;5
536;1.01434e-14;119;1708;23165;18039;1;729;316;3546;162;49;1741;843;113;898;70;67;5
536;1.02131e-14;100;1744;22934;18134;1;668;302;3546;138;55;1739;869;83;870;70;67;5
537;1.01876e-14;102;1773;23206;18110;1;740;344;3546;171;63;1709;832;108;877;69;67;5
537;1.02685e-14;112;1724;23010;18180;1;656;338;3546;152;47;1764;876;105;888;69;67;5
538;1.0248e-14;113;1667;23296;18163;1;721;292;3547;181;42;1761;884;139;877;69;68;6
538;1.03077e-14;107;1682;23069;18240;1;653;277;3547;140;57;1836;903;83;933;69;68;6
539;1.02932e-14;109;1711;23336;18206;1;733;330;3547;136;47;1757;827;89;930;69;68;6
539;1.0359e-14;95;1686;23111;18302;1;662;319;3547;155;46;1755;857;109;898;69;68;6
540;1.03299e-14;106;1714;23390;18248;1;738;307;3547;163;58;1699;895;105;804;69;68;6
540;1.04121e-14;95;1743;23170;18359;1;662;281;3547;183;39;1794;849;144;945;69;68;6
541;1.03658e-14;85;1700;23427;18305;1;753;331;3548;170;61;1738;875;109;863;69;68;6
541;1.04609e-14;82;1719;23227;18403;1;653;320;3548;153;48;1746;882;105;864;69;68;6
542;1.04146e-14;109;1655;23493;18363;1;749;315;3548;169;54;1787;845;115;942;70;68;6
542;1.04987e-14;101;1633;23283;18464;1;646;301;3548;149;48;1753;897;101;856;70;68;6
543;1.04644e-14;99;1675;23576;18406;1;740;308;3548;171;52;1842;799;119;1043;69;68;6
543;1.05511e-14;99;1719;23349;18517;1;640;288;3548;158;56;1733;826;102;907;69;68;6
544;1.05013e-14;78;1818;23642;18458;1;732;297;3548;170;52;1777;832;118;945;69;68;6
544;1.05968e-14;108;1760;23403;18575;1;642;291;3548;152;43;1724;873;109;851;69;68;6
545;1.0546e-14;87;1737;23696;18518;1;729;317;3549;128;45;1791;920;83;871;69;69;6
545;1.06468e-14;96;1773;23455;18627;1;644;306;3549;148;51;1754;807;97;947;69;67;6
546;1.05976e-14;85;1667;23742;18584;1;738;288;3549;165;41;1820;882;124;938;68;67;6
546;1.06917e-14;80;1731;23515;18687;1;640;257;3549;146;60;1737;843;86;894;68;67;6
547;1.06545e-14;93;1758;23761;18633;1;758;276;3549;152;35;1811;884;117;927;68;67;6
547;1.07436e-14;73;1674;23569;18739;1;634;264;3549;115;39;1785;890;76;895;68;67;6
548;1.06969e-14;81;1669;23822;18687;1;749;297;3550;138;43;1793;824;95;969;69;67;6
548;1.07886e-14;85;1713;23610;18788;1;640;282;3550;123;40;1742;822;83;920;69;67;6
549;1.07436e-14;90;1710;23875;18742;1;746;290;3550;155;47;1770;799;108;971;68;68;6
549;1.08311e-14;105;1747;23638;18843;1;649;252;3550;147;46;1739;910;101;829;68;68;6
550;1.07912e-14;97;1669;23930;18801;1;744;272;3550;143;53;1795;854;90;941;68;66;6
550;1.08789e-14;88;1787;23681;18911;1;651;267;3550;144;42;1720;908;102;812;68;66;6
551;1.08424e-14;107;1730;24007;18860;1;731;268;3550;137;50;1725;823;87;902;68;67;6
551;1.0938e-14;90;1734;23760;18964;1;634;259;3550;122;44;1782;860;78;922;68;66;6
552;1.08936e-14;81;1724;24074;18922;1;727;286;3551;139;54;1723;889;85;834;67;66;6
552;1.09842e-14;100;1767;23816;19015;1;631;276;3551;140;45;1858;864;95;994;67;66;6
553;1.09476e-14;75;1702;24155;18977;1;712;280;3551;123;32;1757;869;91;888;67;66;6
553;1.10287e-14;93;1738;23880;19075;1;622;275;3551;140;51;1813;882;89;931;67;66;6
554;1.09955e-14;83;1716;24209;19028;1;711;290;3551;146;45;1795;827;101;968;67;65;6
554;1.10811e-14;99;1735;23926;19136;1;623;286;3551;143;47;1791;877;96;914;67;65;6
555;1.10401e-14;102;1646;24244;19083;1;718;288;3551;140;35;1728;872;105;856;67;65;6
555;1.11345e-14;99;1713;23984;19194;1;620;277;3551;152;59;1778;859;93;919;67;65;6
556;1.10881e-14;114;1768;24303;19134;1;715;318;3552;135;43;1799;853;92;946;67;65;6
556;1.11854e-14;91;1736;24048;19236;1;611;308;3552;148;53;1751;870;95;881;67;65;6
557;1.11328e-14;109;1809;24360;19181;1;714;294;3552;178;51;1758;840;127;918;67;64;6
557;1.12222e-14;109;1693;24067;19303;1;631;260;3552;151;37;1718;871;114;847;67;64;6
558;1.1174e-14;95;1771;24419;19241;1;716;276;3552;143;45;1746;807;98;939;66;64;6
558;1.12811e-14;85;1698;24112;19344;1;638;263;3552;125;44;1855;867;81;988;66;64;6
559;1.12266e-14;108;1719;24490;19299;1;703;253;3553;133;52;1826;857;81;969;66;64;6
559;1.13172e-14;89;1707;24146;19397;1;638;249;3553;114;44;1802;847;70;955;66;64;6
560;1.12776e-14;64;1795;24559;19344;1;693;289;3553;135;49;1731;848;86;883;66;64;6
560;1.13639e-14;70;1661;24212;19450;1;621;244;3553;128;44;1819;892;84;927;66;64;6
561;1.13172e-14;84;1711;24608;19398;1;688;2.14749e+08;-2.14748e+09;140;42;1710;884;98;826;66;63;6
561;1.14107e-14;86;1668;24247;19511;1;621;2.14749e+08;-2.14748e+09;107;38;1783;867;69;916;66;63;6
562;1.13648e-14;84;1711;24608;19398;1;688;4.21148e+08;-2.06399e+09;0;0;-1;0;0;-1;65;63;6
562;1.14646e-14;86;1665;24247;19511;1;621;4.21148e+08;-2.06399e+09;0;0;-1;0;0;-1;65;63;6
563;1.13648e-14;84;1711;24608;19398;1;688;6.19576e+08;-1.98428e+09;0;0;-1;0;0;-1;65;63;6
563;1.14646e-14;86;1662;24247;19511;1;621;6.19576e+08;-1.98428e+09;0;0;-1;0;0;-1;65;63;6
564;1.13648e-14;84;1711;24608;19398;1;688;7.03019e+08;-1.90817e+09;0;0;-1;0;0;-1;416;414;6
564;1.14646e-14;86;1662;24247;19511;1;621;7.03019e+08;-1.90817e+09;1;0;-1;0;1;-1;416;414;6
565;1.13648e-14;84;1708;24608;19398;1;688;9.93942e+08;-1.83548e+09;0;0;-1;0;0;-1;1764;1761;6
565;1.14646e-14;86;1662;24247;19511;1;621;9.93942e+08;-1.83548e+09;0;0;-1;0;0;-1;1764;1761;6
566;1.13648e-14;85;1705;24608;19398;1;688;9.55798e+08;-1.76604e+09;1;0;-1;0;1;-1;5004;5001;6
566;1.14646e-14;87;1661;24247;19511;1;621;9.55798e+08;-1.76604e+09;0;0;-1;0;0;-1;5004;5001;6
567;1.13648e-14;86;1704;24608;19398;1;688;1.34052e+09;-1.69969e+09;1;0;-1;0;1;-1;11232;11230;6
567;1.14646e-14;88;1660;24247;19511;1;621;1.34052e+09;-1.69969e+09;0;0;-1;0;0;-1;11232;11230;6
568;1.13648e-14;86;1701;24608;19398;1;688;1.28939e+09;-1.63627e+09;2;0;-1;0;2;-1;21712;21710;6
568;1.14646e-14;88;1659;24247;19511;1;621;1.28939e+09;-1.63627e+09;0;0;-1;0;0;-1;21712;21710;6
569;1.13648e-14;86;1701;24608;19398;1;688;1.66171e+09;-1.57565e+09;0;0;-1;0;0;-1;37837;37834;6
569;1.14646e-14;89;1658;24247;19511;1;621;1.66171e+09;-1.57565e+09;2;0;-1;0;2;-1;37837;37834;6
570;1.13648e-14;88;1701;24608;19398;1;688;1.81348e+09;-1.51768e+09;0;0;-1;0;0;-1;61099;61096;6
570;1.14646e-14;91;1657;24247;19511;1;621;1.81348e+09;-1.51768e+09;1;0;-1;0;1;-1;61099;61096;6
571;1.13648e-14;88;1700;24608;19398;1;688;1.74495e+09;-1.46224e+09;0;0;-1;0;0;-1;93064;93061;6
571;1.14646e-14;91;1657;24247;19511;1;621;1.85233e+09;-1.46224e+09;0;0;-1;0;0;-1;93064;93061;6
572;1.13648e-14;89;1700;24608;19398;1;688;1.88587e+09;-1.40921e+09;0;0;-1;0;0;-1;135348;135345;6
572;1.14646e-14;93;1656;24247;19511;1;621;1.88587e+09;-1.40921e+09;1;0;-1;0;1;-1;135348;135345;6
573;1.13648e-14;89;1699;24608;19398;1;688;2.02172e+09;-1.35846e+09;0;0;-1;0;0;-1;189593;189590;6
573;1.14646e-14;99;1650;24247;19511;1;621;2.02172e+09;-1.35846e+09;6;0;-1;0;6;-1;189593;189590;6
574;1.13648e-14;91;1697;24608;19398;1;688;-2.14748e+09;-1.30989e+09;0;0;-1;0;0;-1;257453;257450;6
574;1.14646e-14;99;1650;24247;19511;1;621;-2.14748e+09;-1.30989e+09;0;0;-1;0;0;-1;257453;257450;6
575;1.13648e-14;91;1697;24608;19398;1;688;-2.14748e+09;-1.2634e+09;0;0;-1;0;0;-1;340574;340572;6
575;1.14646e-14;99;1648;24247;19511;1;621;-2.14748e+09;-1.2634e+09;-1;0;0;0;-1;0;340574;340572;6
576;1.13648e-14;91;1697;24608;19398;1;688;-2.14748e+09;-1.21888e+09;0;0;-1;0;0;-1;440587;440584;6
576;1.14646e-14;99;1648;24247;19511;1;621;-2.14748e+09;-1.21888e+09;0;0;-1;0;0;-1;440587;440584;6
577;1.13648e-14;90;1696;24608;19398;1;688;-2.14748e+09;-1.17625e+09;0;0;-1;0;0;-1;559086;559083;6
577;1.14646e-14;99;1648;24247;19511;1;621;-2.14748e+09;-1.17625e+09;-1;0;0;0;-1;0;559086;559083;6
578;1.13648e-14;88;1695;24608;19398;1;688;-2.14748e+09;-1.13541e+09;-1;0;0;0;-1;0;697627;697624;6
578;1.14646e-14;96;1648;24247;19511;1;621;-2.14748e+09;-1.13541e+09;-1;0;0;0;-1;0;697627;697624;6
579;1.13648e-14;88;1693;24608;19398;1;688;-2.14748e+09;-1.09627e+09;0;0;-1;0;0;-1;857717;857715;6
579;1.14646e-14;94;1647;24247;19511;1;621;-2.14748e+09;-1.09627e+09;-1;0;0;0;-1;0;857717;857715;6
580;1.13648e-14;88;1693;24608;19398;1;688;-2.14748e+09;-1.05877e+09;0;0;-1;0;0;-1;1040806;1040803;6
580;1.14646e-14;94;1647;24247;19511;1;621;-2.14748e+09;-1.05877e+09;-1;0;0;0;-1;0;1040806;1040803;6
581;1.13648e-14;88;1693;24608;19398;1;688;-2.14748e+09;-1.02281e+09;-1;0;0;0;-1;0;1248279;1248276;6
581;1.14646e-14;94;1647;24247;19511;1;621;-2.14748e+09;-1.02281e+09;-1;0;0;0;-1;0;1248279;1248276;6
582;1.13648e-14;88;1693;24608;19398;1;688;-2.14748e+09;-9.88342e+08;-1;0;0;0;-1;0;1481457;1481455;6
582;1.14646e-14;94;1647;24247;19511;1;621;-2.14748e+09;-9.88342e+08;-1;0;0;0;-1;0;1481457;1481455;6
583;1.13648e-14;86;1693;24608;19398;1;688;-2.14748e+09;-9.5528e+08;-1;0;0;0;-1;0;1741590;1741587;6
583;1.14646e-14;94;1647;24247;19511;1;621;-2.14748e+09;-9.5528e+08;-1;0;0;0;-1;0;1741590;1741587;6
584;1.13648e-14;86;1693;24608;19398;1;688;-2.14748e+09;-9.23566e+08;-1;0;0;0;-1;0;2029853;2029850;6
584;1.14646e-14;93;1646;24247;19511;1;621;-2.14748e+09;-9.23566e+08;-1;0;0;0;-1;0;2029853;2029850;6
585;1.13648e-14;85;1693;24608;19398;1;688;-2.14748e+09;-8.93136e+08;0;0;-1;0;0;-1;2347347;2347344;6
585;1.14646e-14;93;1646;24247;19511;1;621;-2.14748e+09;-8.93136e+08;-1;0;0;0;-1;0;2347347;2347344;6
586;1.13648e-14;85;1693;24608;19398;1;688;-2.14748e+09;-8.63933e+08;0;0;-1;0;0;-1;2695095;2695092;6
586;1.14646e-14;93;1646;24247;19511;1;621;-2.14748e+09;-8.63933e+08;-1;0;0;0;-1;0;2695095;2695092;6
587;1.13648e-14;85;1693;24608;19398;1;688;-2.14748e+09;-8.359e+08;0;0;-1;0;0;-1;3074045;3074042;6
587;1.14646e-14;93;1646;24247;19511;1;621;-2.14748e+09;-8.359e+08;-1;0;0;0;-1;0;3074045;3074042;6
588;1.13648e-14;85;1693;24608;19398;1;688;-2.14748e+09;-8.08984e+08;-1;0;0;0;-1;0;3485064;3485062;6
588;1.14646e-14;93;1646;24247;19511;1;621;-2.14748e+09;-8.08984e+08;0;0;-1;0;0;-1;3485064;3485062;6
589;1.13648e-14;84;1692;24608;19398;1;688;-2.14748e+09;-7.83135e+08;-1;0;0;0;-1;0;3928947;3928944;6
589;1.14646e-14;92;1646;24247;19511;1;621;-2.14748e+09;-7.83135e+08;-1;0;0;0;-1;0;3928947;3928944;6
590;1.13648e-14;83;1692;24608;19398;1;688;-2.14748e+09;-7.58305e+08;-1;0;0;0;-1;0;4406407;4406404;6
590;1.14646e-14;91;1646;24247;19511;1;621;-2.14748e+09;-7.58305e+08;-1;0;0;0;-1;0;4406407;4406404;6
591;1.13648e-14;81;1692;24608;19398;1;688;-2.14748e+09;-7.34449e+08;-1;0;0;0;-1;0;4918086;4918083;6
591;1.14646e-14;91;1646;24247;19511;1;621;-2.14748e+09;-7.34449e+08;-1;0;0;0;-1;0;4918086;4918083;6
592;1.13648e-14;81;1691;24608;19398;1;688;-2.14748e+09;-7.11523e+08;0;0;-1;0;0;-1;5464550;5464547;7
592;1.14646e-14;91;1646;24247;19511;1;621;-2.14748e+09;-7.11523e+08;-1;0;0;0;-1;0;5464550;5464547;7
593;1.13648e-14;80;1691;24608;19398;1;688;-2.14748e+09;-6.89486e+08;-1;0;0;0;-1;0;6046293;6046291;7
593;1.14646e-14;89;1646;24247;19511;1;621;-2.14748e+09;-6.89486e+08;-1;0;0;0;-1;0;6046293;6046291;7
594;1.13648e-14;78;1691;24608;19398;1;688;-2.14748e+09;-6.68298e+08;-1;0;0;0;-1;0;6663741;6663738;7
594;1.14646e-14;89;1646;24247;19511;1;621;-2.14748e+09;-6.68298e+08;-1;0;0;0;-1;0;6663741;6663738;7
595;1.13648e-14;78;1691;24608;19398;1;688;-2.14748e+09;-6.47923e+08;-1;0;0;0;-1;0;7317248;7317245;7
595;1.14646e-14;86;1646;24247;19511;1;621;-2.14748e+09;-6.47923e+08;-1;0;0;0;-1;0;7317248;7317245;7
596;1.13648e-14;78;1691;24608;19398;1;688;-2.14748e+09;-6.28325e+08;0;0;-1;0;0;-1;8007105;8007102;7
596;1.14646e-14;82;1646;24247;19511;1;621;-2.14748e+09;-6.28325e+08;-1;0;0;0;-1;0;8007105;8007102;7
597;1.13648e-14;78;1691;24608;19398;1;688;-2.14748e+09;-6.0947e+08;-1;0;0;0;-1;0;8733537;8733534;7
597;1.14646e-14;82;1645;24247;19511;1;621;-2.14748e+09;-6.0947e+08;0;0;-1;0;0;-1;8733537;8733534;7
598;1.13648e-14;78;1691;24608;19398;1;688;-2.14748e+09;-5.91326e+08;-1;0;0;0;-1;0;9496710;9496707;8
598;1.14646e-14;81;1645;24247;19511;1;621;-2.14748e+09;-5.91326e+08;-1;0;0;0;-1;0;9496710;9496707;8
599;1.13648e-14;76;1691;24608;19398;1;688;-2.14748e+09;-5.73862e+08;-1;0;0;0;-1;0;10296729;10296727;8
599;1.14646e-14;81;1645;24247;19511;1;621;-2.14748e+09;-5.73862e+08;-1;0;0;0;-1;0;10296729;10296727;8
600;1.13648e-14;76;1691;24608;19398;1;688;-2.14748e+09;-5.57049e+08;-1;0;0;0;-1;0;11133645;11133642;9
600;1.14646e-14;80;1645;24247;19511;1;621;-2.14748e+09;-5.57049e+08;0;0;-1;0;0;-1;11133645;11133642;9
601;1.13648e-14;76;1691;24608;19398;1;688;-2.14748e+09;-5.40859e+08;-1;0;0;0;-1;0;12007452;12007450;9
601;1.14646e-14;80;1645;24247;19511;1;621;-2.14748e+09;-5.40859e+08;-1;0;0;0;-1;0;12007452;12007450;9
602;1.13648e-14;76;1691;24608;19398;1;688;-2.14748e+09;-5.25265e+08;0;0;-1;0;0;-1;12918097;12918094;10
602;1.14646e-14;74;1644;24247;19511;1;621;-2.14748e+09;-5.25265e+08;-1;0;0;0;-1;0;12918097;12918094;10
603;1.13648e-14;76;1690;24608;19398;1;688;-2.14748e+09;-5.10244e+08;-1;0;0;0;-1;0;13865473;13865471;11
603;1.14646e-14;74;1644;24247;19511;1;621;-2.14748e+09;-5.10244e+08;-1;0;0;0;-1;0;13865473;13865471;11
604;1.13648e-14;76;1690;24608;19398;1;688;-2.14748e+09;-4.95769e+08;-1;0;0;0;-1;0;14849432;14849430;12
604;1.14646e-14;72;1644;24247;19511;1;621;-2.14748e+09;-4.95769e+08;-1;0;0;0;-1;0;14849432;14849430;12
605;1.13648e-14;76;1690;24608;19398;1;688;-2.14748e+09;-4.81819e+08;-1;0;0;0;-1;0;15869779;15869777;13
605;1.14646e-14;72;1644;24247;19511;1;621;-2.14748e+09;-4.81819e+08;-1;0;0;0;-1;0;15869779;15869777;13
606;1.13648e-14;74;1688;24608;19398;1;688;-2.14748e+09;-4.68371e+08;-1;0;0;0;-1;0;16926279;16926277;15
606;1.14646e-14;71;1643;24247;19511;1;621;-2.14748e+09;-4.68371e+08;0;0;-1;0;0;-1;16926279;16926277;15
607;1.13648e-14;74;1688;24608;19398;1;688;-2.14748e+09;-4.55404e+08;-1;0;0;0;-1;0;18018659;18018657;17
607;1.14646e-14;71;1643;24247;19511;1;621;-2.14748e+09;-4.55404e+08;-1;0;0;0;-1;0;18018659;18018657;17
608;1.13648e-14;74;1688;24608;19398;1;688;-2.14748e+09;-4.429e+08;-1;0;0;0;-1;0;19146609;19146607;19
608;1.14646e-14;71;1643;24247;19511;1;621;-2.14748e+09;-4.429e+08;-1;0;0;0;-1;0;19146609;19146607;19
609;1.13648e-14;74;1688;24608;19398;1;688;-2.14748e+09;-4.30837e+08;-1;0;0;0;-1;0;20309784;20309782;22
609;1.14646e-14;71;1643;24247;19511;1;621;-2.14748e+09;-4.30837e+08;-1;0;0;0;-1;0;20309784;20309782;22
610;1.13648e-14;74;1688;24608;19398;1;688;-2.14748e+09;-4.192e+08;0;0;-1;0;0;-1;21507808;21507806;25
610;1.14646e-14;71;1643;24247;19511;1;621;-2.14748e+09;-4.192e+08;-1;0;0;0;-1;0;21507808;21507806;25
611;1.13648e-14;73;1688;24608;19398;1;688;-2.14748e+09;-4.07969e+08;-1;0;0;0;-1;0;22740277;22740275;29
611;1.14646e-14;71;1643;24247;19511;1;621;-2.14748e+09;-4.07969e+08;-1;0;0;0;-1;0;22740277;22740275;29
612;1.13648e-14;71;1688;24608;19398;1;688;-2.14748e+09;-3.97129e+08;-1;0;0;0;-1;0;24006757;24006756;33
612;1.14646e-14;71;1643;24247;19511;1;621;-2.14748e+09;-3.97129e+08;-1;0;0;0;-1;0;24006757;24006756;33
613;1.13648e-14;71;1688;24608;19398;1;688;-2.14748e+09;-3.86664e+08;-1;0;0;0;-1;0;25306792;25306791;39
613;1.14646e-14;71;1643;24247;19511;1;621;-2.14748e+09;-3.86664e+08;-1;0;0;0;-1;0;25306792;25306791;39
614;1.13648e-14;71;1688;24608;19398;1;688;-2.14748e+09;-3.76558e+08;-1;0;0;0;-1;0;26639899;26639898;45
614;1.14646e-14;70;1643;24247;19511;1;621;-2.14748e+09;-3.76558e+08;-1;0;0;0;-1;0;26639899;26639898;45
615;1.13648e-14;68;1688;24608;19398;1;688;-2.14748e+09;-3.66798e+08;-1;0;0;0;-1;0;28005576;28005576;52
615;1.14646e-14;70;1643;24247;19511;1;621;-2.14748e+09;-3.66798e+08;-1;0;0;0;-1;0;28005576;28005576;52
616;1.13648e-14;67;1687;24608;19398;1;688;-2.14748e+09;-3.57369e+08;-1;0;0;0;-1;0;29403302;29403302;60
616;1.14646e-14;70;1643;24247;19511;1;621;-2.14748e+09;-3.57369e+08;-1;0;0;0;-1;0;29403302;29403302;60
617;1.13648e-14;67;1687;24608;19398;1;688;-2.14748e+09;-3.48258e+08;-1;0;0;0;-1;0;30832536;30832537;69
617;1.14646e-14;70;1643;24247;19511;1;621;-2.14748e+09;-3.48258e+08;-1;0;0;0;-1;0;30832536;30832537;69
618;1.13648e-14;67;1686;24608;19398;1;688;-2.14748e+09;-3.39454e+08;0;0;-1;0;0;-1;32292724;32292725;79
618;1.14646e-14;70;1643;24247;19511;1;621;-2.14748e+09;-3.39454e+08;-1;0;0;0;-1;0;32292724;32292725;79
619;1.13648e-14;67;1686;24608;19398;1;688;-2.14748e+09;-3.30943e+08;-1;0;0;0;-1;0;33783295;33783296;91
619;1.14646e-14;70;1642;24247;19511;1;621;-2.14748e+09;-3.30943e+08;-1;0;0;0;-1;0;33783295;33783296;91
620;1.13648e-14;66;1686;24608;19398;1;688;-2.14748e+09;-3.22714e+08;-1;0;0;0;-1;0;35303667;35303669;105
620;1.14646e-14;70;1642;24247;19511;1;621;-2.14748e+09;-3.22714e+08;-1;0;0;0;-1;0;35303667;35303669;105
621;1.13648e-14;65;1686;24608;19398;1;688;-2.14748e+09;-3.14757e+08;-1;0;0;0;-1;0;36853245;36853247;121
621;1.14646e-14;69;1642;24247;19511;1;621;-2.14748e+09;-3.14757e+08;-1;0;0;0;-1;0;36853245;36853247;121
622;1.13648e-14;65;1686;24608;19398;1;688;-2.14748e+09;-3.07061e+08;0;0;-1;0;0;-1;38431426;38431429;138
622;1.14646e-14;65;1641;24247;19511;1;621;-2.14748e+09;-3.07061e+08;0;0;-1;0;0;-1;38431426;38431429;138
623;1.13648e-14;65;1686;24608;19398;1;688;-2.14748e+09;-2.99615e+08;-1;0;0;0;-1;0;40037598;40037603;158
623;1.14646e-14;63;1641;24247;19511;1;621;-2.14748e+09;-2.99615e+08;0;0;-1;0;0;-1;40037598;40037603;158
624;1.13648e-14;65;1686;24608;19398;1;688;-2.14748e+09;-2.92411e+08;-1;0;0;0;-1;0;41671142;41671148;180
624;1.14646e-14;63;1641;24247;19511;1;621;-2.14748e+09;-2.92411e+08;-1;0;0;0;-1;0;41671142;41671148;180
625;1.13648e-14;64;1686;24608;19398;1;688;-2.14748e+09;-2.85438e+08;-1;0;0;0;-1;0;43331432;43331439;205
625;1.14646e-14;61;1641;24247;19511;1;621;-2.14748e+09;-2.85438e+08;-1;0;0;0;-1;0;43331432;43331439;205
626;1.13648e-14;64;1686;24608;19398;1;688;-2.14748e+09;-2.78689e+08;-1;0;0;0;-1;0;45017839;45017848;233
626;1.14646e-14;60;1641;24247;19511;1;621;-2.14748e+09;-2.78689e+08;0;0;-1;0;0;-1;45017839;45017847;233
627;1.13648e-14;64;1686;24608;19398;1;688;-2.14748e+09;-2.72154e+08;-1;0;0;0;-1;0;46729729;46729739;264
627;1.14646e-14;60;1641;24247;19511;1;621;-2.14748e+09;-2.72154e+08;-1;0;0;0;-1;0;46729729;46729739;264
628;1.13648e-14;62;1686;24608;19398;1;688;-2.14748e+09;-2.65826e+08;0;0;-1;0;0;-1;48466466;48466476;299
628;1.14646e-14;58;1641;24247;19511;1;621;-2.14748e+09;-2.65826e+08;-1;0;0;0;-1;0;48466466;48466476;299
629;1.13648e-14;62;1686;24608;19398;1;688;-2.14748e+09;-2.59697e+08;-1;0;0;0;-1;0;50227410;50227423;338
629;1.14646e-14;58;1641;24247;19511;1;621;-2.14748e+09;-2.59697e+08;-1;0;0;0;-1;0;50227410;50227423;338
630;1.13648e-14;62;1686;24608;19398;1;688;-2.14748e+09;-2.53759e+08;0;0;-1;0;0;-1;52011925;52011940;381
630;1.14646e-14;58;1641;24247;19511;1;621;-2.14748e+09;-2.53759e+08;-1;0;0;0;-1;0;52011925;52011940;381
631;1.13648e-14;60;1686;24608;19398;1;688;-2.14748e+09;-2.48005e+08;-1;0;0;0;-1;0;53819371;53819388;429
631;1.14646e-14;58;1641;24247;19511;1;621;-2.14748e+09;-2.48005e+08;-1;0;0;0;-1;0;53819371;53819388;429
632;1.13648e-14;60;1686;24608;19398;1;688;-2.14748e+09;-2.42429e+08;-1;0;0;0;-1;0;55649111;55649131;481
632;1.14646e-14;58;1641;24247;19511;1;621;-2.14748e+09;-2.42429e+08;-1;0;0;0;-1;0;55649111;55649131;481
633;1.13648e-14;60;1686;24608;19398;1;688;-2.14748e+09;-2.37024e+08;-1;0;0;0;-1;0;57500510;57500531;539
633;1.14646e-14;57;1640;24247;19511;1;621;-2.14748e+09;-2.37024e+08;-1;0;0;0;-1;0;57500510;57500531;539
634;1.13648e-14;60;1686;24608;19398;1;688;-2.14748e+09;-2.31784e+08;-1;0;0;0;-1;0;59372932;59372957;603
634;1.14646e-14;57;1640;24247;19511;1;621;-2.14748e+09;-2.31784e+08;-1;0;0;0;-1;0;59372932;59372957;603
635;1.13648e-14;60;1686;24608;19398;1;688;-2.14748e+09;-2.26703e+08;-1;0;0;0;-1;0;61265750;61265777;674
635;1.14646e-14;54;1640;24247;19511;1;621;-2.14748e+09;-2.26703e+08;-1;0;0;0;-1;0;61265750;61265777;674
636;1.13648e-14;59;1686;24608;19398;1;688;-2.14748e+09;-2.21775e+08;0;0;-1;0;0;-1;63178335;63178365;751
636;1.14646e-14;54;1640;24247;19511;1;621;-2.14748e+09;-2.21775e+08;0;0;-1;0;0;-1;63178335;63178365;751
637;1.13648e-14;57;1686;24608;19398;1;688;-2.14748e+09;-2.16994e+08;-1;0;0;0;-1;0;65110065;65110100;835
637;1.14646e-14;54;1640;24247;19511;1;621;-2.14748e+09;-2.16994e+08;0;0;-1;0;0;-1;65110065;65110100;835
638;1.13648e-14;56;1686;24608;19398;1;688;-2.14748e+09;-2.12356e+08;-1;0;0;0;-1;0;67060324;67060363;927
638;1.14646e-14;54;1640;24247;19511;1;621;-2.14748e+09;-2.12356e+08;0;0;-1;0;0;-1;67060324;67060363;927
639;1.13648e-14;56;1686;24608;19398;1;688;-2.14748e+09;-2.07855e+08;-1;0;0;0;-1;0;69028499;69028543;1028
639;1.14646e-14;54;1640;24247;19511;1;621;-2.14748e+09;-2.07855e+08;-1;0;0;0;-1;0;69028499;69028543;1028
640;1.13648e-14;55;1686;24608;19398;1;688;-2.14748e+09;-2.03486e+08;-1;0;0;0;-1;0;71013983;71014033;1137
640;1.14646e-14;54;1640;24247;19511;1;621;-2.14748e+09;-2.03486e+08;-1;0;0;0;-1;0;71013983;71014033;1137
641;1.13648e-14;54;1686;24608;19398;1;688;-2.14748e+09;-1.99245e+08;-1;0;0;0;-1;0;73016177;73016233;1257
641;1.14646e-14;51;1640;24247;19511;1;621;-2.14748e+09;-1.99245e+08;-1;0;0;0;-1;0;73016177;73016233;1257
642;1.13648e-14;52;1686;24608;19398;1;688;-2.14748e+09;-1.95127e+08;-1;0;0;0;-1;0;75034487;75034549;1386
642;1.14646e-14;51;1640;24247;19511;1;621;-2.14748e+09;-1.95127e+08;-1;0;0;0;-1;0;75034487;75034549;1386
643;1.13648e-14;51;1685;24608;19398;1;688;-2.14748e+09;-1.91128e+08;0;0;-1;0;0;-1;77068327;77068396;1527
643;1.14646e-14;51;1640;24247;19511;1;621;-2.14748e+09;-1.91128e+08;-1;0;0;0;-1;0;77068327;77068396;1527
644;1.13648e-14;50;1685;24608;19398;1;688;-2.14748e+09;-1.87243e+08;-1;0;0;0;-1;0;79117118;79117193;1680
644;1.14646e-14;51;1640;24247;19511;1;621;-2.14748e+09;-1.87243e+08;-1;0;0;0;-1;0;79117118;79117193;1680
645;1.13648e-14;48;1685;24608;19398;1;688;-2.14748e+09;-1.8347e+08;0;0;-1;0;0;-1;81180287;81180369;1844
645;1.14646e-14;51;1640;24247;19511;1;621;-2.14748e+09;-1.8347e+08;-1;0;0;0;-1;0;81180287;81180369;1844
646;1.13648e-14;46;1684;24608;19398;1;688;-2.14748e+09;-1.79803e+08;-1;0;0;0;-1;0;83257270;83257361;2022
646;1.14646e-14;50;1640;24247;19511;1;621;-2.14748e+09;-1.79803e+08;-1;0;0;0;-1;0;83257270;83257361;2022
647;1.13648e-14;46;1684;24608;19398;1;688;-2.14748e+09;-1.76239e+08;-1;0;0;0;-1;0;85347512;85347612;2215
647;1.14646e-14;50;1640;24247;19511;1;621;-2.14748e+09;-1.76239e+08;-1;0;0;0;-1;0;85347512;85347612;2215
648;1.13648e-14;46;1684;24608;19398;1;688;-2.14748e+09;-1.72776e+08;-1;0;0;0;-1;0;87450466;87450575;2422
648;1.14646e-14;48;1640;24247;19511;1;621;-2.14748e+09;-1.72776e+08;-1;0;0;0;-1;0;87450466;87450575;2422
649;1.13648e-14;44;1684;24608;19398;1;688;-2.14748e+09;-1.69408e+08;-1;0;0;0;-1;0;89565591;89565711;2644
649;1.14646e-14;48;1640;24247;19511;1;621;-2.14748e+09;-1.69408e+08;-1;0;0;0;-1;0;89565591;89565711;2644
650;1.13648e-14;44;1684;24608;19398;1;688;-2.14748e+09;-1.66134e+08;-1;0;0;0;-1;0;91692358;91692490;2884
650;1.14646e-14;48;1640;24247;19511;1;621;-2.14748e+09;-1.66134e+08;-1;0;0;0;-1;0;91692358;91692490;2884
651;1.13648e-14;42;1684;24608;19398;1;688;-2.14748e+09;-1.6295e+08;-1;0;0;0;-1;0;93830245;93830389;3141
651;1.14646e-14;44;1640;24247;19511;1;621;-2.14748e+09;-1.6295e+08;-1;0;0;0;-1;0;93830245;93830389;3141
652;1.13648e-14;42;1684;24608;19398;1;688;-2.14748e+09;-1.59852e+08;-1;0;0;0;-1;0;95978738;95978895;3417
652;1.14646e-14;42;1640;24247;19511;1;621;-2.14748e+09;-1.59852e+08;-1;0;0;0;-1;0;95978738;95978895;3417
653;1.13648e-14;40;1683;24608;19398;1;688;-2.14748e+09;-1.56839e+08;-1;0;0;0;-1;0;98137335;98137505;3712
653;1.14646e-14;42;1640;24247;19511;1;621;-2.14748e+09;-1.56839e+08;0;0;-1;0;0;-1;98137335;98137505;3712
654;1.13648e-14;39;1683;24608;19398;1;688;-2.14748e+09;-1.53907e+08;-1;0;0;0;-1;0;100305538;100305725;4028
654;1.14646e-14;42;1640;24247;19511;1;621;-2.14748e+09;-1.53907e+08;-1;0;0;0;-1;0;100305538;100305725;4028
655;1.13648e-14;39;1683;24608;19398;1;688;-2.14748e+09;-1.51054e+08;-1;0;0;0;-1;0;102482865;102483067;4366
655;1.14646e-14;42;1639;24247;19511;1;621;-2.14748e+09;-1.51054e+08;-1;0;0;0;-1;0;102482865;102483067;4366
656;1.13648e-14;37;1682;24608;19398;1;688;-2.14748e+09;-1.48277e+08;-1;0;0;0;-1;0;104668836;104669056;4726
656;1.14646e-14;41;1639;24247;19511;1;621;-2.14748e+09;-1.48277e+08;-1;0;0;0;-1;0;104668836;104669055;4726
657;1.13648e-14;36;1682;24608;19398;1;688;-2.14748e+09;-1.45573e+08;-1;0;0;0;-1;0;106862986;106863224;5111
657;1.14646e-14;41;1639;24247;19511;1;621;-2.14748e+09;-1.45573e+08;-1;0;0;0;-1;0;106862986;106863224;5111
658;1.13648e-14;34;1682;24608;19398;1;688;-2.14748e+09;-1.42941e+08;-1;0;0;0;-1;0;109064855;109065113;5521
658;1.14646e-14;39;1639;24247;19511;1;621;-2.14748e+09;-1.42941e+08;-1;0;0;0;-1;0;109064855;109065113;5521
659;1.13648e-14;34;1682;24608;19398;1;688;-2.14748e+09;-1.40378e+08;-1;0;0;0;-1;0;111273995;111274274;5957
659;1.14646e-14;37;1639;24247;19511;1;621;-2.14748e+09;-1.40378e+08;-1;0;0;0;-1;0;111273995;111274274;5957
660;1.13648e-14;32;1682;24608;19398;1;688;-2.14748e+09;-1.37881e+08;-1;0;0;0;-1;0;113489966;113490268;6421
660;1.14646e-14;36;1639;24247;19511;1;621;-2.14748e+09;-1.37881e+08;-1;0;0;0;-1;0;113489966;113490268;6421
661;1.13648e-14;28;1682;24608;19398;1;688;-2.14748e+09;-1.35448e+08;-1;0;0;0;-1;0;115712338;115712664;6914
661;1.14646e-14;35;1639;24247;19511;1;621;-2.14748e+09;-1.35448e+08;-1;0;0;0;-1;0;115712338;115712664;6914
662;1.13648e-14;28;1682;24608;19398;1;688;-2.14748e+09;-1.33079e+08;-1;0;0;0;-1;0;117940689;117941040;7438
662;1.14646e-14;34;1639;24247;19511;1;621;-2.14748e+09;-1.33079e+08;-1;0;0;0;-1;0;117940689;117941040;7438
663;1.13648e-14;27;1682;24608;19398;1;688;-2.14748e+09;-1.30769e+08;-1;0;0;0;-1;0;120174606;120174985;7993
663;1.14646e-14;31;1639;24247;19511;1;621;-2.14748e+09;-1.30769e+08;-1;0;0;0;-1;0;120174606;120174985;7993
664;1.13648e-14;27;1682;24608;19398;1;688;-2.14748e+09;-1.28518e+08;-1;0;0;0;-1;0;122413688;122414095;8581
664;1.14646e-14;31;1639;24247;19511;1;621;-2.14748e+09;-1.28518e+08;-1;0;0;0;-1;0;122413688;122414095;8581
665;1.13648e-14;26;1682;24608;19398;1;688;-2.14748e+09;-1.26325e+08;-1;0;0;0;-1;0;124657539;124657977;9204
665;1.14646e-14;29;1639;24247;19511;1;621;-2.14748e+09;-1.26325e+08;-1;0;0;0;-1;0;124657539;124657977;9204
666;1.13648e-14;25;1682;24608;19398;1;688;-2.14748e+09;-1.24186e+08;-1;0;0;0;-1;0;126905775;126906246;9862
666;1.14646e-14;24;1639;24247;19511;1;621;-2.14748e+09;-1.24186e+08;-1;0;0;0;-1;0;126905775;126906246;9862
667;1.13648e-14;22;1682;24608;19398;1;688;-2.14748e+09;-1.221e+08;-1;0;0;0;-1;0;129158019;129158524;10559
667;1.14646e-14;21;1639;24247;19511;1;621;-2.14748e+09;-1.221e+08;-1;0;0;0;-1;0;129158017;129158524;10559
668;1.13648e-14;22;1682;24608;19398;1;688;-2.14748e+09;-1.20066e+08;-1;0;0;0;-1;0;131413903;131414446;11294
668;1.14646e-14;21;1639;24247;19511;1;621;-2.14748e+09;-1.20066e+08;-1;0;0;0;-1;0;131413903;131414446;11294
669;1.13648e-14;22;1682;24608;19398;1;688;-2.14748e+09;-1.18082e+08;-1;0;0;0;-1;0;133673070;133673651;12070
669;1.14646e-14;17;1639;24247;19511;1;621;-2.14748e+09;-1.18082e+08;-1;0;0;0;-1;0;133673070;133673651;12070
670;1.13648e-14;22;1682;24608;19398;1;688;-2.14748e+09;-1.16147e+08;0;0;-1;0;0;-1;135935168;135935792;12889
670;1.14646e-14;15;1639;24247;19511;1;621;-2.14748e+09;-1.16147e+08;-1;0;0;0;-1;0;135935168;135935792;12889
671;1.13648e-14;22;1682;24608;19398;1;688;-2.14748e+09;-1.14258e+08;-1;0;0;0;-1;0;138199859;138200525;13751
671;1.14646e-14;14;1639;24247;19511;1;621;-2.14748e+09;-1.14258e+08;-1;0;0;0;-1;0;138199859;138200525;13751
672;1.13648e-14;22;1682;24608;19398;1;688;-2.14748e+09;-1.12415e+08;-1;0;0;0;-1;0;140466807;140467519;14659
672;1.14646e-14;14;1639;24247;19511;1;621;-2.14748e+09;-1.12415e+08;-1;0;0;0;-1;0;140466807;140467519;14659
673;1.13648e-14;22;1682;24608;19398;1;688;-2.14748e+09;-1.10617e+08;-1;0;0;0;-1;0;142735689;142736449;15614
673;1.14646e-14;12;1639;24247;19511;1;621;-2.14748e+09;-1.10617e+08;-1;0;0;0;-1;0;142735689;142736449;15614
674;1.13648e-14;20;1682;24608;19398;1;688;-2.14748e+09;-1.08861e+08;-1;0;0;0;-1;0;145006187;145006998;16619
674;1.14646e-14;9;1639;24247;19511;1;621;-2.14748e+09;-1.08861e+08;-1;0;0;0;-1;0;145006187;145006998;16619
675;1.13648e-14;20;1682;24608;19398;1;688;-2.14748e+09;-1.07148e+08;-1;0;0;0;-1;0;147277994;147278859;17674
675;1.14646e-14;9;1639;24247;19511;1;621;-2.14748e+09;-1.07148e+08;-1;0;0;0;-1;0;147277994;147278859;17674
676;1.13648e-14;20;1682;24608;19398;1;688;-2.14748e+09;-1.05474e+08;-1;0;0;0;-1;0;149550810;149551731;18782
676;1.14646e-14;7;1639;24247;19511;1;621;-2.14748e+09;-1.05474e+08;-1;0;0;0;-1;0;149550810;149551731;18782
677;1.13648e-14;19;1682;24608;19398;1;688;-2.14748e+09;-1.0384e+08;-1;0;0;0;-1;0;151824342;151825322;19944
677;1.14646e-14;5;1639;24247;19511;1;621;-2.14748e+09;-1.0384e+08;-1;0;0;0;-1;0;151824342;151825322;19944
678;1.13648e-14;19;1682;24608;19398;1;688;-2.14748e+09;-1.02244e+08;-1;0;0;0;-1;0;154098305;154099348;21163
678;1.14646e-14;5;1639;24247;19511;1;621;-2.14748e+09;-1.02244e+08;-1;0;0;0;-1;0;154098305;154099348;21163
679;1.13648e-14;16;1682;24608;19398;1;688;-2.14748e+09;-1.00684e+08;-1;0;0;0;-1;0;156372424;156373533;22441
679;1.14646e-14;3;1639;24247;19511;1;621;-2.14748e+09;-1.00684e+08;-1;0;0;0;-1;0;156372424;156373533;22441
680;1.13648e-14;15;1682;24608;19398;1;688;-2.14748e+09;-9.9161e+07;-1;0;0;0;-1;0;158646429;158647607;23779
680;1.14646e-14;2;1639;24247;19511;1;621;-2.14748e+09;-9.9161e+07;-1;0;0;0;-1;0;158646429;158647607;23779
681;1.13648e-14;14;1682;24608;19398;1;688;-2.14748e+09;-9.76726e+07;-1;0;0;0;-1;0;160920057;160921308;25179
681;1.14646e-14;-1;1639;24247;19511;1;621;-2.14748e+09;-9.76726e+07;0;0;0;0;0;0;160920057;160921308;25179
682;1.13648e-14;14;1682;24608;19398;1;688;-2.14748e+09;-9.62178e+07;-1;0;0;0;-1;0;163193056;163194382;26643
682;1.14646e-14;-1;1639;24247;19511;1;621;-2.14748e+09;-9.62178e+07;-1;0;0;0;-1;0;163193056;163194382;26643
683;1.13648e-14;14;1681;24608;19398;1;688;-2.14748e+09;-9.4796e+07;-1;0;0;0;-1;0;165465176;165466582;28174
683;1.14646e-14;-1;1639;24247;19511;1;621;-2.14748e+09;-9.4796e+07;-1;0;0;0;-1;0;165465176;165466582;28174
684;1.13648e-14;14;1681;24608;19398;1;688;-2.14748e+09;-9.34062e+07;-1;0;0;0;-1;0;167736178;167737668;29773
684;1.14646e-14;-2;1639;24247;19511;1;621;-2.14748e+09;-9.34062e+07;0;0;0;0;0;0;167736178;167737668;29773
685;1.13648e-14;14;1681;24608;19398;1;688;-2.14748e+09;-9.20473e+07;-1;0;0;0;-1;0;170005829;170007407;31443
685;1.14646e-14;-2;1639;24247;19511;1;621;-2.14748e+09;-9.20473e+07;-1;0;0;0;-1;0;170005829;170007407;31443
686;1.13648e-14;13;1681;24608;19398;1;688;-2.14748e+09;-9.07186e+07;-1;0;0;0;-1;0;172273901;172275571;33185
686;1.14646e-14;-2;1639;24247;19511;1;621;-2.14748e+09;-9.07186e+07;-1;0;0;0;-1;0;172273901;172275571;33185
687;1.13648e-14;13;1681;24608;19398;1;688;-2.14748e+09;-8.94192e+07;-1;0;0;0;-1;0;174540177;174541941;35002
687;1.14646e-14;-2;1639;24247;19511;1;621;-2.14748e+09;-8.94192e+07;-1;0;0;0;-1;0;174540177;174541941;35002
688;1.13648e-14;10;1681;24608;19398;1;688;-2.14748e+09;-8.81483e+07;-1;0;0;0;-1;0;176804441;176806306;36896
688;1.14646e-14;-3;1639;24247;19511;1;621;-2.14748e+09;-8.81483e+07;0;0;0;0;0;0;176804441;176806306;36896
689;1.13648e-14;7;1681;24608;19398;1;688;-2.14748e+09;-8.69051e+07;-1;0;0;0;-1;0;179066487;179068456;38870
689;1.14646e-14;-3;1639;24247;19511;1;621;-2.14748e+09;-8.69051e+07;-1;0;0;0;-1;0;179066487;179068456;38870
690;1.13648e-14;6;1681;24608;19398;1;688;-2.14748e+09;-8.56888e+07;-1;0;0;0;-1;0;181326114;181328193;40924
690;1.14646e-14;-4;1639;24247;19511;1;621;-2.14748e+09;-8.56888e+07;0;0;0;0;0;0;181326114;181328193;40924
691;1.13648e-14;6;1681;24608;19398;1;688;-2.14748e+09;-8.44987e+07;-1;0;0;0;-1;0;183583128;183585322;43063
691;1.14646e-14;-4;1639;24247;19511;1;621;-2.14748e+09;-8.44987e+07;-1;0;0;0;-1;0;183583128;183585322;43063
692;1.13648e-14;6;1681;24608;19398;1;688;-2.14748e+09;-8.33341e+07;-1;0;0;0;-1;0;185837342;185839654;45287
692;1.14646e-14;-4;1639;24247;19511;1;621;-2.14748e+09;-8.33341e+07;-1;0;0;0;-1;0;185837342;185839654;45287
693;1.13648e-14;6;1681;24608;19398;1;688;-2.14748e+09;-8.21942e+07;-1;0;0;0;-1;0;188088571;188091007;47600
693;1.14646e-14;-4;1639;24247;19511;1;621;-2.14748e+09;-8.21942e+07;-1;0;0;0;-1;0;188088571;188091007;47600
694;1.13648e-14;3;1681;24608;19398;1;688;-2.14748e+09;-8.10785e+07;-1;0;0;0;-1;0;190336640;190339206;50003
694;1.14646e-14;-5;1639;24247;19511;1;621;-2.14748e+09;-8.10785e+07;0;0;0;0;0;0;190336640;190339206;50003
695;1.13648e-14;-1;1681;24608;19398;1;688;-2.14748e+09;-7.99862e+07;0;0;0;0;0;0;192581378;192584079;52499
695;1.14646e-14;-5;1639;24247;19511;1;621;-2.14748e+09;-7.99862e+07;-1;0;0;0;-1;0;192581378;192584079;52499
696;1.13648e-14;-2;1681;24608;19398;1;688;-2.14748e+09;-7.89167e+07;0;0;0;0;0;0;194822618;194825460;55091
696;1.14646e-14;-5;1639;24247;19511;1;621;-2.14748e+09;-7.89167e+07;-1;0;0;0;-1;0;194822618;194825460;55091
697;1.13648e-14;-2;1681;24608;19398;1;688;-2.14748e+09;-7.78694e+07;-1;0;0;0;-1;0;197060202;197063191;57780
697;1.14646e-14;-5;1639;24247;19511;1;621;-2.14748e+09;-7.78694e+07;-1;0;0;0;-1;0;197060202;197063191;57780
698;1.13648e-14;-2;1681;24608;19398;1;688;-2.14748e+09;-7.68437e+07;-1;0;0;0;-1;0;199293975;199297115;60569
698;1.14646e-14;-6;1639;24247;19511;1;621;-2.14748e+09;-7.68437e+07;0;0;0;0;0;0;199293975;199297115;60569
699;1.13648e-14;-2;1681;24608;19398;1;688;-2.14748e+09;-7.58391e+07;-1;0;0;0;-1;0;201523786;201527085;63461
699;1.14646e-14;-7;1639;24247;19511;1;621;-2.14748e+09;-7.58391e+07;0;0;0;0;0;0;201523786;201527085;63461
700;1.13648e-14;-3;1681;24608;19398;1;688;-2.14748e+09;-7.48551e+07;0;0;0;0;0;0;203749493;203752956;66458
700;1.14646e-14;-8;1639;24247;19511;1;621;-2.14748e+09;-7.48551e+07;0;0;0;0;0;0;203749493;203752956;66458
701;1.13648e-14;-3;1681;24608;19398;1;688;-2.14748e+09;-7.38909e+07;-1;0;0;0;-1;0;205970953;205974588;69562
701;1.14646e-14;-8;1639;24247;19511;1;621;-2.14748e+09;-7.38909e+07;-1;0;0;0;-1;0;205970953;205974588;69562
702;1.13648e-14;-4;1681;24608;19398;1;688;-2.14748e+09;-7.2946e+07;0;0;0;0;0;0;208188036;208191848;72776
702;1.14646e-14;-9;1639;24247;19511;1;621;-2.14748e+09;-7.2946e+07;0;0;0;0;0;0;208188036;208191848;72776
703;1.13648e-14;-5;1681;24608;19398;1;688;-2.14748e+09;-7.20202e+07;0;0;0;0;0;0;210400609;210404606;76103
703;1.14646e-14;-10;1639;24247;19511;1;621;-2.14748e+09;-7.20202e+07;0;0;0;0;0;0;210400609;210404606;76103
704;1.13648e-14;-6;1681;24608;19398;1;688;-2.14748e+09;-7.11128e+07;0;0;0;0;0;0;212608547;212612736;79544
704;1.14646e-14;-11;1639;24247;19511;1;621;-2.14748e+09;-7.11128e+07;0;0;0;0;0;0;212608547;212612736;79544
705;1.13648e-14;-7;1681;24608;19398;1;688;-2.14748e+09;-7.02234e+07;0;0;0;0;0;0;214811731;214816119;83103
705;1.14646e-14;-12;1639;24247;19511;1;621;-2.14748e+09;-7.02234e+07;0;0;0;0;0;0;214811731;214816119;83103
706;1.13648e-14;-8;1681;24608;19398;1;688;-2.14748e+09;-6.93515e+07;0;0;0;0;0;0;217010043;217014638;86781
706;1.14646e-14;-12;1639;24247;19511;1;621;-2.14748e+09;-6.93515e+07;-1;0;0;0;-1;0;217010043;217014638;86781
707;1.13648e-14;-9;1681;24608;19398;1;688;-2.14748e+09;-6.84966e+07;0;0;0;0;0;0;219203372;219208180;90583
707;1.14646e-14;-12;1639;24247;19511;1;621;-2.14748e+09;-6.84966e+07;-1;0;0;0;-1;0;219203372;219208180;90583
708;1.13648e-14;-9;1681;24608;19398;1;688;-2.14748e+09;-6.76584e+07;0;0;-1;0;0;-1;221391609;221396640;94509
708;1.14646e-14;-12;1639;24247;19511;1;621;-2.14748e+09;-6.76584e+07;-1;0;0;0;-1;0;221391609;221396640;94509
709;1.13648e-14;-9;1681;24608;19398;1;688;-2.14748e+09;-6.68363e+07;-1;0;0;0;-1;0;223574652;223579912;98563
709;1.14646e-14;-12;1639;24247;19511;1;621;-2.14748e+09;-6.68363e+07;-1;0;0;0;-1;0;223574652;223579912;98563
710;1.13648e-14;-10;1681;24608;19398;1;688;-2.14748e+09;-6.60302e+07;0;0;0;0;0;0;225752401;225757899;102747
710;1.14646e-14;-13;1639;24247;19511;1;621;-2.14748e+09;-6.60302e+07;0;0;0;0;0;0;225752401;225757899;102747
711;1.13648e-14;-10;1681;24608;19398;1;688;-2.14748e+09;-6.52393e+07;-1;0;0;0;-1;0;227924759;227930504;107063
711;1.14646e-14;-13;1639;24247;19511;1;621;-2.14748e+09;-6.52393e+07;-1;0;0;0;-1;0;227924759;227930504;107063
712;1.13648e-14;-10;1681;24608;19398;1;688;-2.14748e+09;-6.44635e+07;-1;0;0;0;-1;0;230091635;230097635;111516
712;1.14646e-14;-13;1639;24247;19511;1;621;-2.14748e+09;-6.44635e+07;-1;0;0;0;-1;0;230091635;230097635;111516
713;1.13648e-14;-11;1681;24608;19398;1;688;-2.14748e+09;-6.37023e+07;0;0;0;0;0;0;232252940;232259205;116106
713;1.14646e-14;-14;1639;24247;19511;1;621;-2.14748e+09;-6.37023e+07;0;0;0;0;0;0;232252940;232259205;116106
714;1.13648e-14;-11;1681;24608;19398;1;688;-2.14748e+09;-6.29556e+07;-1;0;0;0;-1;0;234408591;234415128;120836
714;1.14646e-14;-14;1639;24247;19511;1;621;-2.14748e+09;-6.29556e+07;-1;0;0;0;-1;0;234408591;234415128;120836
715;1.13648e-14;-11;1681;24608;19398;1;688;-2.14748e+09;-6.22226e+07;-1;0;0;0;-1;0;236558502;236565325;125710
715;1.14646e-14;-15;1639;24247;19511;1;621;-2.14748e+09;-6.22226e+07;0;0;0;0;0;0;236558502;236565325;125710
716;1.13648e-14;-12;1681;24608;19398;1;688;-2.14748e+09;-6.15032e+07;0;0;0;0;0;0;238702602;238709717;130730
716;1.14646e-14;-15;1639;24247;19511;1;621;-2.14748e+09;-6.15032e+07;-1;0;0;0;-1;0;238702602;238709717;130730
717;1.13648e-14;-12;1681;24608;19398;1;688;-2.14748e+09;-6.07972e+07;-1;0;0;0;-1;0;240840814;240848231;135898
717;1.14646e-14;-15;1639;24247;19511;1;621;-2.14748e+09;-6.07972e+07;-1;0;0;0;-1;0;240840814;240848231;135898
718;1.13648e-14;-13;1681;24608;19398;1;688;-2.14748e+09;-6.01041e+07;0;0;0;0;0;0;242973066;242980795;141217
718;1.14646e-14;-15;1639;24247;19511;1;621;-2.14748e+09;-6.01041e+07;-1;0;0;0;-1;0;242973066;242980795;141217
719;1.13648e-14;-13;1681;24608;19398;1;688;-2.14748e+09;-5.94236e+07;0;0;-1;0;0;-1;245099291;245107340;146689
719;1.14646e-14;-15;1639;24247;19511;1;621;-2.14748e+09;-5.94236e+07;-1;0;0;0;-1;0;245099291;245107340;146689
720;1.13648e-14;-14;1681;24608;19398;1;688;-2.14748e+09;-5.87555e+07;0;0;0;0;0;0;247219423;247227805;152318
720;1.14646e-14;-15;1639;24247;19511;1;621;-2.14748e+09;-5.87555e+07;-1;0;0;0;-1;0;247219423;247227805;152318
721;1.13648e-14;-15;1681;24608;19398;1;688;-2.14748e+09;-5.80994e+07;0;0;0;0;0;0;249333401;249342125;158106
721;1.14646e-14;-15;1639;24247;19511;1;621;-2.14748e+09;-5.80994e+07;-1;0;0;0;-1;0;249333401;249342125;158106
722;1.13648e-14;-15;1681;24608;19398;1;688;-2.14748e+09;-5.74551e+07;-1;0;0;0;-1;0;251441166;251450244;164055
722;1.14646e-14;-15;1639;24247;19511;1;621;-2.14748e+09;-5.74551e+07;-1;0;0;0;-1;0;251441166;251450244;164055
723;1.13648e-14;-15;1681;24608;19398;1;688;-2.14748e+09;-5.68223e+07;-1;0;0;0;-1;0;253542662;253552105;170168
723;1.14646e-14;-15;1639;24247;19511;1;621;-2.14748e+09;-5.68223e+07;-1;0;0;0;-1;0;253542662;253552105;170168
724;1.13648e-14;-16;1681;24608;19398;1;688;-2.14748e+09;-5.62006e+07;0;0;0;0;0;0;255637835;255647654;176448
724;1.14646e-14;-15;1639;24247;19511;1;621;-2.14748e+09;-5.62006e+07;-1;0;0;0;-1;0;255637835;255647654;176448
725;1.13648e-14;-17;1681;24608;19398;1;688;-2.14748e+09;-5.559e+07;0;0;0;0;0;0;257726633;257736841;182897
725;1.14646e-14;-16;1639;24247;19511;1;621;-2.14748e+09;-5.559e+07;0;0;0;0;0;0;257726633;257736841;182897
726;1.13648e-14;-18;1681;24608;19398;1;688;-2.14748e+09;-5.499e+07;0;0;0;0;0;0;259809009;259819619;189519
726;1.14646e-14;-17;1639;24247;19511;1;621;-2.14748e+09;-5.499e+07;0;0;0;0;0;0;259809009;259819619;189519
727;1.13648e-14;-18;1681;24608;19398;1;688;-2.14748e+09;-5.44004e+07;-1;0;0;0;-1;0;261884921;261895942;196315
727;1.14646e-14;-18;1639;24247;19511;1;621;-2.14748e+09;-5.44004e+07;0;0;0;0;0;0;261884921;261895941;196315
728;1.13648e-14;-19;1681;24608;19398;1;688;-2.14748e+09;-5.38211e+07;0;0;0;0;0;0;263954323;263965767;203288
728;1.14646e-14;-18;1639;24247;19511;1;621;-2.14748e+09;-5.38211e+07;-1;0;0;0;-1;0;263954323;263965766;203288
729;1.13648e-14;-19;1681;24608;19398;1;688;-2.14748e+09;-5.32517e+07;-1;0;0;0;-1;0;266017174;266029052;210440
729;1.14646e-14;-18;1639;24247;19511;1;621;-2.14748e+09;-5.32517e+07;-1;0;0;0;-1;0;266017174;266029052;210440
730;1.13648e-14;-20;1681;24608;19398;1;688;-2.14748e+09;-5.26922e+07;0;0;0;0;0;0;268073437;268085764;217776
730;1.14646e-14;-18;1639;24247;19511;1;621;-2.14748e+09;-5.26922e+07;-1;0;0;0;-1;0;268073437;268085764;217776
731;1.13648e-14;-20;1681;24608;19398;1;688;-2.14748e+09;-5.2142e+07;-1;0;0;0;-1;0;270123074;270135864;225296
731;1.14646e-14;-19;1639;24247;19511;1;621;-2.14748e+09;-5.2142e+07;0;0;0;0;0;0;270123074;270135864;225296
732;1.13648e-14;-20;1681;24608;19398;1;688;-2.14748e+09;-5.16013e+07;-1;0;0;0;-1;0;272166054;272179319;233003
732;1.14646e-14;-20;1639;24247;19511;1;621;-2.14748e+09;-5.16013e+07;0;0;0;0;0;0;272166054;272179319;233003
733;1.13648e-14;-20;1681;24608;19398;1;688;-2.14748e+09;-5.10696e+07;-1;0;0;0;-1;0;274202342;274216097;240901
733;1.14646e-14;-20;1639;24247;19511;1;621;-2.14748e+09;-5.10696e+07;-1;0;0;0;-1;0;274202342;274216097;240901
734;1.13648e-14;-21;1681;24608;19398;1;688;-2.14748e+09;-5.05468e+07;0;0;0;0;0;0;276231911;276246169;248991
734;1.14646e-14;-21;1639;24247;19511;1;621;-2.14748e+09;-5.05468e+07;0;0;0;0;0;0;276231911;276246169;248991
735;1.13648e-14;-22;1681;24608;19398;1;688;-2.14748e+09;-5.00327e+07;0;0;0;0;0;0;278254734;278269508;257276
735;1.14646e-14;-21;1638;24247;19511;1;621;-2.14748e+09;-5.00327e+07;0;0;0;0;0;0;278254734;278269508;257276
736;1.13648e-14;-22;1681;24608;19398;1;688;-2.14748e+09;-4.95272e+07;-1;0;0;0;-1;0;280270783;280286089;265760
736;1.14646e-14;-21;1638;24247;19511;1;621;-2.14748e+09;-4.95272e+07;-1;0;0;0;-1;0;280270783;280286089;265760
737;1.13648e-14;-22;1681;24608;19398;1;688;-2.14748e+09;-4.90299e+07;-1;0;0;0;-1;0;282280034;282295887;274443
737;1.14646e-14;-21;1638;24247;19511;1;621;-2.14748e+09;-4.90299e+07;-1;0;0;0;-1;0;282280034;282295885;274443
738;1.13648e-14;-23;1681;24608;19398;1;688;-2.14748e+09;-4.85408e+07;0;0;0;0;0;0;284282468;284298879;283329
738;1.14646e-14;-22;1638;24247;19511;1;621;-2.14748e+09;-4.85408e+07;0;0;0;0;0;0;284282468;284298878;283329
739;1.13648e-14;-24;1681;24608;19398;1;688;-2.14748e+09;-4.80597e+07;0;0;0;0;0;0;286278063;286295049;292420
739;1.14646e-14;-23;1638;24247;19511;1;621;-2.14748e+09;-4.80597e+07;0;0;0;0;0;0;286278063;286295049;292420
740;1.13648e-14;-25;1681;24608;19398;1;688;-2.14748e+09;-4.75863e+07;0;0;0;0;0;0;288266801;288284379;301719
740;1.14646e-14;-24;1638;24247;19511;1;621;-2.14748e+09;-4.75863e+07;0;0;0;0;0;0;288266801;288284379;301719
741;1.13648e-14;-25;1681;24608;19398;1;688;-2.14748e+09;-4.71205e+07;-1;0;0;0;-1;0;290248665;290266850;311229
741;1.14646e-14;-24;1638;24247;19511;1;621;-2.14748e+09;-4.71205e+07;-1;0;0;0;-1;0;290248665;290266850;311229
742;1.13648e-14;-26;1681;24608;19398;1;688;-2.14748e+09;-4.66622e+07;0;0;0;0;0;0;292223641;292242449;320950
742;1.14646e-14;-24;1638;24247;19511;1;621;-2.14748e+09;-4.66622e+07;-1;0;0;0;-1;0;292223641;292242449;320950
743;1.13648e-14;-27;1681;24608;19398;1;688;-2.14748e+09;-4.62113e+07;0;0;0;0;0;0;294191715;294211162;330887
743;1.14646e-14;-24;1638;24247;19511;1;621;-2.14748e+09;-4.62113e+07;-1;0;0;0;-1;0;294191715;294211162;330887
744;1.13648e-14;-27;1681;24608;19398;1;688;-2.14748e+09;-4.57674e+07;-1;0;0;0;-1;0;296152872;296172978;341042
744;1.14646e-14;-24;1638;24247;19511;1;621;-2.14748e+09;-4.57674e+07;-1;0;0;0;-1;0;296152872;296172978;341042
745;1.13648e-14;-28;1681;24608;19398;1;688;-2.14748e+09;-4.53305e+07;0;0;0;0;0;0;298107108;298127886;351416
745;1.14646e-14;-25;1638;24247;19511;1;621;-2.14748e+09;-4.53305e+07;0;0;0;0;0;0;298107108;298127886;351416
746;1.13648e-14;-28;1681;24608;19398;1;688;-2.14748e+09;-4.49005e+07;-1;0;0;0;-1;0;300054410;300075878;362013
746;1.14646e-14;-25;1638;24247;19511;1;621;-2.14748e+09;-4.49005e+07;-1;0;0;0;-1;0;300054410;300075878;362013
747;1.13648e-14;-28;1681;24608;19398;1;688;-2.14748e+09;-4.44771e+07;-1;0;0;0;-1;0;301994764;302016944;372834
747;1.14646e-14;-26;1638;24247;19511;1;621;-2.14748e+09;-4.44771e+07;0;0;0;0;0;0;301994764;302016944;372834
748;1.13648e-14;-29;1681;24608;19398;1;688;-2.14748e+09;-4.40603e+07;0;0;0;0;0;0;303928179;303951083;383883
748;1.14646e-14;-26;1638;24247;19511;1;621;-2.14748e+09;-4.40603e+07;-1;0;0;0;-1;0;303928179;303951083;383883
749;1.13648e-14;-29;1681;24608;19398;1;688;-2.14748e+09;-4.36499e+07;-1;0;0;0;-1;0;305854640;305878287;395161
749;1.14646e-14;-27;1638;24247;19511;1;621;-2.14748e+09;-4.36499e+07;0;0;0;0;0;0;305854640;305878287;395161
750;1.13648e-14;-30;1681;24608;19398;1;688;-2.14748e+09;-4.32458e+07;0;0;0;0;0;0;307774146;307798553;406670
750;1.14646e-14;-28;1638;24247;19511;1;621;-2.14748e+09;-4.32458e+07;0;0;0;0;0;0;307774146;307798553;406670
751;1.13648e-14;-30;1681;24608;19398;1;688;-2.14748e+09;-4.28479e+07;-1;0;0;0;-1;0;309686695;309711881;418414
751;1.14646e-14;-28;1638;24247;19511;1;621;-2.14748e+09;-4.28479e+07;-1;0;0;0;-1;0;309686695;309711881;418414
752;1.13648e-14;-30;1681;24608;19398;1;688;-2.14748e+09;-4.2456e+07;-1;0;0;0;-1;0;311592283;311618267;430393
752;1.14646e-14;-29;1638;24247;19511;1;621;-2.14748e+09;-4.2456e+07;0;0;0;0;0;0;311592283;311618267;430393
753;1.13648e-14;-31;1681;24608;19398;1;688;-2.14748e+09;-4.207e+07;0;0;0;0;0;0;313490914;313517714;442612
753;1.14646e-14;-29;1638;24247;19511;1;621;-2.14748e+09;-4.207e+07;-1;0;0;0;-1;0;313490914;313517714;442612
754;1.13648e-14;-31;1681;24608;19398;1;688;-2.14748e+09;-4.16897e+07;-1;0;0;0;-1;0;315382586;315410217;455071
754;1.14646e-14;-29;1638;24247;19511;1;621;-2.14748e+09;-4.16897e+07;-1;0;0;0;-1;0;315382586;315410217;455071
755;1.13648e-14;-31;1681;24608;19398;1;688;-2.14748e+09;-4.13153e+07;-1;0;0;0;-1;0;317267302;317295789;467773
755;1.14646e-14;-29;1638;24247;19511;1;621;-2.14748e+09;-4.13153e+07;-1;0;0;0;-1;0;317267302;317295789;467773
756;1.13648e-14;-32;1681;24608;19398;1;688;-2.14748e+09;-4.09462e+07;0;0;0;0;0;0;319145063;319174428;480720
756;1.14646e-14;-29;1638;24247;19511;1;621;-2.14748e+09;-4.09462e+07;-1;0;0;0;-1;0;319145063;319174428;480720
757;1.13648e-14;-33;1681;24608;19398;1;688;-2.14748e+09;-4.05827e+07;0;0;0;0;0;0;321015878;321046139;493915
757;1.14646e-14;-30;1638;24247;19511;1;621;-2.14748e+09;-4.05827e+07;0;0;0;0;0;0;321015878;321046139;493915
758;1.13648e-14;-33;1681;24608;19398;1;688;-2.14748e+09;-4.02244e+07;-1;0;0;0;-1;0;322879747;322910924;507359
758;1.14646e-14;-31;1638;24247;19511;1;621;-2.14748e+09;-4.02244e+07;0;0;0;0;0;0;322879747;322910924;507359
759;1.13648e-14;-33;1681;24608;19398;1;688;-2.14748e+09;-3.98714e+07;-1;0;0;0;-1;0;324736679;324768794;521055
759;1.14646e-14;-32;1638;24247;19511;1;621;-2.14748e+09;-3.98714e+07;0;0;0;0;0;0;324736679;324768794;521055
760;1.13648e-14;-33;1681;24608;19398;1;688;-2.14748e+09;-3.95235e+07;-1;0;0;0;-1;0;326586680;326619755;535005
760;1.14646e-14;-32;1638;24247;19511;1;621;-2.14748e+09;-3.95235e+07;-1;0;0;0;-1;0;326586680;326619755;535005
761;1.13648e-14;-34;1681;24608;19398;1;688;-2.14748e+09;-3.91807e+07;0;0;0;0;0;0;328429759;328463815;549210
761;1.14646e-14;-33;1638;24247;19511;1;621;-2.14748e+09;-3.91807e+07;0;0;0;0;0;0;328429759;328463815;549210
762;1.13648e-14;-34;1681;24608;19398;1;688;-2.14748e+09;-3.88428e+07;-1;0;0;0;-1;0;330265925;330300982;563674
762;1.14646e-14;-33;1638;24247;19511;1;621;-2.14748e+09;-3.88428e+07;-1;0;0;0;-1;0;330265925;330300982;563674
763;1.13648e-14;-34;1681;24608;19398;1;688;-2.14748e+09;-3.85097e+07;-1;0;0;0;-1;0;332095186;332131266;578397
763;1.14646e-14;-33;1638;24247;19511;1;621;-2.14748e+09;-3.85097e+07;-1;0;0;0;-1;0;332095186;332131266;578397
764;1.13648e-14;-34;1681;24608;19398;1;688;-2.14748e+09;-3.81813e+07;-1;0;0;0;-1;0;333917553;333954678;593382
764;1.14646e-14;-33;1638;24247;19511;1;621;-2.14748e+09;-3.81813e+07;-1;0;0;0;-1;0;333917553;333954678;593382
765;1.13648e-14;-34;1681;24608;19398;1;688;-2.14748e+09;-3.78576e+07;-1;0;0;0;-1;0;335733037;335771229;608631
765;1.14646e-14;-33;1638;24247;19511;1;621;-2.14748e+09;-3.78576e+07;-1;0;0;0;-1;0;335733037;335771229;608631
766;1.13648e-14;-35;1681;24608;19398;1;688;-2.14748e+09;-3.75384e+07;0;0;0;0;0;0;337541650;337580933;624146
766;1.14646e-14;-33;1638;24247;19511;1;621;-2.14748e+09;-3.75384e+07;-1;0;0;0;-1;0;337541650;337580933;624146
767;1.13648e-14;-35;1681;24608;19398;1;688;-2.14748e+09;-3.72237e+07;-1;0;0;0;-1;0;339343403;339383802;639929
767;1.14646e-14;-33;1638;24247;19511;1;621;-2.14748e+09;-3.72237e+07;-1;0;0;0;-1;0;339343403;339383802;639929
768;1.13648e-14;-35;1681;24608;19398;1;688;-2.14748e+09;-3.69134e+07;-1;0;0;0;-1;0;341138311;341179849;655982
768;1.14646e-14;-33;1638;24247;19511;1;621;-2.14748e+09;-3.69134e+07;-1;0;0;0;-1;0;341138311;341179849;655982
769;1.13648e-14;-35;1681;24608;19398;1;688;-2.14748e+09;-3.66073e+07;-1;0;0;0;-1;0;342926388;342969088;672306
769;1.14646e-14;-33;1638;24247;19511;1;621;-2.14748e+09;-3.66073e+07;-1;0;0;0;-1;0;342926388;342969088;672306
770;1.13648e-14;-36;1681;24608;19398;1;688;-2.14748e+09;-3.63056e+07;0;0;0;0;0;0;344707647;344751533;688904
770;1.14646e-14;-34;1638;24247;19511;1;621;-2.14748e+09;-3.63056e+07;0;0;0;0;0;0;344707647;344751533;688904
771;1.13648e-14;-37;1681;24608;19398;1;688;-2.14748e+09;-3.60078e+07;0;0;0;0;0;0;346482103;346527201;705776
771;1.14646e-14;-35;1638;24247;19511;1;621;-2.14748e+09;-3.60078e+07;0;0;0;0;0;0;346482103;346527201;705776
772;1.13648e-14;-37;1681;24608;19398;1;688;-2.14748e+09;-3.57142e+07;-1;0;0;0;-1;0;348249773;348296107;722926
772;1.14646e-14;-36;1638;24247;19511;1;621;-2.14748e+09;-3.57142e+07;0;0;0;0;0;0;348249773;348296107;722926
773;1.13648e-14;-38;1681;24608;19398;1;688;-2.14748e+09;-3.54246e+07;0;0;0;0;0;0;350010673;350058267;740355
773;1.14646e-14;-36;1638;24247;19511;1;621;-2.14748e+09;-3.54246e+07;-1;0;0;0;-1;0;350010673;350058267;740355
774;1.13648e-14;-38;1681;24608;19398;1;688;-2.14748e+09;-3.51389e+07;-1;0;0;0;-1;0;351764818;351813700;758065
774;1.14646e-14;-36;1638;24247;19511;1;621;-2.14748e+09;-3.51389e+07;-1;0;0;0;-1;0;351764818;351813700;758065
775;1.13648e-14;-39;1681;24608;19398;1;688;-2.14748e+09;-3.4857e+07;0;0;0;0;0;0;353512228;353562420;776057
775;1.14646e-14;-37;1638;24247;19511;1;621;-2.14748e+09;-3.4857e+07;0;0;0;0;0;0;353512228;353562420;776057
776;1.13648e-14;-40;1681;24608;19398;1;688;-2.14748e+09;-3.45789e+07;0;0;0;0;0;0;355252919;355304449;794333
776;1.14646e-14;-37;1638;24247;19511;1;621;-2.14748e+09;-3.45789e+07;-1;0;0;0;-1;0;355252919;355304449;794333
777;1.13648e-14;-41;1681;24608;19398;1;688;-2.14748e+09;-3.43044e+07;0;0;0;0;0;0;356986909;357039801;812894
777;1.14646e-14;-37;1638;24247;19511;1;621;-2.14748e+09;-3.43044e+07;-1;0;0;0;-1;0;356986909;357039801;812894
778;1.13648e-14;-41;1681;24608;19398;1;688;-2.14748e+09;-3.40336e+07;-1;0;0;0;-1;0;358714217;358768499;831743
778;1.14646e-14;-38;1638;24247;19511;1;621;-2.14748e+09;-3.40336e+07;0;0;0;0;0;0;358714217;358768499;831743
779;1.13648e-14;-42;1681;24608;19398;1;688;-2.14748e+09;-3.37664e+07;0;0;0;0;0;0;360434863;360490563;850881
779;1.14646e-14;-38;1638;24247;19511;1;621;-2.14748e+09;-3.37664e+07;-1;0;0;0;-1;0;360434863;360490563;850881
780;1.13648e-14;-42;1681;24608;19398;1;688;-2.14748e+09;-3.35027e+07;-1;0;0;0;-1;0;362148866;362206011;870309
780;1.14646e-14;-38;1638;24247;19511;1;621;-2.14748e+09;-3.35027e+07;-1;0;0;0;-1;0;362148866;362206011;870309
781;1.13648e-14;-43;1681;24608;19398;1;688;-2.14748e+09;-3.32423e+07;0;0;0;0;0;0;363856245;363914861;890030
781;1.14646e-14;-39;1638;24247;19511;1;621;-2.14748e+09;-3.32423e+07;0;0;0;0;0;0;363856245;363914861;890030
782;1.13648e-14;-43;1681;24608;19398;1;688;-2.14748e+09;-3.29854e+07;-1;0;0;0;-1;0;365557022;365617139;910044
782;1.14646e-14;-40;1638;24247;19511;1;621;-2.14748e+09;-3.29854e+07;0;0;0;0;0;0;365557022;365617139;910044
783;1.13648e-14;-43;1681;24608;19398;1;688;-2.14748e+09;-3.27318e+07;-1;0;0;0;-1;0;367251217;367312864;930353
783;1.14646e-14;-40;1638;24247;19511;1;621;-2.14748e+09;-3.27318e+07;-1;0;0;0;-1;0;367251217;367312864;930353
784;1.13648e-14;-44;1681;24608;19398;1;688;-2.14748e+09;-3.24814e+07;0;0;0;0;0;0;368938851;369002055;950959
784;1.14646e-14;-40;1638;24247;19511;1;621;-2.14748e+09;-3.24814e+07;-1;0;0;0;-1;0;368938851;369002055;950959
785;1.13648e-14;-45;1681;24608;19398;1;688;-2.14748e+09;-3.22342e+07;0;0;0;0;0;0;370619945;370684736;971863
785;1.14646e-14;-40;1638;24247;19511;1;621;-2.14748e+09;-3.22342e+07;-1;0;0;0;-1;0;370619945;370684736;971863
786;1.13648e-14;-46;1681;24608;19398;1;688;-2.14748e+09;-3.19903e+07;0;0;0;0;0;0;372294521;372360929;993066
786;1.14646e-14;-41;1638;24247;19511;1;621;-2.14748e+09;-3.19903e+07;0;0;0;0;0;0;372294521;372360929;993066
787;1.13648e-14;-46;1681;24608;19398;1;688;-2.14748e+09;-3.17492e+07;-1;0;0;0;-1;0;373962601;374030654;1014570
787;1.14646e-14;-41;1638;24247;19511;1;621;-2.14748e+09;-3.17492e+07;-1;0;0;0;-1;0;373962601;374030654;1014570
788;1.13648e-14;-46;1681;24608;19398;1;688;-2.14748e+09;-3.15113e+07;-1;0;0;0;-1;0;375624207;375693936;1036377
788;1.14646e-14;-42;1638;24247;19511;1;621;-2.14748e+09;-3.15113e+07;0;0;0;0;0;0;375624207;375693936;1036377
789;1.13648e-14;-46;1681;24608;19398;1;688;-2.14748e+09;-3.12765e+07;-1;0;0;0;-1;0;377279363;377350797;1058486
789;1.14646e-14;-43;1638;24247;19511;1;621;-2.14748e+09;-3.12765e+07;0;0;0;0;0;0;377279363;377350797;1058486
790;1.13648e-14;-46;1681;24608;19398;1;688;-2.14748e+09;-3.10444e+07;-1;0;0;0;-1;0;378928090;379001260;1080901
790;1.14646e-14;-43;1638;24247;19511;1;621;-2.14748e+09;-3.10444e+07;-1;0;0;0;-1;0;378928090;379001260;1080901
791;1.13648e-14;-47;1681;24608;19398;1;688;-2.14748e+09;-3.08153e+07;0;0;0;0;0;0;380570412;380645349;1103622
791;1.14646e-14;-44;1638;24247;19511;1;621;-2.14748e+09;-3.08153e+07;0;0;0;0;0;0;380570412;380645349;1103622
792;1.13648e-14;-47;1681;24608;19398;1;688;-2.14748e+09;-3.05891e+07;-1;0;0;0;-1;0;382206352;382283086;1126650
792;1.14646e-14;-44;1638;24247;19511;1;621;-2.14748e+09;-3.05891e+07;-1;0;0;0;-1;0;382206352;382283086;1126650
793;1.13648e-14;-47;1681;24608;19398;1;688;-2.14748e+09;-3.03654e+07;-1;0;0;0;-1;0;383835934;383914497;1149986
793;1.14646e-14;-44;1638;24247;19511;1;621;-2.14748e+09;-3.03654e+07;-1;0;0;0;-1;0;383835934;383914497;1149986
794;1.13648e-14;-47;1681;24608;19398;1;688;-2.14748e+09;-3.01448e+07;-1;0;0;0;-1;0;385459182;385539605;1173632
794;1.14646e-14;-44;1638;24247;19511;1;621;-2.14748e+09;-3.01448e+07;-1;0;0;0;-1;0;385459182;385539605;1173632
795;1.13648e-14;-47;1681;24608;19398;1;688;-2.14748e+09;-2.99265e+07;-1;0;0;0;-1;0;387076119;387158435;1197589
795;1.14646e-14;-45;1638;24247;19511;1;621;-2.14748e+09;-2.99265e+07;0;0;0;0;0;0;387076119;387158435;1197589
796;1.13648e-14;-48;1681;24608;19398;1;688;-2.14748e+09;-2.97112e+07;0;0;0;0;0;0;388686769;388771010;1221858
796;1.14646e-14;-46;1638;24247;19511;1;621;-2.14748e+09;-2.97112e+07;0;0;0;0;0;0;388686769;388771010;1221858
797;1.13648e-14;-48;1681;24608;19398;1;688;-2.14748e+09;-2.94982e+07;-1;0;0;0;-1;0;390291158;390377356;1246440
797;1.14646e-14;-47;1638;24247;19511;1;621;-2.14748e+09;-2.94982e+07;0;0;0;0;0;0;390291158;390377356;1246440
798;1.13648e-14;-49;1681;24608;19398;1;688;-2.14748e+09;-2.92879e+07;0;0;0;0;0;0;391889309;391977498;1271336
798;1.14646e-14;-47;1638;24247;19511;1;621;-2.14748e+09;-2.92879e+07;-1;0;0;0;-1;0;391889309;391977498;1271336
799;1.13648e-14;-50;1681;24608;19398;1;688;-2.14748e+09;-2.90801e+07;0;0;0;0;0;0;393481247;393571459;1296548
799;1.14646e-14;-47;1638;24247;19511;1;621;-2.14748e+09;-2.90801e+07;-1;0;0;0;-1;0;393481247;393571459;1296548
800;1.13648e-14;-51;1681;24608;19398;1;688;-2.14748e+09;-2.88747e+07;0;0;0;0;0;0;395066997;395159266;1322075
800;1.14646e-14;-47;1638;24247;19511;1;621;-2.14748e+09;-2.88747e+07;-1;0;0;0;-1;0;395066997;395159266;1322075
801;1.13648e-14;-52;1681;24608;19398;1;688;-2.14748e+09;-2.86718e+07;0;0;0;0;0;0;396646584;396740944;1347920
801;1.14646e-14;-47;1638;24247;19511;1;621;-2.14748e+09;-2.86718e+07;-1;0;0;0;-1;0;396646584;396740944;1347920
802;1.13648e-14;-52;1681;24608;19398;1;688;-2.14748e+09;-2.84713e+07;-1;0;0;0;-1;0;398220032;398316518;1374083
802;1.14646e-14;-47;1638;24247;19511;1;621;-2.14748e+09;-2.84713e+07;-1;0;0;0;-1;0;398220032;398316518;1374083
803;1.13648e-14;-53;1681;24608;19398;1;688;-2.14748e+09;-2.82731e+07;0;0;0;0;0;0;399787368;399886013;1400565
803;1.14646e-14;-48;1638;24247;19511;1;621;-2.14748e+09;-2.82731e+07;0;0;0;0;0;0;399787368;399886013;1400565
804;1.13648e-14;-54;1681;24608;19398;1;688;-2.14748e+09;-2.80773e+07;0;0;0;0;0;0;401348616;401449456;1427367
804;1.14646e-14;-48;1638;24247;19511;1;621;-2.14748e+09;-2.80773e+07;-1;0;0;0;-1;0;401348616;401449456;1427367
805;1.13648e-14;-54;1681;24608;19398;1;688;-2.14748e+09;-2.78837e+07;-1;0;0;0;-1;0;402903802;403006871;1454489
805;1.14646e-14;-48;1638;24247;19511;1;621;-2.14748e+09;-2.78837e+07;-1;0;0;0;-1;0;402903802;403006871;1454489
806;1.13648e-14;-54;1681;24608;19398;1;688;-2.14748e+09;-2.76924e+07;-1;0;0;0;-1;0;404452951;404558285;1481934
806;1.14646e-14;-48;1638;24247;19511;1;621;-2.14748e+09;-2.76924e+07;-1;0;0;0;-1;0;404452951;404558285;1481934
807;1.13648e-14;-54;1681;24608;19398;1;688;-2.14748e+09;-2.75033e+07;-1;0;0;0;-1;0;405996089;406103724;1509700
807;1.14646e-14;-49;1638;24247;19511;1;621;-2.14748e+09;-2.75033e+07;0;0;0;0;0;0;405996089;406103724;1509700
808;1.13648e-14;-55;1681;24608;19398;1;688;-2.14748e+09;-2.73163e+07;0;0;0;0;0;0;407533241;407643213;1537790
808;1.14646e-14;-49;1638;24247;19511;1;621;-2.14748e+09;-2.73163e+07;-1;0;0;0;-1;0;407533241;407643213;1537790
809;1.13648e-14;-55;1681;24608;19398;1;688;-2.14748e+09;-2.71313e+07;-1;0;0;0;-1;0;409064433;409176778;1566204
809;1.14646e-14;-50;1638;24247;19511;1;621;-2.14748e+09;-2.71313e+07;0;0;0;0;0;0;409064433;409176778;1566204
810;1.13648e-14;-56;1681;24608;19398;1;688;-2.14748e+09;-2.69485e+07;0;0;0;0;0;0;410589692;410704447;1594943
810;1.14646e-14;-50;1638;24247;19511;1;621;-2.14748e+09;-2.69485e+07;-1;0;0;0;-1;0;410589692;410704447;1594943
811;1.13648e-14;-57;1681;24608;19398;1;688;-2.14748e+09;-2.67678e+07;0;0;0;0;0;0;412109042;412226243;1624007
811;1.14646e-14;-50;1638;24247;19511;1;621;-2.14748e+09;-2.67678e+07;-1;0;0;0;-1;0;412109042;412226243;1624007
812;1.13648e-14;-57;1681;24608;19398;1;688;-2.14748e+09;-2.65892e+07;-1;0;0;0;-1;0;413622509;413742195;1653397
812;1.14646e-14;-51;1638;24247;19511;1;621;-2.14748e+09;-2.65892e+07;0;0;0;0;0;0;413622509;413742195;1653397
813;1.13648e-14;-57;1681;24608;19398;1;688;-2.14748e+09;-2.64125e+07;-1;0;0;0;-1;0;415130121;415252328;1683114
813;1.14646e-14;-51;1638;24247;19511;1;621;-2.14748e+09;-2.64125e+07;-1;0;0;0;-1;0;415130121;415252328;1683114
814;1.13648e-14;-57;1681;24608;19398;1;688;-2.14748e+09;-2.62378e+07;-1;0;0;0;-1;0;416631901;416756668;1713158
814;1.14646e-14;-51;1638;24247;19511;1;621;-2.14748e+09;-2.62378e+07;-1;0;0;0;-1;0;416631901;416756668;1713158
815;1.13648e-14;-57;1681;24608;19398;1;688;-2.14748e+09;-2.60651e+07;-1;0;0;0;-1;0;418127878;418255242;1743530
815;1.14646e-14;-52;1638;24247;19511;1;621;-2.14748e+09;-2.60651e+07;0;0;0;0;0;0;418127878;418255242;1743530
816;1.13648e-14;-57;1681;24608;19398;1;688;-2.14748e+09;-2.58941e+07;-1;0;0;0;-1;0;419618075;419748076;1774231
816;1.14646e-14;-52;1638;24247;19511;1;621;-2.14748e+09;-2.58941e+07;-1;0;0;0;-1;0;419618075;419748076;1774231
817;1.13648e-14;-58;1681;24608;19398;1;688;-2.14748e+09;-2.57251e+07;0;0;0;0;0;0;421102521;421235197;1805260
817;1.14646e-14;-53;1638;24247;19511;1;621;-2.14748e+09;-2.57251e+07;0;0;0;0;0;0;421102521;421235197;1805260
818;1.13648e-14;-58;1681;24608;19398;1;688;-2.14748e+09;-2.5558e+07;-1;0;0;0;-1;0;422581239;422716630;1836619
818;1.14646e-14;-54;1638;24247;19511;1;621;-2.14748e+09;-2.5558e+07;0;0;0;0;0;0;422581239;422716630;1836619
819;1.13648e-14;-58;1681;24608;19398;1;688;-2.14748e+09;-2.53927e+07;-1;0;0;0;-1;0;424054258;424192402;1868308
819;1.14646e-14;-55;1638;24247;19511;1;621;-2.14748e+09;-2.53927e+07;0;0;0;0;0;0;424054258;424192402;1868308
820;1.13648e-14;-58;1681;24608;19398;1;688;-2.14748e+09;-2.52293e+07;-1;0;0;0;-1;0;425521602;425662539;1900328
820;1.14646e-14;-56;1638;24247;19511;1;621;-2.14748e+09;-2.52293e+07;0;0;0;0;0;0;425521602;425662539;1900328
821;1.13648e-14;-59;1681;24608;19398;1;688;-2.14748e+09;-2.50674e+07;0;0;0;0;0;0;426983297;427127068;1932678
821;1.14646e-14;-57;1638;24247;19511;1;621;-2.14748e+09;-2.50674e+07;0;0;0;0;0;0;426983297;427127068;1932678
822;1.13648e-14;-59;1681;24608;19398;1;688;-2.14748e+09;-2.49075e+07;-1;0;0;0;-1;0;428439370;428586015;1965360
822;1.14646e-14;-57;1638;24247;19511;1;621;-2.14748e+09;-2.49075e+07;-1;0;0;0;-1;0;428439370;428586015;1965360
823;1.13648e-14;-59;1681;24608;19398;1;688;-2.14748e+09;-2.47491e+07;-1;0;0;0;-1;0;429889847;430039407;1998373
823;1.14646e-14;-57;1638;24247;19511;1;621;-2.14748e+09;-2.47491e+07;-1;0;0;0;-1;0;429889847;430039407;1998373
824;1.13648e-14;-59;1681;24608;19398;1;688;-2.14748e+09;-2.45925e+07;-1;0;0;0;-1;0;431334754;431487269;2031719
824;1.14646e-14;-57;1638;24247;19511;1;621;-2.14748e+09;-2.45925e+07;-1;0;0;0;-1;0;431334754;431487269;2031719
825;1.13648e-14;-60;1681;24608;19398;1;688;-2.14748e+09;-2.44375e+07;0;0;0;0;0;0;432774116;432929628;2065396
825;1.14646e-14;-58;1638;24247;19511;1;621;-2.14748e+09;-2.44375e+07;0;0;0;0;0;0;432774116;432929628;2065396
826;1.13648e-14;-61;1681;24608;19398;1;688;-2.14748e+09;-2.42841e+07;0;0;0;0;0;0;434207960;434366510;2099407
826;1.14646e-14;-58;1638;24247;19511;1;621;-2.14748e+09;-2.42841e+07;-1;0;0;0;-1;0;434207960;434366510;2099407
827;1.13648e-14;-61;1681;24608;19398;1;688;-2.14748e+09;-2.41324e+07;-1;0;0;0;-1;0;435636312;435797942;2133750
827;1.14646e-14;-58;1638;24247;19511;1;621;-2.14748e+09;-2.41324e+07;-1;0;0;0;-1;0;435636312;435797942;2133750
828;1.13648e-14;-61;1681;24608;19398;1;688;-2.14748e+09;-2.39824e+07;-1;0;0;0;-1;0;437059197;437223949;2168426
828;1.14646e-14;-59;1638;24247;19511;1;621;-2.14748e+09;-2.39824e+07;0;0;0;0;0;0;437059197;437223949;2168426
829;1.13648e-14;-62;1681;24608;19398;1;688;-2.14748e+09;-2.38337e+07;0;0;0;0;0;0;438476641;438644557;2203436
829;1.14646e-14;-59;1638;24247;19511;1;621;-2.14748e+09;-2.38337e+07;-1;0;0;0;-1;0;438476641;438644557;2203436
830;1.13648e-14;-62;1681;24608;19398;1;688;-2.14748e+09;-2.36867e+07;-1;0;0;0;-1;0;439888670;440059794;2238779
830;1.14646e-14;-59;1638;24247;19511;1;621;-2.14748e+09;-2.36867e+07;-1;0;0;0;-1;0;439888670;440059794;2238779
831;1.13648e-14;-62;1681;24608;19398;1;688;-2.14748e+09;-2.35412e+07;-1;0;0;0;-1;0;441295310;441469684;2274456
831;1.14646e-14;-59;1638;24247;19511;1;621;-2.14748e+09;-2.35412e+07;-1;0;0;0;-1;0;441295310;441469684;2274456
832;1.13648e-14;-62;1681;24608;19398;1;688;-2.14748e+09;-2.33972e+07;-1;0;0;0;-1;0;442696587;442874255;2310467
832;1.14646e-14;-59;1638;24247;19511;1;621;-2.14748e+09;-2.33972e+07;-1;0;0;0;-1;0;442696587;442874255;2310467
833;1.13648e-14;-63;1681;24608;19398;1;688;-2.14748e+09;-2.32547e+07;0;0;0;0;0;0;444092525;444273531;2346812
833;1.14646e-14;-60;1638;24247;19511;1;621;-2.14748e+09;-2.32547e+07;0;0;0;0;0;0;444092525;444273531;2346812
834;1.13648e-14;-63;1681;24608;19398;1;688;-2.14748e+09;-2.31136e+07;-1;0;0;0;-1;0;445483152;445667538;2383491
834;1.14646e-14;-61;1638;24247;19511;1;621;-2.14748e+09;-2.31136e+07;0;0;0;0;0;0;445483152;445667538;2383491
835;1.13648e-14;-63;1681;24608;19398;1;688;-2.14748e+09;-2.29739e+07;-1;0;0;0;-1;0;446868492;447056303;2420504
835;1.14646e-14;-61;1638;24247;19511;1;621;-2.14748e+09;-2.29739e+07;-1;0;0;0;-1;0;446868492;447056303;2420504
836;1.13648e-14;-64;1681;24608;19398;1;688;-2.14748e+09;-2.28357e+07;0;0;0;0;0;0;448248570;448439852;2457851
836;1.14646e-14;-61;1638;24247;19511;1;621;-2.14748e+09;-2.28357e+07;-1;0;0;0;-1;0;448248570;448439852;2457851
837;1.13648e-14;-64;1681;24608;19398;1;688;-2.14748e+09;-2.26989e+07;-1;0;0;0;-1;0;449623413;449818209;2495533
837;1.14646e-14;-61;1638;24247;19511;1;621;-2.14748e+09;-2.26989e+07;-1;0;0;0;-1;0;449623413;449818209;2495533
838;1.13648e-14;-64;1681;24608;19398;1;688;-2.14748e+09;-2.25634e+07;-1;0;0;0;-1;0;450993045;451191401;2533549
838;1.14646e-14;-62;1638;24247;19511;1;621;-2.14748e+09;-2.25634e+07;0;0;0;0;0;0;450993045;451191401;2533549
839;1.13648e-14;-65;1681;24608;19398;1;688;-2.14748e+09;-2.24293e+07;0;0;0;0;0;0;452357493;452559453;2571899
839;1.14646e-14;-62;1638;24247;19511;1;621;-2.14748e+09;-2.24293e+07;-1;0;0;0;-1;0;452357493;452559453;2571899
840;1.13648e-14;-65;1681;24608;19398;1;688;-2.14748e+09;-2.22965e+07;-1;0;0;0;-1;0;453716780;453922391;2610583
840;1.14646e-14;-62;1638;24247;19511;1;621;-2.14748e+09;-2.22965e+07;-1;0;0;0;-1;0;453716780;453922391;2610583
841;1.13648e-14;-66;1681;24608;19398;1;688;-2.14748e+09;-2.21651e+07;0;0;0;0;0;0;455070933;455280240;2649602
841;1.14646e-14;-63;1638;24247;19511;1;621;-2.14748e+09;-2.21651e+07;0;0;0;0;0;0;455070933;455280240;2649602
842;1.13648e-14;-66;1681;24608;19398;1;688;-2.14748e+09;-2.20349e+07;-1;0;0;0;-1;0;456419975;456633025;2688954
842;1.14646e-14;-64;1638;24247;19511;1;621;-2.14748e+09;-2.20349e+07;0;0;0;0;0;0;456419975;456633025;2688954
843;1.13648e-14;-67;1681;24608;19398;1;688;-2.14748e+09;-2.1906e+07;0;0;0;0;0;0;457763934;457980772;2728641
843;1.14646e-14;-65;1638;24247;19511;1;621;-2.14748e+09;-2.1906e+07;0;0;0;0;0;0;457763934;457980772;2728641
844;1.13648e-14;-67;1681;24608;19398;1;688;-2.14748e+09;-2.17784e+07;-1;0;0;0;-1;0;459102832;459323506;2768661
844;1.14646e-14;-65;1638;24247;19511;1;621;-2.14748e+09;-2.17784e+07;-1;0;0;0;-1;0;459102832;459323506;2768661
845;1.13648e-14;-68;1681;24608;19398;1;688;-2.14748e+09;-2.16521e+07;0;0;0;0;0;0;460436695;460661252;2809015
845;1.14646e-14;-66;1638;24247;19511;1;621;-2.14748e+09;-2.16521e+07;0;0;0;0;0;0;460436695;460661252;2809015
846;1.13648e-14;-69;1681;24608;19398;1;688;-2.14748e+09;-2.15269e+07;0;0;0;0;0;0;461765548;461994034;2849703
846;1.14646e-14;-66;1638;24247;19511;1;621;-2.14748e+09;-2.15269e+07;-1;0;0;0;-1;0;461765548;461994034;2849703
847;1.13648e-14;-70;1681;24608;19398;1;688;-2.14748e+09;-2.14031e+07;0;0;0;0;0;0;463089415;463321879;2890723
847;1.14646e-14;-66;1638;24247;19511;1;621;-2.14748e+09;-2.1403e+07;-1;0;0;0;-1;0;463089415;463321879;2890723
848;1.13648e-14;-70;1681;24608;19398;1;688;-2.14748e+09;-2.12802e+07;-1;0;0;0;-1;0;464408321;464644810;2932077
848;1.14646e-14;-67;1638;24247;19511;1;621;-2.14748e+09;-2.12802e+07;0;0;0;0;0;0;464408321;464644810;2932077
849;1.13648e-14;-71;1681;24608;19398;1;688;-2.14748e+09;-2.11587e+07;0;0;0;0;0;0;465722291;465962853;2973764
849;1.14646e-14;-67;1638;24247;19511;1;621;-2.14748e+09;-2.11587e+07;-1;0;0;0;-1;0;465722291;465962853;2973764
850;1.13648e-14;-71;1681;24608;19398;1;688;-2.14748e+09;-2.10384e+07;-1;0;0;0;-1;0;467031348;467276032;3015783
850;1.14646e-14;-68;1638;24247;19511;1;621;-2.14748e+09;-2.10384e+07;0;0;0;0;0;0;467031348;467276032;3015783
851;1.13648e-14;-72;1681;24608;19398;1;688;-2.14748e+09;-2.0919e+07;0;0;0;0;0;0;468335518;468584372;3058135
851;1.14646e-14;-68;1638;24247;19511;1;621;-2.14748e+09;-2.0919e+07;-1;0;0;0;-1;0;468335518;468584372;3058135
852;1.13648e-14;-73;1681;24608;19398;1;688;-2.14748e+09;-2.08009e+07;0;0;0;0;0;0;469634823;469887897;3100818
852;1.14646e-14;-69;1638;24247;19511;1;621;-2.14748e+09;-2.08009e+07;0;0;0;0;0;0;469634823;469887897;3100818
853;1.13648e-14;-74;1681;24608;19398;1;688;-2.14748e+09;-2.06839e+07;0;0;0;0;0;0;470929289;471186631;3143833
853;1.14646e-14;-69;1638;24247;19511;1;621;-2.14748e+09;-2.06839e+07;-1;0;0;0;-1;0;470929289;471186631;3143833
854;1.13648e-14;-74;1681;24608;19398;1;688;-2.14748e+09;-2.05679e+07;-1;0;0;0;-1;0;472218940;472480599;3187180
854;1.14646e-14;-69;1638;24247;19511;1;621;-2.14748e+09;-2.05679e+07;-1;0;0;0;-1;0;472218940;472480599;3187180
855;1.13648e-14;-74;1681;24608;19398;1;688;-2.14748e+09;-2.04531e+07;-1;0;0;0;-1;0;473503799;473769825;3230858
855;1.14646e-14;-69;1638;24247;19511;1;621;-2.14748e+09;-2.04531e+07;-1;0;0;0;-1;0;473503799;473769825;3230858
856;1.13648e-14;-74;1681;24608;19398;1;688;-2.14748e+09;-2.03394e+07;-1;0;0;0;-1;0;474783890;475054334;3274866
856;1.14646e-14;-69;1638;24247;19511;1;621;-2.14748e+09;-2.03394e+07;-1;0;0;0;-1;0;474783890;475054334;3274866
857;1.13648e-14;-74;1681;24608;19398;1;688;-2.14748e+09;-2.02267e+07;-1;0;0;0;-1;0;476059236;476334148;3319204
857;1.14646e-14;-70;1638;24247;19511;1;621;-2.14748e+09;-2.02267e+07;0;0;0;0;0;0;476059236;476334148;3319204
858;1.13648e-14;-75;1681;24608;19398;1;688;-2.14748e+09;-2.0115e+07;0;0;0;0;0;0;477329862;477609292;3363873
858;1.14646e-14;-71;1638;24247;19511;1;621;-2.14748e+09;-2.0115e+07;0;0;0;0;0;0;477329862;477609292;3363873
859;1.13648e-14;-75;1681;24608;19398;1;688;-2.14748e+09;-2.00045e+07;-1;0;0;0;-1;0;478595792;478879789;3408870
859;1.14646e-14;-71;1638;24247;19511;1;621;-2.14748e+09;-2.00045e+07;-1;0;0;0;-1;0;478595792;478879789;3408870
860;1.13648e-14;-76;1681;24608;19398;1;688;-2.14748e+09;-1.98948e+07;0;0;0;0;0;0;479857047;480145664;3454197
860;1.14646e-14;-72;1638;24247;19511;1;621;-2.14748e+09;-1.98948e+07;0;0;0;0;0;0;479857047;480145664;3454197
861;1.13648e-14;-77;1681;24608;19398;1;688;-2.14748e+09;-1.97862e+07;0;0;0;0;0;0;481113652;481406940;3499852
861;1.14646e-14;-72;1638;24247;19511;1;621;-2.14748e+09;-1.97862e+07;-1;0;0;0;-1;0;481113652;481406940;3499852
862;1.13648e-14;-77;1681;24608;19398;1;688;-2.14748e+09;-1.96786e+07;-1;0;0;0;-1;0;482365630;482663640;3545835
862;1.14646e-14;-73;1638;24247;19511;1;621;-2.14748e+09;-1.96786e+07;0;0;0;0;0;0;482365630;482663640;3545835
863;1.13648e-14;-77;1681;24608;19398;1;688;-2.14748e+09;-1.95719e+07;-1;0;0;0;-1;0;483613004;483915788;3592145
863;1.14646e-14;-73;1638;24247;19511;1;621;-2.14748e+09;-1.95719e+07;-1;0;0;0;-1;0;483613004;483915788;3592145
864;1.13648e-14;-78;1681;24608;19398;1;688;-2.14748e+09;-1.94663e+07;0;0;0;0;0;0;484855796;485163407;3638783
864;1.14646e-14;-74;1638;24247;19511;1;621;-2.14748e+09;-1.94663e+07;0;0;0;0;0;0;484855796;485163407;3638783
865;1.13648e-14;-78;1681;24608;19398;1;688;-2.14748e+09;-1.93615e+07;-1;0;0;0;-1;0;486094031;486406520;3685746
865;1.14646e-14;-74;1638;24247;19511;1;621;-2.14748e+09;-1.93615e+07;-1;0;0;0;-1;0;486094031;486406520;3685746
866;1.13648e-14;-79;1681;24608;19398;1;688;-2.14748e+09;-1.92578e+07;0;0;0;0;0;0;487327730;487645149;3733036
866;1.14646e-14;-74;1638;24247;19511;1;621;-2.14748e+09;-1.92578e+07;-1;0;0;0;-1;0;487327730;487645149;3733036
867;1.13648e-14;-79;1681;24608;19398;1;688;-2.14748e+09;-1.9155e+07;-1;0;0;0;-1;0;488556917;488879319;3780651
867;1.14646e-14;-75;1638;24247;19511;1;621;-2.14748e+09;-1.9155e+07;0;0;0;0;0;0;488556917;488879319;3780651
868;1.13648e-14;-79;1681;24608;19398;1;688;-2.14748e+09;-1.90531e+07;-1;0;0;0;-1;0;489781613;490109051;3828591
868;1.14646e-14;-76;1638;24247;19511;1;621;-2.14748e+09;-1.90531e+07;0;0;0;0;0;0;489781613;490109051;3828591
869;1.13648e-14;-80;1681;24608;19398;1;688;-2.14748e+09;-1.89519e+07;0;0;0;0;0;0;491001841;491334369;3876854
869;1.14646e-14;-76;1638;24247;19511;1;621;-2.14748e+09;-1.89519e+07;-1;0;0;0;-1;0;491001841;491334369;3876854
870;1.13648e-14;-81;1681;24608;19398;1;688;-2.14748e+09;-1.88518e+07;0;0;0;0;0;0;492217624;492555295;3925441
870;1.14646e-14;-76;1638;24247;19511;1;621;-2.14748e+09;-1.88518e+07;-1;0;0;0;-1;0;492217624;492555295;3925441
871;1.13648e-14;-82;1681;24608;19398;1;688;-2.14748e+09;-1.87527e+07;0;0;0;0;0;0;493428984;493771851;3974351
871;1.14646e-14;-77;1638;24247;19511;1;621;-2.14748e+09;-1.87527e+07;0;0;0;0;0;0;493428984;493771851;3974351
872;1.13648e-14;-83;1681;24608;19398;1;688;-2.14748e+09;-1.86542e+07;0;0;0;0;0;0;494635943;494984060;4023583
872;1.14646e-14;-77;1638;24247;19511;1;621;-2.14748e+09;-1.86542e+07;-1;0;0;0;-1;0;494635943;494984060;4023583
873;1.13648e-14;-83;1681;24608;19398;1;688;-2.14748e+09;-1.85566e+07;-1;0;0;0;-1;0;495838523;496191944;4073137
873;1.14646e-14;-77;1638;24247;19511;1;621;-2.14748e+09;-1.85566e+07;-1;0;0;0;-1;0;495838523;496191944;4073137
874;1.13648e-14;-83;1681;24608;19398;1;688;-2.14748e+09;-1.846e+07;-1;0;0;0;-1;0;497036746;497395526;4123011
874;1.14646e-14;-78;1638;24247;19511;1;621;-2.14748e+09;-1.846e+07;0;0;0;0;0;0;497036746;497395526;4123011
875;1.13648e-14;-84;1681;24608;19398;1;688;-2.14748e+09;-1.83641e+07;0;0;0;0;0;0;498230633;498594826;4173206
875;1.14646e-14;-78;1638;24247;19511;1;621;-2.14748e+09;-1.83641e+07;-1;0;0;0;-1;0;498230633;498594826;4173206
876;1.13648e-14;-85;1681;24608;19398;1;688;-2.14748e+09;-1.82691e+07;0;0;0;0;0;0;499420207;499789868;4223720
876;1.14646e-14;-78;1638;24247;19511;1;621;-2.14748e+09;-1.82691e+07;-1;0;0;0;-1;0;499420207;499789868;4223720
877;1.13648e-14;-85;1681;24608;19398;1;688;-2.14748e+09;-1.81751e+07;-1;0;0;0;-1;0;500605489;500980672;4274552
877;1.14646e-14;-79;1638;24247;19511;1;621;-2.14748e+09;-1.81751e+07;0;0;0;0;0;0;500605489;500980672;4274552
878;1.13648e-14;-86;1681;24608;19398;1;688;-2.14748e+09;-1.80816e+07;0;0;0;0;0;0;501786500;502167262;4325703
878;1.14646e-14;-80;1638;24247;19511;1;621;-2.14748e+09;-1.80816e+07;0;0;0;0;0;0;501786500;502167262;4325703
879;1.13648e-14;-86;1681;24608;19398;1;688;-2.14748e+09;-1.7989e+07;-1;0;0;0;-1;0;502963261;503349657;4377170
879;1.14646e-14;-80;1638;24247;19511;1;621;-2.14748e+09;-1.7989e+07;-1;0;0;0;-1;0;502963261;503349657;4377170
880;1.13648e-14;-86;1681;24608;19398;1;688;-2.14748e+09;-1.78972e+07;-1;0;0;0;-1;0;504135795;504527880;4428954
880;1.14646e-14;-81;1638;24247;19511;1;621;-2.14748e+09;-1.78972e+07;0;0;0;0;0;0;504135795;504527880;4428954
881;1.13648e-14;-86;1681;24608;19398;1;688;-2.14748e+09;-1.78063e+07;-1;0;0;0;-1;0;505304122;505701952;4481054
881;1.14646e-14;-81;1638;24247;19511;1;621;-2.14748e+09;-1.78063e+07;-1;0;0;0;-1;0;505304122;505701952;4481054
882;1.13648e-14;-87;1681;24608;19398;1;688;-2.14748e+09;-1.77161e+07;0;0;0;0;0;0;506468262;506871894;4533468
882;1.14646e-14;-82;1638;24247;19511;1;621;-2.14748e+09;-1.77161e+07;0;0;0;0;0;0;506468262;506871894;4533468
883;1.13648e-14;-88;1681;24608;19398;1;688;-2.14748e+09;-1.76265e+07;0;0;0;0;0;0;507628238;508037727;4586197
883;1.14646e-14;-82;1638;24247;19511;1;621;-2.14748e+09;-1.76265e+07;-1;0;0;0;-1;0;507628238;508037727;4586197
884;1.13648e-14;-88;1681;24608;19398;1;688;-2.14748e+09;-1.75378e+07;-1;0;0;0;-1;0;508784069;509199473;4639238
884;1.14646e-14;-82;1638;24247;19511;1;621;-2.14748e+09;-1.75378e+07;-1;0;0;0;-1;0;508784069;509199473;4639238
885;1.13648e-14;-88;1681;24608;19398;1;688;-2.14748e+09;-1.74498e+07;-1;0;0;0;-1;0;509935777;510357152;4692592
885;1.14646e-14;-83;1638;24247;19511;1;621;-2.14748e+09;-1.74498e+07;0;0;0;0;0;0;509935777;510357152;4692592
886;1.13648e-14;-89;1681;24608;19398;1;688;-2.14748e+09;-1.73625e+07;0;0;0;0;0;0;511083382;511510785;4746258
886;1.14646e-14;-83;1638;24247;19511;1;621;-2.14748e+09;-1.73625e+07;-1;0;0;0;-1;0;511083382;511510785;4746258
887;1.13648e-14;-90;1681;24608;19398;1;688;-2.14748e+09;-1.7276e+07;0;0;0;0;0;0;512226905;512660392;4800234
887;1.14646e-14;-83;1638;24247;19511;1;621;-2.14748e+09;-1.7276e+07;0;0;-1;0;0;-1;512226905;512660392;4800234
888;1.13648e-14;-91;1681;24608;19398;1;688;-2.14748e+09;-1.71903e+07;0;0;0;0;0;0;513366365;513805994;4854519
888;1.14646e-14;-83;1638;24247;19511;1;621;-2.14748e+09;-1.71903e+07;-1;0;0;0;-1;0;513366365;513805994;4854519
889;1.13648e-14;-91;1681;24608;19398;1;688;-2.14748e+09;-1.71051e+07;-1;0;0;0;-1;0;514501783;514947612;4909114
889;1.14646e-14;-84;1638;24247;19511;1;621;-2.14748e+09;-1.71051e+07;0;0;0;0;0;0;514501783;514947612;4909114
890;1.13648e-14;-91;1681;24608;19398;1;688;-2.14748e+09;-1.70208e+07;-1;0;0;0;-1;0;515633179;516085266;4964016
890;1.14646e-14;-85;1638;24247;19511;1;621;-2.14748e+09;-1.70208e+07;0;0;0;0;0;0;515633179;516085266;4964016
891;1.13648e-14;-92;1681;24608;19398;1;688;-2.14748e+09;-1.6937e+07;0;0;0;0;0;0;516760573;517218976;5019226
891;1.14646e-14;-85;1638;24247;19511;1;621;-2.14748e+09;-1.6937e+07;-1;0;0;0;-1;0;516760573;517218976;5019226
892;1.13648e-14;-93;1681;24608;19398;1;688;-2.14748e+09;-1.68541e+07;0;0;0;0;0;0;517883986;518348763;5074741
892;1.14646e-14;-86;1638;24247;19511;1;621;-2.14748e+09;-1.68541e+07;0;0;0;0;0;0;517883986;518348763;5074741
893;1.13648e-14;-94;1681;24608;19398;1;688;-2.14748e+09;-1.67716e+07;0;0;0;0;0;0;519003436;519474645;5130562
893;1.14646e-14;-87;1638;24247;19511;1;621;-2.14748e+09;-1.67716e+07;0;0;0;0;0;0;519003436;519474645;5130562
894;1.13648e-14;-95;1681;24608;19398;1;688;-2.14748e+09;-1.66899e+07;0;0;0;0;0;0;520118944;520596644;5186687
894;1.14646e-14;-87;1638;24247;19511;1;621;-2.14748e+09;-1.66899e+07;-1;0;0;0;-1;0;520118944;520596644;5186687
895;1.13648e-14;-96;1681;24608;19398;1;688;-2.14748e+09;-1.66089e+07;0;0;0;0;0;0;521230528;521714778;5243115
895;1.14646e-14;-87;1638;24247;19511;1;621;-2.14748e+09;-1.66089e+07;-1;0;0;0;-1;0;521230528;521714778;5243115
896;1.13648e-14;-97;1681;24608;19398;1;688;-2.14748e+09;-1.65285e+07;0;0;0;0;0;0;522338210;522829068;5299846
896;1.14646e-14;-87;1638;24247;19511;1;621;-2.14748e+09;-1.65285e+07;-1;0;0;0;-1;0;522338210;522829068;5299846
897;1.13648e-14;-97;1681;24608;19398;1;688;-2.14748e+09;-1.64488e+07;-1;0;0;0;-1;0;523442007;523939532;5356878
897;1.14646e-14;-87;1638;24247;19511;1;621;-2.14748e+09;-1.64488e+07;-1;0;0;0;-1;0;523442007;523939532;5356878
898;1.13648e-14;-98;1681;24608;19398;1;688;-2.14748e+09;-1.63697e+07;0;0;0;0;0;0;524541939;525046191;5414210
898;1.14646e-14;-88;1638;24247;19511;1;621;-2.14748e+09;-1.63697e+07;0;0;0;0;0;0;524541939;525046191;5414210
899;1.13648e-14;-99;1681;24608;19398;1;688;-2.14748e+09;-1.62914e+07;0;0;0;0;0;0;525638025;526149064;5471842
899;1.14646e-14;-88;1638;24247;19511;1;621;-2.14748e+09;-1.62914e+07;-1;0;0;0;-1;0;525638025;526149064;5471842
900;1.13648e-14;-99;1681;24608;19398;1;688;-2.14748e+09;-1.62134e+07;-1;0;0;0;-1;0;526730284;527248169;5529772
900;1.14646e-14;-88;1638;24247;19511;1;621;-2.14748e+09;-1.62134e+07;-1;0;0;0;-1;0;526730284;527248169;5529772
901;1.13648e-14;-100;1681;24608;19398;1;688;-2.14748e+09;-1.61362e+07;0;0;0;0;0;0;527818736;528343527;5587999
901;1.14646e-14;-89;1638;24247;19511;1;621;-2.14748e+09;-1.61362e+07;0;0;0;0;0;0;527818736;528343527;5587999
902;1.13648e-14;-100;1681;24608;19398;1;688;-2.14748e+09;-1.60597e+07;-1;0;0;0;-1;0;528903399;529435155;5646523
902;1.14646e-14;-90;1638;24247;19511;1;621;-2.14748e+09;-1.60597e+07;0;0;0;0;0;0;528903399;529435155;5646523
903;1.13648e-14;-101;1681;24608;19398;1;688;-2.14748e+09;-1.59836e+07;0;0;0;0;0;0;529984291;530523073;5705342
903;1.14646e-14;-90;1638;24247;19511;1;621;-2.14748e+09;-1.59836e+07;-1;0;0;0;-1;0;529984291;530523073;5705342
904;1.13648e-14;-101;1681;24608;19398;1;688;-2.14748e+09;-1.59082e+07;-1;0;0;0;-1;0;531061431;531607300;5764455
904;1.14646e-14;-90;1638;24247;19511;1;621;-2.14748e+09;-1.59082e+07;-1;0;0;0;-1;0;531061431;531607300;5764455
905;1.13648e-14;-101;1681;24608;19398;1;688;-2.14748e+09;-1.58334e+07;-1;0;0;0;-1;0;532134838;532687854;5823861
905;1.14646e-14;-90;1638;24247;19511;1;621;-2.14748e+09;-1.58334e+07;-1;0;0;0;-1;0;532134838;532687854;5823861
906;1.13648e-14;-101;1681;24608;19398;1;688;-2.14748e+09;-1.57592e+07;-1;0;0;0;-1;0;533204529;533764753;5883559
906;1.14646e-14;-91;1638;24247;19511;1;621;-2.14748e+09;-1.57592e+07;0;0;0;0;0;0;533204529;533764753;5883559
907;1.13648e-14;-102;1681;24608;19398;1;688;-2.14748e+09;-1.56855e+07;0;0;0;0;0;0;534270524;534838017;5943548
907;1.14646e-14;-91;1638;24247;19511;1;621;-2.14748e+09;-1.56855e+07;-1;0;0;0;-1;0;534270524;534838017;5943548
908;1.13648e-14;-103;1681;24608;19398;1;688;-2.14748e+09;-1.56124e+07;0;0;0;0;0;0;535332841;535907663;6003828
908;1.14646e-14;-92;1638;24247;19511;1;621;-2.14748e+09;-1.56124e+07;0;0;0;0;0;0;535332841;535907663;6003828
909;1.13648e-14;-103;1681;24608;19398;1;688;-2.14748e+09;-1.55399e+07;-1;0;0;0;-1;0;536391497;536973710;6064396
909;1.14646e-14;-92;1638;24247;19511;1;621;-2.14748e+09;-1.55399e+07;-1;0;0;0;-1;0;536391497;536973710;6064396
910;1.13648e-14;-104;1681;24608;19398;1;688;-2.14748e+09;-1.54679e+07;0;0;0;0;0;0;537446510;538036176;6125252
910;1.14646e-14;-93;1638;24247;19511;1;621;-2.14748e+09;-1.54679e+07;0;0;0;0;0;0;537446510;538036176;6125252
911;1.13648e-14;-105;1681;24608;19398;1;688;-2.14748e+09;-1.53965e+07;0;0;0;0;0;0;538497899;539095078;6186394
911;1.14646e-14;-93;1638;24247;19511;1;621;-2.14748e+09;-1.53965e+07;-1;0;0;0;-1;0;538497899;539095078;6186394
912;1.13648e-14;-106;1681;24608;19398;1;688;-2.14748e+09;-1.53256e+07;0;0;0;0;0;0;539545680;540150435;6247822
912;1.14646e-14;-94;1638;24247;19511;1;621;-2.14748e+09;-1.53256e+07;0;0;0;0;0;0;539545680;540150435;6247822
913;1.13648e-14;-107;1681;24608;19398;1;688;-2.14748e+09;-1.52553e+07;0;0;0;0;0;0;540589872;541202265;6309535
913;1.14646e-14;-94;1638;24247;19511;1;621;-2.14748e+09;-1.52553e+07;-1;0;0;0;-1;0;540589872;541202265;6309535
914;1.13648e-14;-108;1681;24608;19398;1;688;-2.14748e+09;-1.51855e+07;0;0;0;0;0;0;541630493;542250584;6371531
914;1.14646e-14;-95;1638;24247;19511;1;621;-2.14748e+09;-1.51855e+07;0;0;0;0;0;0;541630493;542250584;6371531
915;1.13648e-14;-109;1681;24608;19398;1;688;-2.14748e+09;-1.51162e+07;0;0;0;0;0;0;542667558;543295411;6433809
915;1.14646e-14;-95;1638;24247;19511;1;621;-2.14748e+09;-1.51162e+07;-1;0;0;0;-1;0;542667558;543295411;6433809
916;1.13648e-14;-109;1681;24608;19398;1;688;-2.14748e+09;-1.50475e+07;-1;0;0;0;-1;0;543701087;544336764;6496368
916;1.14646e-14;-95;1638;24247;19511;1;621;-2.14748e+09;-1.50475e+07;-1;0;0;0;-1;0;543701087;544336764;6496368
917;1.13648e-14;-109;1681;24608;19398;1;688;-2.14748e+09;-1.49792e+07;-1;0;0;0;-1;0;544731095;545374658;6559206
917;1.14646e-14;-96;1638;24247;19511;1;621;-2.14748e+09;-1.49792e+07;0;0;0;0;0;0;544731095;545374658;6559206
918;1.13648e-14;-109;1681;24608;19398;1;688;-2.14748e+09;-1.49115e+07;-1;0;0;0;-1;0;545757601;546409113;6622324
918;1.14646e-14;-96;1638;24247;19511;1;621;-2.14748e+09;-1.49115e+07;-1;0;0;0;-1;0;545757601;546409113;6622324
919;1.13648e-14;-109;1681;24608;19398;1;688;-2.14748e+09;-1.48444e+07;-1;0;0;0;-1;0;546780621;547440144;6685719
919;1.14646e-14;-97;1638;24247;19511;1;621;-2.14748e+09;-1.48444e+07;0;0;0;0;0;0;546780621;547440144;6685719
920;1.13648e-14;-109;1681;24608;19398;1;688;-2.14748e+09;-1.47776e+07;-1;0;0;0;-1;0;547800172;548467770;6749391
920;1.14646e-14;-98;1638;24247;19511;1;621;-2.14748e+09;-1.47776e+07;0;0;0;0;0;0;547800172;548467770;6749391
921;1.13648e-14;-110;1681;24608;19398;1;688;-2.14748e+09;-1.47114e+07;0;0;0;0;0;0;548816270;549492006;6813337
921;1.14646e-14;-98;1638;24247;19511;1;621;-2.14748e+09;-1.47114e+07;-1;0;0;0;-1;0;548816270;549492006;6813337
922;1.13648e-14;-111;1681;24608;19398;1;688;-2.14748e+09;-1.46456e+07;0;0;0;0;0;0;549828934;550512870;6877558
922;1.14646e-14;-99;1638;24247;19511;1;621;-2.14748e+09;-1.46456e+07;0;0;0;0;0;0;549828934;550512870;6877558
923;1.13648e-14;-111;1681;24608;19398;1;688;-2.14748e+09;-1.45803e+07;-1;0;0;0;-1;0;550838178;551530379;6942052
923;1.14646e-14;-100;1638;24247;19511;1;621;-2.14748e+09;-1.45803e+07;0;0;0;0;0;0;550838178;551530379;6942052
924;1.13648e-14;-111;1681;24608;19398;1;688;-2.14748e+09;-1.45157e+07;-1;0;0;0;-1;0;551844020;552544548;7006817
924;1.14646e-14;-100;1638;24247;19511;1;621;-2.14748e+09;-1.45157e+07;-1;0;0;0;-1;0;551844020;552544548;7006817
925;1.13648e-14;-111;1681;24608;19398;1;688;-2.14748e+09;-1.44513e+07;-1;0;0;0;-1;0;552846477;553555395;7071853
925;1.14646e-14;-101;1638;24247;19511;1;621;-2.14748e+09;-1.44513e+07;0;0;0;0;0;0;552846477;553555395;7071853
926;1.13648e-14;-112;1681;24608;19398;1;688;-2.14748e+09;-1.43875e+07;0;0;0;0;0;0;553845563;554562937;7137158
926;1.14646e-14;-102;1638;24247;19511;1;621;-2.14748e+09;-1.43875e+07;0;0;0;0;0;0;553845563;554562937;7137158
927;1.13648e-14;-113;1681;24608;19398;1;688;-2.14748e+09;-1.43241e+07;0;0;0;0;0;0;554841296;555567188;7202731
927;1.14646e-14;-103;1638;24247;19511;1;621;-2.14748e+09;-1.43241e+07;0;0;0;0;0;0;554841296;555567188;7202731
928;1.13648e-14;-113;1681;24608;19398;1;688;-2.14748e+09;-1.42612e+07;-1;0;0;0;-1;0;555833692;556568167;7268571
928;1.14646e-14;-104;1638;24247;19511;1;621;-2.14748e+09;-1.42612e+07;0;0;0;0;0;0;555833692;556568167;7268571
929;1.13648e-14;-113;1681;24608;19398;1;688;-2.14748e+09;-1.41987e+07;0;0;-1;0;0;-1;556822767;557565888;7334676
929;1.14646e-14;-105;1638;24247;19511;1;621;-2.14748e+09;-1.41987e+07;0;0;0;0;0;0;556822767;557565888;7334676
930;1.13648e-14;-114;1681;24608;19398;1;688;-2.14748e+09;-1.41367e+07;0;0;0;0;0;0;557808536;558560368;7401046
930;1.14646e-14;-105;1638;24247;19511;1;621;-2.14748e+09;-1.41367e+07;-1;0;0;0;-1;0;557808536;558560368;7401046
931;1.13648e-14;-115;1681;24608;19398;1;688;-2.14748e+09;-1.40752e+07;0;0;0;0;0;0;558791016;559551622;7467679
931;1.14646e-14;-106;1638;24247;19511;1;621;-2.14748e+09;-1.40752e+07;0;0;0;0;0;0;558791016;559551622;7467679
932;1.13648e-14;-116;1681;24608;19398;1;688;-2.14748e+09;-1.40141e+07;0;0;0;0;0;0;559770222;560539668;7534574
932;1.14646e-14;-106;1638;24247;19511;1;621;-2.14748e+09;-1.40141e+07;-1;0;0;0;-1;0;559770222;560539668;7534574
933;1.13648e-14;-116;1681;24608;19398;1;688;-2.14748e+09;-1.39534e+07;-1;0;0;0;-1;0;560746169;561524519;7601730
933;1.14646e-14;-106;1638;24247;19511;1;621;-2.14748e+09;-1.39534e+07;-1;0;0;0;-1;0;560746169;561524519;7601730
934;1.13648e-14;-116;1681;24608;19398;1;688;-2.14748e+09;-1.38931e+07;-1;0;0;0;-1;0;561718874;562506193;7669145
934;1.14646e-14;-106;1638;24247;19511;1;621;-2.14748e+09;-1.38931e+07;-1;0;0;0;-1;0;561718874;562506193;7669145
935;1.13648e-14;-117;1681;24608;19398;1;688;-2.14748e+09;-1.38333e+07;0;0;0;0;0;0;562688352;563484704;7736819
935;1.14646e-14;-106;1638;24247;19511;1;621;-2.14748e+09;-1.38333e+07;-1;0;0;0;-1;0;562688352;563484704;7736819
936;1.13648e-14;-118;1681;24608;19398;1;688;-2.14748e+09;-1.37739e+07;0;0;0;0;0;0;563654618;564460069;7804749
936;1.14646e-14;-107;1638;24247;19511;1;621;-2.14748e+09;-1.37739e+07;0;0;0;0;0;0;563654618;564460069;7804749
937;1.13648e-14;-119;1681;24608;19398;1;688;-2.14748e+09;-1.3715e+07;0;0;0;0;0;0;564617688;565432301;7872935
937;1.14646e-14;-108;1638;24247;19511;1;621;-2.14748e+09;-1.3715e+07;0;0;0;0;0;0;564617688;565432301;7872935
938;1.13648e-14;-119;1681;24608;19398;1;688;-2.14748e+09;-1.36565e+07;-1;0;0;0;-1;0;565577576;566401418;7941376
938;1.14646e-14;-109;1638;24247;19511;1;621;-2.14748e+09;-1.36565e+07;0;0;0;0;0;0;565577576;566401418;7941376
939;1.13648e-14;-120;1681;24608;19398;1;688;-2.14748e+09;-1.35983e+07;0;0;0;0;0;0;566534297;567367433;8010070
939;1.14646e-14;-109;1638;24247;19511;1;621;-2.14748e+09;-1.35983e+07;-1;0;0;0;-1;0;566534297;567367433;8010070
940;1.13648e-14;-120;1681;24608;19398;1;688;-2.14748e+09;-1.35406e+07;-1;0;0;0;-1;0;567487868;568330362;8079015
940;1.14646e-14;-109;1638;24247;19511;1;621;-2.14748e+09;-1.35405e+07;-1;0;0;0;-1;0;567487868;568330362;8079015
941;1.13648e-14;-120;1681;24608;19398;1;688;-2.14748e+09;-1.34831e+07;-1;0;0;0;-1;0;568438301;569290220;8148212
941;1.14646e-14;-110;1638;24247;19511;1;621;-2.14748e+09;-1.34831e+07;0;0;0;0;0;0;568438301;569290220;8148212
942;1.13648e-14;-121;1681;24608;19398;1;688;-2.14748e+09;-1.34262e+07;0;0;0;0;0;0;569385614;570247022;8217657
942;1.14646e-14;-111;1638;24247;19511;1;621;-2.14748e+09;-1.34262e+07;0;0;0;0;0;0;569385614;570247022;8217657
943;1.13648e-14;-122;1681;24608;19398;1;688;-2.14748e+09;-1.33696e+07;0;0;0;0;0;0;570329819;571200782;8287351
943;1.14646e-14;-112;1638;24247;19511;1;621;-2.14748e+09;-1.33696e+07;0;0;0;0;0;0;570329819;571200782;8287351
944;1.13648e-14;-123;1681;24608;19398;1;688;-2.14748e+09;-1.33134e+07;0;0;0;0;0;0;571270932;572151516;8357292
944;1.14646e-14;-112;1638;24247;19511;1;621;-2.14748e+09;-1.33134e+07;-1;0;0;0;-1;0;571270932;572151516;8357292
945;1.13648e-14;-123;1681;24608;19398;1;688;-2.14748e+09;-1.32577e+07;-1;0;0;0;-1;0;572208966;573099238;8427478
945;1.14646e-14;-113;1638;24247;19511;1;621;-2.14748e+09;-1.32577e+07;0;0;0;0;0;0;572208966;573099238;8427478
946;1.13648e-14;-124;1681;24608;19398;1;688;-2.14748e+09;-1.32023e+07;0;0;0;0;0;0;573143938;574043962;8497909
946;1.14646e-14;-113;1638;24247;19511;1;621;-2.14748e+09;-1.32023e+07;-1;0;0;0;-1;0;573143938;574043962;8497909
947;1.13648e-14;-125;1681;24608;19398;1;688;-2.14748e+09;-1.31474e+07;0;0;0;0;0;0;574075861;574985703;8568583
947;1.14646e-14;-114;1638;24247;19511;1;621;-2.14748e+09;-1.31474e+07;0;0;0;0;0;0;574075861;574985703;8568583
948;1.13648e-14;-126;1681;24608;19398;1;688;-2.14748e+09;-1.30926e+07;0;0;0;0;0;0;575004748;575924476;8639498
948;1.14646e-14;-114;1638;24247;19511;1;621;-2.14748e+09;-1.30926e+07;-1;0;0;0;-1;0;575004748;575924476;8639498
949;1.13648e-14;-127;1681;24608;19398;1;688;-2.14748e+09;-1.30384e+07;0;0;0;0;0;0;575930616;576860294;8710654
949;1.14646e-14;-114;1638;24247;19511;1;621;-2.14748e+09;-1.30384e+07;-1;0;0;0;-1;0;575930616;576860294;8710654
950;1.13648e-14;-128;1681;24608;19398;1;688;-2.14748e+09;-1.29845e+07;0;0;0;0;0;0;576853477;577793172;8782049
950;1.14646e-14;-114;1638;24247;19511;1;621;-2.14748e+09;-1.29845e+07;-1;0;0;0;-1;0;576853477;577793172;8782049
951;1.13648e-14;-129;1681;24608;19398;1;688;-2.14748e+09;-1.29309e+07;0;0;0;0;0;0;577773345;578723123;8853681
951;1.14646e-14;-115;1638;24247;19511;1;621;-2.14748e+09;-1.29309e+07;0;0;0;0;0;0;577773345;578723123;8853681
952;1.13648e-14;-130;1681;24608;19398;1;688;-2.14748e+09;-1.28777e+07;0;0;0;0;0;0;578690235;579650163;8925551
952;1.14646e-14;-115;1638;24247;19511;1;621;-2.14748e+09;-1.28777e+07;-1;0;0;0;-1;0;578690235;579650163;8925551
953;1.13648e-14;-131;1681;24608;19398;1;688;-2.14748e+09;-1.28249e+07;0;0;0;0;0;0;579604160;580574304;8997655
953;1.14646e-14;-116;1638;24247;19511;1;621;-2.14748e+09;-1.28249e+07;0;0;0;0;0;0;579604160;580574304;8997655
954;1.13648e-14;-132;1681;24608;19398;1;688;-2.14748e+09;-1.27725e+07;0;0;0;0;0;0;580515134;581495561;9069994
954;1.14646e-14;-116;1638;24247;19511;1;621;-2.14748e+09;-1.27725e+07;-1;0;0;0;-1;0;580515134;581495561;9069994
955;1.13648e-14;-132;1681;24608;19398;1;688;-2.14748e+09;-1.27204e+07;-1;0;0;0;-1;0;581423171;582413947;9142565
955;1.14646e-14;-117;1638;24247;19511;1;621;-2.14748e+09;-1.27204e+07;0;0;0;0;0;0;581423171;582413947;9142565
956;1.13648e-14;-132;1681;24608;19398;1;688;-2.14748e+09;-1.26686e+07;-1;0;0;0;-1;0;582328285;583329476;9215367
956;1.14646e-14;-118;1638;24247;19511;1;621;-2.14748e+09;-1.26686e+07;0;0;0;0;0;0;582328285;583329476;9215367
957;1.13648e-14;-132;1681;24608;19398;1;688;-2.14748e+09;-1.26172e+07;-1;0;0;0;-1;0;583230488;584242162;9288400
957;1.14646e-14;-119;1638;24247;19511;1;621;-2.14748e+09;-1.26172e+07;0;0;0;0;0;0;583230488;584242162;9288400
958;1.13648e-14;-132;1681;24608;19398;1;688;-2.14748e+09;-1.25661e+07;-1;0;0;0;-1;0;584129794;585152017;9361661
958;1.14646e-14;-119;1638;24247;19511;1;621;-2.14748e+09;-1.25661e+07;-1;0;0;0;-1;0;584129794;585152017;9361661
959;1.13648e-14;-133;1681;24608;19398;1;688;-2.14748e+09;-1.25153e+07;0;0;0;0;0;0;585026217;586059057;9435149
959;1.14646e-14;-119;1638;24247;19511;1;621;-2.14748e+09;-1.25153e+07;-1;0;0;0;-1;0;585026217;586059057;9435149
960;1.13648e-14;-133;1681;24608;19398;1;688;-2.14748e+09;-1.24649e+07;-1;0;0;0;-1;0;585919770;586963293;9508864
960;1.14646e-14;-119;1638;24247;19511;1;621;-2.14748e+09;-1.24649e+07;-1;0;0;0;-1;0;585919770;586963293;9508864
961;1.13648e-14;-133;1681;24608;19398;1;688;-2.14748e+09;-1.24148e+07;-1;0;0;0;-1;0;586810467;587864739;9582804
961;1.14646e-14;-120;1638;24247;19511;1;621;-2.14748e+09;-1.24148e+07;0;0;0;0;0;0;586810467;587864739;9582804
962;1.13648e-14;-133;1681;24608;19398;1;688;-2.14748e+09;-1.23652e+07;-1;0;0;0;-1;0;587698319;588763408;9656967
962;1.14646e-14;-120;1638;24247;19511;1;621;-2.14748e+09;-1.23652e+07;-1;0;0;0;-1;0;587698319;588763408;9656967
963;1.13648e-14;-133;1681;24608;19398;1;688;-2.14748e+09;-1.23157e+07;-1;0;0;0;-1;0;588583340;589659314;9731352
963;1.14646e-14;-120;1638;24247;19511;1;621;-2.14748e+09;-1.23157e+07;-1;0;0;0;-1;0;588583340;589659314;9731352
964;1.13648e-14;-133;1681;24608;19398;1;688;-2.14748e+09;-1.22665e+07;-1;0;0;0;-1;0;589465544;590552469;9805958
964;1.14646e-14;-121;1638;24247;19511;1;621;-2.14748e+09;-1.22665e+07;0;0;0;0;0;0;589465544;590552469;9805958
965;1.13648e-14;-134;1681;24608;19398;1;688;-2.14748e+09;-1.22179e+07;0;0;0;0;0;0;590344943;591442886;9880784
965;1.14646e-14;-121;1638;24247;19511;1;621;-2.14748e+09;-1.22179e+07;-1;0;0;0;-1;0;590344943;591442886;9880784
966;1.13648e-14;-135;1681;24608;19398;1;688;-2.14748e+09;-1.21693e+07;0;0;0;0;0;0;591221549;592330578;9955828
966;1.14646e-14;-122;1638;24247;19511;1;621;-2.14748e+09;-1.21693e+07;0;0;0;0;0;0;591221549;592330578;9955828
967;1.13648e-14;-136;1681;24608;19398;1;688;-2.14748e+09;-1.21212e+07;0;0;0;0;0;0;592095376;593215558;10031088
967;1.14646e-14;-122;1638;24247;19511;1;621;-2.14748e+09;-1.21212e+07;-1;0;0;0;-1;0;592095376;593215558;10031088
968;1.13648e-14;-136;1681;24608;19398;1;688;-2.14748e+09;-1.20733e+07;-1;0;0;0;-1;0;592966436;594097838;10106565
968;1.14646e-14;-123;1638;24247;19511;1;621;-2.14748e+09;-1.20733e+07;0;0;0;0;0;0;592966436;594097838;10106565
969;1.13648e-14;-137;1681;24608;19398;1;688;-2.14748e+09;-1.20257e+07;0;0;0;0;0;0;593834742;594977432;10182256
969;1.14646e-14;-123;1638;24247;19511;1;621;-2.14748e+09;-1.20257e+07;-1;0;0;0;-1;0;593834742;594977432;10182256
970;1.13648e-14;-138;1681;24608;19398;1;688;-2.14748e+09;-1.19785e+07;0;0;0;0;0;0;594700306;595854351;10258159
970;1.14646e-14;-124;1638;24247;19511;1;621;-2.14748e+09;-1.19785e+07;0;0;0;0;0;0;594700306;595854351;10258159
971;1.13648e-14;-139;1681;24608;19398;1;688;-2.14748e+09;-1.19316e+07;0;0;0;0;0;0;595563141;596728608;10334275
971;1.14646e-14;-124;1638;24247;19511;1;621;-2.14748e+09;-1.19316e+07;-1;0;0;0;-1;0;595563141;596728608;10334275
972;1.13648e-14;-139;1681;24608;19398;1;688;-2.14748e+09;-1.18849e+07;-1;0;0;0;-1;0;596423258;597600216;10410600
972;1.14646e-14;-125;1638;24247;19511;1;621;-2.14748e+09;-1.18849e+07;0;0;0;0;0;0;596423258;597600216;10410600
973;1.13648e-14;-139;1680;24608;19398;1;688;-2.14748e+09;-1.18386e+07;0;0;0;0;0;0;597280671;598469187;10487135
973;1.14646e-14;-126;1638;24247;19511;1;621;-2.14748e+09;-1.18386e+07;0;0;0;0;0;0;597280671;598469187;10487135
974;1.13648e-14;-140;1680;24608;19398;1;688;-2.14748e+09;-1.17925e+07;0;0;0;0;0;0;598135391;599335532;10563878
974;1.14646e-14;-127;1638;24247;19511;1;621;-2.14748e+09;-1.17925e+07;0;0;0;0;0;0;598135391;599335532;10563878
975;1.13648e-14;-140;1680;24608;19398;1;688;-2.14748e+09;-1.17468e+07;-1;0;0;0;-1;0;598987431;600199265;10640827
975;1.14646e-14;-127;1638;24247;19511;1;621;-2.14748e+09;-1.17468e+07;-1;0;0;0;-1;0;598987431;600199265;10640827
976;1.13648e-14;-141;1680;24608;19398;1;688;-2.14748e+09;-1.17013e+07;0;0;0;0;0;0;599836802;601060396;10717981
976;1.14646e-14;-128;1638;24247;19511;1;621;-2.14748e+09;-1.17013e+07;0;0;0;0;0;0;599836802;601060396;10717981
977;1.13648e-14;-141;1680;24608;19398;1;688;-2.14748e+09;-1.16561e+07;-1;0;0;0;-1;0;600683517;601918939;10795338
977;1.14646e-14;-129;1638;24247;19511;1;621;-2.14748e+09;-1.16561e+07;0;0;0;0;0;0;600683517;601918939;10795338
978;1.13648e-14;-141;1680;24608;19398;1;688;-2.14748e+09;-1.16112e+07;-1;0;0;0;-1;0;601527587;602774905;10872898
978;1.14646e-14;-129;1638;24247;19511;1;621;-2.14748e+09;-1.16112e+07;-1;0;0;0;-1;0;601527587;602774905;10872898
979;1.13648e-14;-142;1680;24608;19398;1;688;-2.14748e+09;-1.15666e+07;0;0;0;0;0;0;602369025;603628306;10950660
979;1.14646e-14;-129;1638;24247;19511;1;621;-2.14748e+09;-1.15666e+07;-1;0;0;0;-1;0;602369025;603628306;10950660
980;1.13648e-14;-143;1680;24608;19398;1;688;-2.14748e+09;-1.15224e+07;0;0;0;0;0;0;603207841;604479154;11028621
980;1.14646e-14;-129;1638;24247;19511;1;621;-2.14748e+09;-1.15224e+07;-1;0;0;0;-1;0;603207841;604479154;11028621
981;1.13648e-14;-143;1680;24608;19398;1;688;-2.14748e+09;-1.14782e+07;-1;0;0;0;-1;0;604044048;605327460;11106781
981;1.14646e-14;-130;1638;24247;19511;1;621;-2.14748e+09;-1.14782e+07;0;0;0;0;0;0;604044048;605327460;11106781
982;1.13648e-14;-143;1680;24608;19398;1;688;-2.14748e+09;-1.14344e+07;-1;0;0;0;-1;0;604877658;606173237;11185138
982;1.14646e-14;-131;1638;24247;19511;1;621;-2.14748e+09;-1.14344e+07;0;0;0;0;0;0;604877658;606173237;11185138
983;1.13648e-14;-144;1680;24608;19398;1;688;-2.14748e+09;-1.13909e+07;0;0;0;0;0;0;605708681;607016495;11263690
983;1.14646e-14;-132;1638;24247;19511;1;621;-2.14748e+09;-1.13909e+07;0;0;0;0;0;0;605708681;607016495;11263690
984;1.13648e-14;-145;1680;24608;19398;1;688;-2.14748e+09;-1.13477e+07;0;0;0;0;0;0;606537130;607857246;11342438
984;1.14646e-14;-133;1638;24247;19511;1;621;-2.14748e+09;-1.13477e+07;0;0;0;0;0;0;606537130;607857246;11342438
985;1.13648e-14;-145;1680;24608;19398;1;688;-2.14748e+09;-1.13047e+07;-1;0;0;0;-1;0;607363015;608695501;11421378
985;1.14646e-14;-134;1638;24247;19511;1;621;-2.14748e+09;-1.13047e+07;0;0;0;0;0;0;607363015;608695501;11421378
986;1.13648e-14;-146;1680;24608;19398;1;688;-2.14748e+09;-1.1262e+07;0;0;0;0;0;0;608186348;609531273;11500511
986;1.14646e-14;-134;1638;24247;19511;1;621;-2.14748e+09;-1.1262e+07;-1;0;0;0;-1;0;608186348;609531273;11500511
987;1.13648e-14;-147;1680;24608;19398;1;688;-2.14748e+09;-1.12194e+07;0;0;0;0;0;0;609007140;610364571;11579834
987;1.14646e-14;-134;1638;24247;19511;1;621;-2.14748e+09;-1.12194e+07;-1;0;0;0;-1;0;609007140;610364571;11579834
988;1.13648e-14;-147;1680;24608;19398;1;688;-2.14748e+09;-1.11773e+07;-1;0;0;0;-1;0;609825403;611195408;11659347
988;1.14646e-14;-135;1638;24247;19511;1;621;-2.14748e+09;-1.11773e+07;0;0;0;0;0;0;609825403;611195408;11659347
989;1.13648e-14;-147;1680;24608;19398;1;688;-2.14748e+09;-1.11352e+07;-1;0;0;0;-1;0;610641148;612023795;11739047
989;1.14646e-14;-136;1638;24247;19511;1;621;-2.14748e+09;-1.11352e+07;0;0;0;0;0;0;610641148;612023795;11739047
990;1.13648e-14;-148;1680;24608;19398;1;688;-2.14748e+09;-1.10935e+07;0;0;0;0;0;0;611454385;612849742;11818935
990;1.14646e-14;-136;1638;24247;19511;1;621;-2.14748e+09;-1.10935e+07;-1;0;0;0;-1;0;611454385;612849742;11818935
991;1.13648e-14;-148;1680;24608;19398;1;688;-2.14748e+09;-1.10521e+07;-1;0;0;0;-1;0;612265126;613673261;11899008
991;1.14646e-14;-137;1638;24247;19511;1;621;-2.14748e+09;-1.10521e+07;0;0;0;0;0;0;612265126;613673261;11899008
992;1.13648e-14;-148;1680;24608;19398;1;688;-2.14748e+09;-1.10109e+07;-1;0;0;0;-1;0;613073382;614494362;11979265
992;1.14646e-14;-137;1638;24247;19511;1;621;-2.14748e+09;-1.10109e+07;-1;0;0;0;-1;0;613073382;614494362;11979265
993;1.13648e-14;-148;1680;24608;19398;1;688;-2.14748e+09;-1.09699e+07;-1;0;0;0;-1;0;613879163;615313057;12059704
993;1.14646e-14;-138;1638;24247;19511;1;621;-2.14748e+09;-1.09699e+07;0;0;0;0;0;0;613879163;615313057;12059704
994;1.13648e-14;-148;1680;24608;19398;1;688;-2.14748e+09;-1.09293e+07;-1;0;0;0;-1;0;614682481;616129356;12140326
994;1.14646e-14;-138;1638;24247;19511;1;621;-2.14748e+09;-1.09292e+07;-1;0;0;0;-1;0;614682481;616129356;12140326
995;1.13648e-14;-149;1680;24608;19398;1;688;-2.14748e+09;-1.08888e+07;0;0;0;0;0;0;615483345;616943270;12221127
995;1.14646e-14;-139;1638;24247;19511;1;621;-2.14748e+09;-1.08888e+07;0;0;0;0;0;0;615483345;616943270;12221127
996;1.13648e-14;-150;1680;24608;19398;1;688;-2.14748e+09;-1.08486e+07;0;0;0;0;0;0;616281768;617754809;12302108
996;1.14646e-14;-140;1638;24247;19511;1;621;-2.14748e+09;-1.08486e+07;0;0;0;0;0;0;616281768;617754809;12302108
997;1.13648e-14;-150;1680;24608;19398;1;688;-2.14748e+09;-1.08086e+07;-1;0;0;0;-1;0;617077758;618563985;12383266
997;1.14646e-14;-140;1638;24247;19511;1;621;-2.14748e+09;-1.08086e+07;-1;0;0;0;-1;0;617077758;618563985;12383266
998;1.13648e-14;-151;1680;24608;19398;1;688;-2.14748e+09;-1.07688e+07;0;0;0;0;0;0;617871328;619370807;12464600
998;1.14646e-14;-141;1638;24247;19511;1;621;-2.14748e+09;-1.07688e+07;0;0;0;0;0;0;617871328;619370807;12464600
999;1.13648e-14;-151;1680;24608;19398;1;688;-2.14748e+09;-1.07293e+07;-1;0;0;0;-1;0;618662487;620175287;12546110
999;1.14646e-14;-141;1638;24247;19511;1;621;-2.14748e+09;-1.07293e+07;-1;0;0;0;-1;0;618662487;620175287;12546110
1000;1.13648e-14;-151;1680;24608;19398;1;688;-2.14748e+09;-1.069e+07;-1;0;0;0;-1;0;619451246;620977435;12627793
1000;1.14646e-14;-142;1638;24247;19511;1;621;-2.14748e+09;-1.069e+07;0;0;0;0;0;0;619451246;620977435;12627793
1001;1.13648e-14;-151;1680;24608;19398;1;688;-2.14748e+09;-1.06511e+07;-1;0;0;0;-1;0;620237615;621777261;12709649
1001;1.14646e-14;-142;1638;24247;19511;1;621;-2.14748e+09;-1.06511e+07;-1;0;0;0;-1;0;620237615;621777261;12709649
1002;1.13648e-14;-151;1680;24608;19398;1;688;-2.14748e+09;-1.06123e+07;-1;0;0;0;-1;0;621021604;622574775;12791676
1002;1.14646e-14;-142;1638;24247;19511;1;621;-2.14748e+09;-1.06123e+07;-1;0;0;0;-1;0;621021604;622574775;12791676
1003;1.13648e-14;-152;1680;24608;19398;1;688;-2.14748e+09;-1.05736e+07;0;0;0;0;0;0;621803225;623369987;12873873
1003;1.14646e-14;-143;1638;24247;19511;1;621;-2.14748e+09;-1.05736e+07;0;0;0;0;0;0;621803225;623369987;12873873
1004;1.13648e-14;-152;1680;24608;19398;1;688;-2.14748e+09;-1.05353e+07;-1;0;0;0;-1;0;622582486;624162908;12956239
1004;1.14646e-14;-143;1638;24247;19511;1;621;-2.14748e+09;-1.05353e+07;-1;0;0;0;-1;0;622582486;624162908;12956239
1005;1.13648e-14;-152;1680;24608;19398;1;688;-2.14748e+09;-1.04971e+07;-1;0;0;0;-1;0;623359398;624953549;13038772
1005;1.14646e-14;-143;1638;24247;19511;1;621;-2.14748e+09;-1.04971e+07;-1;0;0;0;-1;0;623359398;624953549;13038772
1006;1.13648e-14;-152;1680;24608;19398;1;688;-2.14748e+09;-1.04593e+07;-1;0;0;0;-1;0;624133972;625741918;13121471
1006;1.14646e-14;-144;1638;24247;19511;1;621;-2.14748e+09;-1.04593e+07;0;0;0;0;0;0;624133972;625741918;13121471
1007;1.13648e-14;-153;1680;24608;19398;1;688;-2.14748e+09;-1.04215e+07;0;0;0;0;0;0;624906216;626528025;13204334
1007;1.14646e-14;-145;1638;24247;19511;1;621;-2.14748e+09;-1.04215e+07;0;0;0;0;0;0;624906216;626528025;13204334
1008;1.13648e-14;-153;1680;24608;19398;1;688;-2.14748e+09;-1.0384e+07;-1;0;0;0;-1;0;625676142;627311882;13287362
1008;1.14646e-14;-146;1638;24247;19511;1;621;-2.14748e+09;-1.0384e+07;0;0;0;0;0;0;625676142;627311882;13287362
1009;1.13648e-14;-154;1680;24608;19398;1;688;-2.14748e+09;-1.03467e+07;0;0;0;0;0;0;626443759;628093498;13370552
1009;1.14646e-14;-146;1638;24247;19511;1;621;-2.14748e+09;-1.03467e+07;-1;0;0;0;-1;0;626443759;628093498;13370552
1010;1.13648e-14;-154;1680;24608;19398;1;688;-2.14748e+09;-1.03097e+07;-1;0;0;0;-1;0;627209076;628872882;13453902
1010;1.14646e-14;-146;1638;24247;19511;1;621;-2.14748e+09;-1.03097e+07;-1;0;0;0;-1;0;627209076;628872882;13453902
1011;1.13648e-14;-154;1680;24608;19398;1;688;-2.14748e+09;-1.02728e+07;-1;0;0;0;-1;0;627972104;629650044;13537413
1011;1.14646e-14;-147;1638;24247;19511;1;621;-2.14748e+09;-1.02728e+07;0;0;0;0;0;0;627972104;629650044;13537413
1012;1.13648e-14;-155;1680;24608;19398;1;688;-2.14748e+09;-1.02362e+07;0;0;0;0;0;0;628732853;630424994;13621081
1012;1.14646e-14;-148;1638;24247;19511;1;621;-2.14748e+09;-1.02362e+07;0;0;0;0;0;0;628732853;630424994;13621081
1013;1.13648e-14;-156;1680;24608;19398;1;688;-2.14748e+09;-1.01998e+07;0;0;0;0;0;0;629491331;631197741;13704908
1013;1.14646e-14;-148;1638;24247;19511;1;621;-2.14748e+09;-1.01998e+07;-1;0;0;0;-1;0;629491331;631197741;13704908
1014;1.13648e-14;-157;1680;24608;19398;1;688;-2.14748e+09;-1.01636e+07;0;0;0;0;0;0;630247549;631968296;13788890
1014;1.14646e-14;-148;1638;24247;19511;1;621;-2.14748e+09;-1.01636e+07;-1;0;0;0;-1;0;630247549;631968296;13788890
1015;1.13648e-14;-157;1680;24608;19398;1;688;-2.14748e+09;-1.01275e+07;-1;0;0;0;-1;0;631001516;632736667;13873026
1015;1.14646e-14;-149;1638;24247;19511;1;621;-2.14748e+09;-1.01275e+07;0;0;0;0;0;0;631001516;632736667;13873026
1016;1.13648e-14;-158;1680;24608;19398;1;688;-2.14748e+09;-1.00918e+07;0;0;0;0;0;0;631753242;633502865;13957316
1016;1.14646e-14;-150;1638;24247;19511;1;621;-2.14748e+09;-1.00918e+07;0;0;0;0;0;0;631753242;633502865;13957316
1017;1.13648e-14;-158;1680;24608;19398;1;688;-2.14748e+09;-1.00561e+07;-1;0;0;0;-1;0;632502735;634266897;14041759
1017;1.14646e-14;-151;1638;24247;19511;1;621;-2.14748e+09;-1.00561e+07;0;0;0;0;0;0;632502735;634266897;14041759
1018;1.13648e-14;-158;1680;24608;19398;1;688;-2.14748e+09;-1.00207e+07;-1;0;0;0;-1;0;633250006;635028775;14126352
1018;1.14646e-14;-151;1638;24247;19511;1;621;-2.14748e+09;-1.00207e+07;-1;0;0;0;-1;0;633250006;635028775;14126352
1019;1.13648e-14;-159;1680;24608;19398;1;688;-2.14748e+09;-9.98552e+06;0;0;0;0;0;0;633995064;635788507;14211095
1019;1.14646e-14;-151;1638;24247;19511;1;621;-2.14748e+09;-9.98552e+06;-1;0;0;0;-1;0;633995064;635788507;14211095
1020;1.13648e-14;-159;1680;24608;19398;1;688;-2.14748e+09;-9.95061e+06;-1;0;0;0;-1;0;634737918;636546102;14295987
1020;1.14646e-14;-151;1638;24247;19511;1;621;-2.14748e+09;-9.95061e+06;-1;0;0;0;-1;0;634737918;636546102;14295987
1021;1.13648e-14;-159;1680;24608;19398;1;688;-2.14748e+09;-9.9158e+06;-1;0;0;0;-1;0;635478577;637301570;14381025
1021;1.14646e-14;-152;1638;24247;19511;1;621;-2.14748e+09;-9.9158e+06;0;0;0;0;0;0;635478577;637301570;14381025
1022;1.13648e-14;-159;1680;24608;19398;1;688;-2.14748e+09;-9.88108e+06;-1;0;0;0;-1;0;636217051;638054919;14466210
1022;1.14646e-14;-153;1638;24247;19511;1;621;-2.14748e+09;-9.88108e+06;0;0;0;0;0;0;636217051;638054919;14466210
1023;1.13648e-14;-159;1680;24608;19398;1;688;-2.14748e+09;-9.84676e+06;-1;0;0;0;-1;0;636953348;638806159;14551539
1023;1.14646e-14;-154;1638;24247;19511;1;621;-2.14748e+09;-9.84676e+06;0;0;0;0;0;0;636953348;638806159;14551539
1024;1.13648e-14;-159;1680;24608;19398;1;688;-2.14748e+09;-9.81242e+06;-1;0;0;0;-1;0;637687478;639555299;14637012
1024;1.14646e-14;-155;1638;24247;19511;1;621;-2.14748e+09;-9.81242e+06;0;0;0;0;0;0;637687478;639555299;14637012
1025;1.13648e-14;-160;1680;24608;19398;1;688;-2.14748e+09;-9.77848e+06;0;0;0;0;0;0;638419449;640302347;14722628
1025;1.14646e-14;-155;1638;24247;19511;1;621;-2.14748e+09;-9.77848e+06;-1;0;0;0;-1;0;638419449;640302347;14722628
1026;1.13648e-14;-160;1680;24608;19398;1;688;-2.14748e+09;-9.74452e+06;-1;0;0;0;-1;0;639149271;641047313;14808384
1026;1.14646e-14;-155;1638;24247;19511;1;621;-2.14748e+09;-9.74452e+06;-1;0;0;0;-1;0;639149271;641047313;14808384
1027;1.13648e-14;-160;1680;24608;19398;1;688;-2.14748e+09;-9.71095e+06;-1;0;0;0;-1;0;639876953;641790205;14894280
1027;1.14646e-14;-156;1638;24247;19511;1;621;-2.14748e+09;-9.71095e+06;0;0;0;0;0;0;639876953;641790205;14894280
1028;1.13648e-14;-161;1680;24608;19398;1;688;-2.14748e+09;-9.67746e+06;0;0;0;0;0;0;640602503;642531033;14980315
1028;1.14646e-14;-157;1638;24247;19511;1;621;-2.14748e+09;-9.67746e+06;0;0;0;0;0;0;640602503;642531033;14980315
1029;1.13648e-14;-161;1680;24608;19398;1;688;-2.14748e+09;-9.64406e+06;-1;0;0;0;-1;0;641325930;643269805;15066487
1029;1.14646e-14;-158;1638;24247;19511;1;621;-2.14748e+09;-9.64406e+06;0;0;0;0;0;0;641325930;643269805;15066487
1030;1.13648e-14;-161;1680;24608;19398;1;688;-2.14748e+09;-9.61094e+06;-1;0;0;0;-1;0;642047243;644006529;15152796
1030;1.14646e-14;-158;1638;24247;19511;1;621;-2.14748e+09;-9.61094e+06;-1;0;0;0;-1;0;642047243;644006529;15152796
1031;1.13648e-14;-161;1680;24608;19398;1;688;-2.14748e+09;-9.578e+06;-1;0;0;0;-1;0;642766450;644741215;15239239
1031;1.14646e-14;-158;1638;24247;19511;1;621;-2.14748e+09;-9.578e+06;-1;0;0;0;-1;0;642766450;644741215;15239239
1032;1.13648e-14;-161;1680;24608;19398;1;688;-2.14748e+09;-9.54524e+06;-1;0;0;0;-1;0;643483561;645473871;15325816
1032;1.14646e-14;-158;1638;24247;19511;1;621;-2.14748e+09;-9.54524e+06;-1;0;0;0;-1;0;643483561;645473871;15325816
1033;1.13648e-14;-161;1680;24608;19398;1;688;-2.14748e+09;-9.51266e+06;-1;0;0;0;-1;0;644198584;646204505;15412526
1033;1.14646e-14;-159;1638;24247;19511;1;621;-2.14748e+09;-9.51266e+06;0;0;0;0;0;0;644198584;646204505;15412526
1034;1.13648e-14;-162;1680;24608;19398;1;688;-2.14748e+09;-9.48025e+06;0;0;0;0;0;0;644911527;646933126;15499367
1034;1.14646e-14;-159;1638;24247;19511;1;621;-2.14748e+09;-9.48025e+06;-1;0;0;0;-1;0;644911527;646933126;15499367
1035;1.13648e-14;-162;1680;24608;19398;1;688;-2.14748e+09;-9.44802e+06;-1;0;0;0;-1;0;645622399;647659743;15586339
1035;1.14646e-14;-159;1638;24247;19511;1;621;-2.14748e+09;-9.44802e+06;-1;0;0;0;-1;0;645622399;647659743;15586339
1036;1.13648e-14;-163;1680;24608;19398;1;688;-2.14748e+09;-9.41596e+06;0;0;0;0;0;0;646331209;648384363;15673439
1036;1.14646e-14;-159;1638;24247;19511;1;621;-2.14748e+09;-9.41596e+06;-1;0;0;0;-1;0;646331209;648384363;15673439
1037;1.13648e-14;-164;1680;24608;19398;1;688;-2.14748e+09;-9.38407e+06;0;0;0;0;0;0;647037964;649106996;15760667
1037;1.14646e-14;-160;1638;24247;19511;1;621;-2.14748e+09;-9.38407e+06;0;0;0;0;0;0;647037964;649106996;15760667
1038;1.13648e-14;-165;1680;24608;19398;1;688;-2.14748e+09;-9.35236e+06;0;0;0;0;0;0;647742674;649827649;15848022
1038;1.14646e-14;-161;1638;24247;19511;1;621;-2.14748e+09;-9.35236e+06;0;0;0;0;0;0;647742674;649827649;15848022
1039;1.13648e-14;-166;1680;24608;19398;1;688;-2.14748e+09;-9.32081e+06;0;0;0;0;0;0;648445346;650546331;15935502
1039;1.14646e-14;-162;1638;24247;19511;1;621;-2.14748e+09;-9.32081e+06;0;0;0;0;0;0;648445346;650546331;15935502
1040;1.13648e-14;-166;1680;24608;19398;1;688;-2.14748e+09;-9.28943e+06;-1;0;0;0;-1;0;649145989;651263049;16023107
1040;1.14646e-14;-163;1638;24247;19511;1;621;-2.14748e+09;-9.28943e+06;0;0;0;0;0;0;649145989;651263049;16023107
1041;1.13648e-14;-166;1680;24608;19398;1;688;-2.14748e+09;-9.25832e+06;-1;0;0;0;-1;0;649844611;651977813;16110834
1041;1.14646e-14;-164;1638;24247;19511;1;621;-2.14748e+09;-9.25822e+06;0;0;0;0;0;0;649844611;651977813;16110834
1042;1.13648e-14;-167;1680;24608;19398;1;688;-2.14748e+09;-9.22718e+06;0;0;0;0;0;0;650541220;652690630;16198683
1042;1.14646e-14;-165;1638;24247;19511;1;621;-2.14748e+09;-9.22718e+06;0;0;0;0;0;0;650541220;652690630;16198683
1043;1.13648e-14;-168;1680;24608;19398;1;688;-2.14748e+09;-9.1963e+06;0;0;0;0;0;0;651235824;653401508;16286654
1043;1.14646e-14;-165;1638;24247;19511;1;621;-2.14748e+09;-9.1963e+06;-1;0;0;0;-1;0;651235824;653401508;16286654
1044;1.13648e-14;-169;1680;24608;19398;1;688;-2.14748e+09;-9.16558e+06;0;0;0;0;0;0;651928432;654110456;16374743
1044;1.14646e-14;-165;1638;24247;19511;1;621;-2.14748e+09;-9.16558e+06;-1;0;0;0;-1;0;651928432;654110456;16374743
1045;1.13648e-14;-170;1680;24608;19398;1;688;-2.14748e+09;-9.13502e+06;0;0;0;0;0;0;652619051;654817480;16462951
1045;1.14646e-14;-166;1638;24247;19511;1;621;-2.14748e+09;-9.13502e+06;0;0;0;0;0;0;652619051;654817480;16462951
1046;1.13648e-14;-171;1680;24608;19398;1;688;-2.14748e+09;-9.10463e+06;0;0;0;0;0;0;653307690;655522590;16551277
1046;1.14646e-14;-166;1638;24247;19511;1;621;-2.14748e+09;-9.10463e+06;-1;0;0;0;-1;0;653307690;655522590;16551277
1047;1.13648e-14;-171;1680;24608;19398;1;688;-2.14748e+09;-9.07439e+06;-1;0;0;0;-1;0;653994356;656225793;16639718
1047;1.14646e-14;-167;1638;24247;19511;1;621;-2.14748e+09;-9.07439e+06;0;0;0;0;0;0;653994356;656225793;16639718
1048;1.13648e-14;-171;1680;24608;19398;1;688;-2.14748e+09;-9.04431e+06;-1;0;0;0;-1;0;654679058;656927096;16728275
1048;1.14646e-14;-167;1638;24247;19511;1;621;-2.14748e+09;-9.04431e+06;-1;0;0;0;-1;0;654679058;656927096;16728275
1049;1.13648e-14;-172;1680;24608;19398;1;688;-2.14748e+09;-9.01439e+06;0;0;0;0;0;0;655361803;657626508;16816945
1049;1.14646e-14;-168;1638;24247;19511;1;621;-2.14748e+09;-9.01439e+06;0;0;0;0;0;0;655361803;657626508;16816945
1050;1.13648e-14;-172;1680;24608;19398;1;688;-2.14748e+09;-8.98462e+06;-1;0;0;0;-1;0;656042598;658324037;16905728
1050;1.14646e-14;-169;1638;24247;19511;1;621;-2.14748e+09;-8.98462e+06;0;0;0;0;0;0;656042598;658324037;16905728
1051;1.13648e-14;-173;1680;24608;19398;1;688;-2.14748e+09;-8.95501e+06;0;0;0;0;0;0;656721453;659019689;16994622
1051;1.14646e-14;-169;1638;24247;19511;1;621;-2.14748e+09;-8.95501e+06;-1;0;0;0;-1;0;656721453;659019689;16994622
1052;1.13648e-14;-173;1680;24608;19398;1;688;-2.14748e+09;-8.92556e+06;-1;0;0;0;-1;0;657398374;659713473;17083627
1052;1.14646e-14;-170;1638;24247;19511;1;621;-2.14748e+09;-8.92556e+06;0;0;0;0;0;0;657398374;659713473;17083627
1053;1.13648e-14;-173;1680;24608;19398;1;688;-2.14748e+09;-8.89625e+06;-1;0;0;0;-1;0;658073369;660405397;17172740
1053;1.14646e-14;-170;1638;24247;19511;1;621;-2.14748e+09;-8.89625e+06;-1;0;0;0;-1;0;658073369;660405397;17172740
1054;1.13648e-14;-173;1680;24608;19398;1;688;-2.14748e+09;-8.8671e+06;-1;0;0;0;-1;0;658746446;661095467;17261962
1054;1.14646e-14;-170;1638;24247;19511;1;621;-2.14748e+09;-8.8671e+06;-1;0;0;0;-1;0;658746446;661095467;17261962
1055;1.13648e-14;-173;1680;24608;19398;1;688;-2.14748e+09;-8.83809e+06;-1;0;0;0;-1;0;659417613;661783692;17351291
1055;1.14646e-14;-170;1638;24247;19511;1;621;-2.14748e+09;-8.83809e+06;-1;0;0;0;-1;0;659417613;661783692;17351291
1056;1.13648e-14;-173;1680;24608;19398;1;688;-2.14748e+09;-8.80934e+06;-1;0;0;0;-1;0;660086876;662470078;17440726
1056;1.14646e-14;-171;1638;24247;19511;1;621;-2.14748e+09;-8.80934e+06;0;0;0;0;0;0;660086876;662470078;17440726
1057;1.13648e-14;-174;1680;24608;19398;1;688;-2.14748e+09;-8.78053e+06;0;0;0;0;0;0;660754244;663154634;17530266
1057;1.14646e-14;-171;1638;24247;19511;1;621;-2.14748e+09;-8.78053e+06;-1;0;0;0;-1;0;660754244;663154634;17530266
1058;1.13648e-14;-175;1680;24608;19398;1;688;-2.14748e+09;-8.75197e+06;0;0;0;0;0;0;661419724;663837366;17619909
1058;1.14646e-14;-172;1638;24247;19511;1;621;-2.14748e+09;-8.75197e+06;0;0;0;0;0;0;661419724;663837366;17619909
1059;1.13648e-14;-176;1680;24608;19398;1;688;-2.14748e+09;-8.72355e+06;0;0;0;0;0;0;662083324;664518282;17709654
1059;1.14646e-14;-172;1638;24247;19511;1;621;-2.14748e+09;-8.72355e+06;-1;0;0;0;-1;0;662083324;664518282;17709654
1060;1.13648e-14;-177;1680;24608;19398;1;688;-2.14748e+09;-8.69538e+06;0;0;0;0;0;0;662745050;665197389;17799501
1060;1.14646e-14;-173;1638;24247;19511;1;621;-2.14748e+09;-8.69538e+06;0;0;0;0;0;0;662745050;665197389;17799501
1061;1.13648e-14;-178;1680;24608;19398;1;688;-2.14748e+09;-8.66715e+06;0;0;0;0;0;0;663404911;665874696;17889449
1061;1.14646e-14;-173;1638;24247;19511;1;621;-2.14748e+09;-8.66715e+06;-1;0;0;0;-1;0;663404911;665874696;17889449
1062;1.13648e-14;-178;1680;24608;19398;1;688;-2.14748e+09;-8.63917e+06;-1;0;0;0;-1;0;664062913;666550207;17979495
1062;1.14646e-14;-174;1638;24247;19511;1;621;-2.14748e+09;-8.63917e+06;0;0;0;0;0;0;664062913;666550207;17979495
1063;1.13648e-14;-178;1680;24608;19398;1;688;-2.14748e+09;-8.61132e+06;-1;0;0;0;-1;0;664719064;667223932;18069640
1063;1.14646e-14;-175;1638;24247;19511;1;621;-2.14748e+09;-8.61132e+06;0;0;0;0;0;0;664719064;667223932;18069640
1064;1.13648e-14;-179;1680;24608;19398;1;688;-2.14748e+09;-8.58362e+06;0;0;0;0;0;0;665373371;667895877;18159881
1064;1.14646e-14;-175;1638;24247;19511;1;621;-2.14748e+09;-8.58362e+06;-1;0;0;0;-1;0;665373371;667895877;18159881
1065;1.13648e-14;-179;1680;24608;19398;1;688;-2.14748e+09;-8.55606e+06;-1;0;0;0;-1;0;666025842;668566049;18250218
1065;1.14646e-14;-175;1638;24247;19511;1;621;-2.14748e+09;-8.55606e+06;-1;0;0;0;-1;0;666025842;668566049;18250218
1066;1.13648e-14;-180;1680;24608;19398;1;688;-2.14748e+09;-8.52863e+06;0;0;0;0;0;0;666676483;669234455;18340651
1066;1.14646e-14;-175;1638;24247;19511;1;621;-2.14748e+09;-8.52863e+06;-1;0;0;0;-1;0;666676483;669234455;18340651
1067;1.13648e-14;-181;1680;24608;19398;1;688;-2.14748e+09;-8.50134e+06;0;0;0;0;0;0;667325301;669901102;18431177
1067;1.14646e-14;-175;1638;24247;19511;1;621;-2.14748e+09;-8.50134e+06;-1;0;0;0;-1;0;667325301;669901102;18431177
1068;1.13648e-14;-181;1680;24608;19398;1;688;-2.14748e+09;-8.47419e+06;-1;0;0;0;-1;0;667972304;670565997;18521795
1068;1.14646e-14;-176;1638;24247;19511;1;621;-2.14748e+09;-8.47419e+06;0;0;0;0;0;0;667972304;670565997;18521795
1069;1.13648e-14;-181;1680;24608;19398;1;688;-2.14748e+09;-8.44717e+06;-1;0;0;0;-1;0;668617498;671229148;18612505
1069;1.14646e-14;-176;1638;24247;19511;1;621;-2.14748e+09;-8.44717e+06;-1;0;0;0;-1;0;668617498;671229148;18612505
1070;1.13648e-14;-181;1680;24608;19398;1;688;-2.14748e+09;-8.42028e+06;-1;0;0;0;-1;0;669260892;671890561;18703306
1070;1.14646e-14;-177;1638;24247;19511;1;621;-2.14748e+09;-8.42028e+06;0;0;0;0;0;0;669260892;671890561;18703306
1071;1.13648e-14;-181;1680;24608;19398;1;688;-2.14748e+09;-8.39354e+06;-1;0;0;0;-1;0;669902490;672550242;18794196
1071;1.14646e-14;-177;1638;24247;19511;1;621;-2.14748e+09;-8.39354e+06;-1;0;0;0;-1;0;669902490;672550242;18794196
1072;1.13648e-14;-182;1680;24608;19398;1;688;-2.14748e+09;-8.36692e+06;0;0;0;0;0;0;670542302;673208199;18885175
1072;1.14646e-14;-178;1638;24247;19511;1;621;-2.14748e+09;-8.36692e+06;0;0;0;0;0;0;670542302;673208199;18885175
1073;1.13648e-14;-182;1680;24608;19398;1;688;-2.14748e+09;-8.34043e+06;-1;0;0;0;-1;0;671180333;673864439;18976240
1073;1.14646e-14;-178;1638;24247;19511;1;621;-2.14748e+09;-8.34043e+06;-1;0;0;0;-1;0;671180333;673864439;18976240
1074;1.13648e-14;-183;1680;24608;19398;1;688;-2.14748e+09;-8.31407e+06;0;0;0;0;0;0;671816590;674518968;19067392
1074;1.14646e-14;-178;1638;24247;19511;1;621;-2.14748e+09;-8.31407e+06;-1;0;0;0;-1;0;671816590;674518968;19067392
1075;1.13648e-14;-183;1680;24608;19398;1;688;-2.14748e+09;-8.28785e+06;-1;0;0;0;-1;0;672451080;675171793;19158630
1075;1.14646e-14;-179;1638;24247;19511;1;621;-2.14748e+09;-8.28785e+06;0;0;0;0;0;0;672451080;675171793;19158630
1076;1.13648e-14;-183;1680;24608;19398;1;688;-2.14748e+09;-8.26185e+06;-1;0;0;0;-1;0;673083811;675822920;19249951
1076;1.14646e-14;-180;1638;24247;19511;1;621;-2.14748e+09;-8.26185e+06;0;0;0;0;0;0;673083811;675822920;19249951
1077;1.13648e-14;-183;1680;24608;19398;1;688;-2.14748e+09;-8.23588e+06;-1;0;0;0;-1;0;673714788;676472357;19341356
1077;1.14646e-14;-180;1638;24247;19511;1;621;-2.14748e+09;-8.23588e+06;-1;0;0;0;-1;0;673714788;676472357;19341356
1078;1.13648e-14;-184;1680;24608;19398;1;688;-2.14748e+09;-8.20994e+06;0;0;0;0;0;0;674344018;677120109;19432842
1078;1.14646e-14;-180;1638;24247;19511;1;621;-2.14748e+09;-8.20994e+06;-1;0;0;0;-1;0;674344018;677120109;19432842
1079;1.13648e-14;-185;1680;24608;19398;1;688;-2.14748e+09;-8.18422e+06;0;0;0;0;0;0;674971508;677766184;19524410
1079;1.14646e-14;-180;1638;24247;19511;1;621;-2.14748e+09;-8.18422e+06;-1;0;0;0;-1;0;674971508;677766184;19524410
1080;1.13648e-14;-185;1680;24608;19398;1;688;-2.14748e+09;-8.15862e+06;-1;0;0;0;-1;0;675597265;678410588;19616058
1080;1.14646e-14;-180;1638;24247;19511;1;621;-2.14748e+09;-8.15862e+06;-1;0;0;0;-1;0;675597265;678410588;19616058
1081;1.13648e-14;-185;1680;24608;19398;1;688;-2.14748e+09;-8.13316e+06;-1;0;0;0;-1;0;676221296;679053327;19707784
1081;1.14646e-14;-181;1638;24247;19511;1;621;-2.14748e+09;-8.13316e+06;0;0;0;0;0;0;676221296;679053327;19707784
1082;1.13648e-14;-185;1680;24608;19398;1;688;-2.14748e+09;-8.10781e+06;-1;0;0;0;-1;0;676843606;679694408;19799589
1082;1.14646e-14;-182;1638;24247;19511;1;621;-2.14748e+09;-8.10781e+06;0;0;0;0;0;0;676843606;679694408;19799589
1083;1.13648e-14;-186;1680;24608;19398;1;688;-2.14748e+09;-8.08259e+06;0;0;0;0;0;0;677464202;680333837;19891470
1083;1.14646e-14;-182;1638;24247;19511;1;621;-2.14748e+09;-8.08259e+06;-1;0;0;0;-1;0;677464202;680333837;19891470
1084;1.13648e-14;-186;1680;24608;19398;1;688;-2.14748e+09;-8.05748e+06;-1;0;0;0;-1;0;678083092;680971621;19983428
1084;1.14646e-14;-182;1638;24247;19511;1;621;-2.14748e+09;-8.05748e+06;-1;0;0;0;-1;0;678083092;680971621;19983428
1085;1.13648e-14;-187;1680;24608;19398;1;688;-2.14748e+09;-8.0326e+06;0;0;0;0;0;0;678700281;681607765;20075460
1085;1.14646e-14;-182;1638;24247;19511;1;621;-2.14748e+09;-8.0326e+06;-1;0;0;0;-1;0;678700281;681607765;20075460
1086;1.13648e-14;-188;1680;24608;19398;1;688;-2.14748e+09;-8.00764e+06;0;0;0;0;0;0;679315775;682242277;20167566
1086;1.14646e-14;-183;1638;24247;19511;1;621;-2.14748e+09;-8.00764e+06;0;0;0;0;0;0;679315775;682242277;20167566
1087;1.13648e-14;-189;1680;24608;19398;1;688;-2.14748e+09;-7.9829e+06;0;0;0;0;0;0;679929582;682875162;20259745
1087;1.14646e-14;-184;1638;24247;19511;1;621;-2.14748e+09;-7.9829e+06;0;0;0;0;0;0;679929582;682875162;20259745
1088;1.13648e-14;-190;1680;24608;19398;1;688;-2.14748e+09;-7.95827e+06;0;0;0;0;0;0;680541707;683506427;20351996
1088;1.14646e-14;-184;1638;24247;19511;1;621;-2.14748e+09;-7.95827e+06;-1;0;0;0;-1;0;680541707;683506427;20351996
1089;1.13648e-14;-190;1680;24608;19398;1;688;-2.14748e+09;-7.93376e+06;-1;0;0;0;-1;0;681152157;684136078;20444318
1089;1.14646e-14;-185;1638;24247;19511;1;621;-2.14748e+09;-7.93376e+06;0;0;0;0;0;0;681152157;684136078;20444318
1090;1.13648e-14;-190;1680;24608;19398;1;688;-2.14748e+09;-7.90937e+06;-1;0;0;0;-1;0;681760939;684764121;20536710
1090;1.14646e-14;-186;1638;24247;19511;1;621;-2.14748e+09;-7.90937e+06;0;0;0;0;0;0;681760939;684764121;20536710
1091;1.13648e-14;-191;1680;24608;19398;1;688;-2.14748e+09;-7.8852e+06;0;0;0;0;0;0;682368057;685390563;20629171
1091;1.14646e-14;-187;1638;24247;19511;1;621;-2.14748e+09;-7.8852e+06;0;0;0;0;0;0;682368057;685390563;20629171
1092;1.13648e-14;-192;1680;24608;19398;1;688;-2.14748e+09;-7.86094e+06;0;0;0;0;0;0;682973520;686015408;20721700
1092;1.14646e-14;-187;1638;24247;19511;1;621;-2.14748e+09;-7.86094e+06;-1;0;0;0;-1;0;682973520;686015408;20721700
1093;1.13648e-14;-193;1680;24608;19398;1;688;-2.14748e+09;-7.83689e+06;0;0;0;0;0;0;683577332;686638664;20814295
1093;1.14646e-14;-188;1638;24247;19511;1;621;-2.14748e+09;-7.83689e+06;0;0;0;0;0;0;683577332;686638664;20814295
1094;1.13648e-14;-193;1680;24608;19398;1;688;-2.14748e+09;-7.81296e+06;-1;0;0;0;-1;0;684179500;687260337;20906957
1094;1.14646e-14;-189;1638;24247;19511;1;621;-2.14748e+09;-7.81296e+06;0;0;0;0;0;0;684179500;687260337;20906957
1095;1.13648e-14;-194;1680;24608;19398;1;688;-2.14748e+09;-7.78914e+06;0;0;0;0;0;0;684780030;687880432;20999684
1095;1.14646e-14;-189;1638;24247;19511;1;621;-2.14748e+09;-7.78914e+06;-1;0;0;0;-1;0;684780030;687880432;20999684
1096;1.13648e-14;-194;1680;24608;19398;1;688;-2.14748e+09;-7.76543e+06;-1;0;0;0;-1;0;685378929;688498955;21092474
1096;1.14646e-14;-189;1638;24247;19511;1;621;-2.14748e+09;-7.76543e+06;-1;0;0;0;-1;0;685378929;688498955;21092474
1097;1.13648e-14;-195;1680;24608;19398;1;688;-2.14748e+09;-7.74183e+06;0;0;0;0;0;0;685976202;689115912;21185328
1097;1.14646e-14;-189;1638;24247;19511;1;621;-2.14748e+09;-7.74183e+06;-1;0;0;0;-1;0;685976202;689115912;21185328
1098;1.13648e-14;-195;1680;24608;19398;1;688;-2.14748e+09;-7.71834e+06;-1;0;0;0;-1;0;686571855;689731310;21278244
1098;1.14646e-14;-189;1638;24247;19511;1;621;-2.14748e+09;-7.71834e+06;-1;0;0;0;-1;0;686571855;689731310;21278244
1099;1.13648e-14;-195;1680;24608;19398;1;688;-2.14748e+09;-7.69496e+06;-1;0;0;0;-1;0;687165894;690345154;21371221
1099;1.14646e-14;-189;1638;24247;19511;1;621;-2.14748e+09;-7.69496e+06;-1;0;0;0;-1;0;687165894;690345154;21371221
1100;1.13648e-14;-195;1680;24608;19398;1;688;-2.14748e+09;-7.67169e+06;-1;0;0;0;-1;0;687758326;690957450;21464258
1100;1.14646e-14;-189;1638;24247;19511;1;621;-2.14748e+09;-7.67169e+06;-1;0;0;0;-1;0;687758326;690957450;21464258
1101;1.13648e-14;-196;1680;24608;19398;1;688;-2.14748e+09;-7.64863e+06;0;0;0;0;0;0;688349156;691568203;21557354
1101;1.14646e-14;-190;1638;24247;19511;1;621;-2.14748e+09;-7.64863e+06;0;0;0;0;0;0;688349156;691568203;21557354
1102;1.13648e-14;-196;1680;24608;19398;1;688;-2.14748e+09;-7.62547e+06;-1;0;0;0;-1;0;688938391;692177420;21650509
1102;1.14646e-14;-191;1638;24247;19511;1;621;-2.14748e+09;-7.62547e+06;0;0;0;0;0;0;688938391;692177420;21650509
1103;1.13648e-14;-196;1680;24608;19398;1;688;-2.14748e+09;-7.60252e+06;-1;0;0;0;-1;0;689526035;692785106;21743721
1103;1.14646e-14;-192;1638;24247;19511;1;621;-2.14748e+09;-7.60252e+06;0;0;0;0;0;0;689526035;692785106;21743721
1104;1.13648e-14;-196;1680;24608;19398;1;688;-2.14748e+09;-7.57968e+06;-1;0;0;0;-1;0;690112095;693391267;21836990
1104;1.14646e-14;-192;1638;24247;19511;1;621;-2.14748e+09;-7.57968e+06;-1;0;0;0;-1;0;690112095;693391267;21836990
1105;1.13648e-14;-197;1680;24608;19398;1;688;-2.14748e+09;-7.55704e+06;0;0;0;0;0;0;690696577;693995908;21930314
1105;1.14646e-14;-193;1638;24247;19511;1;621;-2.14748e+09;-7.55704e+06;0;0;0;0;0;0;690696577;693995908;21930314
1106;1.13648e-14;-197;1680;24608;19398;1;688;-2.14748e+09;-7.53441e+06;-1;0;0;0;-1;0;691279487;694599036;22023692
1106;1.14646e-14;-193;1638;24247;19511;1;621;-2.14748e+09;-7.53441e+06;-1;0;0;0;-1;0;691279487;694599036;22023692
1107;1.13648e-14;-198;1680;24608;19398;1;688;-2.14748e+09;-7.51178e+06;0;0;0;0;0;0;691860829;695200656;22117124
1107;1.14646e-14;-193;1638;24247;19511;1;621;-2.14748e+09;-7.51178e+06;-1;0;0;0;-1;0;691860829;695200656;22117124
1108;1.13648e-14;-199;1680;24608;19398;1;688;-2.14748e+09;-7.48936e+06;0;0;0;0;0;0;692440611;695800773;22210609
1108;1.14646e-14;-193;1638;24247;19511;1;621;-2.14748e+09;-7.48936e+06;-1;0;0;0;-1;0;692440611;695800773;22210609
1109;1.13648e-14;-199;1680;24608;19398;1;688;-2.14748e+09;-7.46703e+06;-1;0;0;0;-1;0;693018837;696399393;22304146
1109;1.14646e-14;-194;1638;24247;19511;1;621;-2.14748e+09;-7.46703e+06;0;0;0;0;0;0;693018837;696399393;22304146
1110;1.13648e-14;-199;1680;24608;19398;1;688;-2.14748e+09;-7.44481e+06;-1;0;0;0;-1;0;693595514;696996522;22397734
1110;1.14646e-14;-195;1638;24247;19511;1;621;-2.14748e+09;-7.44481e+06;0;0;0;0;0;0;693595514;696996522;22397734
1111;1.13648e-14;-199;1680;24608;19398;1;688;-2.14748e+09;-7.42269e+06;-1;0;0;0;-1;0;694170647;697592165;22491371
1111;1.14646e-14;-196;1638;24247;19511;1;621;-2.14748e+09;-7.42269e+06;0;0;0;0;0;0;694170647;697592165;22491371
1112;1.13648e-14;-200;1680;24608;19398;1;688;-2.14748e+09;-7.40066e+06;0;0;0;0;0;0;694744242;698186327;22585058
1112;1.14646e-14;-196;1638;24247;19511;1;621;-2.14748e+09;-7.40066e+06;-1;0;0;0;-1;0;694744242;698186327;22585058
1113;1.13648e-14;-201;1680;24608;19398;1;688;-2.14748e+09;-7.37874e+06;0;0;0;0;0;0;695316303;698779014;22678793
1113;1.14646e-14;-197;1638;24247;19511;1;621;-2.14748e+09;-7.37874e+06;0;0;0;0;0;0;695316303;698779014;22678793
1114;1.13648e-14;-201;1680;24608;19398;1;688;-2.14748e+09;-7.35692e+06;-1;0;0;0;-1;0;695886838;699370232;22772575
1114;1.14646e-14;-198;1638;24247;19511;1;621;-2.14748e+09;-7.35692e+06;0;0;0;0;0;0;695886838;699370232;22772575
1115;1.13648e-14;-201;1680;24608;19398;1;688;-2.14748e+09;-7.33519e+06;-1;0;0;0;-1;0;696455851;699959985;22866404
1115;1.14646e-14;-198;1638;24247;19511;1;621;-2.14748e+09;-7.33519e+06;-1;0;0;0;-1;0;696455851;699959985;22866404
1116;1.13648e-14;-201;1680;24608;19398;1;688;-2.14748e+09;-7.31357e+06;-1;0;0;0;-1;0;697023348;700548279;22960278
1116;1.14646e-14;-198;1638;24247;19511;1;621;-2.14748e+09;-7.31357e+06;-1;0;0;0;-1;0;697023348;700548279;22960278
1117;1.13648e-14;-202;1680;24608;19398;1;688;-2.14748e+09;-7.29204e+06;0;0;0;0;0;0;697589334;701135120;23054196
1117;1.14646e-14;-198;1638;24247;19511;1;621;-2.14748e+09;-7.29204e+06;-1;0;0;0;-1;0;697589334;701135120;23054196
1118;1.13648e-14;-202;1680;24608;19398;1;688;-2.14748e+09;-7.2706e+06;-1;0;0;0;-1;0;698153814;701720512;23148159
1118;1.14646e-14;-199;1638;24247;19511;1;621;-2.14748e+09;-7.2706e+06;0;0;0;0;0;0;698153814;701720512;23148159
1119;1.13648e-14;-203;1680;24608;19398;1;688;-2.14748e+09;-7.24936e+06;0;0;0;0;0;0;698716795;702304462;23242164
1119;1.14646e-14;-199;1638;24247;19511;1;621;-2.14748e+09;-7.24936e+06;-1;0;0;0;-1;0;698716795;702304462;23242164
1120;1.13648e-14;-204;1680;24608;19398;1;688;-2.14748e+09;-7.22802e+06;0;0;0;0;0;0;699278282;702886973;23336211
1120;1.14646e-14;-200;1638;24247;19511;1;621;-2.14748e+09;-7.22802e+06;0;0;0;0;0;0;699278282;702886973;23336211
1121;1.13648e-14;-205;1680;24608;19398;1;688;-2.14748e+09;-7.20687e+06;0;0;0;0;0;0;699838279;703468052;23430300
1121;1.14646e-14;-201;1638;24247;19511;1;621;-2.14748e+09;-7.20687e+06;0;0;0;0;0;0;699838279;703468052;23430300
1122;1.13648e-14;-205;1680;24608;19398;1;688;-2.14748e+09;-7.18582e+06;-1;0;0;0;-1;0;700396793;704047704;23524428
1122;1.14646e-14;-202;1638;24247;19511;1;621;-2.14748e+09;-7.18582e+06;0;0;0;0;0;0;700396793;704047704;23524428
1123;1.13648e-14;-206;1680;24608;19398;1;688;-2.14748e+09;-7.16485e+06;0;0;0;0;0;0;700953828;704625933;23618596
1123;1.14646e-14;-203;1638;24247;19511;1;621;-2.14748e+09;-7.16485e+06;0;0;0;0;0;0;700953828;704625933;23618596
1124;1.13648e-14;-207;1680;24608;19398;1;688;-2.14748e+09;-7.14398e+06;0;0;0;0;0;0;701509390;705202745;23712803
1124;1.14646e-14;-204;1638;24247;19511;1;621;-2.14748e+09;-7.14398e+06;0;0;0;0;0;0;701509390;705202745;23712803
1125;1.13648e-14;-207;1680;24608;19398;1;688;-2.14748e+09;-7.12321e+06;-1;0;0;0;-1;0;702063484;705778145;23807047
1125;1.14646e-14;-204;1638;24247;19511;1;621;-2.14748e+09;-7.12321e+06;-1;0;0;0;-1;0;702063484;705778145;23807047
1126;1.13648e-14;-208;1680;24608;19398;1;688;-2.14748e+09;-7.10252e+06;0;0;0;0;0;0;702616116;706352139;23901328
1126;1.14646e-14;-205;1638;24247;19511;1;621;-2.14748e+09;-7.10252e+06;0;0;0;0;0;0;702616116;706352139;23901328
1127;1.13648e-14;-208;1680;24608;19398;1;688;-2.14748e+09;-7.08193e+06;-1;0;0;0;-1;0;703167290;706924730;23995645
1127;1.14646e-14;-206;1638;24247;19511;1;621;-2.14748e+09;-7.08193e+06;0;0;0;0;0;0;703167290;706924730;23995645
1128;1.13648e-14;-208;1680;24608;19398;1;688;-2.14748e+09;-7.06152e+06;-1;0;0;0;-1;0;703717012;707495924;24089997
1128;1.14646e-14;-207;1638;24247;19511;1;621;-2.14748e+09;-7.06152e+06;0;0;0;0;0;0;703717012;707495924;24089997
1129;1.13648e-14;-208;1680;24608;19398;1;688;-2.14748e+09;-7.04101e+06;-1;0;0;0;-1;0;704265286;708065727;24184383
1129;1.14646e-14;-207;1638;24247;19511;1;621;-2.14748e+09;-7.04101e+06;-1;0;0;0;-1;0;704265286;708065727;24184383
1130;1.13648e-14;-208;1680;24608;19398;1;688;-2.14748e+09;-7.02068e+06;-1;0;0;0;-1;0;704812119;708634142;24278803
1130;1.14646e-14;-207;1638;24247;19511;1;621;-2.14748e+09;-7.02068e+06;-1;0;0;0;-1;0;704812119;708634142;24278803
1131;1.13648e-14;-209;1680;24608;19398;1;688;-2.14748e+09;-7.00044e+06;0;0;0;0;0;0;705357515;709201176;24373256
1131;1.14646e-14;-208;1638;24247;19511;1;621;-2.14748e+09;-7.00044e+06;0;0;0;0;0;0;705357515;709201176;24373256
1132;1.13648e-14;-210;1680;24608;19398;1;688;-2.14748e+09;-6.98029e+06;0;0;0;0;0;0;705901479;709766832;24467740
1132;1.14646e-14;-209;1638;24247;19511;1;621;-2.14748e+09;-6.98029e+06;0;0;0;0;0;0;705901479;709766832;24467740
1133;1.13648e-14;-210;1680;24608;19398;1;688;-2.14748e+09;-6.96023e+06;-1;0;0;0;-1;0;706444016;710331117;24562255
1133;1.14646e-14;-209;1638;24247;19511;1;621;-2.14748e+09;-6.96023e+06;-1;0;0;0;-1;0;706444016;710331117;24562255
1134;1.13648e-14;-210;1680;24608;19398;1;688;-2.14748e+09;-6.94026e+06;0;0;-1;0;0;-1;706985132;710894033;24656801
1134;1.14646e-14;-210;1638;24247;19511;1;621;-2.14748e+09;-6.94026e+06;0;0;0;0;0;0;706985132;710894033;24656801
1135;1.13648e-14;-210;1680;24608;19398;1;688;-2.14748e+09;-6.92037e+06;-1;0;0;0;-1;0;707524831;711455588;24751375
1135;1.14646e-14;-211;1638;24247;19511;1;621;-2.14748e+09;-6.92037e+06;0;0;0;0;0;0;707524831;711455588;24751375
1136;1.13648e-14;-211;1680;24608;19398;1;688;-2.14748e+09;-6.90056e+06;0;0;0;0;0;0;708063118;712015785;24845979
1136;1.14646e-14;-211;1638;24247;19511;1;621;-2.14748e+09;-6.90056e+06;-1;0;0;0;-1;0;708063118;712015785;24845979
1137;1.13648e-14;-212;1680;24608;19398;1;688;-2.14748e+09;-6.88085e+06;0;0;0;0;0;0;708599998;712574629;24940610
1137;1.14646e-14;-212;1638;24247;19511;1;621;-2.14748e+09;-6.88085e+06;0;0;0;0;0;0;708599998;712574629;24940610
1138;1.13648e-14;-212;1680;24608;19398;1;688;-2.14748e+09;-6.86121e+06;-1;0;0;0;-1;0;709135477;713132124;25035268
1138;1.14646e-14;-212;1638;24247;19511;1;621;-2.14748e+09;-6.86121e+06;-1;0;0;0;-1;0;709135477;713132124;25035268
1139;1.13648e-14;-212;1680;24608;19398;1;688;-2.14748e+09;-6.84166e+06;-1;0;0;0;-1;0;709669559;713688277;25129952
1139;1.14646e-14;-213;1638;24247;19511;1;621;-2.14748e+09;-6.84166e+06;0;0;0;0;0;0;709669559;713688277;25129952
1140;1.13648e-14;-212;1680;24608;19398;1;688;-2.14748e+09;-6.8223e+06;-1;0;0;0;-1;0;710202248;714243091;25224661
1140;1.14646e-14;-214;1638;24247;19511;1;621;-2.14748e+09;-6.8223e+06;0;0;0;0;0;0;710202248;714243091;25224661
1141;1.13648e-14;-213;1680;24608;19398;1;688;-2.14748e+09;-6.80282e+06;0;0;0;0;0;0;710733550;714796570;25319395
1141;1.14646e-14;-215;1638;24247;19511;1;621;-2.14748e+09;-6.80282e+06;0;0;0;0;0;0;710733550;714796570;25319395
1142;1.13648e-14;-213;1680;24608;19398;1;688;-2.14748e+09;-6.78352e+06;-1;0;0;0;-1;0;711263470;715348721;25414153
1142;1.14646e-14;-216;1638;24247;19511;1;621;-2.14748e+09;-6.78352e+06;0;0;0;0;0;0;711263470;715348721;25414153
1143;1.13648e-14;-214;1680;24608;19398;1;688;-2.14748e+09;-6.7643e+06;0;0;0;0;0;0;711792013;715899547;25508934
1143;1.14646e-14;-217;1638;24247;19511;1;621;-2.14748e+09;-6.7643e+06;0;0;0;0;0;0;711792013;715899547;25508934
1144;1.13648e-14;-215;1680;24608;19398;1;688;-2.14748e+09;-6.74516e+06;0;0;0;0;0;0;712319182;716449053;25603737
1144;1.14646e-14;-217;1638;24247;19511;1;621;-2.14748e+09;-6.74516e+06;-1;0;0;0;-1;0;712319182;716449053;25603737
1145;1.13648e-14;-215;1680;24608;19398;1;688;-2.14748e+09;-6.72611e+06;-1;0;0;0;-1;0;712844984;716997243;25698561
1145;1.14646e-14;-217;1638;24247;19511;1;621;-2.14748e+09;-6.72611e+06;-1;0;0;0;-1;0;712844984;716997243;25698561
1146;1.13648e-14;-216;1680;24608;19398;1;688;-2.14748e+09;-6.70713e+06;0;0;0;0;0;0;713369423;717544123;25793406
1146;1.14646e-14;-217;1638;24247;19511;1;621;-2.14748e+09;-6.70713e+06;-1;0;0;0;-1;0;713369423;717544123;25793406
1147;1.13648e-14;-217;1680;24608;19398;1;688;-2.14748e+09;-6.68824e+06;0;0;0;0;0;0;713892502;718089696;25888271
1147;1.14646e-14;-218;1638;24247;19511;1;621;-2.14748e+09;-6.68824e+06;0;0;0;0;0;0;713892502;718089696;25888271
1148;1.13648e-14;-217;1680;24608;19398;1;688;-2.14748e+09;-6.66942e+06;-1;0;0;0;-1;0;714414229;718633967;25983155
1148;1.14646e-14;-219;1638;24247;19511;1;621;-2.14748e+09;-6.66942e+06;0;0;0;0;0;0;714414229;718633967;25983155
1149;1.13648e-14;-217;1680;24608;19398;1;688;-2.14748e+09;-6.65069e+06;-1;0;0;0;-1;0;714934605;719176941;26078057
1149;1.14646e-14;-219;1638;24247;19511;1;621;-2.14748e+09;-6.65069e+06;-1;0;0;0;-1;0;714934605;719176941;26078057
1150;1.13648e-14;-217;1680;24608;19398;1;688;-2.14748e+09;-6.63213e+06;-1;0;0;0;-1;0;715453638;719718623;26172977
1150;1.14646e-14;-219;1638;24247;19511;1;621;-2.14748e+09;-6.63213e+06;-1;0;0;0;-1;0;715453638;719718623;26172977
1151;1.13648e-14;-218;1680;24608;19398;1;688;-2.14748e+09;-6.61345e+06;0;0;0;0;0;0;715971330;720259016;26267914
1151;1.14646e-14;-219;1638;24247;19511;1;621;-2.14748e+09;-6.61345e+06;-1;0;0;0;-1;0;715971330;720259016;26267914
1152;1.13648e-14;-219;1680;24608;19398;1;688;-2.14748e+09;-6.59505e+06;0;0;0;0;0;0;716487687;720798125;26362867
1152;1.14646e-14;-220;1638;24247;19511;1;621;-2.14748e+09;-6.59505e+06;0;0;0;0;0;0;716487687;720798125;26362867
1153;1.13648e-14;-220;1680;24608;19398;1;688;-2.14748e+09;-6.57652e+06;0;0;0;0;0;0;717002714;721335954;26457835
1153;1.14646e-14;-220;1638;24247;19511;1;621;-2.14748e+09;-6.57652e+06;-1;0;0;0;-1;0;717002714;721335954;26457835
1154;1.13648e-14;-221;1680;24608;19398;1;688;-2.14748e+09;-6.55818e+06;0;0;0;0;0;0;717516414;721872508;26552818
1154;1.14646e-14;-220;1638;24247;19511;1;621;-2.14748e+09;-6.55818e+06;-1;0;0;0;-1;0;717516414;721872508;26552818
1155;1.13648e-14;-222;1680;24608;19398;1;688;-2.14748e+09;-6.54e+06;0;0;0;0;0;0;718028793;722407792;26647814
1155;1.14646e-14;-221;1638;24247;19511;1;621;-2.14748e+09;-6.54e+06;0;0;0;0;0;0;718028793;722407792;26647814
1156;1.13648e-14;-223;1680;24608;19398;1;688;-2.14748e+09;-6.52171e+06;0;0;0;0;0;0;718539855;722941809;26742824
1156;1.14646e-14;-222;1638;24247;19511;1;621;-2.14748e+09;-6.52171e+06;0;0;0;0;0;0;718539855;722941809;26742824
1157;1.13648e-14;-224;1680;24608;19398;1;688;-2.14748e+09;-6.50359e+06;0;0;0;0;0;0;719049604;723474564;26837846
1157;1.14646e-14;-223;1638;24247;19511;1;621;-2.14748e+09;-6.50359e+06;0;0;0;0;0;0;719049604;723474564;26837846
1158;1.13648e-14;-224;1680;24608;19398;1;688;-2.14748e+09;-6.48554e+06;-1;0;0;0;-1;0;719558045;724006061;26932880
1158;1.14646e-14;-223;1638;24247;19511;1;621;-2.14748e+09;-6.48554e+06;-1;0;0;0;-1;0;719558045;724006061;26932880
1159;1.13648e-14;-225;1680;24608;19398;1;688;-2.14748e+09;-6.46757e+06;0;0;0;0;0;0;720065182;724536305;27027924
1159;1.14646e-14;-223;1638;24247;19511;1;621;-2.14748e+09;-6.46757e+06;-1;0;0;0;-1;0;720065182;724536305;27027924
1160;1.13648e-14;-226;1680;24608;19398;1;688;-2.14748e+09;-6.44967e+06;0;0;0;0;0;0;720571020;725065300;27122979
1160;1.14646e-14;-224;1638;24247;19511;1;621;-2.14748e+09;-6.44967e+06;0;0;0;0;0;0;720571020;725065300;27122979
1161;1.13648e-14;-227;1680;24608;19398;1;688;-2.14748e+09;-6.43194e+06;0;0;0;0;0;0;721075563;725593049;27218044
1161;1.14646e-14;-225;1638;24247;19511;1;621;-2.14748e+09;-6.43194e+06;0;0;0;0;0;0;721075563;725593049;27218044
1162;1.13648e-14;-227;1680;24608;19398;1;688;-2.14748e+09;-6.41419e+06;-1;0;0;0;-1;0;721578816;726119558;27313117
1162;1.14646e-14;-225;1638;24247;19511;1;621;-2.14748e+09;-6.41419e+06;-1;0;0;0;-1;0;721578816;726119558;27313117
1163;1.13648e-14;-228;1680;24608;19398;1;688;-2.14748e+09;-6.39652e+06;0;0;0;0;0;0;722080783;726644830;27408198
1163;1.14646e-14;-225;1638;24247;19511;1;621;-2.14748e+09;-6.39652e+06;-1;0;0;0;-1;0;722080783;726644830;27408198
1164;1.13648e-14;-229;1680;24608;19398;1;688;-2.14748e+09;-6.37881e+06;0;0;0;0;0;0;722581468;727168869;27503287
1164;1.14646e-14;-226;1638;24247;19511;1;621;-2.14748e+09;-6.37881e+06;0;0;0;0;0;0;722581468;727168869;27503287
1165;1.13648e-14;-229;1680;24608;19398;1;688;-2.14748e+09;-6.36127e+06;-1;0;0;0;-1;0;723080876;727691680;27598382
1165;1.14646e-14;-226;1638;24247;19511;1;621;-2.14748e+09;-6.36127e+06;-1;0;0;0;-1;0;723080876;727691680;27598382
1166;1.13648e-14;-230;1680;24608;19398;1;688;-2.14748e+09;-6.34391e+06;0;0;0;0;0;0;723579010;728213267;27693484
1166;1.14646e-14;-226;1638;24247;19511;1;621;-2.14748e+09;-6.34391e+06;-1;0;0;0;-1;0;723579010;728213267;27693484
1167;1.13648e-14;-230;1680;24608;19398;1;688;-2.14748e+09;-6.32642e+06;-1;0;0;0;-1;0;724075876;728733634;27788590
1167;1.14646e-14;-227;1638;24247;19511;1;621;-2.14748e+09;-6.32642e+06;0;0;0;0;0;0;724075876;728733634;27788590
1168;1.13648e-14;-231;1680;24608;19398;1;688;-2.14748e+09;-6.30909e+06;0;0;0;0;0;0;724571478;729252786;27883701
1168;1.14646e-14;-227;1638;24247;19511;1;621;-2.14748e+09;-6.30909e+06;-1;0;0;0;-1;0;724571478;729252786;27883701
1169;1.13648e-14;-232;1680;24608;19398;1;688;-2.14748e+09;-6.29184e+06;0;0;0;0;0;0;725065819;729770725;27978817
1169;1.14646e-14;-227;1638;24247;19511;1;621;-2.14748e+09;-6.29184e+06;-1;0;0;0;-1;0;725065819;729770725;27978817
1170;1.13648e-14;-232;1680;24608;19398;1;688;-2.14748e+09;-6.27466e+06;-1;0;0;0;-1;0;725558904;730287456;28073935
1170;1.14646e-14;-227;1638;24247;19511;1;621;-2.14748e+09;-6.27466e+06;-1;0;0;0;-1;0;725558904;730287456;28073935
1171;1.13648e-14;-233;1680;24608;19398;1;688;-2.14748e+09;-6.25754e+06;0;0;0;0;0;0;726050738;730802984;28169056
1171;1.14646e-14;-227;1638;24247;19511;1;621;-2.14748e+09;-6.25754e+06;-1;0;0;0;-1;0;726050738;730802984;28169056
1172;1.13648e-14;-234;1680;24608;19398;1;688;-2.14748e+09;-6.2405e+06;0;0;0;0;0;0;726541324;731317311;28264178
1172;1.14646e-14;-228;1638;24247;19511;1;621;-2.14748e+09;-6.2405e+06;0;0;0;0;0;0;726541324;731317311;28264178
1173;1.13648e-14;-235;1680;24608;19398;1;688;-2.14748e+09;-6.22352e+06;0;0;0;0;0;0;727030666;731830443;28359302
1173;1.14646e-14;-228;1638;24247;19511;1;621;-2.14748e+09;-6.22352e+06;-1;0;0;0;-1;0;727030666;731830443;28359302
1174;1.13648e-14;-236;1680;24608;19398;1;688;-2.14748e+09;-6.20661e+06;0;0;0;0;0;0;727518769;732342383;28454426
1174;1.14646e-14;-229;1638;24247;19511;1;621;-2.14748e+09;-6.20661e+06;0;0;0;0;0;0;727518769;732342383;28454426
1175;1.13648e-14;-236;1680;24608;19398;1;688;-2.14748e+09;-6.18977e+06;-1;0;0;0;-1;0;728005637;732853135;28549551
1175;1.14646e-14;-230;1638;24247;19511;1;621;-2.14748e+09;-6.18977e+06;0;0;0;0;0;0;728005637;732853135;28549551
1176;1.13648e-14;-236;1680;24608;19398;1;688;-2.14748e+09;-6.1731e+06;-1;0;0;0;-1;0;728491274;733362703;28644674
1176;1.14646e-14;-230;1638;24247;19511;1;621;-2.14748e+09;-6.1731e+06;-1;0;0;0;-1;0;728491274;733362703;28644674
1177;1.13648e-14;-237;1680;24608;19398;1;688;-2.14748e+09;-6.15629e+06;0;0;0;0;0;0;728975684;733871091;28739796
1177;1.14646e-14;-230;1638;24247;19511;1;621;-2.14748e+09;-6.15629e+06;-1;0;0;0;-1;0;728975684;733871091;28739796
1178;1.13648e-14;-237;1680;24608;19398;1;688;-2.14748e+09;-6.13965e+06;-1;0;0;0;-1;0;729458871;734378303;28834916
1178;1.14646e-14;-230;1638;24247;19511;1;621;-2.14748e+09;-6.13965e+06;-1;0;0;0;-1;0;729458871;734378303;28834916
1179;1.13648e-14;-238;1680;24608;19398;1;688;-2.14748e+09;-6.12307e+06;0;0;0;0;0;0;729940839;734884343;28930033
1179;1.14646e-14;-231;1638;24247;19511;1;621;-2.14748e+09;-6.12307e+06;0;0;0;0;0;0;729940839;734884343;28930033
1180;1.13648e-14;-239;1680;24608;19398;1;688;-2.14748e+09;-6.10656e+06;0;0;0;0;0;0;730421593;735389214;29025146
1180;1.14646e-14;-232;1638;24247;19511;1;621;-2.14748e+09;-6.10656e+06;0;0;0;0;0;0;730421593;735389214;29025146
1181;1.13648e-14;-239;1680;24608;19398;1;688;-2.14748e+09;-6.09012e+06;-1;0;0;0;-1;0;730901136;735892921;29120256
1181;1.14646e-14;-233;1638;24247;19511;1;621;-2.14748e+09;-6.09012e+06;0;0;0;0;0;0;730901136;735892921;29120256
1182;1.13648e-14;-239;1680;24608;19398;1;688;-2.14748e+09;-6.07374e+06;-1;0;0;0;-1;0;731379471;736395466;29215360
1182;1.14646e-14;-234;1638;24247;19511;1;621;-2.14748e+09;-6.07374e+06;0;0;0;0;0;0;731379471;736395466;29215360
1183;1.13648e-14;-240;1680;24608;19398;1;688;-2.14748e+09;-6.05743e+06;0;0;0;0;0;0;731856605;736896855;29310460
1183;1.14646e-14;-234;1638;24247;19511;1;621;-2.14748e+09;-6.05743e+06;-1;0;0;0;-1;0;731856605;736896855;29310460
1184;1.13648e-14;-240;1680;24608;19398;1;688;-2.14748e+09;-6.04118e+06;-1;0;0;0;-1;0;732332539;737397091;29405553
1184;1.14646e-14;-235;1638;24247;19511;1;621;-2.14748e+09;-6.04118e+06;0;0;0;0;0;0;732332539;737397091;29405553
1185;1.13648e-14;-241;1680;24608;19398;1;688;-2.14748e+09;-6.02499e+06;0;0;0;0;0;0;732807279;737896177;29500640
1185;1.14646e-14;-235;1638;24247;19511;1;621;-2.14748e+09;-6.02499e+06;-1;0;0;0;-1;0;732807279;737896177;29500640
1186;1.13648e-14;-241;1680;24608;19398;1;688;-2.14748e+09;-6.00886e+06;-1;0;0;0;-1;0;733280827;738394117;29595719
1186;1.14646e-14;-236;1638;24247;19511;1;621;-2.14748e+09;-6.00886e+06;0;0;0;0;0;0;733280827;738394117;29595719
1187;1.13648e-14;-242;1680;24608;19398;1;688;-2.14748e+09;-5.9928e+06;0;0;0;0;0;0;733753189;738890916;29690791
1187;1.14646e-14;-237;1638;24247;19511;1;621;-2.14748e+09;-5.9928e+06;0;0;0;0;0;0;733753189;738890916;29690791
1188;1.13648e-14;-242;1680;24608;19398;1;688;-2.14748e+09;-5.97681e+06;-1;0;0;0;-1;0;734224367;739386576;29785854
1188;1.14646e-14;-238;1638;24247;19511;1;621;-2.14748e+09;-5.97681e+06;0;0;0;0;0;0;734224367;739386576;29785854
1189;1.13648e-14;-242;1680;24608;19398;1;688;-2.14748e+09;-5.96087e+06;-1;0;0;0;-1;0;734694366;739881101;29880908
1189;1.14646e-14;-239;1638;24247;19511;1;621;-2.14748e+09;-5.96087e+06;0;0;0;0;0;0;734694366;739881101;29880908
1190;1.13648e-14;-242;1680;24608;19398;1;688;-2.14748e+09;-5.945e+06;-1;0;0;0;-1;0;735163190;740374496;29975952
1190;1.14646e-14;-240;1638;24247;19511;1;621;-2.14748e+09;-5.945e+06;0;0;0;0;0;0;735163190;740374496;29975952
1191;1.13648e-14;-243;1680;24608;19398;1;688;-2.14748e+09;-5.92918e+06;0;0;0;0;0;0;735630842;740866764;30070986
1191;1.14646e-14;-240;1638;24247;19511;1;621;-2.14748e+09;-5.92918e+06;-1;0;0;0;-1;0;735630842;740866764;30070986
1192;1.13648e-14;-243;1680;24608;19398;1;688;-2.14748e+09;-5.91343e+06;-1;0;0;0;-1;0;736097327;741357907;30166009
1192;1.14646e-14;-241;1638;24247;19511;1;621;-2.14748e+09;-5.91343e+06;0;0;0;0;0;0;736097327;741357907;30166009
1193;1.13648e-14;-244;1680;24608;19398;1;688;-2.14748e+09;-5.89774e+06;0;0;0;0;0;0;736562647;741847931;30261021
1193;1.14646e-14;-242;1638;24247;19511;1;621;-2.14748e+09;-5.89774e+06;0;0;0;0;0;0;736562647;741847931;30261021
1194;1.13648e-14;-245;1680;24608;19398;1;688;-2.14748e+09;-5.88211e+06;0;0;0;0;0;0;737026808;742336838;30356020
1194;1.14646e-14;-242;1638;24247;19511;1;621;-2.14748e+09;-5.88211e+06;-1;0;0;0;-1;0;737026808;742336838;30356020
1195;1.13648e-14;-245;1680;24608;19398;1;688;-2.14748e+09;-5.86654e+06;-1;0;0;0;-1;0;737489812;742824633;30451006
1195;1.14646e-14;-242;1638;24247;19511;1;621;-2.14748e+09;-5.86654e+06;-1;0;0;0;-1;0;737489812;742824633;30451006
1196;1.13648e-14;-246;1680;24608;19398;1;688;-2.14748e+09;-5.85103e+06;0;0;0;0;0;0;737951663;743311318;30545979
1196;1.14646e-14;-243;1638;24247;19511;1;621;-2.14748e+09;-5.85103e+06;0;0;0;0;0;0;737951663;743311318;30545979
1197;1.13648e-14;-246;1680;24608;19398;1;688;-2.14748e+09;-5.83558e+06;-1;0;0;0;-1;0;738412366;743796898;30640939
1197;1.14646e-14;-243;1638;24247;19511;1;621;-2.14748e+09;-5.83558e+06;-1;0;0;0;-1;0;738412366;743796898;30640939
1198;1.13648e-14;-246;1680;24608;19398;1;688;-2.14748e+09;-5.82019e+06;-1;0;0;0;-1;0;738871923;744281375;30735883
1198;1.14646e-14;-243;1638;24247;19511;1;621;-2.14748e+09;-5.82019e+06;-1;0;0;0;-1;0;738871923;744281375;30735883
1199;1.13648e-14;-247;1680;24608;19398;1;688;-2.14748e+09;-5.80486e+06;0;0;0;0;0;0;739330339;744764754;30830813
1199;1.14646e-14;-243;1638;24247;19511;1;621;-2.14748e+09;-5.80486e+06;-1;0;0;0;-1;0;739330339;744764754;30830813
1200;1.13648e-14;-247;1680;24608;19398;1;688;-2.14748e+09;-5.78969e+06;-1;0;0;0;-1;0;739787617;745247037;30925726
1200;1.14646e-14;-244;1638;24247;19511;1;621;-2.14748e+09;-5.78959e+06;0;0;0;0;0;0;739787617;745247037;30925726
1201;1.13648e-14;-248;1680;24608;19398;1;688;-2.14748e+09;-5.77437e+06;0;0;0;0;0;0;740243761;745728229;31020624
1201;1.14646e-14;-244;1638;24247;19511;1;621;-2.14748e+09;-5.77437e+06;-1;0;0;0;-1;0;740243761;745728229;31020624
1202;1.13648e-14;-248;1680;24608;19398;1;688;-2.14748e+09;-5.75921e+06;-1;0;0;0;-1;0;740698775;746208333;31115505
1202;1.14646e-14;-245;1638;24247;19511;1;621;-2.14748e+09;-5.75921e+06;0;0;0;0;0;0;740698775;746208333;31115505
1203;1.13648e-14;-249;1680;24608;19398;1;688;-2.14748e+09;-5.74421e+06;0;0;0;0;0;0;741152661;746687352;31210368
1203;1.14646e-14;-245;1638;24247;19511;1;621;-2.14748e+09;-5.74421e+06;-1;0;0;0;-1;0;741152661;746687352;31210368
1204;1.13648e-14;-250;1680;24608;19398;1;688;-2.14748e+09;-5.72907e+06;0;0;0;0;0;0;741605425;747165289;31305213
1204;1.14646e-14;-245;1638;24247;19511;1;621;-2.14748e+09;-5.72907e+06;-1;0;0;0;-1;0;741605425;747165289;31305213
1205;1.13648e-14;-250;1680;24608;19398;1;688;-2.14748e+09;-5.71408e+06;-1;0;0;0;-1;0;742057069;747642149;31400040
1205;1.14646e-14;-245;1638;24247;19511;1;621;-2.14748e+09;-5.71408e+06;-1;0;0;0;-1;0;742057069;747642149;31400040
1206;1.13648e-14;-251;1680;24608;19398;1;688;-2.14748e+09;-5.69925e+06;0;0;0;0;0;0;742507597;748117934;31494847
1206;1.14646e-14;-245;1638;24247;19511;1;621;-2.14748e+09;-5.69925e+06;-1;0;0;0;-1;0;742507597;748117934;31494847
1207;1.13648e-14;-252;1680;24608;19398;1;688;-2.14748e+09;-5.68428e+06;0;0;0;0;0;0;742957013;748592648;31589635
1207;1.14646e-14;-245;1638;24247;19511;1;621;-2.14748e+09;-5.68428e+06;-1;0;0;0;-1;0;742957013;748592648;31589635
1208;1.13648e-14;-252;1680;24608;19398;1;688;-2.14748e+09;-5.66946e+06;-1;0;0;0;-1;0;743405319;749066294;31684403
1208;1.14646e-14;-246;1638;24247;19511;1;621;-2.14748e+09;-5.66946e+06;0;0;0;0;0;0;743405319;749066294;31684403
1209;1.13648e-14;-253;1680;24608;19398;1;688;-2.14748e+09;-5.6548e+06;0;0;0;0;0;0;743852521;749538876;31779150
1209;1.14646e-14;-246;1638;24247;19511;1;621;-2.14748e+09;-5.6548e+06;-1;0;0;0;-1;0;743852521;749538876;31779150
1210;1.13648e-14;-253;1680;24608;19398;1;688;-2.14748e+09;-5.64009e+06;-1;0;0;0;-1;0;744298620;750010397;31873875
1210;1.14646e-14;-246;1638;24247;19511;1;621;-2.14748e+09;-5.64009e+06;-1;0;0;0;-1;0;744298620;750010397;31873875
1211;1.13648e-14;-253;1680;24608;19398;1;688;-2.14748e+09;-5.62534e+06;-1;0;0;0;-1;0;744743622;750480860;31968579
1211;1.14646e-14;-246;1638;24247;19511;1;621;-2.14748e+09;-5.62534e+06;-1;0;0;0;-1;0;744743622;750480860;31968579
1212;1.13648e-14;-254;1680;24608;19398;1;688;-2.14748e+09;-5.61074e+06;0;0;0;0;0;0;745187528;750950268;32063260
1212;1.14646e-14;-246;1638;24247;19511;1;621;-2.14748e+09;-5.61074e+06;-1;0;0;0;-1;0;745187528;750950268;32063260
1213;1.13648e-14;-255;1680;24608;19398;1;688;-2.14748e+09;-5.5962e+06;0;0;0;0;0;0;745630344;751418626;32157918
1213;1.14646e-14;-247;1638;24247;19511;1;621;-2.14748e+09;-5.5962e+06;0;0;0;0;0;0;745630344;751418626;32157918
1214;1.13648e-14;-255;1680;24608;19398;1;688;-2.14748e+09;-5.58181e+06;-1;0;0;0;-1;0;746072071;751885935;32252553
1214;1.14646e-14;-248;1638;24247;19511;1;621;-2.14748e+09;-5.58181e+06;0;0;0;0;0;0;746072071;751885935;32252553
1215;1.13648e-14;-256;1680;24608;19398;1;688;-2.14748e+09;-5.56728e+06;0;0;0;0;0;0;746512714;752352200;32347164
1215;1.14646e-14;-249;1638;24247;19511;1;621;-2.14748e+09;-5.56728e+06;0;0;0;0;0;0;746512714;752352200;32347164
1216;1.13648e-14;-257;1680;24608;19398;1;688;-2.14748e+09;-5.553e+06;0;0;0;0;0;0;746952276;752817424;32441750
1216;1.14646e-14;-249;1638;24247;19511;1;621;-2.14748e+09;-5.553e+06;-1;0;0;0;-1;0;746952276;752817424;32441750
1217;1.13648e-14;-257;1680;24608;19398;1;688;-2.14748e+09;-5.53857e+06;-1;0;0;0;-1;0;747390761;753281609;32536311
1217;1.14646e-14;-250;1638;24247;19511;1;621;-2.14748e+09;-5.53857e+06;0;0;0;0;0;0;747390761;753281609;32536311
1218;1.13648e-14;-257;1680;24608;19398;1;688;-2.14748e+09;-5.5243e+06;-1;0;0;0;-1;0;747828172;753744760;32630846
1218;1.14646e-14;-250;1638;24247;19511;1;621;-2.14748e+09;-5.5243e+06;-1;0;0;0;-1;0;747828172;753744760;32630846
1219;1.13648e-14;-257;1680;24608;19398;1;688;-2.14748e+09;-5.51007e+06;-1;0;0;0;-1;0;748264511;754206878;32725356
1219;1.14646e-14;-250;1638;24247;19511;1;621;-2.14748e+09;-5.51007e+06;-1;0;0;0;-1;0;748264511;754206878;32725356
1220;1.13648e-14;-258;1680;24608;19398;1;688;-2.14748e+09;-5.4959e+06;0;0;0;0;0;0;748699784;754667969;32819838
1220;1.14646e-14;-251;1638;24247;19511;1;621;-2.14748e+09;-5.4959e+06;0;0;0;0;0;0;748699784;754667969;32819838
1221;1.13648e-14;-258;1680;24608;19398;1;688;-2.14748e+09;-5.48179e+06;-1;0;0;0;-1;0;749133992;755128034;32914294
1221;1.14646e-14;-251;1638;24247;19511;1;621;-2.14748e+09;-5.48179e+06;-1;0;0;0;-1;0;749133992;755128034;32914294
1222;1.13648e-14;-259;1680;24608;19398;1;688;-2.14748e+09;-5.46772e+06;0;0;0;0;0;0;749567140;755587076;33008721
1222;1.14646e-14;-252;1638;24247;19511;1;621;-2.14748e+09;-5.46772e+06;0;0;0;0;0;0;749567140;755587076;33008721
1223;1.13648e-14;-259;1680;24608;19398;1;688;-2.14748e+09;-5.45371e+06;-1;0;0;0;-1;0;749999230;756045100;33103121
1223;1.14646e-14;-252;1638;24247;19511;1;621;-2.14748e+09;-5.45371e+06;-1;0;0;0;-1;0;749999230;756045100;33103121
1224;1.13648e-14;-260;1680;24608;19398;1;688;-2.14748e+09;-5.43974e+06;0;0;0;0;0;0;750430267;756502107;33197492
1224;1.14646e-14;-252;1638;24247;19511;1;621;-2.14748e+09;-5.43974e+06;-1;0;0;0;-1;0;750430267;756502107;33197492
1225;1.13648e-14;-260;1680;24608;19398;1;688;-2.14748e+09;-5.42583e+06;-1;0;0;0;-1;0;750860253;756958102;33291833
1225;1.14646e-14;-252;1638;24247;19511;1;621;-2.14748e+09;-5.42583e+06;-1;0;0;0;-1;0;750860253;756958102;33291833
1226;1.13648e-14;-261;1680;24608;19398;1;688;-2.14748e+09;-5.41197e+06;0;0;0;0;0;0;751289191;757413087;33386145
1226;1.14646e-14;-253;1638;24247;19511;1;621;-2.14748e+09;-5.41197e+06;0;0;0;0;0;0;751289191;757413087;33386145
1227;1.13648e-14;-262;1680;24608;19398;1;688;-2.14748e+09;-5.39816e+06;0;0;0;0;0;0;751717085;757867066;33480427
1227;1.14646e-14;-254;1638;24247;19511;1;621;-2.14748e+09;-5.39816e+06;0;0;0;0;0;0;751717085;757867066;33480427
1228;1.13648e-14;-263;1680;24608;19398;1;688;-2.14748e+09;-5.3845e+06;0;0;0;0;0;0;752143939;758320041;33574678
1228;1.14646e-14;-254;1638;24247;19511;1;621;-2.14748e+09;-5.3845e+06;-1;0;0;0;-1;0;752143939;758320041;33574678
1229;1.13648e-14;-264;1680;24608;19398;1;688;-2.14748e+09;-5.37079e+06;0;0;0;0;0;0;752569755;758772015;33668898
1229;1.14646e-14;-254;1638;24247;19511;1;621;-2.14748e+09;-5.37079e+06;-1;0;0;0;-1;0;752569755;758772015;33668898
1230;1.13648e-14;-264;1680;24608;19398;1;688;-2.14748e+09;-5.35702e+06;-1;0;0;0;-1;0;752994536;759222992;33763086
1230;1.14646e-14;-254;1638;24247;19511;1;621;-2.14748e+09;-5.35702e+06;-1;0;0;0;-1;0;752994536;759222992;33763086
1231;1.13648e-14;-265;1680;24608;19398;1;688;-2.14748e+09;-5.34351e+06;0;0;0;0;0;0;753418286;759672975;33857242
1231;1.14646e-14;-255;1638;24247;19511;1;621;-2.14748e+09;-5.34351e+06;0;0;0;0;0;0;753418286;759672975;33857242
1232;1.13648e-14;-266;1680;24608;19398;1;688;-2.14748e+09;-5.32985e+06;0;0;0;0;0;0;753841008;760121966;33951365
1232;1.14646e-14;-255;1638;24247;19511;1;621;-2.14748e+09;-5.32985e+06;-1;0;0;0;-1;0;753841008;760121966;33951365
1233;1.13648e-14;-267;1680;24608;19398;1;688;-2.14748e+09;-5.31634e+06;0;0;0;0;0;0;754262706;760569968;34045455
1233;1.14646e-14;-256;1638;24247;19511;1;621;-2.14748e+09;-5.31634e+06;0;0;0;0;0;0;754262706;760569968;34045455
1234;1.13648e-14;-268;1680;24608;19398;1;688;-2.14748e+09;-5.30297e+06;0;0;0;0;0;0;754683382;761016985;34139512
1234;1.14646e-14;-257;1638;24247;19511;1;621;-2.14748e+09;-5.30297e+06;0;0;0;0;0;0;754683382;761016985;34139512
1235;1.13648e-14;-269;1680;24608;19398;1;688;-2.14748e+09;-5.28945e+06;0;0;0;0;0;0;755103039;761463020;34233534
1235;1.14646e-14;-258;1638;24247;19511;1;621;-2.14748e+09;-5.28945e+06;0;0;0;0;0;0;755103039;761463020;34233534
1236;1.13648e-14;-269;1680;24608;19398;1;688;-2.14748e+09;-5.27618e+06;-1;0;0;0;-1;0;755521682;761908075;34327522
1236;1.14646e-14;-259;1638;24247;19511;1;621;-2.14748e+09;-5.27608e+06;0;0;0;0;0;0;755521682;761908075;34327522
1237;1.13648e-14;-269;1680;24608;19398;1;688;-2.14748e+09;-5.26276e+06;-1;0;0;0;-1;0;755939312;762352154;34421475
1237;1.14646e-14;-259;1638;24247;19511;1;621;-2.14748e+09;-5.26276e+06;-1;0;0;0;-1;0;755939312;762352154;34421475
1238;1.13648e-14;-269;1680;24608;19398;1;688;-2.14748e+09;-5.24949e+06;-1;0;0;0;-1;0;756355933;762795259;34515393
1238;1.14646e-14;-259;1638;24247;19511;1;621;-2.14748e+09;-5.24949e+06;-1;0;0;0;-1;0;756355933;762795259;34515393
1239;1.13648e-14;-270;1680;24608;19398;1;688;-2.14748e+09;-5.23626e+06;0;0;0;0;0;0;756771548;763237393;34609274
1239;1.14646e-14;-260;1638;24247;19511;1;621;-2.14748e+09;-5.23626e+06;0;0;0;0;0;0;756771548;763237393;34609274
1240;1.13648e-14;-270;1680;24608;19398;1;688;-2.14748e+09;-5.22318e+06;-1;0;0;0;-1;0;757186161;763678560;34703119
1240;1.14646e-14;-261;1638;24247;19511;1;621;-2.14748e+09;-5.22318e+06;0;0;0;0;0;0;757186161;763678560;34703119
1241;1.13648e-14;-270;1680;24608;19398;1;688;-2.14748e+09;-5.20995e+06;-1;0;0;0;-1;0;757599773;764118761;34796927
1241;1.14646e-14;-262;1638;24247;19511;1;621;-2.14748e+09;-5.20995e+06;0;0;0;0;0;0;757599773;764118761;34796927
1242;1.13648e-14;-271;1680;24608;19398;1;688;-2.14748e+09;-5.19696e+06;0;0;0;0;0;0;758012390;764558001;34890698
1242;1.14646e-14;-262;1638;24247;19511;1;621;-2.14748e+09;-5.19696e+06;-1;0;0;0;-1;0;758012390;764558001;34890698
1243;1.13648e-14;-272;1680;24608;19398;1;688;-2.14748e+09;-5.18392e+06;0;0;0;0;0;0;758424012;764996281;34984431
1243;1.14646e-14;-263;1638;24247;19511;1;621;-2.14748e+09;-5.18392e+06;0;0;0;0;0;0;758424012;764996281;34984431
1244;1.13648e-14;-272;1680;24608;19398;1;688;-2.14748e+09;-5.17083e+06;-1;0;0;0;-1;0;758834644;765433605;35078126
1244;1.14646e-14;-264;1638;24247;19511;1;621;-2.14748e+09;-5.17083e+06;0;0;0;0;0;0;758834644;765433605;35078126
1245;1.13648e-14;-273;1680;24608;19398;1;688;-2.14748e+09;-5.15788e+06;0;0;0;0;0;0;759244289;765869976;35171783
1245;1.14646e-14;-264;1638;24247;19511;1;621;-2.14748e+09;-5.15788e+06;-1;0;0;0;-1;0;759244289;765869976;35171783
1246;1.13648e-14;-273;1680;24608;19398;1;688;-2.14748e+09;-5.14498e+06;-1;0;0;0;-1;0;759652949;766305396;35265400
1246;1.14646e-14;-265;1638;24247;19511;1;621;-2.14748e+09;-5.14498e+06;0;0;0;0;0;0;759652949;766305396;35265400
1247;1.13648e-14;-273;1680;24608;19398;1;688;-2.14748e+09;-5.13222e+06;-1;0;0;0;-1;0;760060627;766739868;35358977
1247;1.14646e-14;-266;1638;24247;19511;1;621;-2.14748e+09;-5.13222e+06;0;0;0;0;0;0;760060627;766739868;35358977
1248;1.13648e-14;-274;1680;24608;19398;1;688;-2.14748e+09;-5.11931e+06;0;0;0;0;0;0;760467328;767173396;35452515
1248;1.14646e-14;-266;1638;24247;19511;1;621;-2.14748e+09;-5.11931e+06;-1;0;0;0;-1;0;760467328;767173396;35452515
1249;1.13648e-14;-274;1680;24608;19398;1;688;-2.14748e+09;-5.10655e+06;-1;0;0;0;-1;0;760873052;767605981;35546012
1249;1.14646e-14;-266;1638;24247;19511;1;621;-2.14748e+09;-5.10655e+06;-1;0;0;0;-1;0;760873052;767605981;35546012
1250;1.13648e-14;-275;1680;24608;19398;1;688;-2.14748e+09;-5.09382e+06;0;0;0;0;0;0;761277804;768037626;35639468
1250;1.14646e-14;-267;1638;24247;19511;1;621;-2.14748e+09;-5.09382e+06;0;0;0;0;0;0;761277804;768037626;35639468
1251;1.13648e-14;-276;1680;24608;19398;1;688;-2.14748e+09;-5.08115e+06;0;0;0;0;0;0;761681587;768468335;35732884
1251;1.14646e-14;-267;1638;24247;19511;1;621;-2.14748e+09;-5.08115e+06;-1;0;0;0;-1;0;761681587;768468335;35732884
1252;1.13648e-14;-276;1680;24608;19398;1;688;-2.14748e+09;-5.06852e+06;-1;0;0;0;-1;0;762084403;768898111;35826257
1252;1.14646e-14;-267;1638;24247;19511;1;621;-2.14748e+09;-5.06852e+06;-1;0;0;0;-1;0;762084403;768898111;35826257
1253;1.13648e-14;-277;1680;24608;19398;1;688;-2.14748e+09;-5.05592e+06;0;0;0;0;0;0;762486256;769326955;35919588
1253;1.14646e-14;-268;1638;24247;19511;1;621;-2.14748e+09;-5.05592e+06;0;0;0;0;0;0;762486256;769326955;35919588
1254;1.13648e-14;-277;1680;24608;19398;1;688;-2.14748e+09;-5.04348e+06;-1;0;0;0;-1;0;762887147;769754870;36012877
1254;1.14646e-14;-268;1638;24247;19511;1;621;-2.14748e+09;-5.04348e+06;-1;0;0;0;-1;0;762887147;769754870;36012877
1255;1.13648e-14;-277;1680;24608;19398;1;688;-2.14748e+09;-5.03088e+06;-1;0;0;0;-1;0;763287081;770181860;36106123
1255;1.14646e-14;-268;1638;24247;19511;1;621;-2.14748e+09;-5.03088e+06;-1;0;0;0;-1;0;763287081;770181860;36106123
1256;1.13648e-14;-278;1680;24608;19398;1;688;-2.14748e+09;-5.01842e+06;0;0;0;0;0;0;763686060;770607927;36199325
1256;1.14646e-14;-268;1638;24247;19511;1;621;-2.14748e+09;-5.01842e+06;-1;0;0;0;-1;0;763686060;770607927;36199325
1257;1.13648e-14;-279;1680;24608;19398;1;688;-2.14748e+09;-5.006e+06;0;0;0;0;0;0;764084087;771033073;36292484
1257;1.14646e-14;-269;1638;24247;19511;1;621;-2.14748e+09;-5.006e+06;0;0;0;0;0;0;764084087;771033073;36292484
1258;1.13648e-14;-280;1680;24608;19398;1;688;-2.14748e+09;-4.99363e+06;0;0;0;0;0;0;764481165;771457302;36385598
1258;1.14646e-14;-269;1638;24247;19511;1;621;-2.14748e+09;-4.99363e+06;-1;0;0;0;-1;0;764481165;771457302;36385598
1259;1.13648e-14;-281;1680;24608;19398;1;688;-2.14748e+09;-4.9813e+06;0;0;0;0;0;0;764877296;771880617;36478668
1259;1.14646e-14;-269;1638;24247;19511;1;621;-2.14748e+09;-4.9813e+06;-1;0;0;0;-1;0;764877296;771880617;36478668
1260;1.13648e-14;-281;1680;24608;19398;1;688;-2.14748e+09;-4.96901e+06;-1;0;0;0;-1;0;765272484;772303018;36571692
1260;1.14646e-14;-270;1638;24247;19511;1;621;-2.14748e+09;-4.96901e+06;0;0;0;0;0;0;765272484;772303018;36571692
1261;1.13648e-14;-281;1680;24608;19398;1;688;-2.14748e+09;-4.95687e+06;-1;0;0;0;-1;0;765666731;772724510;36664672
1261;1.14646e-14;-271;1638;24247;19511;1;621;-2.14748e+09;-4.95687e+06;0;0;0;0;0;0;765666731;772724510;36664672
1262;1.13648e-14;-282;1680;24608;19398;1;688;-2.14748e+09;-4.94456e+06;0;0;0;0;0;0;766060041;773145096;36757605
1262;1.14646e-14;-272;1638;24247;19511;1;621;-2.14748e+09;-4.94456e+06;0;0;0;0;0;0;766060041;773145096;36757605
1263;1.13648e-14;-283;1680;24608;19398;1;688;-2.14748e+09;-4.9325e+06;0;0;0;0;0;0;766452415;773564777;36850492
1263;1.14646e-14;-273;1638;24247;19511;1;621;-2.14748e+09;-4.9325e+06;0;0;0;0;0;0;766452415;773564777;36850492
1264;1.13648e-14;-283;1680;24608;19398;1;688;-2.14748e+09;-4.92028e+06;-1;0;0;0;-1;0;766843858;773983556;36943333
1264;1.14646e-14;-273;1638;24247;19511;1;621;-2.14748e+09;-4.92028e+06;-1;0;0;0;-1;0;766843858;773983556;36943333
1265;1.13648e-14;-284;1680;24608;19398;1;688;-2.14748e+09;-4.90821e+06;0;0;0;0;0;0;767234371;774401436;37036127
1265;1.14646e-14;-273;1638;24247;19511;1;621;-2.14748e+09;-4.90821e+06;-1;0;0;0;-1;0;767234371;774401436;37036127
1266;1.13648e-14;-284;1680;24608;19398;1;688;-2.14748e+09;-4.89617e+06;-1;0;0;0;-1;0;767623957;774818419;37128873
1266;1.14646e-14;-273;1638;24247;19511;1;621;-2.14748e+09;-4.89617e+06;-1;0;0;0;-1;0;767623957;774818419;37128873
1267;1.13648e-14;-285;1680;24608;19398;1;688;-2.14748e+09;-4.88417e+06;0;0;0;0;0;0;768012620;775234509;37221571
1267;1.14646e-14;-274;1638;24247;19511;1;621;-2.14748e+09;-4.88417e+06;0;0;0;0;0;0;768012620;775234509;37221571
1268;1.13648e-14;-286;1680;24608;19398;1;688;-2.14748e+09;-4.87232e+06;0;0;0;0;0;0;768400361;775649707;37314221
1268;1.14646e-14;-274;1638;24247;19511;1;621;-2.14748e+09;-4.87222e+06;-1;0;0;0;-1;0;768400361;775649707;37314221
1269;1.13648e-14;-286;1680;24608;19398;1;688;-2.14748e+09;-4.8603e+06;-1;0;0;0;-1;0;768787185;776064016;37406823
1269;1.14646e-14;-275;1638;24247;19511;1;621;-2.14748e+09;-4.8603e+06;0;0;0;0;0;0;768787185;776064016;37406823
1270;1.13648e-14;-286;1680;24608;19398;1;688;-2.14748e+09;-4.84843e+06;-1;0;0;0;-1;0;769173092;776477439;37499376
1270;1.14646e-14;-276;1638;24247;19511;1;621;-2.14748e+09;-4.84843e+06;0;0;0;0;0;0;769173092;776477439;37499376
1271;1.13648e-14;-286;1680;24608;19398;1;688;-2.14748e+09;-4.83659e+06;-1;0;0;0;-1;0;769558087;776889978;37591879
1271;1.14646e-14;-277;1638;24247;19511;1;621;-2.14748e+09;-4.83659e+06;0;0;0;0;0;0;769558087;776889978;37591879
1272;1.13648e-14;-286;1680;24608;19398;1;688;-2.14748e+09;-4.8248e+06;-1;0;0;0;-1;0;769942172;777301636;37684333
1272;1.14646e-14;-278;1638;24247;19511;1;621;-2.14748e+09;-4.8248e+06;0;0;0;0;0;0;769942172;777301636;37684333
1273;1.13648e-14;-287;1680;24608;19398;1;688;-2.14748e+09;-4.81304e+06;0;0;0;0;0;0;770325349;777712415;37776737
1273;1.14646e-14;-279;1638;24247;19511;1;621;-2.14748e+09;-4.81304e+06;0;0;0;0;0;0;770325349;777712415;37776737
1274;1.13648e-14;-287;1680;24608;19398;1;688;-2.14748e+09;-4.80143e+06;-1;0;0;0;-1;0;770707622;778122319;37869090
1274;1.14646e-14;-279;1638;24247;19511;1;621;-2.14748e+09;-4.80133e+06;-1;0;0;0;-1;0;770707622;778122319;37869090
1275;1.13648e-14;-287;1680;24608;19398;1;688;-2.14748e+09;-4.78965e+06;-1;0;0;0;-1;0;771088992;778531348;37961393
1275;1.14646e-14;-279;1638;24247;19511;1;621;-2.14748e+09;-4.78965e+06;-1;0;0;0;-1;0;771088992;778531348;37961393
1276;1.13648e-14;-288;1680;24608;19398;1;688;-2.14748e+09;-4.77802e+06;0;0;0;0;0;0;771469464;778939506;38053644
1276;1.14646e-14;-279;1638;24247;19511;1;621;-2.14748e+09;-4.77802e+06;-1;0;0;0;-1;0;771469464;778939506;38053644
1277;1.13648e-14;-289;1680;24608;19398;1;688;-2.14748e+09;-4.76642e+06;0;0;0;0;0;0;771849038;779346796;38145844
1277;1.14646e-14;-279;1638;24247;19511;1;621;-2.14748e+09;-4.76642e+06;-1;0;0;0;-1;0;771849038;779346796;38145844
1278;1.13648e-14;-290;1680;24608;19398;1;688;-2.14748e+09;-4.75486e+06;0;0;0;0;0;0;772227718;779753219;38237992
1278;1.14646e-14;-280;1638;24247;19511;1;621;-2.14748e+09;-4.75486e+06;0;0;0;0;0;0;772227718;779753219;38237992
1279;1.13648e-14;-291;1680;24608;19398;1;688;-2.14748e+09;-4.74334e+06;0;0;0;0;0;0;772605507;780158778;38330088
1279;1.14646e-14;-280;1638;24247;19511;1;621;-2.14748e+09;-4.74334e+06;0;0;-1;0;0;-1;772605507;780158778;38330088
1280;1.13648e-14;-291;1680;24608;19398;1;688;-2.14748e+09;-4.73186e+06;-1;0;0;0;-1;0;772982407;780563476;38422131
1280;1.14646e-14;-281;1638;24247;19511;1;621;-2.14748e+09;-4.73186e+06;0;0;0;0;0;0;772982407;780563476;38422131
1281;1.13648e-14;-291;1680;24608;19398;1;688;-2.14748e+09;-4.72042e+06;-1;0;0;0;-1;0;773358422;780967315;38514121
1281;1.14646e-14;-281;1638;24247;19511;1;621;-2.14748e+09;-4.72042e+06;-1;0;0;0;-1;0;773358422;780967315;38514121
1282;1.13648e-14;-291;1680;24608;19398;1;688;-2.14748e+09;-4.70901e+06;-1;0;0;0;-1;0;773733552;781370298;38606058
1282;1.14646e-14;-282;1638;24247;19511;1;621;-2.14748e+09;-4.70901e+06;0;0;0;0;0;0;773733552;781370298;38606058
1283;1.13648e-14;-292;1680;24608;19398;1;688;-2.14748e+09;-4.69774e+06;0;0;0;0;0;0;774107802;781772426;38697941
1283;1.14646e-14;-282;1638;24247;19511;1;621;-2.14748e+09;-4.69774e+06;-1;0;0;0;-1;0;774107802;781772426;38697941
1284;1.13648e-14;-292;1680;24608;19398;1;688;-2.14748e+09;-4.68632e+06;-1;0;0;0;-1;0;774481173;782173703;38789771
1284;1.14646e-14;-282;1638;24247;19511;1;621;-2.14748e+09;-4.68632e+06;-1;0;0;0;-1;0;774481173;782173703;38789771
1285;1.13648e-14;-293;1680;24608;19398;1;688;-2.14748e+09;-4.67502e+06;0;0;0;0;0;0;774853668;782574131;38881545
1285;1.14646e-14;-282;1638;24247;19511;1;621;-2.14748e+09;-4.67502e+06;-1;0;0;0;-1;0;774853668;782574131;38881545
1286;1.13648e-14;-294;1680;24608;19398;1;688;-2.14748e+09;-4.66377e+06;0;0;0;0;0;0;775225290;782973711;38973266
1286;1.14646e-14;-283;1638;24247;19511;1;621;-2.14748e+09;-4.66377e+06;0;0;0;0;0;0;775225290;782973711;38973266
1287;1.13648e-14;-295;1680;24608;19398;1;688;-2.14748e+09;-4.65265e+06;0;0;0;0;0;0;775596042;783372447;39064931
1287;1.14646e-14;-283;1638;24247;19511;1;621;-2.14748e+09;-4.65265e+06;-1;0;0;0;-1;0;775596042;783372447;39064931
1288;1.13648e-14;-296;1680;24608;19398;1;688;-2.14748e+09;-4.64137e+06;0;0;0;0;0;0;775965925;783770341;39156541
1288;1.14646e-14;-284;1638;24247;19511;1;621;-2.14748e+09;-4.64137e+06;0;0;0;0;0;0;775965925;783770341;39156541
1289;1.13648e-14;-296;1680;24608;19398;1;688;-2.14748e+09;-4.63022e+06;-1;0;0;0;-1;0;776334942;784167395;39248095
1289;1.14646e-14;-284;1638;24247;19511;1;621;-2.14748e+09;-4.63022e+06;-1;0;0;0;-1;0;776334942;784167395;39248095
1290;1.13648e-14;-297;1680;24608;19398;1;688;-2.14748e+09;-4.61912e+06;0;0;0;0;0;0;776703097;784563611;39339593
1290;1.14646e-14;-285;1638;24247;19511;1;621;-2.14748e+09;-4.61912e+06;0;0;0;0;0;0;776703097;784563611;39339593
1291;1.13648e-14;-297;1680;24608;19398;1;688;-2.14748e+09;-4.60805e+06;-1;0;0;0;-1;0;777070391;784958992;39431035
1291;1.14646e-14;-285;1638;24247;19511;1;621;-2.14748e+09;-4.60805e+06;-1;0;0;0;-1;0;777070391;784958992;39431035
1292;1.13648e-14;-298;1680;24608;19398;1;688;-2.14748e+09;-4.59701e+06;0;0;0;0;0;0;777436827;785353541;39522420
1292;1.14646e-14;-285;1638;24247;19511;1;621;-2.14748e+09;-4.59701e+06;-1;0;0;0;-1;0;777436827;785353541;39522420
1293;1.13648e-14;-298;1680;24608;19398;1;688;-2.14748e+09;-4.58601e+06;-1;0;0;0;-1;0;777802408;785747258;39613749
1293;1.14646e-14;-286;1638;24247;19511;1;621;-2.14748e+09;-4.58601e+06;0;0;0;0;0;0;777802408;785747258;39613749
1294;1.13648e-14;-299;1680;24608;19398;1;688;-2.14748e+09;-4.57515e+06;0;0;0;0;0;0;778167135;786140148;39705019
1294;1.14646e-14;-286;1638;24247;19511;1;621;-2.14748e+09;-4.57515e+06;-1;0;0;0;-1;0;778167135;786140148;39705019
1295;1.13648e-14;-300;1680;24608;19398;1;688;-2.14748e+09;-4.56422e+06;0;0;0;0;0;0;778531012;786532212;39796233
1295;1.14646e-14;-286;1638;24247;19511;1;621;-2.14748e+09;-4.56422e+06;-1;0;0;0;-1;0;778531012;786532212;39796233
1296;1.13648e-14;-301;1680;24608;19398;1;688;-2.14748e+09;-4.55323e+06;0;0;0;0;0;0;778894041;786923452;39887388
1296;1.14646e-14;-286;1638;24247;19511;1;621;-2.14748e+09;-4.55323e+06;-1;0;0;0;-1;0;778894041;786923452;39887388
1297;1.13648e-14;-302;1680;24608;19398;1;688;-2.14748e+09;-4.54248e+06;0;0;0;0;0;0;779256224;787313870;39978485
1297;1.14646e-14;-287;1638;24247;19511;1;621;-2.14748e+09;-4.54248e+06;0;0;0;0;0;0;779256224;787313870;39978485
1298;1.13648e-14;-302;1680;24608;19398;1;688;-2.14748e+09;-4.53156e+06;-1;0;0;0;-1;0;779617564;787703470;40069523
1298;1.14646e-14;-288;1638;24247;19511;1;621;-2.14748e+09;-4.53156e+06;0;0;0;0;0;0;779617564;787703470;40069523
1299;1.13648e-14;-302;1680;24608;19398;1;688;-2.14748e+09;-4.52087e+06;-1;0;0;0;-1;0;779978064;788092252;40160503
1299;1.14646e-14;-288;1638;24247;19511;1;621;-2.14748e+09;-4.52087e+06;-1;0;0;0;-1;0;779978064;788092252;40160503
1300;1.13648e-14;-302;1680;24608;19398;1;688;-2.14748e+09;-4.51002e+06;-1;0;0;0;-1;0;780337724;788480220;40251423
1300;1.14646e-14;-288;1638;24247;19511;1;621;-2.14748e+09;-4.51002e+06;-1;0;0;0;-1;0;780337724;788480220;40251423
1301;1.13648e-14;-303;1680;24608;19398;1;688;-2.14748e+09;-4.4994e+06;0;0;0;0;0;0;780696550;788867376;40342284
1301;1.14646e-14;-289;1638;24247;19511;1;621;-2.14748e+09;-4.4994e+06;0;0;0;0;0;0;780696550;788867376;40342284
1302;1.13648e-14;-303;1680;24608;19398;1;688;-2.14748e+09;-4.48862e+06;-1;0;0;0;-1;0;781054541;789253721;40433085
1302;1.14646e-14;-290;1638;24247;19511;1;621;-2.14748e+09;-4.48862e+06;0;0;0;0;0;0;781054541;789253721;40433085
1303;1.13648e-14;-304;1680;24608;19398;1;688;-2.14748e+09;-4.47798e+06;0;0;0;0;0;0;781411702;789639259;40523826
1303;1.14646e-14;-291;1638;24247;19511;1;621;-2.14748e+09;-4.47798e+06;0;0;0;0;0;0;781411702;789639259;40523826
1304;1.13648e-14;-304;1680;24608;19398;1;688;-2.14748e+09;-4.46746e+06;-1;0;0;0;-1;0;781768033;790023991;40614507
1304;1.14646e-14;-292;1638;24247;19511;1;621;-2.14748e+09;-4.46746e+06;0;0;0;0;0;0;781768033;790023991;40614507
1305;1.13648e-14;-305;1680;24608;19398;1;688;-2.14748e+09;-4.45678e+06;0;0;0;0;0;0;782123539;790407919;40705126
1305;1.14646e-14;-292;1638;24247;19511;1;621;-2.14748e+09;-4.45678e+06;-1;0;0;0;-1;0;782123539;790407919;40705126
1306;1.13648e-14;-305;1680;24608;19398;1;688;-2.14748e+09;-4.44624e+06;-1;0;0;0;-1;0;782478220;790791046;40795685
1306;1.14646e-14;-292;1638;24247;19511;1;621;-2.14748e+09;-4.44624e+06;-1;0;0;0;-1;0;782478220;790791046;40795685
1307;1.13648e-14;-305;1680;24608;19398;1;688;-2.14748e+09;-4.43573e+06;-1;0;0;0;-1;0;782832080;791173374;40886183
1307;1.14646e-14;-292;1638;24247;19511;1;621;-2.14748e+09;-4.43573e+06;-1;0;0;0;-1;0;782832080;791173374;40886183
1308;1.13648e-14;-306;1680;24608;19398;1;688;-2.14748e+09;-4.42535e+06;0;0;0;0;0;0;783185121;791554905;40976618
1308;1.14646e-14;-293;1638;24247;19511;1;621;-2.14748e+09;-4.42535e+06;0;0;0;0;0;0;783185121;791554905;40976618
1309;1.13648e-14;-306;1680;24608;19398;1;688;-2.14748e+09;-4.41481e+06;-1;0;0;0;-1;0;783537345;791935641;41066992
1309;1.14646e-14;-294;1638;24247;19511;1;621;-2.14748e+09;-4.41481e+06;0;0;0;0;0;0;783537345;791935641;41066992
1310;1.13648e-14;-306;1680;24608;19398;1;688;-2.14748e+09;-4.4045e+06;-1;0;0;0;-1;0;783888754;792315585;41157304
1310;1.14646e-14;-294;1638;24247;19511;1;621;-2.14748e+09;-4.4045e+06;-1;0;0;0;-1;0;783888754;792315585;41157304
1311;1.13648e-14;-307;1680;24608;19398;1;688;-2.14748e+09;-4.39402e+06;0;0;0;0;0;0;784239351;792694738;41247553
1311;1.14646e-14;-294;1638;24247;19511;1;621;-2.14748e+09;-4.39402e+06;-1;0;0;0;-1;0;784239351;792694738;41247553
1312;1.13648e-14;-307;1680;24608;19398;1;688;-2.14748e+09;-4.38368e+06;-1;0;0;0;-1;0;784589139;793073102;41337740
1312;1.14646e-14;-295;1638;24247;19511;1;621;-2.14748e+09;-4.38368e+06;0;0;0;0;0;0;784589139;793073102;41337740
1313;1.13648e-14;-307;1680;24608;19398;1;688;-2.14748e+09;-4.37346e+06;-1;0;0;0;-1;0;784938119;793450681;41427864
1313;1.14646e-14;-295;1638;24247;19511;1;621;-2.14748e+09;-4.37346e+06;-1;0;0;0;-1;0;784938119;793450681;41427864
1314;1.13648e-14;-308;1680;24608;19398;1;688;-2.14748e+09;-4.36308e+06;0;0;0;0;0;0;785286293;793827475;41517924
1314;1.14646e-14;-295;1638;24247;19511;1;621;-2.14748e+09;-4.36308e+06;-1;0;0;0;-1;0;785286293;793827475;41517924
1315;1.13648e-14;-309;1680;24608;19398;1;688;-2.14748e+09;-4.35294e+06;0;0;0;0;0;0;785633665;794203487;41607920
1315;1.14646e-14;-295;1638;24247;19511;1;621;-2.14748e+09;-4.35294e+06;-1;0;0;0;-1;0;785633665;794203487;41607920
1316;1.13648e-14;-309;1680;24608;19398;1;688;-2.14748e+09;-4.34262e+06;-1;0;0;0;-1;0;785980235;794578720;41697853
1316;1.14646e-14;-296;1638;24247;19511;1;621;-2.14748e+09;-4.34262e+06;0;0;0;0;0;0;785980235;794578720;41697853
1317;1.13648e-14;-310;1680;24608;19398;1;688;-2.14748e+09;-4.33254e+06;0;0;0;0;0;0;786326008;794953175;41787722
1317;1.14646e-14;-297;1638;24247;19511;1;621;-2.14748e+09;-4.33254e+06;0;0;0;0;0;0;786326008;794953175;41787722
1318;1.13648e-14;-310;1680;24608;19398;1;688;-2.14748e+09;-4.32229e+06;-1;0;0;0;-1;0;786670984;795326854;41877526
1318;1.14646e-14;-297;1638;24247;19511;1;621;-2.14748e+09;-4.32229e+06;-1;0;0;0;-1;0;786670984;795326854;41877526
1319;1.13648e-14;-310;1680;24608;19398;1;688;-2.14748e+09;-4.31218e+06;-1;0;0;0;-1;0;787015166;795699759;41967266
1319;1.14646e-14;-297;1638;24247;19511;1;621;-2.14748e+09;-4.31218e+06;-1;0;0;0;-1;0;787015166;795699759;41967266
1320;1.13648e-14;-310;1680;24608;19398;1;688;-2.14748e+09;-4.30219e+06;-1;0;0;0;-1;0;787358557;796071893;42056940
1320;1.14646e-14;-297;1638;24247;19511;1;621;-2.14748e+09;-4.30219e+06;-1;0;0;0;-1;0;787358557;796071893;42056940
1321;1.13648e-14;-311;1680;24608;19398;1;688;-2.14748e+09;-4.29204e+06;0;0;0;0;0;0;787701158;796443257;42146550
1321;1.14646e-14;-297;1638;24247;19511;1;621;-2.14748e+09;-4.29204e+06;-1;0;0;0;-1;0;787701158;796443257;42146550
1322;1.13648e-14;-311;1680;24608;19398;1;688;-2.14748e+09;-4.28211e+06;-1;0;0;0;-1;0;788042973;796813854;42236094
1322;1.14646e-14;-297;1638;24247;19511;1;621;-2.14748e+09;-4.28211e+06;-1;0;0;0;-1;0;788042973;796813854;42236094
1323;1.13648e-14;-311;1680;24608;19398;1;688;-2.14748e+09;-4.27202e+06;-1;0;0;0;-1;0;788384002;797183686;42325572
1323;1.14646e-14;-298;1638;24247;19511;1;621;-2.14748e+09;-4.27202e+06;0;0;0;0;0;0;788384002;797183686;42325572
1324;1.13648e-14;-312;1680;24608;19398;1;688;-2.14748e+09;-4.26206e+06;0;0;0;0;0;0;788724249;797552754;42414984
1324;1.14646e-14;-298;1638;24247;19511;1;621;-2.14748e+09;-4.26206e+06;-1;0;0;0;-1;0;788724249;797552754;42414984
1325;1.13648e-14;-312;1680;24608;19398;1;688;-2.14748e+09;-4.25213e+06;-1;0;0;0;-1;0;789063715;797921061;42504330
1325;1.14646e-14;-298;1638;24247;19511;1;621;-2.14748e+09;-4.25213e+06;-1;0;0;0;-1;0;789063715;797921061;42504330
1326;1.13648e-14;-313;1680;24608;19398;1;688;-2.14748e+09;-4.24224e+06;0;0;0;0;0;0;789402403;798288609;42593610
1326;1.14646e-14;-298;1638;24247;19511;1;621;-2.14748e+09;-4.24224e+06;-1;0;0;0;-1;0;789402403;798288609;42593610
1327;1.13648e-14;-314;1680;24608;19398;1;688;-2.14748e+09;-4.23237e+06;0;0;0;0;0;0;789740314;798655400;42682823
1327;1.14646e-14;-298;1638;24247;19511;1;621;-2.14748e+09;-4.23237e+06;-1;0;0;0;-1;0;789740314;798655400;42682823
1328;1.13648e-14;-315;1680;24608;19398;1;688;-2.14748e+09;-4.22253e+06;0;0;0;0;0;0;790077452;799021435;42771969
1328;1.14646e-14;-299;1638;24247;19511;1;621;-2.14748e+09;-4.22253e+06;0;0;0;0;0;0;790077452;799021435;42771969
1329;1.13648e-14;-316;1680;24608;19398;1;688;-2.14748e+09;-4.21272e+06;0;0;0;0;0;0;790413818;799386717;42861047
1329;1.14646e-14;-300;1638;24247;19511;1;621;-2.14748e+09;-4.21272e+06;0;0;0;0;0;0;790413818;799386717;42861047
1330;1.13648e-14;-317;1680;24608;19398;1;688;-2.14748e+09;-4.20295e+06;0;0;0;0;0;0;790749415;799751248;42950058
1330;1.14646e-14;-300;1638;24247;19511;1;621;-2.14748e+09;-4.20295e+06;-1;0;0;0;-1;0;790749415;799751248;42950058
1331;1.13648e-14;-318;1680;24608;19398;1;688;-2.14748e+09;-4.1933e+06;0;0;0;0;0;0;791084244;800115029;43039001
1331;1.14646e-14;-301;1638;24247;19511;1;621;-2.14748e+09;-4.1933e+06;0;0;0;0;0;0;791084244;800115029;43039001
1332;1.13648e-14;-318;1680;24608;19398;1;688;-2.14748e+09;-4.18359e+06;-1;0;0;0;-1;0;791418307;800478064;43127877
1332;1.14646e-14;-302;1638;24247;19511;1;621;-2.14748e+09;-4.18359e+06;0;0;0;0;0;0;791418307;800478064;43127877
1333;1.13648e-14;-319;1680;24608;19398;1;688;-2.14748e+09;-4.1738e+06;0;0;0;0;0;0;791751608;800840353;43216684
1333;1.14646e-14;-303;1638;24247;19511;1;621;-2.14748e+09;-4.1738e+06;0;0;0;0;0;0;791751608;800840353;43216684
1334;1.13648e-14;-320;1680;24608;19398;1;688;-2.14748e+09;-4.16415e+06;0;0;0;0;0;0;792084148;801201898;43305422
1334;1.14646e-14;-303;1638;24247;19511;1;621;-2.14748e+09;-4.16415e+06;-1;0;0;0;-1;0;792084148;801201898;43305422
1335;1.13648e-14;-320;1680;24608;19398;1;688;-2.14748e+09;-4.15452e+06;-1;0;0;0;-1;0;792415928;801562702;43394092
1335;1.14646e-14;-304;1638;24247;19511;1;621;-2.14748e+09;-4.15452e+06;0;0;0;0;0;0;792415928;801562702;43394092
1336;1.13648e-14;-321;1680;24608;19398;1;688;-2.14748e+09;-4.14493e+06;0;0;0;0;0;0;792746952;801922767;43482693
1336;1.14646e-14;-304;1638;24247;19511;1;621;-2.14748e+09;-4.14493e+06;-1;0;0;0;-1;0;792746952;801922767;43482693
1337;1.13648e-14;-322;1680;24608;19398;1;688;-2.14748e+09;-4.13536e+06;0;0;0;0;0;0;793077222;802282094;43571225
1337;1.14646e-14;-304;1638;24247;19511;1;621;-2.14748e+09;-4.13536e+06;-1;0;0;0;-1;0;793077222;802282094;43571225
1338;1.13648e-14;-322;1680;24608;19398;1;688;-2.14748e+09;-4.12582e+06;-1;0;0;0;-1;0;793406739;802640686;43659687
1338;1.14646e-14;-304;1638;24247;19511;1;621;-2.14748e+09;-4.12582e+06;-1;0;0;0;-1;0;793406739;802640686;43659687
1339;1.13648e-14;-322;1680;24608;19398;1;688;-2.14748e+09;-4.11631e+06;-1;0;0;0;-1;0;793735505;802998544;43748080
1339;1.14646e-14;-304;1638;24247;19511;1;621;-2.14748e+09;-4.11631e+06;-1;0;0;0;-1;0;793735505;802998544;43748080
1340;1.13648e-14;-323;1680;24608;19398;1;688;-2.14748e+09;-4.10683e+06;0;0;0;0;0;0;794063524;803355670;43836403
1340;1.14646e-14;-304;1638;24247;19511;1;621;-2.14748e+09;-4.10683e+06;-1;0;0;0;-1;0;794063524;803355670;43836403
1341;1.13648e-14;-324;1680;24608;19398;1;688;-2.14748e+09;-4.09748e+06;0;0;0;0;0;0;794390795;803712066;43924656
1341;1.14646e-14;-305;1638;24247;19511;1;621;-2.14748e+09;-4.09748e+06;0;0;0;0;0;0;794390795;803712066;43924656
1342;1.13648e-14;-325;1680;24608;19398;1;688;-2.14748e+09;-4.08806e+06;0;0;0;0;0;0;794717323;804067735;44012838
1342;1.14646e-14;-306;1638;24247;19511;1;621;-2.14748e+09;-4.08796e+06;0;0;0;0;0;0;794717323;804067735;44012838
1343;1.13648e-14;-325;1680;24608;19398;1;688;-2.14748e+09;-4.07857e+06;-1;0;0;0;-1;0;795043109;804422677;44100950
1343;1.14646e-14;-306;1638;24247;19511;1;621;-2.14748e+09;-4.07857e+06;-1;0;0;0;-1;0;795043109;804422677;44100950
1344;1.13648e-14;-326;1680;24608;19398;1;688;-2.14748e+09;-4.0692e+06;0;0;0;0;0;0;795368154;804776895;44188991
1344;1.14646e-14;-306;1638;24247;19511;1;621;-2.14748e+09;-4.06921e+06;-1;0;0;0;-1;0;795368154;804776895;44188991
1345;1.13648e-14;-326;1680;24608;19398;1;688;-2.14748e+09;-4.05987e+06;-1;0;0;0;-1;0;795692462;805130391;44276961
1345;1.14646e-14;-306;1638;24247;19511;1;621;-2.14748e+09;-4.05987e+06;-1;0;0;0;-1;0;795692462;805130391;44276961
1346;1.13648e-14;-327;1680;24608;19398;1;688;-2.14748e+09;-4.05056e+06;0;0;0;0;0;0;796016033;805483167;44364860
1346;1.14646e-14;-306;1638;24247;19511;1;621;-2.14748e+09;-4.05056e+06;-1;0;0;0;-1;0;796016033;805483167;44364860
1347;1.13648e-14;-327;1680;24608;19398;1;688;-2.14748e+09;-4.04128e+06;-1;0;0;0;-1;0;796338871;805835224;44452688
1347;1.14646e-14;-307;1638;24247;19511;1;621;-2.14748e+09;-4.04128e+06;0;0;0;0;0;0;796338871;805835224;44452688
1348;1.13648e-14;-327;1680;24608;19398;1;688;-2.14748e+09;-4.03203e+06;-1;0;0;0;-1;0;796660977;806186564;44540444
1348;1.14646e-14;-308;1638;24247;19511;1;621;-2.14748e+09;-4.03203e+06;0;0;0;0;0;0;796660977;806186564;44540444
1349;1.13648e-14;-328;1680;24608;19398;1;688;-2.14748e+09;-4.02281e+06;0;0;0;0;0;0;796982353;806537190;44628128
1349;1.14646e-14;-309;1638;24247;19511;1;621;-2.14748e+09;-4.02281e+06;0;0;0;0;0;0;796982353;806537190;44628128
1350;1.13648e-14;-328;1680;24608;19398;1;688;-2.14748e+09;-4.01361e+06;-1;0;0;0;-1;0;797303001;806887102;44715740
1350;1.14646e-14;-309;1638;24247;19511;1;621;-2.14748e+09;-4.01361e+06;-1;0;0;0;-1;0;797303001;806887102;44715740
1351;1.13648e-14;-329;1680;24608;19398;1;688;-2.14748e+09;-4.00444e+06;0;0;0;0;0;0;797622923;807236304;44803279
1351;1.14646e-14;-309;1638;24247;19511;1;621;-2.14748e+09;-4.00444e+06;-1;0;0;0;-1;0;797622923;807236304;44803279
1352;1.13648e-14;-330;1680;24608;19398;1;688;-2.14748e+09;-3.9953e+06;0;0;0;0;0;0;797942121;807584796;44890746
1352;1.14646e-14;-309;1638;24247;19511;1;621;-2.14748e+09;-3.9953e+06;-1;0;0;0;-1;0;797942121;807584796;44890746
1353;1.13648e-14;-331;1680;24608;19398;1;688;-2.14748e+09;-3.98619e+06;0;0;0;0;0;0;798260598;807932580;44978141
1353;1.14646e-14;-309;1638;24247;19511;1;621;-2.14748e+09;-3.98619e+06;-1;0;0;0;-1;0;798260598;807932580;44978141
1354;1.13648e-14;-332;1680;24608;19398;1;688;-2.14748e+09;-3.9771e+06;0;0;0;0;0;0;798578354;808279659;45065463
1354;1.14646e-14;-310;1638;24247;19511;1;621;-2.14748e+09;-3.9771e+06;0;0;0;0;0;0;798578354;808279659;45065463
1355;1.13648e-14;-333;1680;24608;19398;1;688;-2.14748e+09;-3.96805e+06;0;0;0;0;0;0;798895393;808626034;45152711
1355;1.14646e-14;-311;1638;24247;19511;1;621;-2.14748e+09;-3.96805e+06;0;0;0;0;0;0;798895393;808626034;45152711
1356;1.13648e-14;-333;1680;24608;19398;1;688;-2.14748e+09;-3.95902e+06;-1;0;0;0;-1;0;799211715;808971707;45239887
1356;1.14646e-14;-311;1638;24247;19511;1;621;-2.14748e+09;-3.95902e+06;-1;0;0;0;-1;0;799211715;808971707;45239887
1357;1.13648e-14;-334;1680;24608;19398;1;688;-2.14748e+09;-3.95001e+06;0;0;0;0;0;0;799527324;809316680;45326988
1357;1.14646e-14;-311;1638;24247;19511;1;621;-2.14748e+09;-3.95001e+06;-1;0;0;0;-1;0;799527324;809316680;45326988
1358;1.13648e-14;-335;1680;24608;19398;1;688;-2.14748e+09;-3.94113e+06;0;0;0;0;0;0;799842221;809660954;45414017
1358;1.14646e-14;-312;1638;24247;19511;1;621;-2.14748e+09;-3.94113e+06;0;0;0;0;0;0;799842221;809660954;45414017
1359;1.13648e-14;-336;1680;24608;19398;1;688;-2.14748e+09;-3.93208e+06;0;0;0;0;0;0;800156407;810004532;45500971
1359;1.14646e-14;-313;1638;24247;19511;1;621;-2.14748e+09;-3.93208e+06;0;0;0;0;0;0;800156407;810004532;45500971
1360;1.13648e-14;-336;1680;24608;19398;1;688;-2.14748e+09;-3.92316e+06;-1;0;0;0;-1;0;800469886;810347415;45587851
1360;1.14646e-14;-314;1638;24247;19511;1;621;-2.14748e+09;-3.92316e+06;0;0;0;0;0;0;800469886;810347415;45587851
1361;1.13648e-14;-336;1680;24608;19398;1;688;-2.14748e+09;-3.91426e+06;-1;0;0;0;-1;0;800782658;810689604;45674657
1361;1.14646e-14;-315;1638;24247;19511;1;621;-2.14748e+09;-3.91426e+06;0;0;0;0;0;0;800782658;810689604;45674657
1362;1.13648e-14;-336;1680;24608;19398;1;688;-2.14748e+09;-3.90539e+06;-1;0;0;0;-1;0;801094726;811031102;45761388
1362;1.14646e-14;-316;1638;24247;19511;1;621;-2.14748e+09;-3.90539e+06;0;0;0;0;0;0;801094726;811031102;45761388
1363;1.13648e-14;-337;1680;24608;19398;1;688;-2.14748e+09;-3.89665e+06;0;0;0;0;0;0;801406092;811371911;45848045
1363;1.14646e-14;-316;1638;24247;19511;1;621;-2.14748e+09;-3.89665e+06;-1;0;0;0;-1;0;801406092;811371911;45848045
1364;1.13648e-14;-338;1680;24608;19398;1;688;-2.14748e+09;-3.88783e+06;0;0;0;0;0;0;801716757;811712031;45934627
1364;1.14646e-14;-316;1638;24247;19511;1;621;-2.14748e+09;-3.88783e+06;-1;0;0;0;-1;0;801716757;811712031;45934627
1365;1.13648e-14;-338;1680;24608;19398;1;688;-2.14748e+09;-3.87893e+06;-1;0;0;0;-1;0;802026724;812051466;46021134
1365;1.14646e-14;-316;1638;24247;19511;1;621;-2.14748e+09;-3.87894e+06;-1;0;0;0;-1;0;802026724;812051466;46021134
1366;1.13648e-14;-339;1680;24608;19398;1;688;-2.14748e+09;-3.87017e+06;0;0;0;0;0;0;802335994;812390216;46107566
1366;1.14646e-14;-316;1638;24247;19511;1;621;-2.14748e+09;-3.87017e+06;-1;0;0;0;-1;0;802335994;812390216;46107566
1367;1.13648e-14;-339;1680;24608;19398;1;688;-2.14748e+09;-3.86143e+06;-1;0;0;0;-1;0;802644569;812728283;46193923
1367;1.14646e-14;-316;1638;24247;19511;1;621;-2.14748e+09;-3.86143e+06;-1;0;0;0;-1;0;802644569;812728283;46193923
1368;1.13648e-14;-339;1680;24608;19398;1;688;-2.14748e+09;-3.85271e+06;-1;0;0;0;-1;0;802952452;813065670;46280203
1368;1.14646e-14;-317;1638;24247;19511;1;621;-2.14748e+09;-3.85271e+06;0;0;0;0;0;0;802952452;813065670;46280203
1369;1.13648e-14;-340;1680;24608;19398;1;688;-2.14748e+09;-3.84402e+06;0;0;0;0;0;0;803259644;813402377;46366409
1369;1.14646e-14;-318;1638;24247;19511;1;621;-2.14748e+09;-3.84402e+06;0;0;0;0;0;0;803259644;813402377;46366409
1370;1.13648e-14;-341;1680;24608;19398;1;688;-2.14748e+09;-3.83546e+06;0;0;0;0;0;0;803566146;813738407;46452538
1370;1.14646e-14;-318;1638;24247;19511;1;621;-2.14748e+09;-3.83546e+06;-1;0;0;0;-1;0;803566146;813738407;46452538
1371;1.13648e-14;-341;1680;24608;19398;1;688;-2.14748e+09;-3.82672e+06;-1;0;0;0;-1;0;803871961;814073761;46538591
1371;1.14646e-14;-319;1638;24247;19511;1;621;-2.14748e+09;-3.82672e+06;0;0;0;0;0;0;803871961;814073761;46538591
1372;1.13648e-14;-341;1680;24608;19398;1;688;-2.14748e+09;-3.81811e+06;-1;0;0;0;-1;0;804177091;814408440;46624568
1372;1.14646e-14;-319;1638;24247;19511;1;621;-2.14748e+09;-3.81811e+06;-1;0;0;0;-1;0;804177091;814408440;46624568
1373;1.13648e-14;-341;1680;24608;19398;1;688;-2.14748e+09;-3.80952e+06;-1;0;0;0;-1;0;804481538;814742448;46710468
1373;1.14646e-14;-319;1638;24247;19511;1;621;-2.14748e+09;-3.80952e+06;-1;0;0;0;-1;0;804481538;814742448;46710468
1374;1.13648e-14;-341;1680;24608;19398;1;688;-2.14748e+09;-3.80106e+06;-1;0;0;0;-1;0;804785302;815075785;46796292
1374;1.14646e-14;-319;1638;24247;19511;1;621;-2.14748e+09;-3.80106e+06;-1;0;0;0;-1;0;804785302;815075785;46796292
1375;1.13648e-14;-341;1680;24608;19398;1;688;-2.14748e+09;-3.79242e+06;-1;0;0;0;-1;0;805088387;815408452;46882039
1375;1.14646e-14;-320;1638;24247;19511;1;621;-2.14748e+09;-3.79242e+06;0;0;0;0;0;0;805088387;815408452;46882039
1376;1.13648e-14;-341;1680;24608;19398;1;688;-2.14748e+09;-3.784e+06;-1;0;0;0;-1;0;805390794;815740452;46967709
1376;1.14646e-14;-320;1638;24247;19511;1;621;-2.14748e+09;-3.784e+06;-1;0;0;0;-1;0;805390794;815740452;46967709
1377;1.13648e-14;-342;1680;24608;19398;1;688;-2.14748e+09;-3.77542e+06;0;0;0;0;0;0;805692525;816071787;47053302
1377;1.14646e-14;-320;1638;24247;19511;1;621;-2.14748e+09;-3.77542e+06;-1;0;0;0;-1;0;805692525;816071787;47053302
1378;1.13648e-14;-343;1680;24608;19398;1;688;-2.14748e+09;-3.76695e+06;0;0;0;0;0;0;805993581;816402457;47138818
1378;1.14646e-14;-321;1638;24247;19511;1;621;-2.14748e+09;-3.76695e+06;0;0;0;0;0;0;805993581;816402457;47138818
1379;1.13648e-14;-344;1680;24608;19398;1;688;-2.14748e+09;-3.75851e+06;0;0;0;0;0;0;806293965;816732465;47224256
1379;1.14646e-14;-321;1638;24247;19511;1;621;-2.14748e+09;-3.75851e+06;-1;0;0;0;-1;0;806293965;816732465;47224256
1380;1.13648e-14;-345;1680;24608;19398;1;688;-2.14748e+09;-3.7501e+06;0;0;0;0;0;0;806593678;817061813;47309617
1380;1.14646e-14;-321;1638;24247;19511;1;621;-2.14748e+09;-3.7501e+06;-1;0;0;0;-1;0;806593678;817061813;47309617
1381;1.13648e-14;-345;1680;24608;19398;1;688;-2.14748e+09;-3.74171e+06;-1;0;0;0;-1;0;806892723;817390501;47394900
1381;1.14646e-14;-321;1638;24247;19511;1;621;-2.14748e+09;-3.74171e+06;-1;0;0;0;-1;0;806892723;817390501;47394900
1382;1.13648e-14;-345;1680;24608;19398;1;688;-2.14748e+09;-3.73334e+06;-1;0;0;0;-1;0;807191100;817718532;47480104
1382;1.14646e-14;-322;1638;24247;19511;1;621;-2.14748e+09;-3.73334e+06;0;0;0;0;0;0;807191100;817718532;47480104
1383;1.13648e-14;-346;1680;24608;19398;1;688;-2.14748e+09;-3.725e+06;0;0;0;0;0;0;807488812;818045907;47565231
1383;1.14646e-14;-323;1638;24247;19511;1;621;-2.14748e+09;-3.725e+06;0;0;0;0;0;0;807488812;818045907;47565231
1384;1.13648e-14;-346;1680;24608;19398;1;688;-2.14748e+09;-3.71668e+06;-1;0;0;0;-1;0;807785860;818372627;47650280
1384;1.14646e-14;-324;1638;24247;19511;1;621;-2.14748e+09;-3.71668e+06;0;0;0;0;0;0;807785860;818372627;47650280
1385;1.13648e-14;-346;1680;24608;19398;1;688;-2.14748e+09;-3.70839e+06;-1;0;0;0;-1;0;808082247;818698695;47735250
1385;1.14646e-14;-325;1638;24247;19511;1;621;-2.14748e+09;-3.70839e+06;0;0;0;0;0;0;808082247;818698695;47735250
1386;1.13648e-14;-346;1680;24608;19398;1;688;-2.14748e+09;-3.70012e+06;-1;0;0;0;-1;0;808377973;819024112;47820142
1386;1.14646e-14;-326;1638;24247;19511;1;621;-2.14748e+09;-3.70012e+06;0;0;0;0;0;0;808377973;819024112;47820142
1387;1.13648e-14;-346;1680;24608;19398;1;688;-2.14748e+09;-3.69187e+06;-1;0;0;0;-1;0;808673042;819348880;47904955
1387;1.14646e-14;-326;1638;24247;19511;1;621;-2.14748e+09;-3.69187e+06;-1;0;0;0;-1;0;808673042;819348880;47904955
1388;1.13648e-14;-346;1680;24608;19398;1;688;-2.14748e+09;-3.68365e+06;-1;0;0;0;-1;0;808967453;819673000;47989689
1388;1.14646e-14;-326;1638;24247;19511;1;621;-2.14748e+09;-3.68365e+06;-1;0;0;0;-1;0;808967453;819673000;47989689
1389;1.13648e-14;-346;1680;24608;19398;1;688;-2.14748e+09;-3.67545e+06;-1;0;0;0;-1;0;809261211;819996474;48074344
1389;1.14646e-14;-327;1638;24247;19511;1;621;-2.14748e+09;-3.67545e+06;0;0;0;0;0;0;809261211;819996474;48074344
1390;1.13648e-14;-346;1680;24608;19398;1;688;-2.14748e+09;-3.66728e+06;-1;0;0;0;-1;0;809554315;820319303;48158920
1390;1.14646e-14;-327;1638;24247;19511;1;621;-2.14748e+09;-3.66728e+06;-1;0;0;0;-1;0;809554315;820319303;48158920
1391;1.13648e-14;-346;1680;24608;19398;1;688;-2.14748e+09;-3.65922e+06;-1;0;0;0;-1;0;809846768;820641490;48243417
1391;1.14646e-14;-327;1638;24247;19511;1;621;-2.14748e+09;-3.65922e+06;-1;0;0;0;-1;0;809846768;820641490;48243417
1392;1.13648e-14;-347;1680;24608;19398;1;688;-2.14748e+09;-3.651e+06;0;0;0;0;0;0;810138571;820963034;48327834
1392;1.14646e-14;-327;1638;24247;19511;1;621;-2.14748e+09;-3.651e+06;-1;0;0;0;-1;0;810138571;820963034;48327834
1393;1.13648e-14;-348;1680;24608;19398;1;688;-2.14748e+09;-3.64299e+06;0;0;0;0;0;0;810429727;821283940;48412172
1393;1.14646e-14;-327;1638;24247;19511;1;621;-2.14748e+09;-3.64289e+06;-1;0;0;0;-1;0;810429727;821283940;48412172
1394;1.13648e-14;-348;1680;24608;19398;1;688;-2.14748e+09;-3.63481e+06;-1;0;0;0;-1;0;810720236;821604206;48496430
1394;1.14646e-14;-328;1638;24247;19511;1;621;-2.14748e+09;-3.63481e+06;0;0;0;0;0;0;810720236;821604206;48496430
1395;1.13648e-14;-348;1680;24608;19398;1;688;-2.14748e+09;-3.62685e+06;-1;0;0;0;-1;0;811010102;821923836;48580608
1395;1.14646e-14;-329;1638;24247;19511;1;621;-2.14748e+09;-3.62685e+06;0;0;0;0;0;0;811010102;821923836;48580608
1396;1.13648e-14;-348;1680;24608;19398;1;688;-2.14748e+09;-3.61871e+06;-1;0;0;0;-1;0;811299324;822242831;48664706
1396;1.14646e-14;-329;1638;24247;19511;1;621;-2.14748e+09;-3.61871e+06;-1;0;0;0;-1;0;811299324;822242831;48664706
1397;1.13648e-14;-349;1680;24608;19398;1;688;-2.14748e+09;-3.6108e+06;0;0;0;0;0;0;811587906;822561193;48748724
1397;1.14646e-14;-330;1638;24247;19511;1;621;-2.14748e+09;-3.6108e+06;0;0;0;0;0;0;811587906;822561193;48748724
1398;1.13648e-14;-349;1680;24608;19398;1;688;-2.14748e+09;-3.60271e+06;-1;0;0;0;-1;0;811875849;822878922;48832662
1398;1.14646e-14;-331;1638;24247;19511;1;621;-2.14748e+09;-3.60271e+06;0;0;0;0;0;0;811875849;822878922;48832662
1399;1.13648e-14;-350;1680;24608;19398;1;688;-2.14748e+09;-3.59474e+06;0;0;0;0;0;0;812163154;823196021;48916519
1399;1.14646e-14;-331;1638;24247;19511;1;621;-2.14748e+09;-3.59474e+06;-1;0;0;0;-1;0;812163154;823196021;48916519
1400;1.13648e-14;-351;1680;24608;19398;1;688;-2.14748e+09;-3.58679e+06;0;0;0;0;0;0;812449823;823512491;49000296
1400;1.14646e-14;-331;1638;24247;19511;1;621;-2.14748e+09;-3.58679e+06;-1;0;0;0;-1;0;812449823;823512491;49000296
1401;1.13648e-14;-352;1680;24608;19398;1;688;-2.14748e+09;-3.57887e+06;0;0;0;0;0;0;812735858;823828333;49083992
1401;1.14646e-14;-332;1638;24247;19511;1;621;-2.14748e+09;-3.57887e+06;0;0;0;0;0;0;812735858;823828333;49083992
1402;1.13648e-14;-352;1680;24608;19398;1;688;-2.14748e+09;-3.57097e+06;-1;0;0;0;-1;0;813021260;824143549;49167607
1402;1.14646e-14;-333;1638;24247;19511;1;621;-2.14748e+09;-3.57097e+06;0;0;0;0;0;0;813021260;824143549;49167607
1403;1.13648e-14;-352;1680;24608;19398;1;688;-2.14748e+09;-3.56309e+06;-1;0;0;0;-1;0;813306032;824458141;49251142
1403;1.14646e-14;-334;1638;24247;19511;1;621;-2.14748e+09;-3.56309e+06;0;0;0;0;0;0;813306032;824458141;49251142
1404;1.13648e-14;-352;1680;24608;19398;1;688;-2.14748e+09;-3.55523e+06;-1;0;0;0;-1;0;813590175;824772111;49334595
1404;1.14646e-14;-334;1638;24247;19511;1;621;-2.14748e+09;-3.55523e+06;-1;0;0;0;-1;0;813590175;824772111;49334595
1405;1.13648e-14;-353;1680;24608;19398;1;688;-2.14748e+09;-3.5474e+06;0;0;0;0;0;0;813873690;825085459;49417967
1405;1.14646e-14;-335;1638;24247;19511;1;621;-2.14748e+09;-3.5474e+06;0;0;0;0;0;0;813873690;825085459;49417967
1406;1.13648e-14;-354;1680;24608;19398;1;688;-2.14748e+09;-3.53959e+06;0;0;0;0;0;0;814156579;825398187;49501258
1406;1.14646e-14;-336;1638;24247;19511;1;621;-2.14748e+09;-3.53959e+06;0;0;0;0;0;0;814156579;825398187;49501258
1407;1.13648e-14;-354;1680;24608;19398;1;688;-2.14748e+09;-3.5318e+06;-1;0;0;0;-1;0;814438844;825710296;49584467
1407;1.14646e-14;-336;1638;24247;19511;1;621;-2.14748e+09;-3.5318e+06;-1;0;0;0;-1;0;814438844;825710296;49584467
1408;1.13648e-14;-354;1680;24608;19398;1;688;-2.14748e+09;-3.52403e+06;-1;0;0;0;-1;0;814720486;826021789;49667595
1408;1.14646e-14;-336;1638;24247;19511;1;621;-2.14748e+09;-3.52403e+06;-1;0;0;0;-1;0;814720486;826021789;49667595
1409;1.13648e-14;-355;1680;24608;19398;1;688;-2.14748e+09;-3.51628e+06;0;0;0;0;0;0;815001508;826332666;49750641
1409;1.14646e-14;-336;1638;24247;19511;1;621;-2.14748e+09;-3.51628e+06;-1;0;0;0;-1;0;815001508;826332666;49750641
1410;1.13648e-14;-356;1680;24608;19398;1;688;-2.14748e+09;-3.50856e+06;0;0;0;0;0;0;815281910;826642930;49833606
1410;1.14646e-14;-337;1638;24247;19511;1;621;-2.14748e+09;-3.50856e+06;0;0;0;0;0;0;815281910;826642930;49833606
1411;1.13648e-14;-356;1680;24608;19398;1;688;-2.14748e+09;-3.50085e+06;-1;0;0;0;-1;0;815561695;826952581;49916488
1411;1.14646e-14;-338;1638;24247;19511;1;621;-2.14748e+09;-3.50085e+06;0;0;0;0;0;0;815561695;826952581;49916488
1412;1.13648e-14;-356;1680;24608;19398;1;688;-2.14748e+09;-3.49327e+06;-1;0;0;0;-1;0;815840863;827261621;49999288
1412;1.14646e-14;-339;1638;24247;19511;1;621;-2.14748e+09;-3.49327e+06;0;0;0;0;0;0;815840863;827261621;49999288
1413;1.13648e-14;-357;1680;24608;19398;1;688;-2.14748e+09;-3.48551e+06;0;0;0;0;0;0;816119418;827570051;50082007
1413;1.14646e-14;-340;1638;24247;19511;1;621;-2.14748e+09;-3.48551e+06;0;0;0;0;0;0;816119418;827570051;50082007
1414;1.13648e-14;-358;1680;24608;19398;1;688;-2.14748e+09;-3.47787e+06;0;0;0;0;0;0;816397359;827877874;50164643
1414;1.14646e-14;-340;1638;24247;19511;1;621;-2.14748e+09;-3.47787e+06;-1;0;0;0;-1;0;816397359;827877874;50164643
1415;1.13648e-14;-359;1680;24608;19398;1;688;-2.14748e+09;-3.47035e+06;0;0;0;0;0;0;816674689;828185090;50247196
1415;1.14646e-14;-341;1638;24247;19511;1;621;-2.14748e+09;-3.47025e+06;0;0;0;0;0;0;816674689;828185090;50247196
1416;1.13648e-14;-359;1680;24608;19398;1;688;-2.14748e+09;-3.46275e+06;-1;0;0;0;-1;0;816951410;828491701;50329667
1416;1.14646e-14;-342;1638;24247;19511;1;621;-2.14748e+09;-3.46275e+06;0;0;0;0;0;0;816951410;828491701;50329667
1417;1.13648e-14;-359;1680;24608;19398;1;688;-2.14748e+09;-3.45508e+06;-1;0;0;0;-1;0;817227522;828797708;50412056
1417;1.14646e-14;-342;1638;24247;19511;1;621;-2.14748e+09;-3.45508e+06;-1;0;0;0;-1;0;817227522;828797708;50412056
1418;1.13648e-14;-359;1680;24608;19398;1;688;-2.14748e+09;-3.44762e+06;-1;0;0;0;-1;0;817503028;829103113;50494362
1418;1.14646e-14;-343;1638;24247;19511;1;621;-2.14748e+09;-3.44762e+06;0;0;0;0;0;0;817503028;829103113;50494362
1419;1.13648e-14;-360;1680;24608;19398;1;688;-2.14748e+09;-3.43999e+06;0;0;0;0;0;0;817777929;829407917;50576585
1419;1.14646e-14;-343;1638;24247;19511;1;621;-2.14748e+09;-3.43999e+06;-1;0;0;0;-1;0;817777929;829407917;50576585
1420;1.13648e-14;-361;1680;24608;19398;1;688;-2.14748e+09;-3.43248e+06;0;0;0;0;0;0;818052227;829712122;50658725
1420;1.14646e-14;-344;1638;24247;19511;1;621;-2.14748e+09;-3.43248e+06;0;0;0;0;0;0;818052227;829712122;50658725
1421;1.13648e-14;-361;1680;24608;19398;1;688;-2.14748e+09;-3.42508e+06;-1;0;0;0;-1;0;818325923;830015729;50740782
1421;1.14646e-14;-344;1638;24247;19511;1;621;-2.14748e+09;-3.42508e+06;-1;0;0;0;-1;0;818325923;830015729;50740782
1422;1.13648e-14;-362;1680;24608;19398;1;688;-2.14748e+09;-3.41761e+06;0;0;0;0;0;0;818599019;830318739;50822755
1422;1.14646e-14;-345;1638;24247;19511;1;621;-2.14748e+09;-3.41761e+06;0;0;0;0;0;0;818599019;830318739;50822755
1423;1.13648e-14;-363;1680;24608;19398;1;688;-2.14748e+09;-3.41016e+06;0;0;0;0;0;0;818871517;830621154;50904646
1423;1.14646e-14;-346;1638;24247;19511;1;621;-2.14748e+09;-3.41016e+06;0;0;0;0;0;0;818871517;830621154;50904646
1424;1.13648e-14;-363;1680;24608;19398;1;688;-2.14748e+09;-3.40263e+06;-1;0;0;0;-1;0;819143417;830922976;50986453
1424;1.14646e-14;-347;1638;24247;19511;1;621;-2.14748e+09;-3.40263e+06;0;0;0;0;0;0;819143417;830922976;50986453
1425;1.13648e-14;-363;1680;24608;19398;1;688;-2.14748e+09;-3.39532e+06;-1;0;0;0;-1;0;819414722;831224205;51068177
1425;1.14646e-14;-347;1638;24247;19511;1;621;-2.14748e+09;-3.39532e+06;-1;0;0;0;-1;0;819414722;831224205;51068177
1426;1.13648e-14;-364;1680;24608;19398;1;688;-2.14748e+09;-3.38793e+06;0;0;0;0;0;0;819685433;831524844;51149817
1426;1.14646e-14;-347;1638;24247;19511;1;621;-2.14748e+09;-3.38793e+06;-1;0;0;0;-1;0;819685433;831524844;51149817
1427;1.13648e-14;-365;1680;24608;19398;1;688;-2.14748e+09;-3.38046e+06;0;0;0;0;0;0;819955552;831824893;51231374
1427;1.14646e-14;-348;1638;24247;19511;1;621;-2.14748e+09;-3.38046e+06;0;0;0;0;0;0;819955552;831824893;51231374
1428;1.13648e-14;-365;1680;24608;19398;1;688;-2.14748e+09;-3.37311e+06;-1;0;0;0;-1;0;820225079;832124354;51312847
1428;1.14646e-14;-348;1638;24247;19511;1;621;-2.14748e+09;-3.37311e+06;-1;0;0;0;-1;0;820225079;832124354;51312847
1429;1.13648e-14;-365;1680;24608;19398;1;688;-2.14748e+09;-3.36578e+06;-1;0;0;0;-1;0;820494018;832423228;51394236
1429;1.14646e-14;-348;1638;24247;19511;1;621;-2.14748e+09;-3.36578e+06;-1;0;0;0;-1;0;820494018;832423228;51394236
1430;1.13648e-14;-366;1680;24608;19398;1;688;-2.14748e+09;-3.35847e+06;0;0;0;0;0;0;820762368;832721517;51475541
1430;1.14646e-14;-348;1638;24247;19511;1;621;-2.14748e+09;-3.35847e+06;-1;0;0;0;-1;0;820762368;832721517;51475541
1431;1.13648e-14;-366;1680;24608;19398;1;688;-2.14748e+09;-3.35128e+06;-1;0;0;0;-1;0;821030133;833019222;51556762
1431;1.14646e-14;-349;1638;24247;19511;1;621;-2.14748e+09;-3.35128e+06;0;0;0;0;0;0;821030133;833019222;51556762
1432;1.13648e-14;-367;1680;24608;19398;1;688;-2.14748e+09;-3.34391e+06;0;0;0;0;0;0;821297312;833316345;51637899
1432;1.14646e-14;-350;1638;24247;19511;1;621;-2.14748e+09;-3.34391e+06;0;0;0;0;0;0;821297312;833316345;51637899
1433;1.13648e-14;-367;1680;24608;19398;1;688;-2.14748e+09;-3.33666e+06;-1;0;0;0;-1;0;821563909;833612886;51718952
1433;1.14646e-14;-350;1638;24247;19511;1;621;-2.14748e+09;-3.33666e+06;-1;0;0;0;-1;0;821563909;833612886;51718952
1434;1.13648e-14;-367;1680;24608;19398;1;688;-2.14748e+09;-3.32943e+06;-1;0;0;0;-1;0;821829923;833908847;51799920
1434;1.14646e-14;-351;1638;24247;19511;1;621;-2.14748e+09;-3.32943e+06;0;0;0;0;0;0;821829923;833908847;51799920
1435;1.13648e-14;-367;1680;24608;19398;1;688;-2.14748e+09;-3.32222e+06;-1;0;0;0;-1;0;822095357;834204231;51880804
1435;1.14646e-14;-352;1638;24247;19511;1;621;-2.14748e+09;-3.32222e+06;0;0;0;0;0;0;822095357;834204231;51880804
1436;1.13648e-14;-367;1680;24608;19398;1;688;-2.14748e+09;-3.31503e+06;-1;0;0;0;-1;0;822360213;834499037;51961604
1436;1.14646e-14;-352;1638;24247;19511;1;621;-2.14748e+09;-3.31503e+06;-1;0;0;0;-1;0;822360213;834499037;51961604
1437;1.13648e-14;-367;1680;24608;19398;1;688;-2.14748e+09;-3.30786e+06;-1;0;0;0;-1;0;822624491;834793267;52042319
1437;1.14646e-14;-352;1638;24247;19511;1;621;-2.14748e+09;-3.30786e+06;-1;0;0;0;-1;0;822624491;834793267;52042319
1438;1.13648e-14;-368;1680;24608;19398;1;688;-2.14748e+09;-3.3007e+06;0;0;0;0;0;0;822888193;835086923;52122949
1438;1.14646e-14;-353;1638;24247;19511;1;621;-2.14748e+09;-3.3007e+06;0;0;0;0;0;0;822888193;835086923;52122949
1439;1.13648e-14;-369;1680;24608;19398;1;688;-2.14748e+09;-3.29367e+06;0;0;0;0;0;0;823151322;835380006;52203495
1439;1.14646e-14;-354;1638;24247;19511;1;621;-2.14748e+09;-3.29367e+06;0;0;0;0;0;0;823151322;835380006;52203495
1440;1.13648e-14;-370;1680;24608;19398;1;688;-2.14748e+09;-3.28646e+06;0;0;0;0;0;0;823413877;835672517;52283955
1440;1.14646e-14;-355;1638;24247;19511;1;621;-2.14748e+09;-3.28646e+06;0;0;0;0;0;0;823413877;835672517;52283955
1441;1.13648e-14;-370;1680;24608;19398;1;688;-2.14748e+09;-3.27936e+06;-1;0;0;0;-1;0;823675861;835964458;52364331
1441;1.14646e-14;-355;1638;24247;19511;1;621;-2.14748e+09;-3.27936e+06;-1;0;0;0;-1;0;823675861;835964458;52364331
1442;1.13648e-14;-370;1680;24608;19398;1;688;-2.14748e+09;-3.27229e+06;-1;0;0;0;-1;0;823937275;836255829;52444622
1442;1.14646e-14;-356;1638;24247;19511;1;621;-2.14748e+09;-3.27229e+06;0;0;0;0;0;0;823937275;836255829;52444622
1443;1.13648e-14;-371;1680;24608;19398;1;688;-2.14748e+09;-3.26533e+06;0;0;0;0;0;0;824198120;836546634;52524828
1443;1.14646e-14;-357;1638;24247;19511;1;621;-2.14748e+09;-3.26533e+06;0;0;0;0;0;0;824198120;836546634;52524828
1444;1.13648e-14;-371;1680;24608;19398;1;688;-2.14748e+09;-3.2582e+06;-1;0;0;0;-1;0;824458399;836836871;52604949
1444;1.14646e-14;-357;1638;24247;19511;1;621;-2.14748e+09;-3.2582e+06;-1;0;0;0;-1;0;824458399;836836871;52604949
1445;1.13648e-14;-372;1680;24608;19398;1;688;-2.14748e+09;-3.25128e+06;0;0;0;0;0;0;824718112;837126544;52684984
1445;1.14646e-14;-358;1638;24247;19511;1;621;-2.14748e+09;-3.25128e+06;0;0;0;0;0;0;824718112;837126544;52684984
1446;1.13648e-14;-373;1680;24608;19398;1;688;-2.14748e+09;-3.24418e+06;0;0;0;0;0;0;824977261;837415653;52764934
1446;1.14646e-14;-359;1638;24247;19511;1;621;-2.14748e+09;-3.24418e+06;0;0;0;0;0;0;824977261;837415653;52764934
1447;1.13648e-14;-374;1680;24608;19398;1;688;-2.14748e+09;-3.2373e+06;0;0;0;0;0;0;825235847;837704199;52844799
1447;1.14646e-14;-360;1638;24247;19511;1;621;-2.14748e+09;-3.2373e+06;0;0;0;0;0;0;825235847;837704199;52844799
1448;1.13648e-14;-374;1680;24608;19398;1;688;-2.14748e+09;-3.23024e+06;-1;0;0;0;-1;0;825493872;837992184;52924578
1448;1.14646e-14;-360;1638;24247;19511;1;621;-2.14748e+09;-3.23024e+06;-1;0;0;0;-1;0;825493872;837992184;52924578
1449;1.13648e-14;-374;1680;24608;19398;1;688;-2.14748e+09;-3.22329e+06;-1;0;0;0;-1;0;825751337;838279610;53004272
1449;1.14646e-14;-361;1638;24247;19511;1;621;-2.14748e+09;-3.22329e+06;0;0;0;0;0;0;825751337;838279610;53004272
1450;1.13648e-14;-375;1680;24608;19398;1;688;-2.14748e+09;-3.21637e+06;0;0;0;0;0;0;826008244;838566477;53083880
1450;1.14646e-14;-361;1638;24247;19511;1;621;-2.14748e+09;-3.21637e+06;-1;0;0;0;-1;0;826008244;838566477;53083880
1451;1.13648e-14;-376;1680;24608;19398;1;688;-2.14748e+09;-3.20946e+06;0;0;0;0;0;0;826264594;838852786;53163402
1451;1.14646e-14;-362;1638;24247;19511;1;621;-2.14748e+09;-3.20946e+06;0;0;0;0;0;0;826264594;838852786;53163402
1452;1.13648e-14;-377;1680;24608;19398;1;688;-2.14748e+09;-3.20257e+06;0;0;0;0;0;0;826520388;839138540;53242839
1452;1.14646e-14;-362;1638;24247;19511;1;621;-2.14748e+09;-3.20257e+06;-1;0;0;0;-1;0;826520388;839138540;53242839
1453;1.13648e-14;-378;1680;24608;19398;1;688;-2.14748e+09;-3.1958e+06;0;0;0;0;0;0;826775629;839423739;53322190
1453;1.14646e-14;-362;1638;24247;19511;1;621;-2.14748e+09;-3.1958e+06;-1;0;0;0;-1;0;826775629;839423739;53322190
1454;1.13648e-14;-378;1680;24608;19398;1;688;-2.14748e+09;-3.18895e+06;-1;0;0;0;-1;0;827030317;839708385;53401455
1454;1.14646e-14;-362;1638;24247;19511;1;621;-2.14748e+09;-3.18895e+06;-1;0;0;0;-1;0;827030317;839708385;53401455
1455;1.13648e-14;-379;1680;24608;19398;1;688;-2.14748e+09;-3.18212e+06;0;0;0;0;0;0;827284453;839992478;53480634
1455;1.14646e-14;-363;1638;24247;19511;1;621;-2.14748e+09;-3.18212e+06;0;0;0;0;0;0;827284453;839992478;53480634
1456;1.13648e-14;-379;1680;24608;19398;1;688;-2.14748e+09;-3.1753e+06;-1;0;0;0;-1;0;827538039;840276020;53559726
1456;1.14646e-14;-363;1638;24247;19511;1;621;-2.14748e+09;-3.1753e+06;-1;0;0;0;-1;0;827538039;840276020;53559726
1457;1.13648e-14;-379;1680;24608;19398;1;688;-2.14748e+09;-3.16841e+06;-1;0;0;0;-1;0;827791077;840559013;53638733
1457;1.14646e-14;-364;1638;24247;19511;1;621;-2.14748e+09;-3.16841e+06;0;0;0;0;0;0;827791077;840559013;53638733
1458;1.13648e-14;-380;1680;24608;19398;1;688;-2.14748e+09;-3.16163e+06;0;0;0;0;0;0;828043568;840841458;53717654
1458;1.14646e-14;-365;1638;24247;19511;1;621;-2.14748e+09;-3.16163e+06;0;0;0;0;0;0;828043568;840841458;53717654
1459;1.13648e-14;-381;1680;24608;19398;1;688;-2.14748e+09;-3.15487e+06;0;0;0;0;0;0;828295513;841123356;53796489
1459;1.14646e-14;-366;1638;24247;19511;1;621;-2.14748e+09;-3.15487e+06;0;0;0;0;0;0;828295513;841123356;53796489
1460;1.13648e-14;-382;1680;24608;19398;1;688;-2.14748e+09;-3.14812e+06;0;0;0;0;0;0;828546914;841404707;53875237
1460;1.14646e-14;-367;1638;24247;19511;1;621;-2.14748e+09;-3.14812e+06;0;0;0;0;0;0;828546914;841404707;53875237
1461;1.13648e-14;-382;1680;24608;19398;1;688;-2.14748e+09;-3.1414e+06;-1;0;0;0;-1;0;828797772;841685515;53953899
1461;1.14646e-14;-368;1638;24247;19511;1;621;-2.14748e+09;-3.1414e+06;0;0;0;0;0;0;828797772;841685515;53953899
1462;1.13648e-14;-383;1680;24608;19398;1;688;-2.14748e+09;-3.13469e+06;0;0;0;0;0;0;829048088;841965778;54032474
1462;1.14646e-14;-369;1638;24247;19511;1;621;-2.14748e+09;-3.13469e+06;0;0;0;0;0;0;829048088;841965778;54032474
1463;1.13648e-14;-384;1680;24608;19398;1;688;-2.14748e+09;-3.128e+06;0;0;0;0;0;0;829297864;842245500;54110963
1463;1.14646e-14;-370;1638;24247;19511;1;621;-2.14748e+09;-3.128e+06;0;0;0;0;0;0;829297864;842245500;54110963
1464;1.13648e-14;-384;1680;24608;19398;1;688;-2.14748e+09;-3.12133e+06;-1;0;0;0;-1;0;829547101;842524681;54189366
1464;1.14646e-14;-371;1638;24247;19511;1;621;-2.14748e+09;-3.12133e+06;0;0;0;0;0;0;829547101;842524681;54189366
1465;1.13648e-14;-385;1680;24608;19398;1;688;-2.14748e+09;-3.11478e+06;0;0;0;0;0;0;829795801;842803322;54267681
1465;1.14646e-14;-371;1638;24247;19511;1;621;-2.14748e+09;-3.11478e+06;-1;0;0;0;-1;0;829795801;842803322;54267681
1466;1.13648e-14;-386;1680;24608;19398;1;688;-2.14748e+09;-3.10814e+06;0;0;0;0;0;0;830043965;843081425;54345911
1466;1.14646e-14;-371;1638;24247;19511;1;621;-2.14748e+09;-3.10814e+06;-1;0;0;0;-1;0;830043965;843081425;54345911
1467;1.13648e-14;-387;1680;24608;19398;1;688;-2.14748e+09;-3.10142e+06;0;0;0;0;0;0;830291593;843358991;54424053
1467;1.14646e-14;-371;1638;24247;19511;1;621;-2.14748e+09;-3.10142e+06;-1;0;0;0;-1;0;830291593;843358991;54424053
1468;1.13648e-14;-387;1680;24608;19398;1;688;-2.14748e+09;-3.09492e+06;-1;0;0;0;-1;0;830538689;843636021;54502109
1468;1.14646e-14;-371;1638;24247;19511;1;621;-2.14748e+09;-3.09492e+06;-1;0;0;0;-1;0;830538689;843636021;54502109
1469;1.13648e-14;-388;1680;24608;19398;1;688;-2.14748e+09;-3.08823e+06;0;0;0;0;0;0;830785252;843912516;54580078
1469;1.14646e-14;-372;1638;24247;19511;1;621;-2.14748e+09;-3.08823e+06;0;0;0;0;0;0;830785252;843912516;54580078
1470;1.13648e-14;-388;1680;24608;19398;1;688;-2.14748e+09;-3.08176e+06;-1;0;0;0;-1;0;831031284;844188478;54657960
1470;1.14646e-14;-373;1638;24247;19511;1;621;-2.14748e+09;-3.08176e+06;0;0;0;0;0;0;831031284;844188478;54657960
1471;1.13648e-14;-389;1680;24608;19398;1;688;-2.14748e+09;-3.07511e+06;0;0;0;0;0;0;831276788;844463907;54735755
1471;1.14646e-14;-374;1638;24247;19511;1;621;-2.14748e+09;-3.07511e+06;0;0;0;0;0;0;831276788;844463907;54735755
1472;1.13648e-14;-389;1680;24608;19398;1;688;-2.14748e+09;-3.06858e+06;-1;0;0;0;-1;0;831521763;844738805;54813463
1472;1.14646e-14;-374;1638;24247;19511;1;621;-2.14748e+09;-3.06858e+06;-1;0;0;0;-1;0;831521763;844738805;54813463
1473;1.13648e-14;-389;1680;24608;19398;1;688;-2.14748e+09;-3.06206e+06;-1;0;0;0;-1;0;831766211;845013174;54891085
1473;1.14646e-14;-375;1638;24247;19511;1;621;-2.14748e+09;-3.06206e+06;0;0;0;0;0;0;831766211;845013174;54891085
1474;1.13648e-14;-390;1680;24608;19398;1;688;-2.14748e+09;-3.05556e+06;0;0;0;0;0;0;832010133;845287013;54968619
1474;1.14646e-14;-376;1638;24247;19511;1;621;-2.14748e+09;-3.05556e+06;0;0;0;0;0;0;832010133;845287013;54968619
1475;1.13648e-14;-391;1680;24608;19398;1;688;-2.14748e+09;-3.04908e+06;0;0;0;0;0;0;832253532;845560326;55046066
1475;1.14646e-14;-377;1638;24247;19511;1;621;-2.14748e+09;-3.04908e+06;0;0;0;0;0;0;832253532;845560326;55046066
1476;1.13648e-14;-391;1680;24608;19398;1;688;-2.14748e+09;-3.04262e+06;-1;0;0;0;-1;0;832496408;845833112;55123426
1476;1.14646e-14;-377;1638;24247;19511;1;621;-2.14748e+09;-3.04262e+06;-1;0;0;0;-1;0;832496408;845833112;55123426
1477;1.13648e-14;-391;1680;24608;19398;1;688;-2.14748e+09;-3.03617e+06;-1;0;0;0;-1;0;832738762;846105372;55200698
1477;1.14646e-14;-377;1638;24247;19511;1;621;-2.14748e+09;-3.03617e+06;-1;0;0;0;-1;0;832738762;846105372;55200698
1478;1.13648e-14;-391;1680;24608;19398;1;688;-2.14748e+09;-3.02974e+06;-1;0;0;0;-1;0;832980596;846377109;55277884
1478;1.14646e-14;-378;1638;24247;19511;1;621;-2.14748e+09;-3.02974e+06;0;0;0;0;0;0;832980596;846377109;55277884
1479;1.13648e-14;-391;1680;24608;19398;1;688;-2.14748e+09;-3.02332e+06;-1;0;0;0;-1;0;833221911;846648324;55354982
1479;1.14646e-14;-378;1638;24247;19511;1;621;-2.14748e+09;-3.02332e+06;-1;0;0;0;-1;0;833221911;846648324;55354982
1480;1.13648e-14;-391;1680;24608;19398;1;688;-2.14748e+09;-3.01702e+06;-1;0;0;0;-1;0;833462709;846919016;55431993
1480;1.14646e-14;-379;1638;24247;19511;1;621;-2.14748e+09;-3.01692e+06;0;0;0;0;0;0;833462709;846919016;55431993
1481;1.13648e-14;-392;1680;24608;19398;1;688;-2.14748e+09;-3.01054e+06;0;0;0;0;0;0;833702990;847189188;55508916
1481;1.14646e-14;-379;1638;24247;19511;1;621;-2.14748e+09;-3.01054e+06;-1;0;0;0;-1;0;833702990;847189188;55508916
1482;1.13648e-14;-393;1680;24608;19398;1;688;-2.14748e+09;-3.00417e+06;0;0;0;0;0;0;833942756;847458841;55585752
1482;1.14646e-14;-380;1638;24247;19511;1;621;-2.14748e+09;-3.00417e+06;0;0;0;0;0;0;833942756;847458841;55585752
1483;1.13648e-14;-393;1680;24608;19398;1;688;-2.14748e+09;-2.99782e+06;-1;0;0;0;-1;0;834182009;847727976;55662501
1483;1.14646e-14;-380;1638;24247;19511;1;621;-2.14748e+09;-2.99782e+06;-1;0;0;0;-1;0;834182009;847727976;55662501
1484;1.13648e-14;-394;1680;24608;19398;1;688;-2.14748e+09;-2.99149e+06;0;0;0;0;0;0;834420749;847996595;55739161
1484;1.14646e-14;-380;1638;24247;19511;1;621;-2.14748e+09;-2.99149e+06;-1;0;0;0;-1;0;834420749;847996595;55739161
1485;1.13648e-14;-395;1680;24608;19398;1;688;-2.14748e+09;-2.98518e+06;0;0;0;0;0;0;834658978;848264697;55815735
1485;1.14646e-14;-381;1638;24247;19511;1;621;-2.14748e+09;-2.98518e+06;0;0;0;0;0;0;834658978;848264697;55815735
1486;1.13648e-14;-396;1680;24608;19398;1;688;-2.14748e+09;-2.97888e+06;0;0;0;0;0;0;834896696;848532285;55892221
1486;1.14646e-14;-381;1638;24247;19511;1;621;-2.14748e+09;-2.97888e+06;-1;0;0;0;-1;0;834896696;848532285;55892221
1487;1.13648e-14;-397;1680;24608;19398;1;688;-2.14748e+09;-2.97259e+06;0;0;0;0;0;0;835133907;848799359;55968619
1487;1.14646e-14;-381;1638;24247;19511;1;621;-2.14748e+09;-2.97259e+06;-1;0;0;0;-1;0;835133907;848799359;55968619
1488;1.13648e-14;-398;1680;24608;19398;1;688;-2.14748e+09;-2.96632e+06;0;0;0;0;0;0;835370610;849065921;56044929
1488;1.14646e-14;-381;1638;24247;19511;1;621;-2.14748e+09;-2.96632e+06;-1;0;0;0;-1;0;835370610;849065921;56044929
1489;1.13648e-14;-398;1680;24608;19398;1;688;-2.14748e+09;-2.96007e+06;-1;0;0;0;-1;0;835606806;849331972;56121152
1489;1.14646e-14;-382;1638;24247;19511;1;621;-2.14748e+09;-2.96007e+06;0;0;0;0;0;0;835606806;849331972;56121152
1490;1.13648e-14;-398;1680;24608;19398;1;688;-2.14748e+09;-2.95384e+06;-1;0;0;0;-1;0;835842498;849597513;56197287
1490;1.14646e-14;-382;1638;24247;19511;1;621;-2.14748e+09;-2.95384e+06;-1;0;0;0;-1;0;835842498;849597513;56197287
1491;1.13648e-14;-398;1680;24608;19398;1;688;-2.14748e+09;-2.94762e+06;-1;0;0;0;-1;0;836077686;849862545;56273335
1491;1.14646e-14;-383;1638;24247;19511;1;621;-2.14748e+09;-2.94762e+06;0;0;0;0;0;0;836077686;849862545;56273335
1492;1.13648e-14;-399;1680;24608;19398;1;688;-2.14748e+09;-2.94141e+06;0;0;0;0;0;0;836312372;850127070;56349294
1492;1.14646e-14;-384;1638;24247;19511;1;621;-2.14748e+09;-2.94141e+06;0;0;0;0;0;0;836312372;850127070;56349294
1493;1.13648e-14;-399;1680;24608;19398;1;688;-2.14748e+09;-2.93532e+06;-1;0;0;0;-1;0;836546557;850391088;56425166
1493;1.14646e-14;-384;1638;24247;19511;1;621;-2.14748e+09;-2.93532e+06;-1;0;0;0;-1;0;836546557;850391088;56425166
1494;1.13648e-14;-400;1680;24608;19398;1;688;-2.14748e+09;-2.92915e+06;0;0;0;0;0;0;836780242;850654600;56500950
1494;1.14646e-14;-385;1638;24247;19511;1;621;-2.14748e+09;-2.92915e+06;0;0;0;0;0;0;836780242;850654600;56500950
1495;1.13648e-14;-400;1680;24608;19398;1;688;-2.14748e+09;-2.923e+06;-1;0;0;0;-1;0;837013428;850917608;56576646
1495;1.14646e-14;-386;1638;24247;19511;1;621;-2.14748e+09;-2.923e+06;0;0;0;0;0;0;837013428;850917608;56576646
1496;1.13648e-14;-401;1680;24608;19398;1;688;-2.14748e+09;-2.91676e+06;0;0;0;0;0;0;837246117;851180113;56652254
1496;1.14646e-14;-387;1638;24247;19511;1;621;-2.14748e+09;-2.91676e+06;0;0;0;0;0;0;837246117;851180113;56652254
1497;1.13648e-14;-401;1680;24608;19398;1;688;-2.14748e+09;-2.91063e+06;-1;0;0;0;-1;0;837478310;851442116;56727774
1497;1.14646e-14;-387;1638;24247;19511;1;621;-2.14748e+09;-2.91063e+06;-1;0;0;0;-1;0;837478310;851442116;56727774
1498;1.13648e-14;-401;1680;24608;19398;1;688;-2.14748e+09;-2.90452e+06;-1;0;0;0;-1;0;837710007;851703617;56803206
1498;1.14646e-14;-388;1638;24247;19511;1;621;-2.14748e+09;-2.90452e+06;0;0;0;0;0;0;837710007;851703617;56803206
1499;1.13648e-14;-401;1680;24608;19398;1;688;-2.14748e+09;-2.89843e+06;-1;0;0;0;-1;0;837941211;851964619;56878550
1499;1.14646e-14;-388;1638;24247;19511;1;621;-2.14748e+09;-2.89843e+06;-1;0;0;0;-1;0;837941211;851964619;56878550
1500;1.13648e-14;-401;1680;24608;19398;1;688;-2.14748e+09;-2.89235e+06;-1;0;0;0;-1;0;838171923;852225122;56953806
1500;1.14646e-14;-388;1638;24247;19511;1;621;-2.14748e+09;-2.89235e+06;-1;0;0;0;-1;0;838171923;852225122;56953806
1501;1.13648e-14;-401;1680;24608;19398;1;688;-2.14748e+09;-2.88629e+06;-1;0;0;0;-1;0;838402143;852485128;57028973
1501;1.14646e-14;-389;1638;24247;19511;1;621;-2.14748e+09;-2.88629e+06;0;0;0;0;0;0;838402143;852485128;57028973
1502;1.13648e-14;-401;1680;24608;19398;1;688;-2.14748e+09;-2.88024e+06;-1;0;0;0;-1;0;838631873;852744637;57104053
1502;1.14646e-14;-390;1638;24247;19511;1;621;-2.14748e+09;-2.88024e+06;0;0;0;0;0;0;838631873;852744637;57104053
1503;1.13648e-14;-402;1680;24608;19398;1;688;-2.14748e+09;-2.87421e+06;0;0;0;0;0;0;838861114;853003650;57179045
1503;1.14646e-14;-391;1638;24247;19511;1;621;-2.14748e+09;-2.87421e+06;0;0;0;0;0;0;838861114;853003650;57179045
1504;1.13648e-14;-403;1680;24608;19398;1;688;-2.14748e+09;-2.86829e+06;0;0;0;0;0;0;839089868;853262169;57253948
1504;1.14646e-14;-392;1638;24247;19511;1;621;-2.14748e+09;-2.86829e+06;0;0;0;0;0;0;839089868;853262169;57253948
1505;1.13648e-14;-404;1680;24608;19398;1;688;-2.14748e+09;-2.86219e+06;0;0;0;0;0;0;839318135;853520195;57328764
1505;1.14646e-14;-392;1638;24247;19511;1;621;-2.14748e+09;-2.86219e+06;-1;0;0;0;-1;0;839318135;853520195;57328764
1506;1.13648e-14;-405;1680;24608;19398;1;688;-2.14748e+09;-2.8563e+06;0;0;0;0;0;0;839545916;853777729;57403491
1506;1.14646e-14;-392;1638;24247;19511;1;621;-2.14748e+09;-2.8563e+06;-1;0;0;0;-1;0;839545916;853777729;57403491
1507;1.13648e-14;-405;1680;24608;19398;1;688;-2.14748e+09;-2.85023e+06;-1;0;0;0;-1;0;839773214;854034771;57478130
1507;1.14646e-14;-393;1638;24247;19511;1;621;-2.14748e+09;-2.85023e+06;0;0;0;0;0;0;839773214;854034771;57478130
1508;1.13648e-14;-406;1680;24608;19398;1;688;-2.14748e+09;-2.84427e+06;0;0;0;0;0;0;840000028;854291323;57552681
1508;1.14646e-14;-393;1638;24247;19511;1;621;-2.14748e+09;-2.84427e+06;-1;0;0;0;-1;0;840000028;854291323;57552681
1509;1.13648e-14;-407;1680;24608;19398;1;688;-2.14748e+09;-2.83843e+06;0;0;0;0;0;0;840226361;854547387;57627143
1509;1.14646e-14;-394;1638;24247;19511;1;621;-2.14748e+09;-2.83843e+06;0;0;0;0;0;0;840226361;854547387;57627143
1510;1.13648e-14;-408;1680;24608;19398;1;688;-2.14748e+09;-2.8324e+06;0;0;0;0;0;0;840452214;854802963;57701517
1510;1.14646e-14;-394;1638;24247;19511;1;621;-2.14748e+09;-2.8324e+06;-1;0;0;0;-1;0;840452214;854802963;57701517
1511;1.13648e-14;-408;1680;24608;19398;1;688;-2.14748e+09;-2.82649e+06;-1;0;0;0;-1;0;840677587;855058051;57775803
1511;1.14646e-14;-395;1638;24247;19511;1;621;-2.14748e+09;-2.82649e+06;0;0;0;0;0;0;840677587;855058051;57775803
1512;1.13648e-14;-408;1680;24608;19398;1;688;-2.14748e+09;-2.8206e+06;-1;0;0;0;-1;0;840902482;855312654;57850000
1512;1.14646e-14;-395;1638;24247;19511;1;621;-2.14748e+09;-2.8206e+06;-1;0;0;0;-1;0;840902482;855312654;57850000
1513;1.13648e-14;-409;1680;24608;19398;1;688;-2.14748e+09;-2.81472e+06;0;0;0;0;0;0;841126900;855566773;57924110
1513;1.14646e-14;-396;1638;24247;19511;1;621;-2.14748e+09;-2.81472e+06;0;0;0;0;0;0;841126900;855566773;57924110
1514;1.13648e-14;-409;1680;24608;19398;1;688;-2.14748e+09;-2.80885e+06;-1;0;0;0;-1;0;841350842;855820407;57998131
1514;1.14646e-14;-396;1638;24247;19511;1;621;-2.14748e+09;-2.80885e+06;-1;0;0;0;-1;0;841350842;855820407;57998131
1515;1.13648e-14;-409;1680;24608;19398;1;688;-2.14748e+09;-2.803e+06;-1;0;0;0;-1;0;841574309;856073560;58072063
1515;1.14646e-14;-396;1638;24247;19511;1;621;-2.14748e+09;-2.803e+06;-1;0;0;0;-1;0;841574309;856073560;58072063
1516;1.13648e-14;-410;1680;24608;19398;1;688;-2.14748e+09;-2.79716e+06;0;0;0;0;0;0;841797303;856326230;58145907
1516;1.14646e-14;-396;1638;24247;19511;1;621;-2.14748e+09;-2.79716e+06;-1;0;0;0;-1;0;841797303;856326230;58145907
1517;1.13648e-14;-411;1680;24608;19398;1;688;-2.14748e+09;-2.79134e+06;0;0;0;0;0;0;842019824;856578420;58219663
1517;1.14646e-14;-397;1638;24247;19511;1;621;-2.14748e+09;-2.79134e+06;0;0;0;0;0;0;842019824;856578420;58219663
1518;1.13648e-14;-411;1680;24608;19398;1;688;-2.14748e+09;-2.78553e+06;-1;0;0;0;-1;0;842241874;856830131;58293330
1518;1.14646e-14;-397;1638;24247;19511;1;621;-2.14748e+09;-2.78553e+06;-1;0;0;0;-1;0;842241874;856830131;58293330
1519;1.13648e-14;-411;1680;24608;19398;1;688;-2.14748e+09;-2.77973e+06;-1;0;0;0;-1;0;842463454;857081363;58366909
1519;1.14646e-14;-398;1638;24247;19511;1;621;-2.14748e+09;-2.77973e+06;0;0;0;0;0;0;842463454;857081363;58366909
1520;1.13648e-14;-411;1680;24608;19398;1;688;-2.14748e+09;-2.77395e+06;-1;0;0;0;-1;0;842684565;857332119;58440400
1520;1.14646e-14;-399;1638;24247;19511;1;621;-2.14748e+09;-2.77395e+06;0;0;0;0;0;0;842684565;857332119;58440400
1521;1.13648e-14;-411;1680;24608;19398;1;688;-2.14748e+09;-2.76819e+06;-1;0;0;0;-1;0;842905209;857582397;58513802
1521;1.14646e-14;-400;1638;24247;19511;1;621;-2.14748e+09;-2.76819e+06;0;0;0;0;0;0;842905209;857582397;58513802
1522;1.13648e-14;-411;1680;24608;19398;1;688;-2.14748e+09;-2.76244e+06;-1;0;0;0;-1;0;843125385;857832201;58587115
1522;1.14646e-14;-401;1638;24247;19511;1;621;-2.14748e+09;-2.76244e+06;0;0;0;0;0;0;843125385;857832201;58587115
1523;1.13648e-14;-411;1680;24608;19398;1;688;-2.14748e+09;-2.7567e+06;-1;0;0;0;-1;0;843345096;858081530;58660340
1523;1.14646e-14;-401;1638;24247;19511;1;621;-2.14748e+09;-2.7567e+06;-1;0;0;0;-1;0;843345096;858081530;58660340
1524;1.13648e-14;-412;1680;24608;19398;1;688;-2.14748e+09;-2.75098e+06;0;0;0;0;0;0;843564343;858330386;58733477
1524;1.14646e-14;-401;1638;24247;19511;1;621;-2.14748e+09;-2.75098e+06;-1;0;0;0;-1;0;843564343;858330386;58733477
1525;1.13648e-14;-413;1680;24608;19398;1;688;-2.14748e+09;-2.74537e+06;0;0;0;0;0;0;843783127;858578770;58806525
1525;1.14646e-14;-401;1638;24247;19511;1;621;-2.14748e+09;-2.74537e+06;-1;0;0;0;-1;0;843783127;858578770;58806525
1526;1.13648e-14;-414;1680;24608;19398;1;688;-2.14748e+09;-2.73958e+06;0;0;0;0;0;0;844001448;858826683;58879485
1526;1.14646e-14;-401;1638;24247;19511;1;621;-2.14748e+09;-2.73958e+06;-1;0;0;0;-1;0;844001448;858826683;58879485
1527;1.13648e-14;-415;1680;24608;19398;1;688;-2.14748e+09;-2.7339e+06;0;0;0;0;0;0;844219309;859074126;58952356
1527;1.14646e-14;-402;1638;24247;19511;1;621;-2.14748e+09;-2.7339e+06;0;0;0;0;0;0;844219309;859074126;58952356
1528;1.13648e-14;-415;1680;24608;19398;1;688;-2.14748e+09;-2.72823e+06;-1;0;0;0;-1;0;844436709;859321100;59025138
1528;1.14646e-14;-402;1638;24247;19511;1;621;-2.14748e+09;-2.72823e+06;-1;0;0;0;-1;0;844436709;859321100;59025138
1529;1.13648e-14;-416;1680;24608;19398;1;688;-2.14748e+09;-2.72258e+06;0;0;0;0;0;0;844653651;859567605;59097833
1529;1.14646e-14;-402;1638;24247;19511;1;621;-2.14748e+09;-2.72258e+06;-1;0;0;0;-1;0;844653651;859567605;59097833
1530;1.13648e-14;-417;1680;24608;19398;1;688;-2.14748e+09;-2.71694e+06;0;0;0;0;0;0;844870135;859813644;59170438
1530;1.14646e-14;-403;1638;24247;19511;1;621;-2.14748e+09;-2.71694e+06;0;0;0;0;0;0;844870135;859813644;59170438
1531;1.13648e-14;-417;1680;24608;19398;1;688;-2.14748e+09;-2.71132e+06;-1;0;0;0;-1;0;845086162;860059216;59242955
1531;1.14646e-14;-404;1638;24247;19511;1;621;-2.14748e+09;-2.71132e+06;0;0;0;0;0;0;845086162;860059216;59242955
1532;1.13648e-14;-418;1680;24608;19398;1;688;-2.14748e+09;-2.70571e+06;0;0;0;0;0;0;845301734;860304324;59315384
1532;1.14646e-14;-404;1638;24247;19511;1;621;-2.14748e+09;-2.70571e+06;-1;0;0;0;-1;0;845301734;860304324;59315384
1533;1.13648e-14;-418;1680;24608;19398;1;688;-2.14748e+09;-2.70011e+06;-1;0;0;0;-1;0;845516852;860548967;59387724
1533;1.14646e-14;-405;1638;24247;19511;1;621;-2.14748e+09;-2.70011e+06;0;0;0;0;0;0;845516852;860548967;59387724
1534;1.13648e-14;-419;1680;24608;19398;1;688;-2.14748e+09;-2.69453e+06;0;0;0;0;0;0;845731517;860793147;59459975
1534;1.14646e-14;-406;1638;24247;19511;1;621;-2.14748e+09;-2.69453e+06;0;0;0;0;0;0;845731517;860793147;59459975
1535;1.13648e-14;-419;1680;24608;19398;1;688;-2.14748e+09;-2.68906e+06;-1;0;0;0;-1;0;845945729;861036865;59532138
1535;1.14646e-14;-407;1638;24247;19511;1;621;-2.14748e+09;-2.68906e+06;0;0;0;0;0;0;845945729;861036865;59532138
1536;1.13648e-14;-420;1680;24608;19398;1;688;-2.14748e+09;-2.68341e+06;0;0;0;0;0;0;846159490;861280123;59604213
1536;1.14646e-14;-408;1638;24247;19511;1;621;-2.14748e+09;-2.68341e+06;0;0;0;0;0;0;846159490;861280123;59604213
1537;1.13648e-14;-421;1680;24608;19398;1;688;-2.14748e+09;-2.67786e+06;0;0;0;0;0;0;846372801;861522920;59676199
1537;1.14646e-14;-408;1638;24247;19511;1;621;-2.14748e+09;-2.67786e+06;-1;0;0;0;-1;0;846372801;861522920;59676199
1538;1.13648e-14;-422;1680;24608;19398;1;688;-2.14748e+09;-2.67244e+06;0;0;0;0;0;0;846585664;861765258;59748096
1538;1.14646e-14;-408;1638;24247;19511;1;621;-2.14748e+09;-2.67234e+06;-1;0;0;0;-1;0;846585664;861765258;59748096
1539;1.13648e-14;-423;1680;24608;19398;1;688;-2.14748e+09;-2.66682e+06;0;0;0;0;0;0;846798078;862007138;59819905
1539;1.14646e-14;-408;1638;24247;19511;1;621;-2.14748e+09;-2.66682e+06;-1;0;0;0;-1;0;846798078;862007138;59819905
1540;1.13648e-14;-423;1680;24608;19398;1;688;-2.14748e+09;-2.66132e+06;-1;0;0;0;-1;0;847010046;862248560;59891625
1540;1.14646e-14;-408;1638;24247;19511;1;621;-2.14748e+09;-2.66132e+06;-1;0;0;0;-1;0;847010046;862248560;59891625
1541;1.13648e-14;-424;1680;24608;19398;1;688;-2.14748e+09;-2.65584e+06;0;0;0;0;0;0;847221568;862489527;59963257
1541;1.14646e-14;-409;1638;24247;19511;1;621;-2.14748e+09;-2.65584e+06;0;0;0;0;0;0;847221568;862489527;59963257
1542;1.13648e-14;-424;1680;24608;19398;1;688;-2.14748e+09;-2.65036e+06;-1;0;0;0;-1;0;847432646;862730039;60034800
1542;1.14646e-14;-409;1638;24247;19511;1;621;-2.14748e+09;-2.65036e+06;-1;0;0;0;-1;0;847432646;862730039;60034800
1543;1.13648e-14;-425;1680;24608;19398;1;688;-2.14748e+09;-2.6449e+06;0;0;0;0;0;0;847643280;862970096;60106255
1543;1.14646e-14;-409;1638;24247;19511;1;621;-2.14748e+09;-2.6449e+06;-1;0;0;0;-1;0;847643280;862970096;60106255
1544;1.13648e-14;-425;1680;24608;19398;1;688;-2.14748e+09;-2.63946e+06;-1;0;0;0;-1;0;847853471;863209700;60177621
1544;1.14646e-14;-410;1638;24247;19511;1;621;-2.14748e+09;-2.63946e+06;0;0;0;0;0;0;847853471;863209700;60177621
1545;1.13648e-14;-426;1680;24608;19398;1;688;-2.14748e+09;-2.63402e+06;0;0;0;0;0;0;848063221;863448852;60248899
1545;1.14646e-14;-410;1638;24247;19511;1;621;-2.14748e+09;-2.63402e+06;-1;0;0;0;-1;0;848063221;863448852;60248899
1546;1.13648e-14;-426;1680;24608;19398;1;688;-2.14748e+09;-2.6286e+06;-1;0;0;0;-1;0;848272531;863687553;60320088
1546;1.14646e-14;-410;1638;24247;19511;1;621;-2.14748e+09;-2.6286e+06;-1;0;0;0;-1;0;848272531;863687553;60320088
1547;1.13648e-14;-427;1680;24608;19398;1;688;-2.14748e+09;-2.62329e+06;0;0;0;0;0;0;848481402;863925803;60391188
1547;1.14646e-14;-410;1638;24247;19511;1;621;-2.14748e+09;-2.62329e+06;-1;0;0;0;-1;0;848481402;863925803;60391188
1548;1.13648e-14;-427;1680;24608;19398;1;688;-2.14748e+09;-2.6178e+06;-1;0;0;0;-1;0;848689834;864163604;60462201
1548;1.14646e-14;-411;1638;24247;19511;1;621;-2.14748e+09;-2.6178e+06;0;0;0;0;0;0;848689834;864163604;60462201
1549;1.13648e-14;-427;1680;24608;19398;1;688;-2.14748e+09;-2.61242e+06;-1;0;0;0;-1;0;848897829;864400957;60533124
1549;1.14646e-14;-412;1638;24247;19511;1;621;-2.14748e+09;-2.61242e+06;0;0;0;0;0;0;848897829;864400957;60533124
1550;1.13648e-14;-428;1680;24608;19398;1;688;-2.14748e+09;-2.60705e+06;0;0;0;0;0;0;849105388;864637862;60603959
1550;1.14646e-14;-412;1638;24247;19511;1;621;-2.14748e+09;-2.60705e+06;-1;0;0;0;-1;0;849105388;864637862;60603959
1551;1.13648e-14;-429;1680;24608;19398;1;688;-2.14748e+09;-2.6017e+06;0;0;0;0;0;0;849312512;864874320;60674706
1551;1.14646e-14;-412;1638;24247;19511;1;621;-2.14748e+09;-2.6017e+06;-1;0;0;0;-1;0;849312512;864874320;60674706
1552;1.13648e-14;-430;1680;24608;19398;1;688;-2.14748e+09;-2.59636e+06;0;0;0;0;0;0;849519202;865110334;60745364
1552;1.14646e-14;-413;1638;24247;19511;1;621;-2.14748e+09;-2.59636e+06;0;0;0;0;0;0;849519202;865110334;60745364
1553;1.13648e-14;-430;1680;24608;19398;1;688;-2.14748e+09;-2.59113e+06;-1;0;0;0;-1;0;849725459;865345902;60815934
1553;1.14646e-14;-414;1638;24247;19511;1;621;-2.14748e+09;-2.59113e+06;0;0;0;0;0;0;849725459;865345902;60815934
1554;1.13648e-14;-430;1680;24608;19398;1;688;-2.14748e+09;-2.58571e+06;-1;0;0;0;-1;0;849931284;865581027;60886415
1554;1.14646e-14;-414;1638;24247;19511;1;621;-2.14748e+09;-2.58571e+06;-1;0;0;0;-1;0;849931284;865581027;60886415
1555;1.13648e-14;-431;1680;24608;19398;1;688;-2.14748e+09;-2.58041e+06;0;0;0;0;0;0;850136678;865815709;60956808
1555;1.14646e-14;-415;1638;24247;19511;1;621;-2.14748e+09;-2.58041e+06;0;0;0;0;0;0;850136678;865815709;60956808
1556;1.13648e-14;-432;1680;24608;19398;1;688;-2.14748e+09;-2.57512e+06;0;0;0;0;0;0;850341642;866049950;61027112
1556;1.14646e-14;-416;1638;24247;19511;1;621;-2.14748e+09;-2.57512e+06;0;0;0;0;0;0;850341642;866049950;61027112
1557;1.13648e-14;-432;1680;24608;19398;1;688;-2.14748e+09;-2.56984e+06;-1;0;0;0;-1;0;850546177;866283749;61097328
1557;1.14646e-14;-416;1638;24247;19511;1;621;-2.14748e+09;-2.56984e+06;-1;0;0;0;-1;0;850546177;866283749;61097328
1558;1.13648e-14;-433;1680;24608;19398;1;688;-2.14748e+09;-2.56458e+06;0;0;0;0;0;0;850750285;866517109;61167456
1558;1.14646e-14;-417;1638;24247;19511;1;621;-2.14748e+09;-2.56458e+06;0;0;0;0;0;0;850750285;866517109;61167456
1559;1.13648e-14;-434;1680;24608;19398;1;688;-2.14748e+09;-2.55942e+06;0;0;0;0;0;0;850953965;866750030;61237495
1559;1.14646e-14;-417;1638;24247;19511;1;621;-2.14748e+09;-2.55932e+06;-1;0;0;0;-1;0;850953965;866750030;61237495
1560;1.13648e-14;-435;1680;24608;19398;1;688;-2.14748e+09;-2.55408e+06;0;0;0;0;0;0;851157220;866982513;61307446
1560;1.14646e-14;-417;1638;24247;19511;1;621;-2.14748e+09;-2.55408e+06;-1;0;0;0;-1;0;851157220;866982513;61307446
1561;1.13648e-14;-436;1680;24608;19398;1;688;-2.14748e+09;-2.54886e+06;0;0;0;0;0;0;851360050;867214558;61377308
1561;1.14646e-14;-417;1638;24247;19511;1;621;-2.14748e+09;-2.54886e+06;-1;0;0;0;-1;0;851360050;867214558;61377308
1562;1.13648e-14;-437;1680;24608;19398;1;688;-2.14748e+09;-2.54364e+06;0;0;0;0;0;0;851562456;867446168;61447082
1562;1.14646e-14;-418;1638;24247;19511;1;621;-2.14748e+09;-2.54364e+06;0;0;0;0;0;0;851562456;867446168;61447082
1563;1.13648e-14;-438;1680;24608;19398;1;688;-2.14748e+09;-2.53844e+06;0;0;0;0;0;0;851764439;867677342;61516768
1563;1.14646e-14;-418;1638;24247;19511;1;621;-2.14748e+09;-2.53844e+06;-1;0;0;0;-1;0;851764439;867677342;61516768
1564;1.13648e-14;-439;1680;24608;19398;1;688;-2.14748e+09;-2.53325e+06;0;0;0;0;0;0;851966001;867908082;61586365
1564;1.14646e-14;-418;1638;24247;19511;1;621;-2.14748e+09;-2.53325e+06;-1;0;0;0;-1;0;851966001;867908082;61586365
1565;1.13648e-14;-440;1680;24608;19398;1;688;-2.14748e+09;-2.52808e+06;0;0;0;0;0;0;852167142;868138388;61655875
1565;1.14646e-14;-419;1638;24247;19511;1;621;-2.14748e+09;-2.52808e+06;0;0;0;0;0;0;852167142;868138388;61655875
1566;1.13648e-14;-441;1680;24608;19398;1;688;-2.14748e+09;-2.52291e+06;0;0;0;0;0;0;852367863;868368262;61725295
1566;1.14646e-14;-420;1638;24247;19511;1;621;-2.14748e+09;-2.52291e+06;0;0;0;0;0;0;852367863;868368262;61725295
1567;1.13648e-14;-441;1680;24608;19398;1;688;-2.14748e+09;-2.51776e+06;-1;0;0;0;-1;0;852568165;868597705;61794628
1567;1.14646e-14;-421;1638;24247;19511;1;621;-2.14748e+09;-2.51776e+06;0;0;0;0;0;0;852568165;868597705;61794628
1568;1.13648e-14;-441;1680;24608;19398;1;688;-2.14748e+09;-2.51262e+06;-1;0;0;0;-1;0;852768049;868826716;61863872
1568;1.14646e-14;-422;1638;24247;19511;1;621;-2.14748e+09;-2.51262e+06;0;0;0;0;0;0;852768049;868826716;61863872
1569;1.13648e-14;-441;1680;24608;19398;1;688;-2.14748e+09;-2.5075e+06;-1;0;0;0;-1;0;852967517;869055298;61933028
1569;1.14646e-14;-422;1638;24247;19511;1;621;-2.14748e+09;-2.5075e+06;-1;0;0;0;-1;0;852967517;869055298;61933028
1570;1.13648e-14;-442;1680;24608;19398;1;688;-2.14748e+09;-2.50238e+06;0;0;0;0;0;0;853166569;869283451;62002096
1570;1.14646e-14;-423;1638;24247;19511;1;621;-2.14748e+09;-2.50238e+06;0;0;0;0;0;0;853166569;869283451;62002096
1571;1.13648e-14;-443;1680;24608;19398;1;688;-2.14748e+09;-2.49738e+06;0;0;0;0;0;0;853365206;869511176;62071075
1571;1.14646e-14;-423;1638;24247;19511;1;621;-2.14748e+09;-2.49738e+06;-1;0;0;0;-1;0;853365206;869511176;62071075
1572;1.13648e-14;-444;1680;24608;19398;1;688;-2.14748e+09;-2.49219e+06;0;0;0;0;0;0;853563429;869738474;62139967
1572;1.14646e-14;-423;1638;24247;19511;1;621;-2.14748e+09;-2.49219e+06;-1;0;0;0;-1;0;853563429;869738474;62139967
1573;1.13648e-14;-444;1680;24608;19398;1;688;-2.14748e+09;-2.48721e+06;-1;0;0;0;-1;0;853761239;869965346;62208770
1573;1.14646e-14;-424;1638;24247;19511;1;621;-2.14748e+09;-2.48721e+06;0;0;0;0;0;0;853761239;869965346;62208770
1574;1.13648e-14;-445;1680;24608;19398;1;688;-2.14748e+09;-2.48214e+06;0;0;0;0;0;0;853958637;870191792;62277485
1574;1.14646e-14;-425;1638;24247;19511;1;621;-2.14748e+09;-2.48214e+06;0;0;0;0;0;0;853958637;870191792;62277485
1575;1.13648e-14;-445;1680;24608;19398;1;688;-2.14748e+09;-2.47709e+06;-1;0;0;0;-1;0;854155624;870417814;62346112
1575;1.14646e-14;-426;1638;24247;19511;1;621;-2.14748e+09;-2.47709e+06;0;0;0;0;0;0;854155624;870417814;62346112
1576;1.13648e-14;-445;1680;24608;19398;1;688;-2.14748e+09;-2.47195e+06;-1;0;0;0;-1;0;854352202;870643413;62414651
1576;1.14646e-14;-427;1638;24247;19511;1;621;-2.14748e+09;-2.47195e+06;0;0;0;0;0;0;854352202;870643413;62414651
1577;1.13648e-14;-445;1680;24608;19398;1;688;-2.14748e+09;-2.46702e+06;-1;0;0;0;-1;0;854548370;870868589;62483102
1577;1.14646e-14;-427;1638;24247;19511;1;621;-2.14748e+09;-2.46702e+06;-1;0;0;0;-1;0;854548370;870868589;62483102
1578;1.13648e-14;-446;1680;24608;19398;1;688;-2.14748e+09;-2.462e+06;0;0;0;0;0;0;854744131;871093343;62551465
1578;1.14646e-14;-428;1638;24247;19511;1;621;-2.14748e+09;-2.462e+06;0;0;0;0;0;0;854744131;871093343;62551465
1579;1.13648e-14;-446;1680;24608;19398;1;688;-2.14748e+09;-2.45689e+06;-1;0;0;0;-1;0;854939484;871317676;62619739
1579;1.14646e-14;-429;1638;24247;19511;1;621;-2.14748e+09;-2.45689e+06;0;0;0;0;0;0;854939484;871317676;62619739
1580;1.13648e-14;-446;1680;24608;19398;1;688;-2.14748e+09;-2.4519e+06;-1;0;0;0;-1;0;855134431;871541589;62687926
1580;1.14646e-14;-430;1638;24247;19511;1;621;-2.14748e+09;-2.4519e+06;0;0;0;0;0;0;855134431;871541589;62687926
1581;1.13648e-14;-446;1680;24608;19398;1;688;-2.14748e+09;-2.44692e+06;-1;0;0;0;-1;0;855328973;871765084;62756025
1581;1.14646e-14;-431;1638;24247;19511;1;621;-2.14748e+09;-2.44692e+06;0;0;0;0;0;0;855328973;871765084;62756025
1582;1.13648e-14;-446;1680;24608;19398;1;688;-2.14748e+09;-2.44204e+06;-1;0;0;0;-1;0;855523111;871988159;62824035
1582;1.14646e-14;-432;1638;24247;19511;1;621;-2.14748e+09;-2.44204e+06;0;0;0;0;0;0;855523111;871988159;62824035
1583;1.13648e-14;-446;1680;24608;19398;1;688;-2.14748e+09;-2.43699e+06;-1;0;0;0;-1;0;855716846;872210818;62891958
1583;1.14646e-14;-432;1638;24247;19511;1;621;-2.14748e+09;-2.43699e+06;-1;0;0;0;-1;0;855716846;872210818;62891958
1584;1.13648e-14;-447;1680;24608;19398;1;688;-2.14748e+09;-2.43204e+06;0;0;0;0;0;0;855910178;872433060;62959793
1584;1.14646e-14;-432;1638;24247;19511;1;621;-2.14748e+09;-2.43204e+06;-1;0;0;0;-1;0;855910178;872433060;62959793
1585;1.13648e-14;-448;1680;24608;19398;1;688;-2.14748e+09;-2.4272e+06;0;0;0;0;0;0;856103109;872654887;63027540
1585;1.14646e-14;-433;1638;24247;19511;1;621;-2.14748e+09;-2.4272e+06;0;0;0;0;0;0;856103109;872654887;63027540
1586;1.13648e-14;-449;1680;24608;19398;1;688;-2.14748e+09;-2.42228e+06;0;0;0;0;0;0;856295640;872876298;63095199
1586;1.14646e-14;-433;1638;24247;19511;1;621;-2.14748e+09;-2.42228e+06;-1;0;0;0;-1;0;856295640;872876298;63095199
1587;1.13648e-14;-450;1680;24608;19398;1;688;-2.14748e+09;-2.41727e+06;0;0;0;0;0;0;856487771;873097296;63162771
1587;1.14646e-14;-433;1638;24247;19511;1;621;-2.14748e+09;-2.41727e+06;-1;0;0;0;-1;0;856487771;873097296;63162771
1588;1.13648e-14;-451;1680;24608;19398;1;688;-2.14748e+09;-2.41237e+06;0;0;0;0;0;0;856679504;873317881;63230254
1588;1.14646e-14;-434;1638;24247;19511;1;621;-2.14748e+09;-2.41237e+06;0;0;0;0;0;0;856679504;873317881;63230254
1589;1.13648e-14;-451;1680;24608;19398;1;688;-2.14748e+09;-2.40758e+06;-1;0;0;0;-1;0;856870839;873538053;63297650
1589;1.14646e-14;-435;1638;24247;19511;1;621;-2.14748e+09;-2.40758e+06;0;0;0;0;0;0;856870839;873538053;63297650
1590;1.13648e-14;-452;1680;24608;19398;1;688;-2.14748e+09;-2.4026e+06;0;0;0;0;0;0;857061777;873757814;63364958
1590;1.14646e-14;-436;1638;24247;19511;1;621;-2.14748e+09;-2.4026e+06;0;0;0;0;0;0;857061777;873757814;63364958
1591;1.13648e-14;-453;1680;24608;19398;1;688;-2.14748e+09;-2.39774e+06;0;0;0;0;0;0;857252320;873977165;63432178
1591;1.14646e-14;-436;1638;24247;19511;1;621;-2.14748e+09;-2.39774e+06;-1;0;0;0;-1;0;857252320;873977165;63432178
1592;1.13648e-14;-454;1680;24608;19398;1;688;-2.14748e+09;-2.39288e+06;0;0;0;0;0;0;857442468;874196106;63499311
1592;1.14646e-14;-436;1638;24247;19511;1;621;-2.14748e+09;-2.39288e+06;-1;0;0;0;-1;0;857442468;874196106;63499311
1593;1.13648e-14;-454;1680;24608;19398;1;688;-2.14748e+09;-2.38804e+06;-1;0;0;0;-1;0;857632222;874414638;63566356
1593;1.14646e-14;-437;1638;24247;19511;1;621;-2.14748e+09;-2.38804e+06;0;0;0;0;0;0;857632222;874414638;63566356
1594;1.13648e-14;-455;1680;24608;19398;1;688;-2.14748e+09;-2.38321e+06;0;0;0;0;0;0;857821582;874632763;63633313
1594;1.14646e-14;-437;1638;24247;19511;1;621;-2.14748e+09;-2.38321e+06;-1;0;0;0;-1;0;857821582;874632763;63633313
1595;1.13648e-14;-456;1680;24608;19398;1;688;-2.14748e+09;-2.37839e+06;0;0;0;0;0;0;858010551;874850480;63700183
1595;1.14646e-14;-437;1638;24247;19511;1;621;-2.14748e+09;-2.37839e+06;-1;0;0;0;-1;0;858010551;874850480;63700183
1596;1.13648e-14;-456;1680;24608;19398;1;688;-2.14748e+09;-2.37358e+06;-1;0;0;0;-1;0;858199129;875067791;63766965
1596;1.14646e-14;-437;1638;24247;19511;1;621;-2.14748e+09;-2.37358e+06;-1;0;0;0;-1;0;858199129;875067791;63766965
1597;1.13648e-14;-457;1680;24608;19398;1;688;-2.14748e+09;-2.36878e+06;0;0;0;0;0;0;858387317;875284696;63833659
1597;1.14646e-14;-438;1638;24247;19511;1;621;-2.14748e+09;-2.36878e+06;0;0;0;0;0;0;858387317;875284696;63833659
1598;1.13648e-14;-458;1680;24608;19398;1;688;-2.14748e+09;-2.36399e+06;0;0;0;0;0;0;858575115;875501197;63900266
1598;1.14646e-14;-439;1638;24247;19511;1;621;-2.14748e+09;-2.36399e+06;0;0;0;0;0;0;858575115;875501197;63900266
1599;1.13648e-14;-459;1680;24608;19398;1;688;-2.14748e+09;-2.35922e+06;0;0;0;0;0;0;858762525;875717295;63966786
1599;1.14646e-14;-440;1638;24247;19511;1;621;-2.14748e+09;-2.35922e+06;0;0;0;0;0;0;858762525;875717295;63966786
1600;1.13648e-14;-459;1680;24608;19398;1;688;-2.14748e+09;-2.35445e+06;-1;0;0;0;-1;0;858949548;875932989;64033218
1600;1.14646e-14;-440;1638;24247;19511;1;621;-2.14748e+09;-2.35445e+06;-1;0;0;0;-1;0;858949548;875932989;64033218
1601;1.13648e-14;-460;1680;24608;19398;1;688;-2.14748e+09;-2.3497e+06;0;0;0;0;0;0;859136184;876148281;64099563
1601;1.14646e-14;-441;1638;24247;19511;1;621;-2.14748e+09;-2.3497e+06;0;0;0;0;0;0;859136184;876148281;64099563
1602;1.13648e-14;-460;1680;24608;19398;1;688;-2.14748e+09;-2.34506e+06;-1;0;0;0;-1;0;859322434;876363172;64165820
1602;1.14646e-14;-441;1638;24247;19511;1;621;-2.14748e+09;-2.34506e+06;-1;0;0;0;-1;0;859322434;876363172;64165820
1603;1.13648e-14;-460;1680;24608;19398;1;688;-2.14748e+09;-2.34023e+06;-1;0;0;0;-1;0;859508299;876577663;64231990
1603;1.14646e-14;-442;1638;24247;19511;1;621;-2.14748e+09;-2.34023e+06;0;0;0;0;0;0;859508299;876577663;64231990
1604;1.13648e-14;-460;1680;24608;19398;1;688;-2.14748e+09;-2.33561e+06;-1;0;0;0;-1;0;859693781;876791754;64298073
1604;1.14646e-14;-442;1638;24247;19511;1;621;-2.14748e+09;-2.33561e+06;-1;0;0;0;-1;0;859693781;876791754;64298073
1605;1.13648e-14;-460;1680;24608;19398;1;688;-2.14748e+09;-2.3308e+06;-1;0;0;0;-1;0;859878879;877005446;64364069
1605;1.14646e-14;-442;1638;24247;19511;1;621;-2.14748e+09;-2.3308e+06;-1;0;0;0;-1;0;859878879;877005446;64364069
1606;1.13648e-14;-460;1680;24608;19398;1;688;-2.14748e+09;-2.3262e+06;-1;0;0;0;-1;0;860063596;877218741;64429977
1606;1.14646e-14;-443;1638;24247;19511;1;621;-2.14748e+09;-2.3262e+06;0;0;0;0;0;0;860063596;877218741;64429977
1607;1.13648e-14;-460;1680;24608;19398;1;688;-2.14748e+09;-2.32141e+06;-1;0;0;0;-1;0;860247931;877431638;64495798
1607;1.14646e-14;-444;1638;24247;19511;1;621;-2.14748e+09;-2.32141e+06;0;0;0;0;0;0;860247931;877431638;64495798
1608;1.13648e-14;-460;1680;24608;19398;1;688;-2.14748e+09;-2.31674e+06;-1;0;0;0;-1;0;860431886;877644139;64561532
1608;1.14646e-14;-445;1638;24247;19511;1;621;-2.14748e+09;-2.31674e+06;0;0;0;0;0;0;860431886;877644139;64561532
1609;1.13648e-14;-461;1680;24608;19398;1;688;-2.14748e+09;-2.31207e+06;0;0;0;0;0;0;860615461;877856244;64627179
1609;1.14646e-14;-445;1638;24247;19511;1;621;-2.14748e+09;-2.31207e+06;-1;0;0;0;-1;0;860615461;877856244;64627179
1610;1.13648e-14;-461;1680;24608;19398;1;688;-2.14748e+09;-2.30742e+06;-1;0;0;0;-1;0;860798658;878067955;64692738
1610;1.14646e-14;-446;1638;24247;19511;1;621;-2.14748e+09;-2.30742e+06;0;0;0;0;0;0;860798658;878067955;64692738
1611;1.13648e-14;-461;1680;24608;19398;1;688;-2.14748e+09;-2.30287e+06;-1;0;0;0;-1;0;860981477;878279271;64758211
1611;1.14646e-14;-446;1638;24247;19511;1;621;-2.14748e+09;-2.30287e+06;-1;0;0;0;-1;0;860981477;878279271;64758211
1612;1.13648e-14;-461;1680;24608;19398;1;688;-2.14748e+09;-2.29814e+06;-1;0;0;0;-1;0;861163920;878490195;64823597
1612;1.14646e-14;-447;1638;24247;19511;1;621;-2.14748e+09;-2.29814e+06;0;0;0;0;0;0;861163920;878490195;64823597
1613;1.13648e-14;-462;1680;24608;19398;1;688;-2.14748e+09;-2.29352e+06;0;0;0;0;0;0;861345986;878700726;64888895
1613;1.14646e-14;-447;1638;24247;19511;1;621;-2.14748e+09;-2.29352e+06;-1;0;0;0;-1;0;861345986;878700726;64888895
1614;1.13648e-14;-463;1680;24608;19398;1;688;-2.14748e+09;-2.28891e+06;0;0;0;0;0;0;861527678;878910866;64954107
1614;1.14646e-14;-448;1638;24247;19511;1;621;-2.14748e+09;-2.28891e+06;0;0;0;0;0;0;861527678;878910866;64954107
1615;1.13648e-14;-464;1680;24608;19398;1;688;-2.14748e+09;-2.28431e+06;0;0;0;0;0;0;861708995;879120615;65019232
1615;1.14646e-14;-448;1638;24247;19511;1;621;-2.14748e+09;-2.28431e+06;-1;0;0;0;-1;0;861708995;879120615;65019232
1616;1.13648e-14;-464;1680;24608;19398;1;688;-2.14748e+09;-2.27972e+06;-1;0;0;0;-1;0;861889939;879329974;65084270
1616;1.14646e-14;-449;1638;24247;19511;1;621;-2.14748e+09;-2.27972e+06;0;0;0;0;0;0;861889939;879329974;65084270
1617;1.13648e-14;-465;1680;24608;19398;1;688;-2.14748e+09;-2.27514e+06;0;0;0;0;0;0;862070510;879538945;65149221
1617;1.14646e-14;-449;1638;24247;19511;1;621;-2.14748e+09;-2.27514e+06;-1;0;0;0;-1;0;862070510;879538945;65149221
1618;1.13648e-14;-466;1680;24608;19398;1;688;-2.14748e+09;-2.27057e+06;0;0;0;0;0;0;862250710;879747527;65214086
1618;1.14646e-14;-449;1638;24247;19511;1;621;-2.14748e+09;-2.27057e+06;-1;0;0;0;-1;0;862250710;879747527;65214086
1619;1.13648e-14;-466;1680;24608;19398;1;688;-2.14748e+09;-2.26601e+06;-1;0;0;0;-1;0;862430539;879955721;65278863
1619;1.14646e-14;-450;1638;24247;19511;1;621;-2.14748e+09;-2.26601e+06;0;0;0;0;0;0;862430539;879955721;65278863
1620;1.13648e-14;-467;1680;24608;19398;1;688;-2.14748e+09;-2.26146e+06;0;0;0;0;0;0;862609998;880163529;65343554
1620;1.14646e-14;-450;1638;24247;19511;1;621;-2.14748e+09;-2.26146e+06;-1;0;0;0;-1;0;862609998;880163529;65343554
1621;1.13648e-14;-467;1680;24608;19398;1;688;-2.14748e+09;-2.25692e+06;-1;0;0;0;-1;0;862789088;880370950;65408159
1621;1.14646e-14;-451;1638;24247;19511;1;621;-2.14748e+09;-2.25692e+06;0;0;0;0;0;0;862789088;880370950;65408159
1622;1.13648e-14;-468;1680;24608;19398;1;688;-2.14748e+09;-2.2525e+06;0;0;0;0;0;0;862967810;880577987;65472676
1622;1.14646e-14;-451;1638;24247;19511;1;621;-2.14748e+09;-2.2525e+06;-1;0;0;0;-1;0;862967810;880577987;65472676
1623;1.13648e-14;-469;1680;24608;19398;1;688;-2.14748e+09;-2.24788e+06;0;0;0;0;0;0;863146165;880784639;65537107
1623;1.14646e-14;-452;1638;24247;19511;1;621;-2.14748e+09;-2.24788e+06;0;0;0;0;0;0;863146165;880784639;65537107
1624;1.13648e-14;-469;1680;24608;19398;1;688;-2.14748e+09;-2.24337e+06;-1;0;0;0;-1;0;863324153;880990908;65601452
1624;1.14646e-14;-452;1638;24247;19511;1;621;-2.14748e+09;-2.24337e+06;-1;0;0;0;-1;0;863324153;880990908;65601452
1625;1.13648e-14;-470;1680;24608;19398;1;688;-2.14748e+09;-2.23888e+06;0;0;0;0;0;0;863501775;881196794;65665710
1625;1.14646e-14;-452;1638;24247;19511;1;621;-2.14748e+09;-2.23888e+06;-1;0;0;0;-1;0;863501775;881196794;65665710
1626;1.13648e-14;-471;1680;24608;19398;1;688;-2.14748e+09;-2.23439e+06;0;0;0;0;0;0;863679033;881402298;65729882
1626;1.14646e-14;-453;1638;24247;19511;1;621;-2.14748e+09;-2.23439e+06;0;0;0;0;0;0;863679033;881402298;65729882
1627;1.13648e-14;-472;1680;24608;19398;1;688;-2.14748e+09;-2.22992e+06;0;0;0;0;0;0;863855927;881607420;65793967
1627;1.14646e-14;-453;1638;24247;19511;1;621;-2.14748e+09;-2.22992e+06;-1;0;0;0;-1;0;863855927;881607420;65793967
1628;1.13648e-14;-472;1680;24608;19398;1;688;-2.14748e+09;-2.22545e+06;-1;0;0;0;-1;0;864032457;881812163;65857966
1628;1.14646e-14;-454;1638;24247;19511;1;621;-2.14748e+09;-2.22545e+06;0;0;0;0;0;0;864032457;881812163;65857966
1629;1.13648e-14;-473;1680;24608;19398;1;688;-2.14748e+09;-2.221e+06;0;0;0;0;0;0;864208625;882016525;65921879
1629;1.14646e-14;-455;1638;24247;19511;1;621;-2.14748e+09;-2.221e+06;0;0;0;0;0;0;864208625;882016525;65921879
1630;1.13648e-14;-474;1680;24608;19398;1;688;-2.14748e+09;-2.21655e+06;0;0;0;0;0;0;864384432;882220509;65985705
1630;1.14646e-14;-455;1638;24247;19511;1;621;-2.14748e+09;-2.21655e+06;-1;0;0;0;-1;0;864384432;882220509;65985705
1631;1.13648e-14;-474;1680;24608;19398;1;688;-2.14748e+09;-2.21212e+06;-1;0;0;0;-1;0;864559878;882424114;66049445
1631;1.14646e-14;-456;1638;24247;19511;1;621;-2.14748e+09;-2.21212e+06;0;0;0;0;0;0;864559878;882424114;66049445
1632;1.13648e-14;-475;1680;24608;19398;1;688;-2.14748e+09;-2.2077e+06;0;0;0;0;0;0;864734965;882627342;66113099
1632;1.14646e-14;-456;1638;24247;19511;1;621;-2.14748e+09;-2.2077e+06;-1;0;0;0;-1;0;864734965;882627342;66113099
1633;1.13648e-14;-476;1680;24608;19398;1;688;-2.14748e+09;-2.20328e+06;0;0;0;0;0;0;864909692;882830193;66176667
1633;1.14646e-14;-456;1638;24247;19511;1;621;-2.14748e+09;-2.20328e+06;-1;0;0;0;-1;0;864909692;882830193;66176667
1634;1.13648e-14;-476;1680;24608;19398;1;688;-2.14748e+09;-2.19898e+06;-1;0;0;0;-1;0;865084062;883032669;66240149
1634;1.14646e-14;-457;1638;24247;19511;1;621;-2.14748e+09;-2.19898e+06;0;0;0;0;0;0;865084062;883032669;66240149
1635;1.13648e-14;-476;1680;24608;19398;1;688;-2.14748e+09;-2.19448e+06;-1;0;0;0;-1;0;865258073;883234769;66303545
1635;1.14646e-14;-458;1638;24247;19511;1;621;-2.14748e+09;-2.19448e+06;0;0;0;0;0;0;865258073;883234769;66303545
1636;1.13648e-14;-476;1680;24608;19398;1;688;-2.14748e+09;-2.1901e+06;-1;0;0;0;-1;0;865431729;883436495;66366855
1636;1.14646e-14;-459;1638;24247;19511;1;621;-2.14748e+09;-2.1901e+06;0;0;0;0;0;0;865431729;883436495;66366855
1637;1.13648e-14;-476;1680;24608;19398;1;688;-2.14748e+09;-2.18572e+06;-1;0;0;0;-1;0;865605029;883637848;66430079
1637;1.14646e-14;-460;1638;24247;19511;1;621;-2.14748e+09;-2.18572e+06;0;0;0;0;0;0;865605029;883637848;66430079
1638;1.13648e-14;-476;1680;24608;19398;1;688;-2.14748e+09;-2.18136e+06;-1;0;0;0;-1;0;865777973;883838827;66493217
1638;1.14646e-14;-461;1638;24247;19511;1;621;-2.14748e+09;-2.18136e+06;0;0;0;0;0;0;865777973;883838827;66493217
1639;1.13648e-14;-477;1680;24608;19398;1;688;-2.14748e+09;-2.17701e+06;0;0;0;0;0;0;865950564;884039435;66556269
1639;1.14646e-14;-461;1638;24247;19511;1;621;-2.14748e+09;-2.17701e+06;-1;0;0;0;-1;0;865950564;884039435;66556269
1640;1.13648e-14;-477;1680;24608;19398;1;688;-2.14748e+09;-2.17276e+06;-1;0;0;0;-1;0;866122802;884239671;66619235
1640;1.14646e-14;-461;1638;24247;19511;1;621;-2.14748e+09;-2.17276e+06;-1;0;0;0;-1;0;866122802;884239671;66619235
1641;1.13648e-14;-478;1680;24608;19398;1;688;-2.14748e+09;-2.16833e+06;0;0;0;0;0;0;866294687;884439537;66682116
1641;1.14646e-14;-462;1638;24247;19511;1;621;-2.14748e+09;-2.16833e+06;0;0;0;0;0;0;866294687;884439537;66682116
1642;1.13648e-14;-479;1680;24608;19398;1;688;-2.14748e+09;-2.1641e+06;0;0;0;0;0;0;866466220;884639033;66744911
1642;1.14646e-14;-463;1638;24247;19511;1;621;-2.14748e+09;-2.1641e+06;0;0;0;0;0;0;866466220;884639033;66744911
1643;1.13648e-14;-480;1680;24608;19398;1;688;-2.14748e+09;-2.15979e+06;0;0;0;0;0;0;866637403;884838159;66807620
1643;1.14646e-14;-463;1638;24247;19511;1;621;-2.14748e+09;-2.15979e+06;-1;0;0;0;-1;0;866637403;884838159;66807620
1644;1.13648e-14;-481;1680;24608;19398;1;688;-2.14748e+09;-2.15538e+06;0;0;0;0;0;0;866808235;885036918;66870243
1644;1.14646e-14;-464;1638;24247;19511;1;621;-2.14748e+09;-2.15538e+06;0;0;0;0;0;0;866808235;885036918;66870243
1645;1.13648e-14;-481;1680;24608;19398;1;688;-2.14748e+09;-2.15109e+06;-1;0;0;0;-1;0;866978719;885235308;66932781
1645;1.14646e-14;-465;1638;24247;19511;1;621;-2.14748e+09;-2.15109e+06;0;0;0;0;0;0;866978719;885235308;66932781
1646;1.13648e-14;-481;1680;24608;19398;1;688;-2.14748e+09;-2.1468e+06;-1;0;0;0;-1;0;867148854;885433332;66995234
1646;1.14646e-14;-466;1638;24247;19511;1;621;-2.14748e+09;-2.1468e+06;0;0;0;0;0;0;867148854;885433332;66995234
1647;1.13648e-14;-481;1680;24608;19398;1;688;-2.14748e+09;-2.14253e+06;-1;0;0;0;-1;0;867318641;885630990;67057601
1647;1.14646e-14;-467;1638;24247;19511;1;621;-2.14748e+09;-2.14253e+06;0;0;0;0;0;0;867318641;885630990;67057601
1648;1.13648e-14;-482;1680;24608;19398;1;688;-2.14748e+09;-2.13826e+06;0;0;0;0;0;0;867488081;885828282;67119883
1648;1.14646e-14;-467;1638;24247;19511;1;621;-2.14748e+09;-2.13826e+06;-1;0;0;0;-1;0;867488081;885828282;67119883
1649;1.13648e-14;-483;1680;24608;19398;1;688;-2.14748e+09;-2.13401e+06;0;0;0;0;0;0;867657176;886025210;67182079
1649;1.14646e-14;-468;1638;24247;19511;1;621;-2.14748e+09;-2.13401e+06;0;0;0;0;0;0;867657176;886025210;67182079
1650;1.13648e-14;-483;1680;24608;19398;1;688;-2.14748e+09;-2.12976e+06;-1;0;0;0;-1;0;867825925;886221773;67244191
1650;1.14646e-14;-469;1638;24247;19511;1;621;-2.14748e+09;-2.12976e+06;0;0;0;0;0;0;867825925;886221773;67244191
1651;1.13648e-14;-484;1680;24608;19398;1;688;-2.14748e+09;-2.12552e+06;0;0;0;0;0;0;867994329;886417974;67306216
1651;1.14646e-14;-469;1638;24247;19511;1;621;-2.14748e+09;-2.12552e+06;-1;0;0;0;-1;0;867994329;886417974;67306216
1652;1.13648e-14;-484;1680;24608;19398;1;688;-2.14748e+09;-2.1213e+06;-1;0;0;0;-1;0;868162390;886613812;67368157
1652;1.14646e-14;-470;1638;24247;19511;1;621;-2.14748e+09;-2.1213e+06;0;0;0;0;0;0;868162390;886613812;67368157
1653;1.13648e-14;-485;1680;24608;19398;1;688;-2.14748e+09;-2.11708e+06;0;0;0;0;0;0;868330108;886809288;67430013
1653;1.14646e-14;-471;1638;24247;19511;1;621;-2.14748e+09;-2.11708e+06;0;0;0;0;0;0;868330108;886809288;67430013
1654;1.13648e-14;-486;1680;24608;19398;1;688;-2.14748e+09;-2.11297e+06;0;0;0;0;0;0;868497484;887004403;67491783
1654;1.14646e-14;-472;1638;24247;19511;1;621;-2.14748e+09;-2.11297e+06;0;0;0;0;0;0;868497484;887004403;67491783
1655;1.13648e-14;-486;1680;24608;19398;1;688;-2.14748e+09;-2.10867e+06;-1;0;0;0;-1;0;868664518;887199158;67553468
1655;1.14646e-14;-473;1638;24247;19511;1;621;-2.14748e+09;-2.10867e+06;0;0;0;0;0;0;868664518;887199158;67553468
1656;1.13648e-14;-487;1680;24608;19398;1;688;-2.14748e+09;-2.10448e+06;0;0;0;0;0;0;868831212;887393553;67615069
1656;1.14646e-14;-473;1638;24247;19511;1;621;-2.14748e+09;-2.10448e+06;-1;0;0;0;-1;0;868831212;887393553;67615069
1657;1.13648e-14;-487;1680;24608;19398;1;688;-2.14748e+09;-2.1003e+06;-1;0;0;0;-1;0;868997566;887587590;67676584
1657;1.14646e-14;-473;1638;24247;19511;1;621;-2.14748e+09;-2.1003e+06;-1;0;0;0;-1;0;868997566;887587590;67676584
1658;1.13648e-14;-488;1680;24608;19398;1;688;-2.14748e+09;-2.09613e+06;0;0;0;0;0;0;869163581;887781268;67738015
1658;1.14646e-14;-474;1638;24247;19511;1;621;-2.14748e+09;-2.09613e+06;0;0;0;0;0;0;869163581;887781268;67738015
1659;1.13648e-14;-488;1680;24608;19398;1;688;-2.14748e+09;-2.09197e+06;-1;0;0;0;-1;0;869329258;887974589;67799361
1659;1.14646e-14;-474;1638;24247;19511;1;621;-2.14748e+09;-2.09197e+06;-1;0;0;0;-1;0;869329258;887974589;67799361
1660;1.13648e-14;-489;1680;24608;19398;1;688;-2.14748e+09;-2.08782e+06;0;0;0;0;0;0;869494597;888167553;67860622
1660;1.14646e-14;-474;1638;24247;19511;1;621;-2.14748e+09;-2.08782e+06;-1;0;0;0;-1;0;869494597;888167553;67860622
1661;1.13648e-14;-490;1680;24608;19398;1;688;-2.14748e+09;-2.08367e+06;0;0;0;0;0;0;869659599;888360161;67921798
1661;1.14646e-14;-474;1638;24247;19511;1;621;-2.14748e+09;-2.08367e+06;-1;0;0;0;-1;0;869659599;888360161;67921798
1662;1.13648e-14;-490;1680;24608;19398;1;688;-2.14748e+09;-2.07964e+06;-1;0;0;0;-1;0;869824266;888552414;67982890
1662;1.14646e-14;-475;1638;24247;19511;1;621;-2.14748e+09;-2.07964e+06;0;0;0;0;0;0;869824266;888552414;67982890
1663;1.13648e-14;-491;1680;24608;19398;1;688;-2.14748e+09;-2.07542e+06;0;0;0;0;0;0;869988597;888744312;68043897
1663;1.14646e-14;-476;1638;24247;19511;1;621;-2.14748e+09;-2.07542e+06;0;0;0;0;0;0;869988597;888744312;68043897
1664;1.13648e-14;-491;1680;24608;19398;1;688;-2.14748e+09;-2.0713e+06;-1;0;0;0;-1;0;870152594;888935857;68104820
1664;1.14646e-14;-476;1638;24247;19511;1;621;-2.14748e+09;-2.0713e+06;-1;0;0;0;-1;0;870152594;888935857;68104820
1665;1.13648e-14;-491;1680;24608;19398;1;688;-2.14748e+09;-2.0673e+06;-1;0;0;0;-1;0;870316257;889127048;68165658
1665;1.14646e-14;-477;1638;24247;19511;1;621;-2.14748e+09;-2.0673e+06;0;0;0;0;0;0;870316257;889127048;68165658
1666;1.13648e-14;-492;1680;24608;19398;1;688;-2.14748e+09;-2.0632e+06;0;0;0;0;0;0;870479587;889317886;68226412
1666;1.14646e-14;-477;1638;24247;19511;1;621;-2.14748e+09;-2.0632e+06;-1;0;0;0;-1;0;870479587;889317886;68226412
1667;1.13648e-14;-493;1680;24608;19398;1;688;-2.14748e+09;-2.05911e+06;0;0;0;0;0;0;870642585;889508373;68287081
1667;1.14646e-14;-478;1638;24247;19511;1;621;-2.14748e+09;-2.05911e+06;0;0;0;0;0;0;870642585;889508373;68287081
1668;1.13648e-14;-493;1680;24608;19398;1;688;-2.14748e+09;-2.05493e+06;-1;0;0;0;-1;0;870805252;889698509;68347666
1668;1.14646e-14;-478;1638;24247;19511;1;621;-2.14748e+09;-2.05493e+06;-1;0;0;0;-1;0;870805252;889698509;68347666
1669;1.13648e-14;-493;1680;24608;19398;1;688;-2.14748e+09;-2.05086e+06;-1;0;0;0;-1;0;870967588;889888295;68408166
1669;1.14646e-14;-479;1638;24247;19511;1;621;-2.14748e+09;-2.05086e+06;0;0;0;0;0;0;870967588;889888295;68408166
1670;1.13648e-14;-494;1680;24608;19398;1;688;-2.14748e+09;-2.0468e+06;0;0;0;0;0;0;871129594;890077730;68468583
1670;1.14646e-14;-479;1638;24247;19511;1;621;-2.14748e+09;-2.0468e+06;-1;0;0;0;-1;0;871129594;890077730;68468583
1671;1.13648e-14;-494;1680;24608;19398;1;688;-2.14748e+09;-2.04275e+06;-1;0;0;0;-1;0;871291270;890266817;68528915
1671;1.14646e-14;-479;1638;24247;19511;1;621;-2.14748e+09;-2.04275e+06;-1;0;0;0;-1;0;871291270;890266817;68528915
1672;1.13648e-14;-494;1680;24608;19398;1;688;-2.14748e+09;-2.03881e+06;-1;0;0;0;-1;0;871452619;890455556;68589164
1672;1.14646e-14;-479;1638;24247;19511;1;621;-2.14748e+09;-2.03871e+06;-1;0;0;0;-1;0;871452619;890455556;68589164
1673;1.13648e-14;-494;1680;24608;19398;1;688;-2.14748e+09;-2.03468e+06;-1;0;0;0;-1;0;871613639;890643946;68649328
1673;1.14646e-14;-479;1638;24247;19511;1;621;-2.14748e+09;-2.03468e+06;-1;0;0;0;-1;0;871613639;890643946;68649328
1674;1.13648e-14;-495;1680;24608;19398;1;688;-2.14748e+09;-2.03065e+06;0;0;0;0;0;0;871774333;890831990;68709408
1674;1.14646e-14;-479;1638;24247;19511;1;621;-2.14748e+09;-2.03065e+06;-1;0;0;0;-1;0;871774333;890831990;68709408
1675;1.13648e-14;-496;1680;24608;19398;1;688;-2.14748e+09;-2.02664e+06;0;0;0;0;0;0;871934700;891019688;68769404
1675;1.14646e-14;-479;1638;24247;19511;1;621;-2.14748e+09;-2.02664e+06;-1;0;0;0;-1;0;871934700;891019688;68769404
1676;1.13648e-14;-496;1680;24608;19398;1;688;-2.14748e+09;-2.02263e+06;-1;0;0;0;-1;0;872094742;891207040;68829317
1676;1.14646e-14;-480;1638;24247;19511;1;621;-2.14748e+09;-2.02263e+06;0;0;0;0;0;0;872094742;891207040;68829317
1677;1.13648e-14;-497;1680;24608;19398;1;688;-2.14748e+09;-2.01874e+06;0;0;0;0;0;0;872254459;891394048;68889146
1677;1.14646e-14;-481;1638;24247;19511;1;621;-2.14748e+09;-2.01874e+06;0;0;0;0;0;0;872254459;891394048;68889146
1678;1.13648e-14;-498;1680;24608;19398;1;688;-2.14748e+09;-2.01465e+06;0;0;0;0;0;0;872413852;891580711;68948891
1678;1.14646e-14;-481;1638;24247;19511;1;621;-2.14748e+09;-2.01465e+06;-1;0;0;0;-1;0;872413852;891580711;68948891
1679;1.13648e-14;-499;1680;24608;19398;1;688;-2.14748e+09;-2.01067e+06;0;0;0;0;0;0;872572921;891767030;69008552
1679;1.14646e-14;-482;1638;24247;19511;1;621;-2.14748e+09;-2.01067e+06;0;0;0;0;0;0;872572921;891767030;69008552
1680;1.13648e-14;-500;1680;24608;19398;1;688;-2.14748e+09;-2.0068e+06;0;0;0;0;0;0;872731668;891953007;69068130
1680;1.14646e-14;-482;1638;24247;19511;1;621;-2.14748e+09;-2.0068e+06;-1;0;0;0;-1;0;872731668;891953007;69068130
1681;1.13648e-14;-501;1680;24608;19398;1;688;-2.14748e+09;-2.00274e+06;0;0;0;0;0;0;872890094;892138642;69127624
1681;1.14646e-14;-482;1638;24247;19511;1;621;-2.14748e+09;-2.00274e+06;-1;0;0;0;-1;0;872890094;892138642;69127624
1682;1.13648e-14;-502;1680;24608;19398;1;688;-2.14748e+09;-1.99878e+06;0;0;0;0;0;0;873048198;892323935;69187034
1682;1.14646e-14;-483;1638;24247;19511;1;621;-2.14748e+09;-1.99878e+06;0;0;0;0;0;0;873048198;892323935;69187034
1683;1.13648e-14;-503;1680;24608;19398;1;688;-2.14748e+09;-1.99494e+06;0;0;0;0;0;0;873205981;892508887;69246361
1683;1.14646e-14;-484;1638;24247;19511;1;621;-2.14748e+09;-1.99494e+06;0;0;0;0;0;0;873205981;892508887;69246361
1684;1.13648e-14;-503;1680;24608;19398;1;688;-2.14748e+09;-1.9909e+06;-1;0;0;0;-1;0;873363445;892693500;69305605
1684;1.14646e-14;-484;1638;24247;19511;1;621;-2.14748e+09;-1.9909e+06;-1;0;0;0;-1;0;873363445;892693500;69305605
1685;1.13648e-14;-504;1680;24608;19398;1;688;-2.14748e+09;-1.98698e+06;0;0;0;0;0;0;873520590;892877772;69364766
1685;1.14646e-14;-485;1638;24247;19511;1;621;-2.14748e+09;-1.98698e+06;0;0;0;0;0;0;873520590;892877772;69364766
1686;1.13648e-14;-505;1680;24608;19398;1;688;-2.14748e+09;-1.98306e+06;0;0;0;0;0;0;873677417;893061707;69423843
1686;1.14646e-14;-486;1638;24247;19511;1;621;-2.14748e+09;-1.98306e+06;0;0;0;0;0;0;873677417;893061707;69423843
1687;1.13648e-14;-506;1680;24608;19398;1;688;-2.14748e+09;-1.97915e+06;0;0;0;0;0;0;873833926;893245302;69482837
1687;1.14646e-14;-486;1638;24247;19511;1;621;-2.14748e+09;-1.97915e+06;-1;0;0;0;-1;0;873833926;893245302;69482837
1688;1.13648e-14;-507;1680;24608;19398;1;688;-2.14748e+09;-1.97525e+06;0;0;0;0;0;0;873990118;893428561;69541748
1688;1.14646e-14;-487;1638;24247;19511;1;621;-2.14748e+09;-1.97525e+06;0;0;0;0;0;0;873990118;893428561;69541748
1689;1.13648e-14;-508;1680;24608;19398;1;688;-2.14748e+09;-1.97136e+06;0;0;0;0;0;0;874145995;893611483;69600576
1689;1.14646e-14;-487;1638;24247;19511;1;621;-2.14748e+09;-1.97136e+06;-1;0;0;0;-1;0;874145995;893611483;69600576
1690;1.13648e-14;-508;1680;24608;19398;1;688;-2.14748e+09;-1.96747e+06;-1;0;0;0;-1;0;874301555;893794068;69659321
1690;1.14646e-14;-487;1638;24247;19511;1;621;-2.14748e+09;-1.96747e+06;-1;0;0;0;-1;0;874301555;893794068;69659321
1691;1.13648e-14;-508;1680;24608;19398;1;688;-2.14748e+09;-1.9636e+06;-1;0;0;0;-1;0;874456801;893976318;69717983
1691;1.14646e-14;-488;1638;24247;19511;1;621;-2.14748e+09;-1.9636e+06;0;0;0;0;0;0;874456801;893976318;69717983
1692;1.13648e-14;-508;1680;24608;19398;1;688;-2.14748e+09;-1.95973e+06;-1;0;0;0;-1;0;874611733;894158234;69776562
1692;1.14646e-14;-489;1638;24247;19511;1;621;-2.14748e+09;-1.95973e+06;0;0;0;0;0;0;874611733;894158234;69776562
1693;1.13648e-14;-509;1680;24608;19398;1;688;-2.14748e+09;-1.95587e+06;0;0;0;0;0;0;874766352;894339815;69835058
1693;1.14646e-14;-489;1638;24247;19511;1;621;-2.14748e+09;-1.95588e+06;-1;0;0;0;-1;0;874766352;894339815;69835058
1694;1.13648e-14;-510;1680;24608;19398;1;688;-2.14748e+09;-1.95213e+06;0;0;0;0;0;0;874920658;894521063;69893471
1694;1.14646e-14;-490;1638;24247;19511;1;621;-2.14748e+09;-1.95213e+06;0;0;0;0;0;0;874920658;894521063;69893471
1695;1.13648e-14;-510;1680;24608;19398;1;688;-2.14748e+09;-1.94828e+06;-1;0;0;0;-1;0;875074652;894701978;69951802
1695;1.14646e-14;-491;1638;24247;19511;1;621;-2.14748e+09;-1.94829e+06;0;0;0;0;0;0;875074652;894701978;69951802
1696;1.13648e-14;-511;1680;24608;19398;1;688;-2.14748e+09;-1.94435e+06;0;0;0;0;0;0;875228335;894882561;70010050
1696;1.14646e-14;-491;1638;24247;19511;1;621;-2.14748e+09;-1.94435e+06;-1;0;0;0;-1;0;875228335;894882561;70010050
1697;1.13648e-14;-512;1680;24608;19398;1;688;-2.14748e+09;-1.94053e+06;0;0;0;0;0;0;875381708;895062812;70068216
1697;1.14646e-14;-492;1638;24247;19511;1;621;-2.14748e+09;-1.94053e+06;0;0;0;0;0;0;875381708;895062812;70068216
1698;1.13648e-14;-513;1680;24608;19398;1;688;-2.14748e+09;-1.93671e+06;0;0;0;0;0;0;875534770;895242732;70126299
1698;1.14646e-14;-492;1638;24247;19511;1;621;-2.14748e+09;-1.93671e+06;-1;0;0;0;-1;0;875534770;895242732;70126299
1699;1.13648e-14;-514;1680;24608;19398;1;688;-2.14748e+09;-1.9329e+06;0;0;0;0;0;0;875687524;895422322;70184300
1699;1.14646e-14;-493;1638;24247;19511;1;621;-2.14748e+09;-1.93291e+06;0;0;0;0;0;0;875687524;895422322;70184300
1700;1.13648e-14;-514;1680;24608;19398;1;688;-2.14748e+09;-1.92911e+06;-1;0;0;0;-1;0;875839969;895601583;70242218
1700;1.14646e-14;-493;1638;24247;19511;1;621;-2.14748e+09;-1.92911e+06;-1;0;0;0;-1;0;875839969;895601583;70242218
1701;1.13648e-14;-514;1680;24608;19398;1;688;-2.14748e+09;-1.92532e+06;-1;0;0;0;-1;0;875992106;895780514;70300054
1701;1.14646e-14;-493;1638;24247;19511;1;621;-2.14748e+09;-1.92532e+06;-1;0;0;0;-1;0;875992106;895780514;70300054
1702;1.13648e-14;-515;1680;24608;19398;1;688;-2.14748e+09;-1.92153e+06;0;0;0;0;0;0;876143936;895959118;70357808
1702;1.14646e-14;-494;1638;24247;19511;1;621;-2.14748e+09;-1.92153e+06;0;0;0;0;0;0;876143936;895959118;70357808
1703;1.13648e-14;-515;1680;24608;19398;1;688;-2.14748e+09;-1.91786e+06;-1;0;0;0;-1;0;876295460;896137394;70415479
1703;1.14646e-14;-495;1638;24247;19511;1;621;-2.14748e+09;-1.91786e+06;0;0;0;0;0;0;876295460;896137394;70415479
1704;1.13648e-14;-516;1680;24608;19398;1;688;-2.14748e+09;-1.91409e+06;0;0;0;0;0;0;876446678;896315342;70473069
1704;1.14646e-14;-495;1638;24247;19511;1;621;-2.14748e+09;-1.91409e+06;-1;0;0;0;-1;0;876446678;896315342;70473069
1705;1.13648e-14;-517;1680;24608;19398;1;688;-2.14748e+09;-1.91024e+06;0;0;0;0;0;0;876597591;896492965;70530576
1705;1.14646e-14;-496;1638;24247;19511;1;621;-2.14748e+09;-1.91024e+06;0;0;0;0;0;0;876597591;896492965;70530576
1706;1.13648e-14;-517;1680;24608;19398;1;688;-2.14748e+09;-1.90649e+06;-1;0;0;0;-1;0;876748200;896670261;70588001
1706;1.14646e-14;-496;1638;24247;19511;1;621;-2.14748e+09;-1.90649e+06;-1;0;0;0;-1;0;876748200;896670261;70588001
1707;1.13648e-14;-517;1680;24608;19398;1;688;-2.14748e+09;-1.90275e+06;-1;0;0;0;-1;0;876898505;896847233;70645345
1707;1.14646e-14;-496;1638;24247;19511;1;621;-2.14748e+09;-1.90275e+06;-1;0;0;0;-1;0;876898505;896847233;70645345
1708;1.13648e-14;-517;1680;24608;19398;1;688;-2.14748e+09;-1.89901e+06;-1;0;0;0;-1;0;877048507;897023880;70702607
1708;1.14646e-14;-496;1638;24247;19511;1;621;-2.14748e+09;-1.89901e+06;-1;0;0;0;-1;0;877048507;897023880;70702607
1709;1.13648e-14;-517;1680;24608;19398;1;688;-2.14748e+09;-1.89529e+06;-1;0;0;0;-1;0;877198207;897200203;70759787
1709;1.14646e-14;-496;1638;24247;19511;1;621;-2.14748e+09;-1.89529e+06;-1;0;0;0;-1;0;877198207;897200203;70759787
1710;1.13648e-14;-518;1680;24608;19398;1;688;-2.14748e+09;-1.89167e+06;0;0;0;0;0;0;877347605;897376203;70816885
1710;1.14646e-14;-497;1638;24247;19511;1;621;-2.14748e+09;-1.89167e+06;0;0;0;0;0;0;877347605;897376203;70816885
1711;1.13648e-14;-518;1680;24608;19398;1;688;-2.14748e+09;-1.88786e+06;-1;0;0;0;-1;0;877496702;897551881;70873901
1711;1.14646e-14;-497;1638;24247;19511;1;621;-2.14748e+09;-1.88786e+06;-1;0;0;0;-1;0;877496702;897551881;70873901
1712;1.13648e-14;-519;1680;24608;19398;1;688;-2.14748e+09;-1.88416e+06;0;0;0;0;0;0;877645499;897727237;70930836
1712;1.14646e-14;-497;1638;24247;19511;1;621;-2.14748e+09;-1.88416e+06;-1;0;0;0;-1;0;877645499;897727237;70930836
1713;1.13648e-14;-520;1680;24608;19398;1;688;-2.14748e+09;-1.88047e+06;0;0;0;0;0;0;877793996;897902271;70987690
1713;1.14646e-14;-498;1638;24247;19511;1;621;-2.14748e+09;-1.88047e+06;0;0;0;0;0;0;877793996;897902271;70987690
1714;1.13648e-14;-520;1680;24608;19398;1;688;-2.14748e+09;-1.87679e+06;-1;0;0;0;-1;0;877942194;898076985;71044462
1714;1.14646e-14;-499;1638;24247;19511;1;621;-2.14748e+09;-1.87679e+06;0;0;0;0;0;0;877942194;898076985;71044462
1715;1.13648e-14;-521;1680;24608;19398;1;688;-2.14748e+09;-1.87311e+06;0;0;0;0;0;0;878090094;898251379;71101152
1715;1.14646e-14;-499;1638;24247;19511;1;621;-2.14748e+09;-1.87311e+06;-1;0;0;0;-1;0;878090094;898251379;71101152
1716;1.13648e-14;-522;1680;24608;19398;1;688;-2.14748e+09;-1.86944e+06;0;0;0;0;0;0;878237696;898425453;71157761
1716;1.14646e-14;-499;1638;24247;19511;1;621;-2.14748e+09;-1.86944e+06;-1;0;0;0;-1;0;878237696;898425453;71157761
1717;1.13648e-14;-523;1680;24608;19398;1;688;-2.14748e+09;-1.86578e+06;0;0;0;0;0;0;878385001;898599208;71214289
1717;1.14646e-14;-499;1638;24247;19511;1;621;-2.14748e+09;-1.86578e+06;-1;0;0;0;-1;0;878385001;898599208;71214289
1718;1.13648e-14;-523;1680;24608;19398;1;688;-2.14748e+09;-1.86213e+06;-1;0;0;0;-1;0;878532010;898772645;71270736
1718;1.14646e-14;-499;1638;24247;19511;1;621;-2.14748e+09;-1.86213e+06;-1;0;0;0;-1;0;878532010;898772645;71270736
1719;1.13648e-14;-524;1680;24608;19398;1;688;-2.14748e+09;-1.85848e+06;0;0;0;0;0;0;878678723;898945765;71327102
1719;1.14646e-14;-499;1638;24247;19511;1;621;-2.14748e+09;-1.85848e+06;-1;0;0;0;-1;0;878678723;898945765;71327102
1720;1.13648e-14;-525;1680;24608;19398;1;688;-2.14748e+09;-1.85485e+06;0;0;0;0;0;0;878825141;899118568;71383387
1720;1.14646e-14;-500;1638;24247;19511;1;621;-2.14748e+09;-1.85485e+06;0;0;0;0;0;0;878825141;899118568;71383387
1721;1.13648e-14;-526;1680;24608;19398;1;688;-2.14748e+09;-1.85122e+06;0;0;0;0;0;0;878971265;899291054;71439591
1721;1.14646e-14;-500;1638;24247;19511;1;621;-2.14748e+09;-1.85122e+06;-1;0;0;0;-1;0;878971265;899291054;71439591
1722;1.13648e-14;-526;1680;24608;19398;1;688;-2.14748e+09;-1.8476e+06;-1;0;0;0;-1;0;879117095;899463225;71495713
1722;1.14646e-14;-500;1638;24247;19511;1;621;-2.14748e+09;-1.8476e+06;-1;0;0;0;-1;0;879117095;899463225;71495713
1723;1.13648e-14;-527;1680;24608;19398;1;688;-2.14748e+09;-1.84398e+06;0;0;0;0;0;0;879262632;899635080;71551755
1723;1.14646e-14;-500;1638;24247;19511;1;621;-2.14748e+09;-1.84398e+06;-1;0;0;0;-1;0;879262632;899635080;71551755
1724;1.13648e-14;-527;1680;24608;19398;1;688;-2.14748e+09;-1.84038e+06;-1;0;0;0;-1;0;879407876;899806622;71607717
1724;1.14646e-14;-501;1638;24247;19511;1;621;-2.14748e+09;-1.84038e+06;0;0;0;0;0;0;879407876;899806622;71607717
1725;1.13648e-14;-528;1680;24608;19398;1;688;-2.14748e+09;-1.83678e+06;0;0;0;0;0;0;879552829;899977849;71663597
1725;1.14646e-14;-501;1638;24247;19511;1;621;-2.14748e+09;-1.83678e+06;-1;0;0;0;-1;0;879552829;899977849;71663597
1726;1.13648e-14;-529;1680;24608;19398;1;688;-2.14748e+09;-1.83319e+06;0;0;0;0;0;0;879697490;900148763;71719397
1726;1.14646e-14;-501;1638;24247;19511;1;621;-2.14748e+09;-1.83319e+06;-1;0;0;0;-1;0;879697490;900148763;71719397
1727;1.13648e-14;-529;1680;24608;19398;1;688;-2.14748e+09;-1.82961e+06;-1;0;0;0;-1;0;879841861;900319364;71775117
1727;1.14646e-14;-502;1638;24247;19511;1;621;-2.14748e+09;-1.82961e+06;0;0;0;0;0;0;879841861;900319364;71775117
1728;1.13648e-14;-530;1680;24608;19398;1;688;-2.14748e+09;-1.82614e+06;0;0;0;0;0;0;879985943;900489653;71830755
1728;1.14646e-14;-503;1638;24247;19511;1;621;-2.14748e+09;-1.82614e+06;0;0;0;0;0;0;879985943;900489653;71830755
1729;1.13648e-14;-531;1680;24608;19398;1;688;-2.14748e+09;-1.82247e+06;0;0;0;0;0;0;880129735;900659631;71886314
1729;1.14646e-14;-503;1638;24247;19511;1;621;-2.14748e+09;-1.82247e+06;-1;0;0;0;-1;0;880129735;900659631;71886314
1730;1.13648e-14;-532;1680;24608;19398;1;688;-2.14748e+09;-1.81901e+06;0;0;0;0;0;0;880273238;900829298;71941792
1730;1.14646e-14;-504;1638;24247;19511;1;621;-2.14748e+09;-1.81901e+06;0;0;0;0;0;0;880273238;900829298;71941792
1731;1.13648e-14;-532;1680;24608;19398;1;688;-2.14748e+09;-1.81536e+06;-1;0;0;0;-1;0;880416454;900998655;71997190
1731;1.14646e-14;-505;1638;24247;19511;1;621;-2.14748e+09;-1.81536e+06;0;0;0;0;0;0;880416454;900998655;71997190
1732;1.13648e-14;-532;1680;24608;19398;1;688;-2.14748e+09;-1.81182e+06;-1;0;0;0;-1;0;880559382;901167702;72052508
1732;1.14646e-14;-505;1638;24247;19511;1;621;-2.14748e+09;-1.81182e+06;-1;0;0;0;-1;0;880559382;901167702;72052508
1733;1.13648e-14;-532;1680;24608;19398;1;688;-2.14748e+09;-1.80828e+06;-1;0;0;0;-1;0;880702023;901336440;72107745
1733;1.14646e-14;-506;1638;24247;19511;1;621;-2.14748e+09;-1.80828e+06;0;0;0;0;0;0;880702023;901336440;72107745
1734;1.13648e-14;-533;1680;24608;19398;1;688;-2.14748e+09;-1.80476e+06;0;0;0;0;0;0;880844379;901504870;72162902
1734;1.14646e-14;-507;1638;24247;19511;1;621;-2.14748e+09;-1.80476e+06;0;0;0;0;0;0;880844379;901504870;72162902
1735;1.13648e-14;-533;1680;24608;19398;1;688;-2.14748e+09;-1.80133e+06;-1;0;0;0;-1;0;880986449;901672992;72217980
1735;1.14646e-14;-507;1638;24247;19511;1;621;-2.14748e+09;-1.80133e+06;-1;0;0;0;-1;0;880986449;901672992;72217980
1736;1.13648e-14;-534;1680;24608;19398;1;688;-2.14748e+09;-1.79772e+06;0;0;0;0;0;0;881128234;901840806;72272977
1736;1.14646e-14;-508;1638;24247;19511;1;621;-2.14748e+09;-1.79772e+06;0;0;0;0;0;0;881128234;901840806;72272977
1737;1.13648e-14;-535;1680;24608;19398;1;688;-2.14748e+09;-1.79422e+06;0;0;0;0;0;0;881269735;902008314;72327895
1737;1.14646e-14;-508;1638;24247;19511;1;621;-2.14748e+09;-1.79422e+06;-1;0;0;0;-1;0;881269735;902008314;72327895
1738;1.13648e-14;-535;1680;24608;19398;1;688;-2.14748e+09;-1.79072e+06;-1;0;0;0;-1;0;881410953;902175516;72382733
1738;1.14646e-14;-509;1638;24247;19511;1;621;-2.14748e+09;-1.79072e+06;0;0;0;0;0;0;881410953;902175516;72382733
1739;1.13648e-14;-535;1680;24608;19398;1;688;-2.14748e+09;-1.78723e+06;-1;0;0;0;-1;0;881551887;902342412;72437491
1739;1.14646e-14;-510;1638;24247;19511;1;621;-2.14748e+09;-1.78723e+06;0;0;0;0;0;0;881551887;902342412;72437491
1740;1.13648e-14;-535;1680;24608;19398;1;688;-2.14748e+09;-1.78375e+06;-1;0;0;0;-1;0;881692540;902509004;72492170
1740;1.14646e-14;-511;1638;24247;19511;1;621;-2.14748e+09;-1.78375e+06;0;0;0;0;0;0;881692540;902509004;72492170
1741;1.13648e-14;-536;1680;24608;19398;1;688;-2.14748e+09;-1.78027e+06;0;0;0;0;0;0;881832910;902675291;72546769
1741;1.14646e-14;-512;1638;24247;19511;1;621;-2.14748e+09;-1.78027e+06;0;0;0;0;0;0;881832910;902675291;72546769
1742;1.13648e-14;-536;1680;24608;19398;1;688;-2.14748e+09;-1.7768e+06;-1;0;0;0;-1;0;881973000;902841274;72601288
1742;1.14646e-14;-513;1638;24247;19511;1;621;-2.14748e+09;-1.7768e+06;0;0;0;0;0;0;881973000;902841274;72601288
1743;1.13648e-14;-536;1680;24608;19398;1;688;-2.14748e+09;-1.77334e+06;-1;0;0;0;-1;0;882112809;903006954;72655728
1743;1.14646e-14;-513;1638;24247;19511;1;621;-2.14748e+09;-1.77334e+06;-1;0;0;0;-1;0;882112809;903006954;72655728
1744;1.13648e-14;-536;1680;24608;19398;1;688;-2.14748e+09;-1.76989e+06;-1;0;0;0;-1;0;882252339;903172332;72710089
1744;1.14646e-14;-514;1638;24247;19511;1;621;-2.14748e+09;-1.76989e+06;0;0;0;0;0;0;882252339;903172332;72710089
1745;1.13648e-14;-536;1680;24608;19398;1;688;-2.14748e+09;-1.76644e+06;-1;0;0;0;-1;0;882391589;903337408;72764370
1745;1.14646e-14;-515;1638;24247;19511;1;621;-2.14748e+09;-1.76644e+06;0;0;0;0;0;0;882391589;903337408;72764370
1746;1.13648e-14;-536;1680;24608;19398;1;688;-2.14748e+09;-1.76301e+06;-1;0;0;0;-1;0;882530560;903502182;72818573
1746;1.14646e-14;-516;1638;24247;19511;1;621;-2.14748e+09;-1.76301e+06;0;0;0;0;0;0;882530560;903502182;72818573
1747;1.13648e-14;-537;1680;24608;19398;1;688;-2.14748e+09;-1.75958e+06;0;0;0;0;0;0;882669254;903666656;72872696
1747;1.14646e-14;-516;1638;24247;19511;1;621;-2.14748e+09;-1.75958e+06;-1;0;0;0;-1;0;882669254;903666656;72872696
1748;1.13648e-14;-538;1680;24608;19398;1;688;-2.14748e+09;-1.75615e+06;0;0;0;0;0;0;882807670;903830829;72926740
1748;1.14646e-14;-517;1638;24247;19511;1;621;-2.14748e+09;-1.75615e+06;0;0;0;0;0;0;882807670;903830829;72926740
1749;1.13648e-14;-538;1680;24608;19398;1;688;-2.14748e+09;-1.75274e+06;-1;0;0;0;-1;0;882945809;903994703;72980705
1749;1.14646e-14;-517;1638;24247;19511;1;621;-2.14748e+09;-1.75274e+06;-1;0;0;0;-1;0;882945809;903994703;72980705
1750;1.13648e-14;-538;1680;24608;19398;1;688;-2.14748e+09;-1.74943e+06;-1;0;0;0;-1;0;883083673;904158278;73034591
1750;1.14646e-14;-517;1638;24247;19511;1;621;-2.14748e+09;-1.74943e+06;-1;0;0;0;-1;0;883083673;904158278;73034591
1751;1.13648e-14;-538;1680;24608;19398;1;688;-2.14748e+09;-1.74593e+06;-1;0;0;0;-1;0;883221260;904321554;73088398
1751;1.14646e-14;-517;1638;24247;19511;1;621;-2.14748e+09;-1.74593e+06;-1;0;0;0;-1;0;883221260;904321554;73088398
1752;1.13648e-14;-538;1680;24608;19398;1;688;-2.14748e+09;-1.74263e+06;-1;0;0;0;-1;0;883358573;904484532;73142127
1752;1.14646e-14;-517;1638;24247;19511;1;621;-2.14748e+09;-1.74263e+06;-1;0;0;0;-1;0;883358573;904484532;73142127
1753;1.13648e-14;-539;1680;24608;19398;1;688;-2.14748e+09;-1.73914e+06;0;0;0;0;0;0;883495611;904647213;73195777
1753;1.14646e-14;-518;1638;24247;19511;1;621;-2.14748e+09;-1.73914e+06;0;0;0;0;0;0;883495611;904647213;73195777
1754;1.13648e-14;-540;1680;24608;19398;1;688;-2.14748e+09;-1.73586e+06;0;0;0;0;0;0;883632376;904809597;73249348
1754;1.14646e-14;-519;1638;24247;19511;1;621;-2.14748e+09;-1.73587e+06;0;0;0;0;0;0;883632376;904809597;73249348
1755;1.13648e-14;-540;1680;24608;19398;1;688;-2.14748e+09;-1.73249e+06;-1;0;0;0;-1;0;883768867;904971685;73302841
1755;1.14646e-14;-519;1638;24247;19511;1;621;-2.14748e+09;-1.73249e+06;-1;0;0;0;-1;0;883768867;904971685;73302841
1756;1.13648e-14;-540;1680;24608;19398;1;688;-2.14748e+09;-1.72903e+06;-1;0;0;0;-1;0;883905086;905133478;73356255
1756;1.14646e-14;-519;1638;24247;19511;1;621;-2.14748e+09;-1.72903e+06;-1;0;0;0;-1;0;883905086;905133478;73356255
1757;1.13648e-14;-541;1680;24608;19398;1;688;-2.14748e+09;-1.72567e+06;0;0;0;0;0;0;884041033;905294975;73409591
1757;1.14646e-14;-520;1638;24247;19511;1;621;-2.14748e+09;-1.72567e+06;0;0;0;0;0;0;884041033;905294975;73409591
1758;1.13648e-14;-541;1680;24608;19398;1;688;-2.14748e+09;-1.72232e+06;-1;0;0;0;-1;0;884176709;905456178;73462848
1758;1.14646e-14;-521;1638;24247;19511;1;621;-2.14748e+09;-1.72232e+06;0;0;0;0;0;0;884176709;905456178;73462848
1759;1.13648e-14;-542;1680;24608;19398;1;688;-2.14748e+09;-1.71898e+06;0;0;0;0;0;0;884312113;905617087;73516028
1759;1.14646e-14;-521;1638;24247;19511;1;621;-2.14748e+09;-1.71898e+06;-1;0;0;0;-1;0;884312113;905617087;73516028
1760;1.13648e-14;-543;1680;24608;19398;1;688;-2.14748e+09;-1.71564e+06;0;0;0;0;0;0;884447248;905777702;73569129
1760;1.14646e-14;-521;1638;24247;19511;1;621;-2.14748e+09;-1.71564e+06;-1;0;0;0;-1;0;884447248;905777702;73569129
1761;1.13648e-14;-544;1680;24608;19398;1;688;-2.14748e+09;-1.71241e+06;0;0;0;0;0;0;884582113;905938025;73622152
1761;1.14646e-14;-522;1638;24247;19511;1;621;-2.14748e+09;-1.71241e+06;0;0;0;0;0;0;884582113;905938025;73622152
1762;1.13648e-14;-545;1680;24608;19398;1;688;-2.14748e+09;-1.70899e+06;0;0;0;0;0;0;884716709;906098055;73675097
1762;1.14646e-14;-522;1638;24247;19511;1;621;-2.14748e+09;-1.70899e+06;-1;0;0;0;-1;0;884716709;906098055;73675097
1763;1.13648e-14;-545;1680;24608;19398;1;688;-2.14748e+09;-1.70567e+06;-1;0;0;0;-1;0;884851036;906257794;73727964
1763;1.14646e-14;-522;1638;24247;19511;1;621;-2.14748e+09;-1.70567e+06;-1;0;0;0;-1;0;884851036;906257794;73727964
1764;1.13648e-14;-545;1680;24608;19398;1;688;-2.14748e+09;-1.70236e+06;-1;0;0;0;-1;0;884985096;906417242;73780753
1764;1.14646e-14;-523;1638;24247;19511;1;621;-2.14748e+09;-1.70236e+06;0;0;0;0;0;0;884985096;906417242;73780753
1765;1.13648e-14;-545;1680;24608;19398;1;688;-2.14748e+09;-1.69906e+06;-1;0;0;0;-1;0;885118888;906576399;73833464
1765;1.14646e-14;-523;1638;24247;19511;1;621;-2.14748e+09;-1.69906e+06;-1;0;0;0;-1;0;885118888;906576399;73833464
1766;1.13648e-14;-546;1680;24608;19398;1;688;-2.14748e+09;-1.69577e+06;0;0;0;0;0;0;885252414;906735266;73886098
1766;1.14646e-14;-524;1638;24247;19511;1;621;-2.14748e+09;-1.69577e+06;0;0;0;0;0;0;885252414;906735266;73886098
1767;1.13648e-14;-546;1680;24608;19398;1;688;-2.14748e+09;-1.69258e+06;-1;0;0;0;-1;0;885385674;906893843;73938654
1767;1.14646e-14;-524;1638;24247;19511;1;621;-2.14748e+09;-1.69248e+06;-1;0;0;0;-1;0;885385674;906893843;73938654
1768;1.13648e-14;-547;1680;24608;19398;1;688;-2.14748e+09;-1.6892e+06;0;0;0;0;0;0;885518668;907052132;73991132
1768;1.14646e-14;-524;1638;24247;19511;1;621;-2.14748e+09;-1.6892e+06;-1;0;0;0;-1;0;885518668;907052132;73991132
1769;1.13648e-14;-548;1680;24608;19398;1;688;-2.14748e+09;-1.68592e+06;0;0;0;0;0;0;885651397;907210132;74043533
1769;1.14646e-14;-524;1638;24247;19511;1;621;-2.14748e+09;-1.68592e+06;-1;0;0;0;-1;0;885651397;907210132;74043533
1770;1.13648e-14;-549;1680;24608;19398;1;688;-2.14748e+09;-1.68266e+06;0;0;0;0;0;0;885783862;907367845;74095856
1770;1.14646e-14;-525;1638;24247;19511;1;621;-2.14748e+09;-1.68266e+06;0;0;0;0;0;0;885783862;907367845;74095856
1771;1.13648e-14;-550;1680;24608;19398;1;688;-2.14748e+09;-1.6794e+06;0;0;0;0;0;0;885916063;907525270;74148102
1771;1.14646e-14;-526;1638;24247;19511;1;621;-2.14748e+09;-1.6794e+06;0;0;0;0;0;0;885916063;907525270;74148102
1772;1.13648e-14;-551;1680;24608;19398;1;688;-2.14748e+09;-1.67615e+06;0;0;0;0;0;0;886048000;907682408;74200271
1772;1.14646e-14;-527;1638;24247;19511;1;621;-2.14748e+09;-1.67615e+06;0;0;0;0;0;0;886048000;907682408;74200271
1773;1.13648e-14;-552;1680;24608;19398;1;688;-2.14748e+09;-1.673e+06;0;0;0;0;0;0;886179676;907839261;74252363
1773;1.14646e-14;-528;1638;24247;19511;1;621;-2.14748e+09;-1.673e+06;0;0;0;0;0;0;886179676;907839261;74252363
1774;1.13648e-14;-552;1680;24608;19398;1;688;-2.14748e+09;-1.66966e+06;-1;0;0;0;-1;0;886311088;907995827;74304377
1774;1.14646e-14;-529;1638;24247;19511;1;621;-2.14748e+09;-1.66966e+06;0;0;0;0;0;0;886311088;907995827;74304377
1775;1.13648e-14;-553;1680;24608;19398;1;688;-2.14748e+09;-1.66643e+06;0;0;0;0;0;0;886442240;908152109;74356315
1775;1.14646e-14;-530;1638;24247;19511;1;621;-2.14748e+09;-1.66643e+06;0;0;0;0;0;0;886442240;908152109;74356315
1776;1.13648e-14;-553;1680;24608;19398;1;688;-2.14748e+09;-1.6632e+06;-1;0;0;0;-1;0;886573131;908308106;74408175
1776;1.14646e-14;-531;1638;24247;19511;1;621;-2.14748e+09;-1.6632e+06;0;0;0;0;0;0;886573131;908308106;74408175
1777;1.13648e-14;-553;1680;24608;19398;1;688;-2.14748e+09;-1.65999e+06;-1;0;0;0;-1;0;886703761;908463819;74459959
1777;1.14646e-14;-531;1638;24247;19511;1;621;-2.14748e+09;-1.65999e+06;-1;0;0;0;-1;0;886703761;908463819;74459959
1778;1.13648e-14;-553;1680;24608;19398;1;688;-2.14748e+09;-1.65677e+06;-1;0;0;0;-1;0;886834131;908619249;74511666
1778;1.14646e-14;-532;1638;24247;19511;1;621;-2.14748e+09;-1.65677e+06;0;0;0;0;0;0;886834131;908619249;74511666
1779;1.13648e-14;-553;1680;24608;19398;1;688;-2.14748e+09;-1.65357e+06;-1;0;0;0;-1;0;886964242;908774396;74563296
1779;1.14646e-14;-532;1638;24247;19511;1;621;-2.14748e+09;-1.65357e+06;-1;0;0;0;-1;0;886964242;908774396;74563296
1780;1.13648e-14;-553;1680;24608;19398;1;688;-2.14748e+09;-1.65037e+06;-1;0;0;0;-1;0;887094095;908929260;74614849
1780;1.14646e-14;-532;1638;24247;19511;1;621;-2.14748e+09;-1.65037e+06;-1;0;0;0;-1;0;887094095;908929260;74614849
1781;1.13648e-14;-553;1680;24608;19398;1;688;-2.14748e+09;-1.64728e+06;-1;0;0;0;-1;0;887223689;909083843;74666326
1781;1.14646e-14;-532;1638;24247;19511;1;621;-2.14748e+09;-1.64728e+06;-1;0;0;0;-1;0;887223689;909083843;74666326
1782;1.13648e-14;-553;1680;24608;19398;1;688;-2.14748e+09;-1.644e+06;-1;0;0;0;-1;0;887353026;909238144;74717727
1782;1.14646e-14;-533;1638;24247;19511;1;621;-2.14748e+09;-1.644e+06;0;0;0;0;0;0;887353026;909238144;74717727
1783;1.13648e-14;-553;1680;24608;19398;1;688;-2.14748e+09;-1.64082e+06;-1;0;0;0;-1;0;887482105;909392165;74769050
1783;1.14646e-14;-534;1638;24247;19511;1;621;-2.14748e+09;-1.64082e+06;0;0;0;0;0;0;887482105;909392165;74769050
1784;1.13648e-14;-554;1680;24608;19398;1;688;-2.14748e+09;-1.63765e+06;0;0;0;0;0;0;887610928;909545905;74820298
1784;1.14646e-14;-535;1638;24247;19511;1;621;-2.14748e+09;-1.63765e+06;0;0;0;0;0;0;887610928;909545905;74820298
1785;1.13648e-14;-555;1680;24608;19398;1;688;-2.14748e+09;-1.63448e+06;0;0;0;0;0;0;887739496;909699366;74871469
1785;1.14646e-14;-536;1638;24247;19511;1;621;-2.14748e+09;-1.63448e+06;0;0;0;0;0;0;887739496;909699366;74871469
1786;1.13648e-14;-556;1680;24608;19398;1;688;-2.14748e+09;-1.63132e+06;0;0;0;0;0;0;887867808;909852547;74922564
1786;1.14646e-14;-537;1638;24247;19511;1;621;-2.14748e+09;-1.63132e+06;0;0;0;0;0;0;887867808;909852547;74922564
1787;1.13648e-14;-557;1680;24608;19398;1;688;-2.14748e+09;-1.62817e+06;0;0;0;0;0;0;887995865;910005450;74973583
1787;1.14646e-14;-537;1638;24247;19511;1;621;-2.14748e+09;-1.62817e+06;-1;0;0;0;-1;0;887995865;910005450;74973583
1788;1.13648e-14;-557;1680;24608;19398;1;688;-2.14748e+09;-1.62513e+06;-1;0;0;0;-1;0;888123668;910158075;75024526
1788;1.14646e-14;-538;1638;24247;19511;1;621;-2.14748e+09;-1.62513e+06;0;0;0;0;0;0;888123668;910158075;75024526
1789;1.13648e-14;-558;1680;24608;19398;1;688;-2.14748e+09;-1.62199e+06;0;0;0;0;0;0;888251217;910310422;75075393
1789;1.14646e-14;-539;1638;24247;19511;1;621;-2.14748e+09;-1.62199e+06;0;0;0;0;0;0;888251217;910310422;75075393
1790;1.13648e-14;-559;1680;24608;19398;1;688;-2.14748e+09;-1.61876e+06;0;0;0;0;0;0;888378513;910462493;75126184
1790;1.14646e-14;-540;1638;24247;19511;1;621;-2.14748e+09;-1.61876e+06;0;0;0;0;0;0;888378513;910462493;75126184
1791;1.13648e-14;-560;1680;24608;19398;1;688;-2.14748e+09;-1.61563e+06;0;0;0;0;0;0;888505557;910614286;75176899
1791;1.14646e-14;-541;1638;24247;19511;1;621;-2.14748e+09;-1.61563e+06;0;0;0;0;0;0;888505557;910614286;75176899
1792;1.13648e-14;-560;1680;24608;19398;1;688;-2.14748e+09;-1.61252e+06;-1;0;0;0;-1;0;888632348;910765804;75227539
1792;1.14646e-14;-541;1638;24247;19511;1;621;-2.14748e+09;-1.61252e+06;-1;0;0;0;-1;0;888632348;910765804;75227539
1793;1.13648e-14;-561;1680;24608;19398;1;688;-2.14748e+09;-1.6094e+06;0;0;0;0;0;0;888758888;910917046;75278102
1793;1.14646e-14;-541;1638;24247;19511;1;621;-2.14748e+09;-1.6094e+06;-1;0;0;0;-1;0;888758888;910917046;75278102
1794;1.13648e-14;-562;1680;24608;19398;1;688;-2.14748e+09;-1.6063e+06;0;0;0;0;0;0;888885177;911068013;75328591
1794;1.14646e-14;-541;1638;24247;19511;1;621;-2.14748e+09;-1.6063e+06;-1;0;0;0;-1;0;888885177;911068013;75328591
1795;1.13648e-14;-563;1680;24608;19398;1;688;-2.14748e+09;-1.6032e+06;0;0;0;0;0;0;889011215;911218706;75379003
1795;1.14646e-14;-541;1638;24247;19511;1;621;-2.14748e+09;-1.6032e+06;-1;0;0;0;-1;0;889011215;911218706;75379003
1796;1.13648e-14;-563;1680;24608;19398;1;688;-2.14748e+09;-1.60011e+06;-1;0;0;0;-1;0;889137004;911369125;75429341
1796;1.14646e-14;-542;1638;24247;19511;1;621;-2.14748e+09;-1.60011e+06;0;0;0;0;0;0;889137004;911369125;75429341
1797;1.13648e-14;-564;1680;24608;19398;1;688;-2.14748e+09;-1.59702e+06;0;0;0;0;0;0;889262543;911519271;75479603
1797;1.14646e-14;-543;1638;24247;19511;1;621;-2.14748e+09;-1.59702e+06;0;0;0;0;0;0;889262543;911519271;75479603
1798;1.13648e-14;-564;1680;24608;19398;1;688;-2.14748e+09;-1.59404e+06;-1;0;0;0;-1;0;889387833;911669144;75529789
1798;1.14646e-14;-543;1638;24247;19511;1;621;-2.14748e+09;-1.59394e+06;-1;0;0;0;-1;0;889387833;911669144;75529789
1799;1.13648e-14;-564;1680;24608;19398;1;688;-2.14748e+09;-1.59087e+06;-1;0;0;0;-1;0;889512875;911818744;75579901
1799;1.14646e-14;-544;1638;24247;19511;1;621;-2.14748e+09;-1.59087e+06;0;0;0;0;0;0;889512875;911818744;75579901
1800;1.13648e-14;-565;1680;24608;19398;1;688;-2.14748e+09;-1.5878e+06;0;0;0;0;0;0;889637670;911968073;75629937
1800;1.14646e-14;-544;1638;24247;19511;1;621;-2.14748e+09;-1.5878e+06;-1;0;0;0;-1;0;889637670;911968073;75629937
1801;1.13648e-14;-565;1680;24608;19398;1;688;-2.14748e+09;-1.58484e+06;-1;0;0;0;-1;0;889762217;912117130;75679899
1801;1.14646e-14;-544;1638;24247;19511;1;621;-2.14748e+09;-1.58484e+06;-1;0;0;0;-1;0;889762217;912117130;75679899
1802;1.13648e-14;-566;1680;24608;19398;1;688;-2.14748e+09;-1.58179e+06;0;0;0;0;0;0;889886517;912265916;75729785
1802;1.14646e-14;-545;1638;24247;19511;1;621;-2.14748e+09;-1.58179e+06;0;0;0;0;0;0;889886517;912265916;75729785
1803;1.13648e-14;-566;1680;24608;19398;1;688;-2.14748e+09;-1.57874e+06;-1;0;0;0;-1;0;890010572;912414433;75779597
1803;1.14646e-14;-545;1638;24247;19511;1;621;-2.14748e+09;-1.57874e+06;-1;0;0;0;-1;0;890010572;912414433;75779597
1804;1.13648e-14;-566;1680;24608;19398;1;688;-2.14748e+09;-1.5757e+06;-1;0;0;0;-1;0;890134380;912562679;75829333
1804;1.14646e-14;-546;1638;24247;19511;1;621;-2.14748e+09;-1.5757e+06;0;0;0;0;0;0;890134380;912562679;75829333
1805;1.13648e-14;-566;1680;24608;19398;1;688;-2.14748e+09;-1.57257e+06;-1;0;0;0;-1;0;890257944;912710656;75878996
1805;1.14646e-14;-546;1638;24247;19511;1;621;-2.14748e+09;-1.57257e+06;-1;0;0;0;-1;0;890257944;912710656;75878996
1806;1.13648e-14;-567;1680;24608;19398;1;688;-2.14748e+09;-1.56954e+06;0;0;0;0;0;0;890381263;912858364;75928583
1806;1.14646e-14;-547;1638;24247;19511;1;621;-2.14748e+09;-1.56954e+06;0;0;0;0;0;0;890381263;912858364;75928583
1807;1.13648e-14;-567;1680;24608;19398;1;688;-2.14748e+09;-1.56652e+06;-1;0;0;0;-1;0;890504338;913005805;75978096
1807;1.14646e-14;-547;1638;24247;19511;1;621;-2.14748e+09;-1.56652e+06;-1;0;0;0;-1;0;890504338;913005805;75978096
1808;1.13648e-14;-568;1680;24608;19398;1;688;-2.14748e+09;-1.5635e+06;0;0;0;0;0;0;890627169;913152977;76027534
1808;1.14646e-14;-547;1638;24247;19511;1;621;-2.14748e+09;-1.5635e+06;-1;0;0;0;-1;0;890627169;913152977;76027534
1809;1.13648e-14;-569;1680;24608;19398;1;688;-2.14748e+09;-1.56049e+06;0;0;0;0;0;0;890749757;913299882;76076898
1809;1.14646e-14;-547;1638;24247;19511;1;621;-2.14748e+09;-1.56049e+06;-1;0;0;0;-1;0;890749757;913299882;76076898
1810;1.13648e-14;-570;1680;24608;19398;1;688;-2.14748e+09;-1.55749e+06;0;0;0;0;0;0;890872103;913446520;76126188
1810;1.14646e-14;-547;1638;24247;19511;1;621;-2.14748e+09;-1.55749e+06;-1;0;0;0;-1;0;890872103;913446520;76126188
1811;1.13648e-14;-571;1680;24608;19398;1;688;-2.14748e+09;-1.55449e+06;0;0;0;0;0;0;890994207;913592893;76175403
1811;1.14646e-14;-547;1638;24247;19511;1;621;-2.14748e+09;-1.55449e+06;-1;0;0;0;-1;0;890994207;913592893;76175403
1812;1.13648e-14;-572;1680;24608;19398;1;688;-2.14748e+09;-1.5515e+06;0;0;0;0;0;0;891116070;913738999;76224544
1812;1.14646e-14;-547;1638;24247;19511;1;621;-2.14748e+09;-1.5515e+06;-1;0;0;0;-1;0;891116070;913738999;76224544
1813;1.13648e-14;-572;1680;24608;19398;1;688;-2.14748e+09;-1.54862e+06;-1;0;0;0;-1;0;891237691;913884840;76273611
1813;1.14646e-14;-547;1638;24247;19511;1;621;-2.14748e+09;-1.54862e+06;-1;0;0;0;-1;0;891237691;913884840;76273611
1814;1.13648e-14;-573;1680;24608;19398;1;688;-2.14748e+09;-1.54554e+06;0;0;0;0;0;0;891359072;914030417;76322605
1814;1.14646e-14;-547;1638;24247;19511;1;621;-2.14748e+09;-1.54554e+06;-1;0;0;0;-1;0;891359072;914030417;76322605
1815;1.13648e-14;-574;1680;24608;19398;1;688;-2.14748e+09;-1.54257e+06;0;0;0;0;0;0;891480214;914175729;76371524
1815;1.14646e-14;-547;1638;24247;19511;1;621;-2.14748e+09;-1.54257e+06;-1;0;0;0;-1;0;891480214;914175729;76371524
1816;1.13648e-14;-575;1680;24608;19398;1;688;-2.14748e+09;-1.5396e+06;0;0;0;0;0;0;891601116;914320777;76420369
1816;1.14646e-14;-547;1638;24247;19511;1;621;-2.14748e+09;-1.5396e+06;-1;0;0;0;-1;0;891601116;914320777;76420369
1817;1.13648e-14;-576;1680;24608;19398;1;688;-2.14748e+09;-1.53674e+06;0;0;0;0;0;0;891721779;914465563;76469141
1817;1.14646e-14;-547;1638;24247;19511;1;621;-2.14748e+09;-1.53674e+06;-1;0;0;0;-1;0;891721779;914465563;76469141
1818;1.13648e-14;-577;1680;24608;19398;1;688;-2.14748e+09;-1.53369e+06;0;0;0;0;0;0;891842203;914610085;76517839
1818;1.14646e-14;-547;1638;24247;19511;1;621;-2.14748e+09;-1.53369e+06;-1;0;0;0;-1;0;891842203;914610085;76517839
1819;1.13648e-14;-578;1680;24608;19398;1;688;-2.14748e+09;-1.53074e+06;0;0;0;0;0;0;891962390;914754346;76566463
1819;1.14646e-14;-548;1638;24247;19511;1;621;-2.14748e+09;-1.53074e+06;0;0;0;0;0;0;891962390;914754346;76566463
1820;1.13648e-14;-578;1680;24608;19398;1;688;-2.14748e+09;-1.5278e+06;-1;0;0;0;-1;0;892082340;914898344;76615014
1820;1.14646e-14;-549;1638;24247;19511;1;621;-2.14748e+09;-1.5278e+06;0;0;0;0;0;0;892082340;914898344;76615014
1821;1.13648e-14;-579;1680;24608;19398;1;688;-2.14748e+09;-1.52487e+06;0;0;0;0;0;0;892202052;915042082;76663491
1821;1.14646e-14;-550;1638;24247;19511;1;621;-2.14748e+09;-1.52487e+06;0;0;0;0;0;0;892202052;915042082;76663491
1822;1.13648e-14;-579;1680;24608;19398;1;688;-2.14748e+09;-1.52194e+06;-1;0;0;0;-1;0;892321529;915185558;76711895
1822;1.14646e-14;-550;1638;24247;19511;1;621;-2.14748e+09;-1.52194e+06;-1;0;0;0;-1;0;892321529;915185558;76711895
1823;1.13648e-14;-580;1680;24608;19398;1;688;-2.14748e+09;-1.51902e+06;0;0;0;0;0;0;892440769;915328774;76760226
1823;1.14646e-14;-550;1638;24247;19511;1;621;-2.14748e+09;-1.51902e+06;-1;0;0;0;-1;0;892440769;915328774;76760226
1824;1.13648e-14;-580;1680;24608;19398;1;688;-2.14748e+09;-1.5161e+06;-1;0;0;0;-1;0;892559774;915471731;76808483
1824;1.14646e-14;-551;1638;24247;19511;1;621;-2.14748e+09;-1.5161e+06;0;0;0;0;0;0;892559774;915471731;76808483
1825;1.13648e-14;-581;1680;24608;19398;1;688;-2.14748e+09;-1.51319e+06;0;0;0;0;0;0;892678544;915614428;76856668
1825;1.14646e-14;-552;1638;24247;19511;1;621;-2.14748e+09;-1.51319e+06;0;0;0;0;0;0;892678544;915614428;76856668
1826;1.13648e-14;-581;1680;24608;19398;1;688;-2.14748e+09;-1.51028e+06;-1;0;0;0;-1;0;892797080;915756867;76904779
1826;1.14646e-14;-553;1638;24247;19511;1;621;-2.14748e+09;-1.51028e+06;0;0;0;0;0;0;892797080;915756867;76904779
1827;1.13648e-14;-581;1680;24608;19398;1;688;-2.14748e+09;-1.50738e+06;-1;0;0;0;-1;0;892915383;915899047;76952817
1827;1.14646e-14;-554;1638;24247;19511;1;621;-2.14748e+09;-1.50738e+06;0;0;0;0;0;0;892915383;915899047;76952817
1828;1.13648e-14;-581;1680;24608;19398;1;688;-2.14748e+09;-1.50449e+06;-1;0;0;0;-1;0;893033451;916040969;77000783
1828;1.14646e-14;-554;1638;24247;19511;1;621;-2.14748e+09;-1.50449e+06;-1;0;0;0;-1;0;893033451;916040969;77000783
1829;1.13648e-14;-581;1680;24608;19398;1;688;-2.14748e+09;-1.5016e+06;-1;0;0;0;-1;0;893151287;916182634;77048675
1829;1.14646e-14;-554;1638;24247;19511;1;621;-2.14748e+09;-1.5016e+06;-1;0;0;0;-1;0;893151287;916182634;77048675
1830;1.13648e-14;-582;1680;24608;19398;1;688;-2.14748e+09;-1.49872e+06;0;0;0;0;0;0;893268891;916324042;77096495
1830;1.14646e-14;-555;1638;24247;19511;1;621;-2.14748e+09;-1.49872e+06;0;0;0;0;0;0;893268891;916324042;77096495
1831;1.13648e-14;-582;1680;24608;19398;1;688;-2.14748e+09;-1.49585e+06;-1;0;0;0;-1;0;893386263;916465194;77144243
1831;1.14646e-14;-556;1638;24247;19511;1;621;-2.14748e+09;-1.49585e+06;0;0;0;0;0;0;893386263;916465194;77144243
1832;1.13648e-14;-582;1680;24608;19398;1;688;-2.14748e+09;-1.49298e+06;-1;0;0;0;-1;0;893503404;916606090;77191917
1832;1.14646e-14;-556;1638;24247;19511;1;621;-2.14748e+09;-1.49298e+06;-1;0;0;0;-1;0;893503404;916606090;77191917
1833;1.13648e-14;-583;1680;24608;19398;1;688;-2.14748e+09;-1.49012e+06;0;0;0;0;0;0;893620313;916746730;77239520
1833;1.14646e-14;-557;1638;24247;19511;1;621;-2.14748e+09;-1.49012e+06;0;0;0;0;0;0;893620313;916746730;77239520
1834;1.13648e-14;-584;1680;24608;19398;1;688;-2.14748e+09;-1.48726e+06;0;0;0;0;0;0;893736993;916887115;77287049
1834;1.14646e-14;-558;1638;24247;19511;1;621;-2.14748e+09;-1.48726e+06;0;0;0;0;0;0;893736993;916887115;77287049
1835;1.13648e-14;-584;1680;24608;19398;1;688;-2.14748e+09;-1.48451e+06;-1;0;0;0;-1;0;893853442;917027246;77334507
1835;1.14646e-14;-559;1638;24247;19511;1;621;-2.14748e+09;-1.48441e+06;0;0;0;0;0;0;893853442;917027246;77334507
1836;1.13648e-14;-585;1680;24608;19398;1;688;-2.14748e+09;-1.48156e+06;0;0;0;0;0;0;893969662;917167123;77381892
1836;1.14646e-14;-560;1638;24247;19511;1;621;-2.14748e+09;-1.48156e+06;0;0;0;0;0;0;893969662;917167123;77381892
1837;1.13648e-14;-585;1680;24608;19398;1;688;-2.14748e+09;-1.47872e+06;-1;0;0;0;-1;0;894085653;917306747;77429205
1837;1.14646e-14;-561;1638;24247;19511;1;621;-2.14748e+09;-1.47872e+06;0;0;0;0;0;0;894085653;917306747;77429205
1838;1.13648e-14;-585;1680;24608;19398;1;688;-2.14748e+09;-1.47589e+06;-1;0;0;0;-1;0;894201416;917446117;77476446
1838;1.14646e-14;-561;1638;24247;19511;1;621;-2.14748e+09;-1.47589e+06;-1;0;0;0;-1;0;894201416;917446117;77476446
1839;1.13648e-14;-586;1680;24608;19398;1;688;-2.14748e+09;-1.47306e+06;0;0;0;0;0;0;894316951;917585235;77523615
1839;1.14646e-14;-562;1638;24247;19511;1;621;-2.14748e+09;-1.47306e+06;0;0;0;0;0;0;894316951;917585235;77523615
1840;1.13648e-14;-586;1680;24608;19398;1;688;-2.14748e+09;-1.47024e+06;-1;0;0;0;-1;0;894432259;917724101;77570712
1840;1.14646e-14;-562;1638;24247;19511;1;621;-2.14748e+09;-1.47024e+06;-1;0;0;0;-1;0;894432259;917724101;77570712
1841;1.13648e-14;-587;1680;24608;19398;1;688;-2.14748e+09;-1.46742e+06;0;0;0;0;0;0;894547339;917862715;77617738
1841;1.14646e-14;-562;1638;24247;19511;1;621;-2.14748e+09;-1.46742e+06;-1;0;0;0;-1;0;894547339;917862715;77617738
1842;1.13648e-14;-588;1680;24608;19398;1;688;-2.14748e+09;-1.46462e+06;0;0;0;0;0;0;894662193;918001078;77664691
1842;1.14646e-14;-562;1638;24247;19511;1;621;-2.14748e+09;-1.46462e+06;-1;0;0;0;-1;0;894662193;918001078;77664691
1843;1.13648e-14;-589;1680;24608;19398;1;688;-2.14748e+09;-1.46181e+06;0;0;0;0;0;0;894776821;918139190;77711573
1843;1.14646e-14;-562;1638;24247;19511;1;621;-2.14748e+09;-1.46181e+06;-1;0;0;0;-1;0;894776821;918139190;77711573
1844;1.13648e-14;-590;1680;24608;19398;1;688;-2.14748e+09;-1.45901e+06;0;0;0;0;0;0;894891224;918277053;77758383
1844;1.14646e-14;-562;1638;24247;19511;1;621;-2.14748e+09;-1.45901e+06;-1;0;0;0;-1;0;894891224;918277053;77758383
1845;1.13648e-14;-590;1680;24608;19398;1;688;-2.14748e+09;-1.45622e+06;-1;0;0;0;-1;0;895005402;918414665;77805122
1845;1.14646e-14;-562;1638;24247;19511;1;621;-2.14748e+09;-1.45622e+06;-1;0;0;0;-1;0;895005402;918414665;77805122
1846;1.13648e-14;-591;1680;24608;19398;1;688;-2.14748e+09;-1.45343e+06;0;0;0;0;0;0;895119355;918552028;77851789
1846;1.14646e-14;-562;1638;24247;19511;1;621;-2.14748e+09;-1.45343e+06;-1;0;0;0;-1;0;895119355;918552028;77851789
1847;1.13648e-14;-591;1680;24608;19398;1;688;-2.14748e+09;-1.45065e+06;-1;0;0;0;-1;0;895233084;918689143;77898385
1847;1.14646e-14;-562;1638;24247;19511;1;621;-2.14748e+09;-1.45065e+06;-1;0;0;0;-1;0;895233084;918689143;77898385
1848;1.13648e-14;-592;1680;24608;19398;1;688;-2.14748e+09;-1.44788e+06;0;0;0;0;0;0;895346589;918826009;77944910
1848;1.14646e-14;-562;1638;24247;19511;1;621;-2.14748e+09;-1.44788e+06;-1;0;0;0;-1;0;895346589;918826009;77944910
1849;1.13648e-14;-592;1680;24608;19398;1;688;-2.14748e+09;-1.4451e+06;-1;0;0;0;-1;0;895459871;918962627;77991363
1849;1.14646e-14;-562;1638;24247;19511;1;621;-2.14748e+09;-1.4451e+06;-1;0;0;0;-1;0;895459871;918962627;77991363
1850;1.13648e-14;-593;1680;24608;19398;1;688;-2.14748e+09;-1.44234e+06;0;0;0;0;0;0;895572931;919098998;78037746
1850;1.14646e-14;-563;1638;24247;19511;1;621;-2.14748e+09;-1.44234e+06;0;0;0;0;0;0;895572931;919098998;78037746
1851;1.13648e-14;-594;1680;24608;19398;1;688;-2.14748e+09;-1.43958e+06;0;0;0;0;0;0;895685768;919235121;78084057
1851;1.14646e-14;-563;1638;24247;19511;1;621;-2.14748e+09;-1.43958e+06;-1;0;0;0;-1;0;895685768;919235121;78084057
1852;1.13648e-14;-595;1680;24608;19398;1;688;-2.14748e+09;-1.43683e+06;0;0;0;0;0;0;895798384;919370999;78130297
1852;1.14646e-14;-564;1638;24247;19511;1;621;-2.14748e+09;-1.43683e+06;0;0;0;0;0;0;895798384;919370999;78130297
1853;1.13648e-14;-595;1680;24608;19398;1;688;-2.14748e+09;-1.43408e+06;-1;0;0;0;-1;0;895910778;919506630;78176467
1853;1.14646e-14;-564;1638;24247;19511;1;621;-2.14748e+09;-1.43408e+06;-1;0;0;0;-1;0;895910778;919506630;78176467
1854;1.13648e-14;-596;1680;24608;19398;1;688;-2.14748e+09;-1.43134e+06;0;0;0;0;0;0;896022952;919642016;78222566
1854;1.14646e-14;-565;1638;24247;19511;1;621;-2.14748e+09;-1.43134e+06;0;0;0;0;0;0;896022952;919642016;78222566
1855;1.13648e-14;-597;1680;24608;19398;1;688;-2.14748e+09;-1.4286e+06;0;0;0;0;0;0;896134905;919777157;78268594
1855;1.14646e-14;-565;1638;24247;19511;1;621;-2.14748e+09;-1.4286e+06;-1;0;0;0;-1;0;896134905;919777157;78268594
1856;1.13648e-14;-598;1680;24608;19398;1;688;-2.14748e+09;-1.42587e+06;0;0;0;0;0;0;896246639;919912053;78314551
1856;1.14646e-14;-566;1638;24247;19511;1;621;-2.14748e+09;-1.42587e+06;0;0;0;0;0;0;896246639;919912053;78314551
1857;1.13648e-14;-599;1680;24608;19398;1;688;-2.14748e+09;-1.42315e+06;0;0;0;0;0;0;896358153;920046704;78360438
1857;1.14646e-14;-567;1638;24247;19511;1;621;-2.14748e+09;-1.42315e+06;0;0;0;0;0;0;896358153;920046704;78360438
1858;1.13648e-14;-600;1680;24608;19398;1;688;-2.14748e+09;-1.42043e+06;0;0;0;0;0;0;896469448;920181113;78406254
1858;1.14646e-14;-568;1638;24247;19511;1;621;-2.14748e+09;-1.42043e+06;0;0;0;0;0;0;896469448;920181113;78406254
1859;1.13648e-14;-601;1680;24608;19398;1;688;-2.14748e+09;-1.41771e+06;0;0;0;0;0;0;896580525;920315277;78452000
1859;1.14646e-14;-568;1638;24247;19511;1;621;-2.14748e+09;-1.41771e+06;-1;0;0;0;-1;0;896580525;920315277;78452000
1860;1.13648e-14;-601;1680;24608;19398;1;688;-2.14748e+09;-1.41501e+06;-1;0;0;0;-1;0;896691384;920449199;78497676
1860;1.14646e-14;-568;1638;24247;19511;1;621;-2.14748e+09;-1.41501e+06;-1;0;0;0;-1;0;896691384;920449199;78497676
1861;1.13648e-14;-602;1680;24608;19398;1;688;-2.14748e+09;-1.4123e+06;0;0;0;0;0;0;896802025;920582879;78543282
1861;1.14646e-14;-568;1638;24247;19511;1;621;-2.14748e+09;-1.4123e+06;-1;0;0;0;-1;0;896802025;920582879;78543282
1862;1.13648e-14;-602;1680;24608;19398;1;688;-2.14748e+09;-1.40961e+06;-1;0;0;0;-1;0;896912449;920716317;78588817
1862;1.14646e-14;-569;1638;24247;19511;1;621;-2.14748e+09;-1.40961e+06;0;0;0;0;0;0;896912449;920716317;78588817
1863;1.13648e-14;-602;1680;24608;19398;1;688;-2.14748e+09;-1.40691e+06;-1;0;0;0;-1;0;897022657;920849513;78634282
1863;1.14646e-14;-569;1638;24247;19511;1;621;-2.14748e+09;-1.40691e+06;-1;0;0;0;-1;0;897022657;920849513;78634282
1864;1.13648e-14;-603;1680;24608;19398;1;688;-2.14748e+09;-1.40423e+06;0;0;0;0;0;0;897132648;920982468;78679678
1864;1.14646e-14;-569;1638;24247;19511;1;621;-2.14748e+09;-1.40423e+06;-1;0;0;0;-1;0;897132648;920982468;78679678
1865;1.13648e-14;-604;1680;24608;19398;1;688;-2.14748e+09;-1.40155e+06;0;0;0;0;0;0;897242424;921115183;78725003
1865;1.14646e-14;-569;1638;24247;19511;1;621;-2.14748e+09;-1.40155e+06;-1;0;0;0;-1;0;897242424;921115183;78725003
1866;1.13648e-14;-605;1680;24608;19398;1;688;-2.14748e+09;-1.39887e+06;0;0;0;0;0;0;897351984;921247657;78770259
1866;1.14646e-14;-569;1638;24247;19511;1;621;-2.14748e+09;-1.39887e+06;-1;0;0;0;-1;0;897351984;921247657;78770259
1867;1.13648e-14;-605;1680;24608;19398;1;688;-2.14748e+09;-1.3962e+06;-1;0;0;0;-1;0;897461330;921379892;78815445
1867;1.14646e-14;-569;1638;24247;19511;1;621;-2.14748e+09;-1.3962e+06;-1;0;0;0;-1;0;897461330;921379892;78815445
1868;1.13648e-14;-605;1680;24608;19398;1;688;-2.14748e+09;-1.39354e+06;-1;0;0;0;-1;0;897570461;921511888;78860561
1868;1.14646e-14;-570;1638;24247;19511;1;621;-2.14748e+09;-1.39354e+06;0;0;0;0;0;0;897570461;921511888;78860561
1869;1.13648e-14;-605;1680;24608;19398;1;688;-2.14748e+09;-1.39088e+06;-1;0;0;0;-1;0;897679379;921643645;78905608
1869;1.14646e-14;-571;1638;24247;19511;1;621;-2.14748e+09;-1.39088e+06;0;0;0;0;0;0;897679379;921643645;78905608
1870;1.13648e-14;-606;1680;24608;19398;1;688;-2.14748e+09;-1.38823e+06;0;0;0;0;0;0;897788083;921775163;78950585
1870;1.14646e-14;-571;1638;24247;19511;1;621;-2.14748e+09;-1.38823e+06;-1;0;0;0;-1;0;897788083;921775163;78950585
1871;1.13648e-14;-606;1680;24608;19398;1;688;-2.14748e+09;-1.38558e+06;-1;0;0;0;-1;0;897896574;921906444;78995493
1871;1.14646e-14;-572;1638;24247;19511;1;621;-2.14748e+09;-1.38558e+06;0;0;0;0;0;0;897896574;921906444;78995493
1872;1.13648e-14;-606;1680;24608;19398;1;688;-2.14748e+09;-1.38294e+06;-1;0;0;0;-1;0;898004853;922037487;79040331
1872;1.14646e-14;-572;1638;24247;19511;1;621;-2.14748e+09;-1.38294e+06;-1;0;0;0;-1;0;898004853;922037487;79040331
1873;1.13648e-14;-606;1680;24608;19398;1;688;-2.14748e+09;-1.3803e+06;-1;0;0;0;-1;0;898112919;922168293;79085101
1873;1.14646e-14;-572;1638;24247;19511;1;621;-2.14748e+09;-1.3803e+06;-1;0;0;0;-1;0;898112919;922168293;79085101
1874;1.13648e-14;-607;1680;24608;19398;1;688;-2.14748e+09;-1.37767e+06;0;0;0;0;0;0;898220774;922298863;79129801
1874;1.14646e-14;-572;1638;24247;19511;1;621;-2.14748e+09;-1.37767e+06;-1;0;0;0;-1;0;898220774;922298863;79129801
1875;1.13648e-14;-607;1680;24608;19398;1;688;-2.14748e+09;-1.37504e+06;-1;0;0;0;-1;0;898328418;922429197;79174432
1875;1.14646e-14;-572;1638;24247;19511;1;621;-2.14748e+09;-1.37504e+06;-1;0;0;0;-1;0;898328418;922429197;79174432
1876;1.13648e-14;-607;1680;24608;19398;1;688;-2.14748e+09;-1.37242e+06;-1;0;0;0;-1;0;898435850;922559294;79218994
1876;1.14646e-14;-572;1638;24247;19511;1;621;-2.14748e+09;-1.37242e+06;-1;0;0;0;-1;0;898435850;922559294;79218994
1877;1.13648e-14;-608;1680;24608;19398;1;688;-2.14748e+09;-1.3698e+06;0;0;0;0;0;0;898543073;922689157;79263487
1877;1.14646e-14;-572;1638;24247;19511;1;621;-2.14748e+09;-1.3698e+06;-1;0;0;0;-1;0;898543073;922689157;79263487
1878;1.13648e-14;-608;1680;24608;19398;1;688;-2.14748e+09;-1.36719e+06;-1;0;0;0;-1;0;898650086;922818785;79307911
1878;1.14646e-14;-573;1638;24247;19511;1;621;-2.14748e+09;-1.36719e+06;0;0;0;0;0;0;898650086;922818785;79307911
1879;1.13648e-14;-609;1680;24608;19398;1;688;-2.14748e+09;-1.36459e+06;0;0;0;0;0;0;898756889;922948178;79352267
1879;1.14646e-14;-574;1638;24247;19511;1;621;-2.14748e+09;-1.36459e+06;0;0;0;0;0;0;898756889;922948178;79352267
1880;1.13648e-14;-610;1680;24608;19398;1;688;-2.14748e+09;-1.36199e+06;0;0;0;0;0;0;898863483;923077338;79396554
1880;1.14646e-14;-574;1638;24247;19511;1;621;-2.14748e+09;-1.36199e+06;-1;0;0;0;-1;0;898863483;923077338;79396554
1881;1.13648e-14;-610;1680;24608;19398;1;688;-2.14748e+09;-1.35939e+06;-1;0;0;0;-1;0;898969869;923206264;79440772
1881;1.14646e-14;-574;1638;24247;19511;1;621;-2.14748e+09;-1.35939e+06;-1;0;0;0;-1;0;898969869;923206264;79440772
1882;1.13648e-14;-610;1680;24608;19398;1;688;-2.14748e+09;-1.3568e+06;-1;0;0;0;-1;0;899076047;923334956;79484922
1882;1.14646e-14;-574;1638;24247;19511;1;621;-2.14748e+09;-1.3568e+06;-1;0;0;0;-1;0;899076047;923334956;79484922
1883;1.13648e-14;-610;1680;24608;19398;1;688;-2.14748e+09;-1.35422e+06;-1;0;0;0;-1;0;899182017;923463417;79529004
1883;1.14646e-14;-575;1638;24247;19511;1;621;-2.14748e+09;-1.35422e+06;0;0;0;0;0;0;899182017;923463417;79529004
1884;1.13648e-14;-611;1680;24608;19398;1;688;-2.14748e+09;-1.35164e+06;0;0;0;0;0;0;899287779;923591645;79573017
1884;1.14646e-14;-575;1638;24247;19511;1;621;-2.14748e+09;-1.35164e+06;-1;0;0;0;-1;0;899287779;923591645;79573017
1885;1.13648e-14;-611;1680;24608;19398;1;688;-2.14748e+09;-1.34907e+06;-1;0;0;0;-1;0;899393335;923719641;79616962
1885;1.14646e-14;-575;1638;24247;19511;1;621;-2.14748e+09;-1.34907e+06;-1;0;0;0;-1;0;899393335;923719641;79616962
1886;1.13648e-14;-611;1680;24608;19398;1;688;-2.14748e+09;-1.3465e+06;-1;0;0;0;-1;0;899498685;923847406;79660838
1886;1.14646e-14;-576;1638;24247;19511;1;621;-2.14748e+09;-1.3465e+06;0;0;0;0;0;0;899498685;923847406;79660838
1887;1.13648e-14;-612;1680;24608;19398;1;688;-2.14748e+09;-1.34393e+06;0;0;0;0;0;0;899603828;923974940;79704647
1887;1.14646e-14;-576;1638;24247;19511;1;621;-2.14748e+09;-1.34393e+06;-1;0;0;0;-1;0;899603828;923974940;79704647
1888;1.13648e-14;-613;1680;24608;19398;1;688;-2.14748e+09;-1.34138e+06;0;0;0;0;0;0;899708766;924102243;79748388
1888;1.14646e-14;-576;1638;24247;19511;1;621;-2.14748e+09;-1.34138e+06;-1;0;0;0;-1;0;899708766;924102243;79748388
1889;1.13648e-14;-613;1680;24608;19398;1;688;-2.14748e+09;-1.33882e+06;-1;0;0;0;-1;0;899813499;924229317;79792060
1889;1.14646e-14;-576;1638;24247;19511;1;621;-2.14748e+09;-1.33882e+06;-1;0;0;0;-1;0;899813499;924229317;79792060
1890;1.13648e-14;-614;1680;24608;19398;1;688;-2.14748e+09;-1.33628e+06;0;0;0;0;0;0;899918028;924356160;79835665
1890;1.14646e-14;-576;1638;24247;19511;1;621;-2.14748e+09;-1.33628e+06;-1;0;0;0;-1;0;899918028;924356160;79835665
1891;1.13648e-14;-614;1680;24608;19398;1;688;-2.14748e+09;-1.33373e+06;-1;0;0;0;-1;0;900022352;924482775;79879202
1891;1.14646e-14;-577;1638;24247;19511;1;621;-2.14748e+09;-1.33373e+06;0;0;0;0;0;0;900022352;924482775;79879202
1892;1.13648e-14;-615;1680;24608;19398;1;688;-2.14748e+09;-1.3312e+06;0;0;0;0;0;0;900126472;924609161;79922672
1892;1.14646e-14;-577;1638;24247;19511;1;621;-2.14748e+09;-1.3312e+06;-1;0;0;0;-1;0;900126472;924609161;79922672
1893;1.13648e-14;-616;1680;24608;19398;1;688;-2.14748e+09;-1.32866e+06;0;0;0;0;0;0;900230389;924735318;79966073
1893;1.14646e-14;-578;1638;24247;19511;1;621;-2.14748e+09;-1.32866e+06;0;0;0;0;0;0;900230389;924735318;79966073
1894;1.13648e-14;-617;1680;24608;19398;1;688;-2.14748e+09;-1.32614e+06;0;0;0;0;0;0;900334104;924861248;80009408
1894;1.14646e-14;-578;1638;24247;19511;1;621;-2.14748e+09;-1.32614e+06;-1;0;0;0;-1;0;900334104;924861248;80009408
1895;1.13648e-14;-618;1680;24608;19398;1;688;-2.14748e+09;-1.32361e+06;0;0;0;0;0;0;900437615;924986950;80052674
1895;1.14646e-14;-579;1638;24247;19511;1;621;-2.14748e+09;-1.32361e+06;0;0;0;0;0;0;900437615;924986950;80052674
1896;1.13648e-14;-619;1680;24608;19398;1;688;-2.14748e+09;-1.3211e+06;0;0;0;0;0;0;900540925;925112425;80095874
1896;1.14646e-14;-580;1638;24247;19511;1;621;-2.14748e+09;-1.3211e+06;0;0;0;0;0;0;900540925;925112425;80095874
1897;1.13648e-14;-620;1680;24608;19398;1;688;-2.14748e+09;-1.31858e+06;0;0;0;0;0;0;900644032;925237673;80139006
1897;1.14646e-14;-580;1638;24247;19511;1;621;-2.14748e+09;-1.31858e+06;-1;0;0;0;-1;0;900644032;925237673;80139006
1898;1.13648e-14;-621;1680;24608;19398;1;688;-2.14748e+09;-1.31618e+06;0;0;0;0;0;0;900746939;925362695;80182071
1898;1.14646e-14;-580;1638;24247;19511;1;621;-2.14748e+09;-1.31618e+06;-1;0;0;0;-1;0;900746939;925362695;80182071
1899;1.13648e-14;-621;1680;24608;19398;1;688;-2.14748e+09;-1.31368e+06;-1;0;0;0;-1;0;900849645;925487491;80225069
1899;1.14646e-14;-580;1638;24247;19511;1;621;-2.14748e+09;-1.31358e+06;-1;0;0;0;-1;0;900849645;925487491;80225069
1900;1.13648e-14;-621;1680;24608;19398;1;688;-2.14748e+09;-1.31118e+06;-1;0;0;0;-1;0;900952150;925612062;80268000
1900;1.14646e-14;-581;1638;24247;19511;1;621;-2.14748e+09;-1.31118e+06;0;0;0;0;0;0;900952150;925612062;80268000
1901;1.13648e-14;-622;1680;24608;19398;1;688;-2.14748e+09;-1.30869e+06;0;0;0;0;0;0;901054456;925736408;80310864
1901;1.14646e-14;-581;1638;24247;19511;1;621;-2.14748e+09;-1.30869e+06;-1;0;0;0;-1;0;901054456;925736408;80310864
1902;1.13648e-14;-623;1680;24608;19398;1;688;-2.14748e+09;-1.3061e+06;0;0;0;0;0;0;901156561;925860529;80353661
1902;1.14646e-14;-581;1638;24247;19511;1;621;-2.14748e+09;-1.3061e+06;-1;0;0;0;-1;0;901156561;925860529;80353661
1903;1.13648e-14;-623;1680;24608;19398;1;688;-2.14748e+09;-1.30372e+06;-1;0;0;0;-1;0;901258468;925984426;80396391
1903;1.14646e-14;-582;1638;24247;19511;1;621;-2.14748e+09;-1.30372e+06;0;0;0;0;0;0;901258468;925984426;80396391
1904;1.13648e-14;-624;1680;24608;19398;1;688;-2.14748e+09;-1.30114e+06;0;0;0;0;0;0;901360176;926108099;80439055
1904;1.14646e-14;-582;1638;24247;19511;1;621;-2.14748e+09;-1.30114e+06;-1;0;0;0;-1;0;901360176;926108099;80439055
1905;1.13648e-14;-625;1680;24608;19398;1;688;-2.14748e+09;-1.29867e+06;0;0;0;0;0;0;901461685;926231549;80481652
1905;1.14646e-14;-582;1638;24247;19511;1;621;-2.14748e+09;-1.29867e+06;-1;0;0;0;-1;0;901461685;926231549;80481652
1906;1.13648e-14;-626;1680;24608;19398;1;688;-2.14748e+09;-1.2962e+06;0;0;0;0;0;0;901562997;926354776;80524183
1906;1.14646e-14;-582;1638;24247;19511;1;621;-2.14748e+09;-1.2962e+06;-1;0;0;0;-1;0;901562997;926354776;80524183
1907;1.13648e-14;-626;1680;24608;19398;1;688;-2.14748e+09;-1.29374e+06;-1;0;0;0;-1;0;901664111;926477781;80566647
1907;1.14646e-14;-583;1638;24247;19511;1;621;-2.14748e+09;-1.29374e+06;0;0;0;0;0;0;901664111;926477781;80566647
1908;1.13648e-14;-627;1680;24608;19398;1;688;-2.14748e+09;-1.29129e+06;0;0;0;0;0;0;901765028;926600563;80609044
1908;1.14646e-14;-583;1638;24247;19511;1;621;-2.14748e+09;-1.29129e+06;-1;0;0;0;-1;0;901765028;926600563;80609044
1909;1.13648e-14;-628;1680;24608;19398;1;688;-2.14748e+09;-1.28884e+06;0;0;0;0;0;0;901865749;926723124;80651376
1909;1.14646e-14;-583;1638;24247;19511;1;621;-2.14748e+09;-1.28884e+06;-1;0;0;0;-1;0;901865749;926723124;80651376
1910;1.13648e-14;-629;1680;24608;19398;1;688;-2.14748e+09;-1.28649e+06;0;0;0;0;0;0;901966273;926845463;80693641
1910;1.14646e-14;-584;1638;24247;19511;1;621;-2.14748e+09;-1.28639e+06;0;0;0;0;0;0;901966273;926845463;80693641
1911;1.13648e-14;-630;1680;24608;19398;1;688;-2.14748e+09;-1.28395e+06;0;0;0;0;0;0;902066601;926967582;80735840
1911;1.14646e-14;-584;1638;24247;19511;1;621;-2.14748e+09;-1.28395e+06;-1;0;0;0;-1;0;902066601;926967582;80735840
1912;1.13648e-14;-631;1680;24608;19398;1;688;-2.14748e+09;-1.28151e+06;0;0;0;0;0;0;902166734;927089480;80777973
1912;1.14646e-14;-584;1638;24247;19511;1;621;-2.14748e+09;-1.28151e+06;-1;0;0;0;-1;0;902166734;927089480;80777973
1913;1.13648e-14;-632;1680;24608;19398;1;688;-2.14748e+09;-1.27908e+06;0;0;0;0;0;0;902266672;927211158;80820040
1913;1.14646e-14;-584;1638;24247;19511;1;621;-2.14748e+09;-1.27908e+06;-1;0;0;0;-1;0;902266672;927211158;80820040
1914;1.13648e-14;-633;1680;24608;19398;1;688;-2.14748e+09;-1.27665e+06;0;0;0;0;0;0;902366415;927332616;80862041
1914;1.14646e-14;-585;1638;24247;19511;1;621;-2.14748e+09;-1.27665e+06;0;0;0;0;0;0;902366415;927332616;80862041
1915;1.13648e-14;-634;1680;24608;19398;1;688;-2.14748e+09;-1.27423e+06;0;0;0;0;0;0;902465964;927453855;80903976
1915;1.14646e-14;-586;1638;24247;19511;1;621;-2.14748e+09;-1.27423e+06;0;0;0;0;0;0;902465964;927453855;80903976
1916;1.13648e-14;-634;1680;24608;19398;1;688;-2.14748e+09;-1.27181e+06;-1;0;0;0;-1;0;902565319;927574876;80945846
1916;1.14646e-14;-587;1638;24247;19511;1;621;-2.14748e+09;-1.27181e+06;0;0;0;0;0;0;902565319;927574876;80945846
1917;1.13648e-14;-634;1680;24608;19398;1;688;-2.14748e+09;-1.2694e+06;-1;0;0;0;-1;0;902664481;927695677;80987650
1917;1.14646e-14;-588;1638;24247;19511;1;621;-2.14748e+09;-1.2694e+06;0;0;0;0;0;0;902664481;927695677;80987650
1918;1.13648e-14;-635;1680;24608;19398;1;688;-2.14748e+09;-1.26699e+06;0;0;0;0;0;0;902763450;927816261;81029389
1918;1.14646e-14;-588;1638;24247;19511;1;621;-2.14748e+09;-1.26699e+06;-1;0;0;0;-1;0;902763450;927816261;81029389
1919;1.13648e-14;-636;1680;24608;19398;1;688;-2.14748e+09;-1.26459e+06;0;0;0;0;0;0;902862226;927936627;81071062
1919;1.14646e-14;-589;1638;24247;19511;1;621;-2.14748e+09;-1.26459e+06;0;0;0;0;0;0;902862226;927936627;81071062
1920;1.13648e-14;-636;1680;24608;19398;1;688;-2.14748e+09;-1.26219e+06;-1;0;0;0;-1;0;902960810;928056776;81112669
1920;1.14646e-14;-590;1638;24247;19511;1;621;-2.14748e+09;-1.26219e+06;0;0;0;0;0;0;902960810;928056776;81112669
1921;1.13648e-14;-637;1680;24608;19398;1;688;-2.14748e+09;-1.2598e+06;0;0;0;0;0;0;903059202;928176708;81154212
1921;1.14646e-14;-591;1638;24247;19511;1;621;-2.14748e+09;-1.2598e+06;0;0;0;0;0;0;903059202;928176708;81154212
1922;1.13648e-14;-638;1680;24608;19398;1;688;-2.14748e+09;-1.25741e+06;0;0;0;0;0;0;903157402;928296424;81195689
1922;1.14646e-14;-591;1638;24247;19511;1;621;-2.14748e+09;-1.25741e+06;-1;0;0;0;-1;0;903157402;928296424;81195689
1923;1.13648e-14;-639;1680;24608;19398;1;688;-2.14748e+09;-1.25512e+06;0;0;0;0;0;0;903255412;928415924;81237101
1923;1.14646e-14;-591;1638;24247;19511;1;621;-2.14748e+09;-1.25502e+06;-1;0;0;0;-1;0;903255412;928415924;81237101
1924;1.13648e-14;-640;1680;24608;19398;1;688;-2.14748e+09;-1.25265e+06;0;0;0;0;0;0;903353231;928535208;81278448
1924;1.14646e-14;-591;1638;24247;19511;1;621;-2.14748e+09;-1.25265e+06;-1;0;0;0;-1;0;903353231;928535208;81278448
1925;1.13648e-14;-641;1680;24608;19398;1;688;-2.14748e+09;-1.25027e+06;0;0;0;0;0;0;903450860;928654277;81319730
1925;1.14646e-14;-591;1638;24247;19511;1;621;-2.14748e+09;-1.25027e+06;-1;0;0;0;-1;0;903450860;928654277;81319730
1926;1.13648e-14;-641;1680;24608;19398;1;688;-2.14748e+09;-1.248e+06;-1;0;0;0;-1;0;903548299;928773131;81360947
1926;1.14646e-14;-592;1638;24247;19511;1;621;-2.14748e+09;-1.248e+06;0;0;0;0;0;0;903548299;928773131;81360947
1927;1.13648e-14;-642;1680;24608;19398;1;688;-2.14748e+09;-1.24554e+06;0;0;0;0;0;0;903645548;928891770;81402099
1927;1.14646e-14;-593;1638;24247;19511;1;621;-2.14748e+09;-1.24554e+06;0;0;0;0;0;0;903645548;928891770;81402099
1928;1.13648e-14;-643;1680;24608;19398;1;688;-2.14748e+09;-1.24318e+06;0;0;0;0;0;0;903742609;929010196;81443187
1928;1.14646e-14;-594;1638;24247;19511;1;621;-2.14748e+09;-1.24318e+06;0;0;0;0;0;0;903742609;929010196;81443187
1929;1.13648e-14;-643;1680;24608;19398;1;688;-2.14748e+09;-1.24082e+06;-1;0;0;0;-1;0;903839481;929128408;81484209
1929;1.14646e-14;-595;1638;24247;19511;1;621;-2.14748e+09;-1.24082e+06;0;0;0;0;0;0;903839481;929128408;81484209
1930;1.13648e-14;-643;1680;24608;19398;1;688;-2.14748e+09;-1.23847e+06;-1;0;0;0;-1;0;903936164;929246406;81525168
1930;1.14646e-14;-595;1638;24247;19511;1;621;-2.14748e+09;-1.23847e+06;-1;0;0;0;-1;0;903936164;929246406;81525168
1931;1.13648e-14;-644;1680;24608;19398;1;688;-2.14748e+09;-1.23613e+06;0;0;0;0;0;0;904032660;929364192;81566062
1931;1.14646e-14;-595;1638;24247;19511;1;621;-2.14748e+09;-1.23613e+06;-1;0;0;0;-1;0;904032660;929364192;81566062
1932;1.13648e-14;-644;1680;24608;19398;1;688;-2.14748e+09;-1.23378e+06;-1;0;0;0;-1;0;904128968;929481765;81606891
1932;1.14646e-14;-596;1638;24247;19511;1;621;-2.14748e+09;-1.23378e+06;0;0;0;0;0;0;904128968;929481765;81606891
1933;1.13648e-14;-645;1680;24608;19398;1;688;-2.14748e+09;-1.23155e+06;0;0;0;0;0;0;904225089;929599126;81647656
1933;1.14646e-14;-597;1638;24247;19511;1;621;-2.14748e+09;-1.23155e+06;0;0;0;0;0;0;904225089;929599126;81647656
1934;1.13648e-14;-646;1680;24608;19398;1;688;-2.14748e+09;-1.22912e+06;0;0;0;0;0;0;904321023;929716276;81688357
1934;1.14646e-14;-597;1638;24247;19511;1;621;-2.14748e+09;-1.22912e+06;-1;0;0;0;-1;0;904321023;929716276;81688357
1935;1.13648e-14;-647;1680;24608;19398;1;688;-2.14748e+09;-1.22679e+06;0;0;0;0;0;0;904416771;929833214;81728994
1935;1.14646e-14;-598;1638;24247;19511;1;621;-2.14748e+09;-1.22679e+06;0;0;0;0;0;0;904416771;929833214;81728994
1936;1.13648e-14;-648;1680;24608;19398;1;688;-2.14748e+09;-1.22447e+06;0;0;0;0;0;0;904512333;929949941;81769566
1936;1.14646e-14;-598;1638;24247;19511;1;621;-2.14748e+09;-1.22447e+06;-1;0;0;0;-1;0;904512333;929949941;81769566
1937;1.13648e-14;-648;1680;24608;19398;1;688;-2.14748e+09;-1.22215e+06;-1;0;0;0;-1;0;904607710;930066458;81810075
1937;1.14646e-14;-598;1638;24247;19511;1;621;-2.14748e+09;-1.22215e+06;-1;0;0;0;-1;0;904607710;930066458;81810075
1938;1.13648e-14;-649;1680;24608;19398;1;688;-2.14748e+09;-1.21994e+06;0;0;0;0;0;0;904702901;930182764;81850519
1938;1.14646e-14;-599;1638;24247;19511;1;621;-2.14748e+09;-1.21994e+06;0;0;0;0;0;0;904702901;930182764;81850519
1939;1.13648e-14;-649;1680;24608;19398;1;688;-2.14748e+09;-1.21763e+06;-1;0;0;0;-1;0;904797908;930298861;81890900
1939;1.14646e-14;-599;1638;24247;19511;1;621;-2.14748e+09;-1.21763e+06;-1;0;0;0;-1;0;904797908;930298861;81890900
1940;1.13648e-14;-649;1680;24608;19398;1;688;-2.14748e+09;-1.21532e+06;-1;0;0;0;-1;0;904892730;930414749;81931217
1940;1.14646e-14;-600;1638;24247;19511;1;621;-2.14748e+09;-1.21532e+06;0;0;0;0;0;0;904892730;930414749;81931217
1941;1.13648e-14;-650;1680;24608;19398;1;688;-2.14748e+09;-1.21293e+06;0;0;0;0;0;0;904987368;930530427;81971471
1941;1.14646e-14;-601;1638;24247;19511;1;621;-2.14748e+09;-1.21293e+06;0;0;0;0;0;0;904987368;930530427;81971471
1942;1.13648e-14;-651;1680;24608;19398;1;688;-2.14748e+09;-1.21063e+06;0;0;0;0;0;0;905081823;930645897;82011661
1942;1.14646e-14;-601;1638;24247;19511;1;621;-2.14748e+09;-1.21063e+06;-1;0;0;0;-1;0;905081823;930645897;82011661
1943;1.13648e-14;-652;1680;24608;19398;1;688;-2.14748e+09;-1.20834e+06;0;0;0;0;0;0;905176094;930761159;82051787
1943;1.14646e-14;-601;1638;24247;19511;1;621;-2.14748e+09;-1.20834e+06;-1;0;0;0;-1;0;905176094;930761159;82051787
1944;1.13648e-14;-652;1680;24608;19398;1;688;-2.14748e+09;-1.20606e+06;-1;0;0;0;-1;0;905270183;930876213;82091850
1944;1.14646e-14;-601;1638;24247;19511;1;621;-2.14748e+09;-1.20606e+06;-1;0;0;0;-1;0;905270183;930876213;82091850
1945;1.13648e-14;-652;1680;24608;19398;1;688;-2.14748e+09;-1.20377e+06;-1;0;0;0;-1;0;905364088;930991059;82131850
1945;1.14646e-14;-602;1638;24247;19511;1;621;-2.14748e+09;-1.20377e+06;0;0;0;0;0;0;905364088;930991059;82131850
1946;1.13648e-14;-652;1680;24608;19398;1;688;-2.14748e+09;-1.2016e+06;-1;0;0;0;-1;0;905457812;931105698;82171786
1946;1.14646e-14;-603;1638;24247;19511;1;621;-2.14748e+09;-1.2016e+06;0;0;0;0;0;0;905457812;931105698;82171786
1947;1.13648e-14;-653;1680;24608;19398;1;688;-2.14748e+09;-1.19923e+06;0;0;0;0;0;0;905551354;931220131;82211659
1947;1.14646e-14;-603;1638;24247;19511;1;621;-2.14748e+09;-1.19923e+06;-1;0;0;0;-1;0;905551354;931220131;82211659
1948;1.13648e-14;-653;1680;24608;19398;1;688;-2.14748e+09;-1.19696e+06;-1;0;0;0;-1;0;905644715;931334357;82251469
1948;1.14646e-14;-603;1638;24247;19511;1;621;-2.14748e+09;-1.19696e+06;-1;0;0;0;-1;0;905644715;931334357;82251469
1949;1.13648e-14;-654;1680;24608;19398;1;688;-2.14748e+09;-1.1947e+06;0;0;0;0;0;0;905737895;931448378;82291216
1949;1.14646e-14;-603;1638;24247;19511;1;621;-2.14748e+09;-1.1947e+06;-1;0;0;0;-1;0;905737895;931448378;82291216
1950;1.13648e-14;-654;1680;24608;19398;1;688;-2.14748e+09;-1.19244e+06;-1;0;0;0;-1;0;905830894;931562193;82330900
1950;1.14646e-14;-604;1638;24247;19511;1;621;-2.14748e+09;-1.19244e+06;0;0;0;0;0;0;905830894;931562193;82330900
1951;1.13648e-14;-654;1680;24608;19398;1;688;-2.14748e+09;-1.19028e+06;-1;0;0;0;-1;0;905923712;931675802;82370522
1951;1.14646e-14;-604;1638;24247;19511;1;621;-2.14748e+09;-1.19028e+06;-1;0;0;0;-1;0;905923712;931675802;82370522
1952;1.13648e-14;-654;1680;24608;19398;1;688;-2.14748e+09;-1.18793e+06;-1;0;0;0;-1;0;906016351;931789207;82410080
1952;1.14646e-14;-605;1638;24247;19511;1;621;-2.14748e+09;-1.18793e+06;0;0;0;0;0;0;906016351;931789207;82410080
1953;1.13648e-14;-655;1680;24608;19398;1;688;-2.14748e+09;-1.18579e+06;0;0;0;0;0;0;906108811;931902408;82449576
1953;1.14646e-14;-606;1638;24247;19511;1;621;-2.14748e+09;-1.18579e+06;0;0;0;0;0;0;906108811;931902408;82449576
1954;1.13648e-14;-655;1680;24608;19398;1;688;-2.14748e+09;-1.18355e+06;-1;0;0;0;-1;0;906201091;932015404;82489009
1954;1.14646e-14;-607;1638;24247;19511;1;621;-2.14748e+09;-1.18355e+06;0;0;0;0;0;0;906201091;932015404;82489009
1955;1.13648e-14;-655;1680;24608;19398;1;688;-2.14748e+09;-1.18131e+06;-1;0;0;0;-1;0;906293192;932128197;82528380
1955;1.14646e-14;-607;1638;24247;19511;1;621;-2.14748e+09;-1.18131e+06;-1;0;0;0;-1;0;906293192;932128197;82528380
1956;1.13648e-14;-655;1680;24608;19398;1;688;-2.14748e+09;-1.17898e+06;-1;0;0;0;-1;0;906385115;932240786;82567688
1956;1.14646e-14;-607;1638;24247;19511;1;621;-2.14748e+09;-1.17898e+06;-1;0;0;0;-1;0;906385115;932240786;82567688
1957;1.13648e-14;-655;1680;24608;19398;1;688;-2.14748e+09;-1.17685e+06;-1;0;0;0;-1;0;906476860;932353173;82606934
1957;1.14646e-14;-607;1638;24247;19511;1;621;-2.14748e+09;-1.17685e+06;-1;0;0;0;-1;0;906476860;932353173;82606934
1958;1.13648e-14;-656;1680;24608;19398;1;688;-2.14748e+09;-1.17463e+06;0;0;0;0;0;0;906568428;932465357;82646117
1958;1.14646e-14;-607;1638;24247;19511;1;621;-2.14748e+09;-1.17463e+06;-1;0;0;0;-1;0;906568428;932465357;82646117
1959;1.13648e-14;-657;1680;24608;19398;1;688;-2.14748e+09;-1.17231e+06;0;0;0;0;0;0;906659818;932577338;82685239
1959;1.14646e-14;-607;1638;24247;19511;1;621;-2.14748e+09;-1.17231e+06;-1;0;0;0;-1;0;906659818;932577338;82685239
1960;1.13648e-14;-657;1680;24608;19398;1;688;-2.14748e+09;-1.1702e+06;-1;0;0;0;-1;0;906751031;932689118;82724298
1960;1.14646e-14;-607;1638;24247;19511;1;621;-2.14748e+09;-1.1702e+06;-1;0;0;0;-1;0;906751031;932689118;82724298
1961;1.13648e-14;-657;1680;24608;19398;1;688;-2.14748e+09;-1.16789e+06;-1;0;0;0;-1;0;906842067;932800697;82763295
1961;1.14646e-14;-608;1638;24247;19511;1;621;-2.14748e+09;-1.16789e+06;0;0;0;0;0;0;906842067;932800697;82763295
1962;1.13648e-14;-657;1680;24608;19398;1;688;-2.14748e+09;-1.16568e+06;-1;0;0;0;-1;0;906932927;932912074;82802230
1962;1.14646e-14;-609;1638;24247;19511;1;621;-2.14748e+09;-1.16568e+06;0;0;0;0;0;0;906932927;932912074;82802230
1963;1.13648e-14;-657;1680;24608;19398;1;688;-2.14748e+09;-1.16348e+06;-1;0;0;0;-1;0;907023612;933023251;82841104
1963;1.14646e-14;-610;1638;24247;19511;1;621;-2.14748e+09;-1.16348e+06;0;0;0;0;0;0;907023612;933023251;82841104
1964;1.13648e-14;-658;1680;24608;19398;1;688;-2.14748e+09;-1.16129e+06;0;0;0;0;0;0;907114121;933134227;82879915
1964;1.14646e-14;-611;1638;24247;19511;1;621;-2.14748e+09;-1.16129e+06;0;0;0;0;0;0;907114121;933134227;82879915
1965;1.13648e-14;-658;1680;24608;19398;1;688;-2.14748e+09;-1.1592e+06;-1;0;0;0;-1;0;907204455;933245004;82918665
1965;1.14646e-14;-612;1638;24247;19511;1;621;-2.14748e+09;-1.1592e+06;0;0;0;0;0;0;907204455;933245004;82918665
1966;1.13648e-14;-659;1680;24608;19398;1;688;-2.14748e+09;-1.15691e+06;0;0;0;0;0;0;907294614;933355581;82957353
1966;1.14646e-14;-613;1638;24247;19511;1;621;-2.14748e+09;-1.15691e+06;0;0;0;0;0;0;907294614;933355581;82957353
1967;1.13648e-14;-660;1680;24608;19398;1;688;-2.14748e+09;-1.15472e+06;0;0;0;0;0;0;907384598;933465958;82995980
1967;1.14646e-14;-613;1638;24247;19511;1;621;-2.14748e+09;-1.15472e+06;-1;0;0;0;-1;0;907384598;933465958;82995980
1968;1.13648e-14;-660;1680;24608;19398;1;688;-2.14748e+09;-1.15265e+06;-1;0;0;0;-1;0;907474409;933576137;83034545
1968;1.14646e-14;-614;1638;24247;19511;1;621;-2.14748e+09;-1.15265e+06;0;0;0;0;0;0;907474409;933576137;83034545
1969;1.13648e-14;-660;1680;24608;19398;1;688;-2.14748e+09;-1.15037e+06;-1;0;0;0;-1;0;907564046;933686117;83073048
1969;1.14646e-14;-615;1638;24247;19511;1;621;-2.14748e+09;-1.15037e+06;0;0;0;0;0;0;907564046;933686117;83073048
1970;1.13648e-14;-661;1680;24608;19398;1;688;-2.14748e+09;-1.1482e+06;0;0;0;0;0;0;907653509;933795899;83111491
1970;1.14646e-14;-616;1638;24247;19511;1;621;-2.14748e+09;-1.1482e+06;0;0;0;0;0;0;907653509;933795899;83111491
1971;1.13648e-14;-662;1680;24608;19398;1;688;-2.14748e+09;-1.14604e+06;0;0;0;0;0;0;907742800;933905484;83149872
1971;1.14646e-14;-616;1638;24247;19511;1;621;-2.14748e+09;-1.14604e+06;-1;0;0;0;-1;0;907742800;933905484;83149872
1972;1.13648e-14;-663;1680;24608;19398;1;688;-2.14748e+09;-1.14387e+06;0;0;0;0;0;0;907831918;934014871;83188192
1972;1.14646e-14;-617;1638;24247;19511;1;621;-2.14748e+09;-1.14387e+06;0;0;0;0;0;0;907831918;934014871;83188192
1973;1.13648e-14;-663;1680;24608;19398;1;688;-2.14748e+09;-1.14172e+06;-1;0;0;0;-1;0;907920863;934124060;83226451
1973;1.14646e-14;-618;1638;24247;19511;1;621;-2.14748e+09;-1.14172e+06;0;0;0;0;0;0;907920863;934124060;83226451
1974;1.13648e-14;-664;1680;24608;19398;1;688;-2.14748e+09;-1.13956e+06;0;0;0;0;0;0;908009637;934233053;83264649
1974;1.14646e-14;-618;1638;24247;19511;1;621;-2.14748e+09;-1.13956e+06;-1;0;0;0;-1;0;908009637;934233053;83264649
1975;1.13648e-14;-664;1680;24608;19398;1;688;-2.14748e+09;-1.13741e+06;-1;0;0;0;-1;0;908098239;934341850;83302786
1975;1.14646e-14;-619;1638;24247;19511;1;621;-2.14748e+09;-1.13741e+06;0;0;0;0;0;0;908098239;934341850;83302786
1976;1.13648e-14;-664;1680;24608;19398;1;688;-2.14748e+09;-1.13527e+06;-1;0;0;0;-1;0;908186670;934450451;83340862
1976;1.14646e-14;-619;1638;24247;19511;1;621;-2.14748e+09;-1.13527e+06;-1;0;0;0;-1;0;908186670;934450451;83340862
1977;1.13648e-14;-665;1680;24608;19398;1;688;-2.14748e+09;-1.13313e+06;0;0;0;0;0;0;908274930;934558856;83378878
1977;1.14646e-14;-620;1638;24247;19511;1;621;-2.14748e+09;-1.13313e+06;0;0;0;0;0;0;908274930;934558856;83378878
1978;1.13648e-14;-666;1680;24608;19398;1;688;-2.14748e+09;-1.13099e+06;0;0;0;0;0;0;908363020;934667066;83416833
1978;1.14646e-14;-621;1638;24247;19511;1;621;-2.14748e+09;-1.13099e+06;0;0;0;0;0;0;908363020;934667066;83416833
1979;1.13648e-14;-667;1680;24608;19398;1;688;-2.14748e+09;-1.12886e+06;0;0;0;0;0;0;908450939;934775081;83454727
1979;1.14646e-14;-621;1638;24247;19511;1;621;-2.14748e+09;-1.12886e+06;-1;0;0;0;-1;0;908450939;934775081;83454727
1980;1.13648e-14;-667;1680;24608;19398;1;688;-2.14748e+09;-1.12673e+06;-1;0;0;0;-1;0;908538689;934882902;83492561
1980;1.14646e-14;-622;1638;24247;19511;1;621;-2.14748e+09;-1.12673e+06;0;0;0;0;0;0;908538689;934882902;83492561
1981;1.13648e-14;-668;1680;24608;19398;1;688;-2.14748e+09;-1.12471e+06;0;0;0;0;0;0;908626269;934990528;83530334
1981;1.14646e-14;-622;1638;24247;19511;1;621;-2.14748e+09;-1.12471e+06;-1;0;0;0;-1;0;908626269;934990528;83530334
1982;1.13648e-14;-668;1680;24608;19398;1;688;-2.14748e+09;-1.12249e+06;-1;0;0;0;-1;0;908713680;935097960;83568047
1982;1.14646e-14;-623;1638;24247;19511;1;621;-2.14748e+09;-1.12249e+06;0;0;0;0;0;0;908713680;935097960;83568047
1983;1.13648e-14;-669;1680;24608;19398;1;688;-2.14748e+09;-1.12037e+06;0;0;0;0;0;0;908800922;935205199;83605699
1983;1.14646e-14;-623;1638;24247;19511;1;621;-2.14748e+09;-1.12037e+06;-1;0;0;0;-1;0;908800922;935205199;83605699
1984;1.13648e-14;-669;1680;24608;19398;1;688;-2.14748e+09;-1.11826e+06;-1;0;0;0;-1;0;908887996;935312245;83643292
1984;1.14646e-14;-624;1638;24247;19511;1;621;-2.14748e+09;-1.11826e+06;0;0;0;0;0;0;908887996;935312245;83643292
1985;1.13648e-14;-670;1680;24608;19398;1;688;-2.14748e+09;-1.11616e+06;0;0;0;0;0;0;908974902;935419098;83680824
1985;1.14646e-14;-624;1638;24247;19511;1;621;-2.14748e+09;-1.11616e+06;-1;0;0;0;-1;0;908974902;935419098;83680824
1986;1.13648e-14;-671;1680;24608;19398;1;688;-2.14748e+09;-1.11405e+06;0;0;0;0;0;0;909061640;935525759;83718297
1986;1.14646e-14;-624;1638;24247;19511;1;621;-2.14748e+09;-1.11405e+06;-1;0;0;0;-1;0;909061640;935525759;83718297
1987;1.13648e-14;-672;1680;24608;19398;1;688;-2.14748e+09;-1.11196e+06;0;0;0;0;0;0;909148211;935632227;83755709
1987;1.14646e-14;-625;1638;24247;19511;1;621;-2.14748e+09;-1.11196e+06;0;0;0;0;0;0;909148211;935632227;83755709
1988;1.13648e-14;-672;1680;24608;19398;1;688;-2.14748e+09;-1.10986e+06;-1;0;0;0;-1;0;909234614;935738504;83793061
1988;1.14646e-14;-626;1638;24247;19511;1;621;-2.14748e+09;-1.10986e+06;0;0;0;0;0;0;909234614;935738504;83793061
1989;1.13648e-14;-673;1680;24608;19398;1;688;-2.14748e+09;-1.10777e+06;0;0;0;0;0;0;909320851;935844590;83830354
1989;1.14646e-14;-627;1638;24247;19511;1;621;-2.14748e+09;-1.10777e+06;0;0;0;0;0;0;909320851;935844590;83830354
1990;1.13648e-14;-674;1680;24608;19398;1;688;-2.14748e+09;-1.10568e+06;0;0;0;0;0;0;909406922;935950484;83867587
1990;1.14646e-14;-627;1638;24247;19511;1;621;-2.14748e+09;-1.10568e+06;-1;0;0;0;-1;0;909406922;935950484;83867587
1991;1.13648e-14;-675;1680;24608;19398;1;688;-2.14748e+09;-1.1037e+06;0;0;0;0;0;0;909492826;936056188;83904761
1991;1.14646e-14;-628;1638;24247;19511;1;621;-2.14748e+09;-1.1037e+06;0;0;0;0;0;0;909492826;936056188;83904761
1992;1.13648e-14;-675;1680;24608;19398;1;688;-2.14748e+09;-1.10162e+06;-1;0;0;0;-1;0;909578565;936161701;83941874
1992;1.14646e-14;-628;1638;24247;19511;1;621;-2.14748e+09;-1.10162e+06;-1;0;0;0;-1;0;909578565;936161701;83941874
1993;1.13648e-14;-676;1680;24608;19398;1;688;-2.14748e+09;-1.09945e+06;0;0;0;0;0;0;909664138;936267025;83978929
1993;1.14646e-14;-628;1638;24247;19511;1;621;-2.14748e+09;-1.09945e+06;-1;0;0;0;-1;0;909664138;936267025;83978929
1994;1.13648e-14;-677;1680;24608;19398;1;688;-2.14748e+09;-1.09738e+06;0;0;0;0;0;0;909749546;936372159;84015924
1994;1.14646e-14;-628;1638;24247;19511;1;621;-2.14748e+09;-1.09738e+06;-1;0;0;0;-1;0;909749546;936372159;84015924
1995;1.13648e-14;-677;1680;24608;19398;1;688;-2.14748e+09;-1.09532e+06;-1;0;0;0;-1;0;909834790;936477103;84052859
1995;1.14646e-14;-629;1638;24247;19511;1;621;-2.14748e+09;-1.09532e+06;0;0;0;0;0;0;909834790;936477103;84052859
1996;1.13648e-14;-677;1680;24608;19398;1;688;-2.14748e+09;-1.09325e+06;-1;0;0;0;-1;0;909919870;936581859;84089736
1996;1.14646e-14;-629;1638;24247;19511;1;621;-2.14748e+09;-1.09325e+06;-1;0;0;0;-1;0;909919870;936581859;84089736
1997;1.13648e-14;-678;1680;24608;19398;1;688;-2.14748e+09;-1.0912e+06;0;0;0;0;0;0;910004785;936686426;84126553
1997;1.14646e-14;-629;1638;24247;19511;1;621;-2.14748e+09;-1.0912e+06;-1;0;0;0;-1;0;910004785;936686426;84126553
1998;1.13648e-14;-679;1680;24608;19398;1;688;-2.14748e+09;-1.08914e+06;0;0;0;0;0;0;910089537;936790805;84163311
1998;1.14646e-14;-630;1638;24247;19511;1;621;-2.14748e+09;-1.08914e+06;0;0;0;0;0;0;910089537;936790805;84163311
1999;1.13648e-14;-680;1680;24608;19398;1;688;-2.14748e+09;-1.08719e+06;0;0;0;0;0;0;910174125;936894995;84200011
1999;1.14646e-14;-631;1638;24247;19511;1;621;-2.14748e+09;-1.08719e+06;0;0;0;0;0;0;910174125;936894995;84200011
