step;volume;A_0;B_0;C;L;p;Compl;Aext;Bext;A_ingresso;A_uscita;B_ingresso;B_uscita;A_netto;B_netto;Avicino;Amedio;Alontano
407;4.18816e-15;71;557;13039;10030;1;2;605;3501;483;134;487;116;349;371;97;91;3
407;4.18816e-15;71;557;13039;10030;1;1;587;3501;503;153;512;144;350;368;97;91;3
408;4.20775e-15;162;1271;12950;10115;1;98;574;3502;290;62;1750;511;228;1239;97;91;3
408;4.20775e-15;132;1265;12949;10102;1;102;542;3502;298;65;1745;479;233;1266;97;88;3
409;4.26162e-15;171;1633;12888;10205;1;182;549;3502;270;88;1731;701;182;1030;97;88;3
409;4.25336e-15;142;1533;12890;10186;1;187;540;3502;251;77;1741;759;174;982;97;88;3
410;4.31891e-15;165;1688;12850;10282;1;262;521;3502;319;67;1833;860;252;973;96;89;3
410;4.30679e-15;151;1645;12864;10262;1;255;510;3502;280;69;1742;804;211;938;96;89;3
411;4.36812e-15;150;1650;12846;10353;1;315;519;3503;241;76;1683;823;165;860;95;88;3
411;4.35532e-15;131;1755;12851;10329;1;319;498;3503;272;66;1767;840;206;927;95;88;3
412;4.41367e-15;150;1659;12843;10431;1;371;519;3503;269;78;1705;849;191;856;95;88;3
412;4.39761e-15;134;1696;12901;10390;1;345;487;3503;285;76;1757;836;209;921;95;88;3
413;4.46389e-15;167;1651;12899;10499;1;389;510;3504;271;70;1808;829;201;979;94;89;3
413;4.43747e-15;129;1716;12943;10454;1;376;482;3504;252;74;1777;838;178;939;94;87;3
414;4.50783e-15;130;1675;12940;10578;1;423;506;3504;263;88;1714;828;175;886;94;88;3
414;4.47874e-15;140;1708;12991;10535;1;398;475;3504;270;79;1804;818;191;986;94;88;3
415;4.55905e-15;147;1708;13013;10634;1;430;490;3505;250;74;1769;841;176;928;94;88;3
415;4.53115e-15;131;1658;13069;10612;1;407;480;3505;254;62;1780;853;192;927;94;88;3
416;4.59483e-15;139;1696;13091;10709;1;449;504;3505;233;72;1801;800;161;1001;94;88;3
416;4.58116e-15;124;1700;13119;10683;1;430;488;3505;217;64;1713;813;153;900;94;88;3
417;4.64442e-15;171;1660;13176;10771;1;450;512;3505;263;66;1741;848;197;893;94;87;3
417;4.62743e-15;121;1616;13175;10772;1;449;503;3505;242;68;1765;841;174;924;94;87;3
418;4.68501e-15;158;1669;13233;10844;1;477;508;3506;248;78;1674;784;170;890;94;87;3
418;4.68566e-15;161;1639;13245;10844;1;459;489;3506;253;88;1828;791;165;1037;94;87;3
419;4.73295e-15;153;1685;13308;10919;1;494;506;3506;278;79;1757;844;199;913;94;87;3
419;4.73295e-15;150;1638;13304;10912;1;475;498;3506;238;76;1749;829;162;920;94;87;3
420;4.78237e-15;149;1706;13370;10973;1;520;509;3507;273;66;1778;894;207;884;93;87;3
420;4.77775e-15;139;1702;13382;10973;1;488;491;3507;256;82;1723;806;174;917;93;87;3
421;4.81806e-15;152;1659;13466;11045;1;518;496;3507;254;81;1767;832;173;935;94;87;3
421;4.81806e-15;138;1712;13457;11037;1;506;479;3507;264;80;1711;846;184;865;94;87;3
422;4.86579e-15;150;1701;13548;11121;1;533;491;3507;240;74;1775;803;166;972;93;87;3
422;4.86048e-15;115;1652;13549;11132;1;507;474;3507;243;62;1772;825;181;947;93;87;3
423;4.91634e-15;135;1696;13634;11196;1;545;501;3508;241;78;1783;846;163;937;93;87;3
423;4.92367e-15;127;1621;13657;11200;1;488;474;3508;236;63;1846;868;173;978;93;87;3
424;4.96639e-15;172;1735;13692;11264;1;569;499;3508;254;66;1768;836;188;932;92;85;3
424;4.96907e-15;151;1640;13749;11265;1;485;492;3508;208;56;1766;804;152;962;92;85;3
425;5.01192e-15;165;1700;13807;11319;1;562;494;3509;250;74;1709;841;176;868;92;85;3
425;5.01259e-15;148;1660;13809;11332;1;507;469;3509;263;74;1757;839;189;918;92;85;3
426;5.04885e-15;145;1707;13915;11398;1;553;471;3509;240;78;1734;847;162;887;91;85;3
426;5.05759e-15;131;1642;13879;11402;1;515;463;3509;238;76;1703;877;162;826;91;85;3
427;5.10205e-15;149;1736;14021;11490;1;547;481;3509;230;77;1723;833;153;890;91;85;3
427;5.10475e-15;152;1698;13917;11475;1;544;471;3509;248;64;1722;803;184;919;91;85;3
428;5.16424e-15;152;1627;14094;11549;1;560;493;3510;219;77;1753;902;142;851;91;84;3
428;5.15408e-15;162;1625;13999;11545;1;556;477;3510;239;67;1759;881;172;878;91;84;3
429;5.20425e-15;151;1687;14176;11623;1;570;502;3510;273;81;1693;842;192;851;90;84;3
429;5.20153e-15;146;1693;14069;11616;1;567;484;3510;229;78;1769;821;151;948;90;84;3
430;5.25458e-15;182;1660;14277;11692;1;570;490;3511;267;66;1753;872;201;881;90;84;3
430;5.24982e-15;150;1594;14136;11682;1;584;475;3511;221;71;1704;858;150;846;90;84;3
431;5.30166e-15;144;1645;14377;11754;1;573;492;3511;254;89;1820;791;165;1029;91;84;3
431;5.29483e-15;143;1575;14241;11741;1;575;474;3511;263;65;1710;763;198;947;91;84;3
432;5.34408e-15;136;1659;14475;11812;1;569;490;3511;260;76;1788;834;184;954;91;83;3
432;5.33518e-15;137;1631;14316;11799;1;584;482;3511;250;78;1723;823;172;900;91;83;3
433;5.38387e-15;170;1702;14556;11882;1;573;492;3512;254;49;1719;810;205;909;91;84;3
433;5.37495e-15;128;1685;14413;11864;1;579;473;3512;263;65;1740;812;198;928;91;84;3
434;5.43202e-15;149;1598;14649;11938;1;578;472;3512;242;80;1794;886;162;908;91;82;3
434;5.41963e-15;150;1679;14491;11922;1;581;464;3512;249;80;1700;809;169;891;91;82;3
435;5.47065e-15;160;1647;14753;12005;1;575;488;3513;241;51;1816;811;190;1005;90;83;4
435;5.4596e-15;137;1639;14578;11988;1;583;472;3513;228;76;1694;835;152;859;90;83;4
436;5.51698e-15;126;1620;14843;12073;1;578;511;3513;220;87;1813;870;133;943;89;82;4
436;5.50521e-15;146;1635;14658;12061;1;594;496;3513;224;71;1816;829;153;987;89;82;4
437;5.56413e-15;125;1604;14912;12131;1;594;493;3513;234;74;1809;901;160;908;89;81;4
437;5.5558e-15;132;1701;14756;12123;1;591;473;3513;258;62;1741;802;196;939;89;81;4
438;5.60446e-15;149;1570;14969;12209;1;622;487;3514;289;64;1800;811;225;989;90;82;4
438;5.59889e-15;128;1712;14833;12192;1;603;469;3514;241;66;1817;837;175;980;90;82;4
439;5.65885e-15;159;1582;15014;12274;1;646;494;3514;279;71;1823;810;208;1013;89;82;4
439;5.64698e-15;168;1680;14955;12270;1;588;478;3514;235;69;1798;849;166;949;89;82;4
440;5.70431e-15;152;1650;15108;12348;1;650;483;3514;261;77;1757;837;184;920;90;82;4
440;5.7015e-15;143;1686;15032;12340;1;597;473;3514;275;89;1777;800;186;977;90;82;4
441;5.7562e-15;143;1616;15201;12403;1;657;481;3515;248;62;1799;838;186;961;90;83;4
441;5.75059e-15;163;1710;15120;12408;1;601;462;3515;246;67;1743;825;179;918;90;83;4
442;5.79488e-15;149;1660;15280;12480;1;671;485;3515;249;68;1631;784;181;847;90;82;4
442;5.7984e-15;177;1694;15202;12480;1;609;477;3515;240;82;1802;847;158;955;90;82;4
443;5.84917e-15;153;1625;15376;12542;1;669;479;3516;274;64;1725;822;210;903;90;83;4
443;5.84917e-15;149;1702;15232;12545;1;647;461;3516;242;67;1740;873;175;867;90;83;4
444;5.89301e-15;159;1606;15478;12609;1;669;488;3516;232;74;1782;854;158;928;89;83;4
444;5.89513e-15;147;1699;15325;12614;1;647;479;3516;252;76;1712;823;176;889;89;83;4
445;5.9405e-15;153;1644;15529;12671;1;704;465;3516;249;81;1861;831;168;1030;89;82;4
445;5.94405e-15;155;1702;15392;12684;1;666;459;3516;196;63;1744;824;133;920;89;82;4
446;5.98457e-15;151;1621;15612;12745;1;712;487;3517;223;72;1666;850;151;816;89;82;4
446;5.99382e-15;136;1702;15502;12762;1;659;480;3517;219;71;1734;811;148;923;89;82;4
447;6.03731e-15;155;1643;15677;12824;1;729;493;3517;240;76;1694;801;164;893;88;82;4
447;6.04944e-15;141;1660;15604;12819;1;652;484;3517;242;61;1793;875;181;918;88;82;4
448;6.09378e-15;145;1692;15771;12901;1;737;495;3517;245;81;1706;813;164;893;89;81;4
448;6.0902e-15;127;1703;15638;12883;1;687;479;3517;242;74;1748;834;168;914;89;81;4
449;6.14899e-15;154;1763;15876;12964;1;727;475;3518;240;74;1753;832;166;921;88;81;4
449;6.13606e-15;123;1649;15761;12935;1;668;466;3518;248;69;1763;839;179;924;88;81;4
450;6.19428e-15;130;1788;15984;13036;1;725;494;3518;237;68;1739;898;169;841;87;82;4
450;6.17342e-15;146;1641;15852;12998;1;665;466;3518;246;70;1816;839;176;977;87;80;4
451;6.24618e-15;164;1815;16113;13113;1;701;494;3519;230;61;1755;863;169;892;87;79;4
451;6.21877e-15;149;1642;15907;13050;1;682;485;3519;240;65;1687;804;175;883;87;79;4
452;6.30185e-15;139;1640;16196;13176;1;716;495;3519;246;70;1713;899;176;814;86;80;4
452;6.25629e-15;137;1661;15989;13108;1;695;478;3519;243;65;1760;802;178;958;86;80;4
453;6.34752e-15;146;1629;16302;13251;1;708;506;3519;283;81;1802;860;202;942;85;79;4
453;6.29823e-15;147;1727;16052;13162;1;711;490;3519;217;76;1787;841;141;946;85;79;4
454;6.40203e-15;161;1628;16389;13314;1;714;484;3520;226;71;1822;827;155;995;85;79;4
454;6.33736e-15;149;1675;16154;13227;1;705;477;3520;215;77;1727;878;138;849;85;79;4
455;6.44794e-15;140;1617;16487;13377;1;708;514;3520;243;83;1819;815;160;1004;85;80;4
455;6.38457e-15;139;1695;16240;13289;1;709;507;3520;226;77;1792;847;149;945;85;79;4
456;6.49396e-15;168;1634;16543;13444;1;730;534;3520;248;72;1797;775;176;1022;85;79;4
456;6.42971e-15;159;1694;16316;13352;1;714;515;3520;277;72;1704;856;205;848;85;79;4
457;6.54302e-15;161;1653;16657;13524;1;720;523;3521;265;75;1716;803;190;913;86;79;4
457;6.47568e-15;167;1669;16444;13418;1;701;514;3521;253;72;1735;832;181;903;86;79;4
458;6.60176e-15;165;1733;16734;13589;1;742;499;3521;305;82;1824;831;223;993;86;79;4
458;6.52397e-15;171;1662;16540;13483;1;702;492;3521;253;102;1730;795;151;935;86;79;4
459;6.64962e-15;157;1693;16815;13652;1;746;508;3521;273;66;1760;880;207;880;84;79;4
459;6.57164e-15;168;1626;16599;13561;1;723;490;3521;258;87;1789;834;171;955;84;79;4
460;6.69612e-15;148;1645;16914;13729;1;747;515;3522;239;69;1796;806;170;990;83;79;4
460;6.62899e-15;176;1613;16677;13638;1;731;498;3522;246;72;1747;816;174;931;83;79;4
461;6.75309e-15;150;1643;17028;13797;1;732;503;3522;261;83;1762;820;178;942;83;79;4
461;6.68577e-15;163;1611;16770;13699;1;726;485;3522;247;75;1751;807;172;944;83;79;4
462;6.80354e-15;142;1636;17127;13865;1;731;481;3523;260;82;1799;836;178;963;83;79;4
462;6.73087e-15;154;1675;16851;13763;1;732;473;3523;229;74;1798;823;155;975;83;79;4
463;6.85411e-15;159;1707;17200;13935;1;734;510;3523;238;88;1775;829;150;946;83;79;4
463;6.7783e-15;138;1610;16946;13828;1;728;503;3523;215;77;1799;822;138;977;83;79;4
464;6.90631e-15;167;1660;17310;13993;1;727;490;3523;220;80;1745;829;140;916;82;79;4
464;6.82658e-15;159;1612;17022;13884;1;734;481;3523;254;74;1763;792;180;971;82;79;4
465;6.94965e-15;169;1695;17388;14055;1;731;511;3524;269;74;1749;802;195;947;82;80;4
465;6.86827e-15;159;1633;17089;13942;1;743;473;3524;251;69;1807;845;182;962;82;79;4
466;6.99609e-15;150;1700;17484;14114;1;728;490;3524;244;79;1710;858;165;852;82;78;4
466;6.91153e-15;130;1717;17165;14000;1;758;482;3524;244;80;1776;792;164;984;82;78;4
467;7.04037e-15;160;1655;17529;14178;1;747;494;3524;262;81;1822;831;181;991;81;78;4
467;6.95489e-15;147;1791;17264;14059;1;752;476;3524;254;59;1707;835;195;872;81;78;4
468;7.08852e-15;152;1656;17616;14239;1;755;478;3525;246;80;1794;811;166;983;81;78;4
468;6.99909e-15;132;1709;17392;14132;1;732;470;3525;222;67;1782;879;155;903;81;78;4
469;7.13451e-15;139;1671;17705;14296;1;759;499;3525;223;78;1700;829;145;871;82;77;4
469;7.0539e-15;148;1662;17517;14186;1;708;483;3525;233;63;1783;879;170;904;82;77;4
470;7.17757e-15;138;1622;17798;14364;1;758;495;3525;264;58;1697;829;206;868;82;77;4
470;7.09454e-15;149;1654;17569;14253;1;735;479;3525;226;74;1779;875;152;904;82;77;4
471;7.2283e-15;160;1648;17900;14438;1;750;490;3526;250;70;1811;790;180;1021;82;78;4
471;7.14508e-15;148;1627;17648;14304;1;743;472;3526;263;68;1775;866;195;909;82;78;4
472;7.28523e-15;161;1647;17966;14501;1;766;486;3526;250;69;1748;802;181;946;81;77;4
472;7.18362e-15;156;1686;17749;14352;1;735;478;3526;222;72;1756;830;150;926;81;77;4
473;7.33316e-15;146;1647;18080;14572;1;761;473;3526;245;71;1785;852;174;933;81;78;4
473;7.21996e-15;142;1673;17862;14409;1;716;466;3526;240;87;1774;831;153;943;81;78;4
474;7.38731e-15;126;1687;18188;14629;1;746;496;3527;269;79;1731;857;190;874;82;77;4
474;7.2632e-15;158;1662;17931;14477;1;722;471;3527;205;61;1788;841;144;947;82;77;4
475;7.43088e-15;148;1694;18269;14702;1;747;503;3527;261;75;1715;844;186;871;81;78;4
475;7.31489e-15;158;1646;18010;14532;1;733;476;3527;240;57;1766;858;183;908;81;78;4
476;7.4868e-15;165;1727;18368;14767;1;745;488;3527;269;72;1733;833;197;900;81;78;4
476;7.35679e-15;129;1646;18102;14582;1;737;471;3527;218;75;1806;857;143;949;81;77;4
477;7.53671e-15;166;1705;18450;14814;1;752;495;3528;244;75;1705;830;169;875;81;77;4
477;7.39495e-15;129;1729;18156;14650;1;755;477;3528;257;70;1784;838;187;946;81;77;4
478;7.57287e-15;172;1680;18523;14882;1;762;489;3528;230;86;1862;848;144;1014;81;77;4
478;7.44695e-15;146;1703;18227;14703;1;767;463;3528;228;61;1746;917;167;829;81;77;4
479;7.62528e-15;152;1651;18552;14947;1;804;473;3528;254;103;1791;815;151;976;81;76;4
479;7.48756e-15;163;1667;18300;14770;1;778;464;3528;248;67;1785;855;181;930;81;76;4
480;7.6755e-15;128;1744;18618;15007;1;814;470;3529;263;83;1742;864;180;878;81;76;4
480;7.53901e-15;168;1725;18419;14832;1;762;453;3529;237;86;1765;857;151;908;81;76;4
481;7.72195e-15;130;1741;18762;15062;1;784;460;3529;225;71;1743;809;154;934;81;76;4
481;7.58673e-15;138;1735;18459;14892;1;792;434;3529;248;90;1734;856;158;878;81;76;4
482;7.76462e-15;133;1700;18855;15127;1;777;460;3529;224;76;1781;826;148;955;80;77;4
482;7.633e-15;127;1704;18547;14952;1;798;437;3529;228;83;1712;878;145;834;80;76;4
483;7.81514e-15;172;1720;18927;15206;1;786;471;3530;236;59;1667;822;177;845;80;76;4
483;7.67937e-15;130;1719;18644;15012;1;790;447;3530;222;70;1734;844;152;890;80;76;4
484;7.87669e-15;156;1659;18992;15270;1;804;478;3530;255;89;1713;829;166;884;80;76;5
484;7.72583e-15;134;1682;18734;15067;1;787;462;3530;240;72;1792;833;168;959;80;76;5
485;7.92667e-15;154;1702;19061;15328;1;819;411;3430;228;73;1839;838;155;1001;81;76;5
485;7.7685e-15;153;1668;18854;15129;1;764;389;3430;221;73;1784;824;148;960;81;76;5
486;7.97206e-15;136;1684;19159;15378;1;813;451;3531;173;57;1709;802;116;907;79;75;5
486;7.81669e-15;121;1708;18884;15195;1;800;444;3531;219;66;1760;860;153;900;79;75;5
487;8.01126e-15;150;1707;19244;15439;1;810;400;3431;223;53;1766;852;170;914;80;75;5
487;7.86811e-15;142;1710;18931;15258;1;813;377;3431;203;73;1758;802;130;956;80;75;5
488;8.05916e-15;138;1603;19334;15491;1;805;494;3531;213;61;1760;891;152;869;80;75;5
488;7.91729e-15;159;1657;19022;15321;1;795;474;3531;216;75;1704;874;141;830;80;75;5
489;8.10008e-15;146;1637;19398;15554;1;818;402;3432;228;81;1740;814;147;926;81;74;5
489;7.96658e-15;153;1707;19118;15389;1;791;370;3432;247;69;1741;822;178;919;81;74;5
490;8.14974e-15;134;1645;19470;15620;1;825;498;3532;205;66;1753;826;139;927;79;74;5
490;8.01989e-15;130;1649;19207;15446;1;788;475;3532;189;73;1698;820;116;878;79;74;5
491;8.20188e-15;145;1611;19551;15673;1;826;489;3532;262;63;1788;834;199;954;79;74;5
491;8.06467e-15;151;1704;19280;15503;1;797;464;3532;247;83;1698;795;164;903;79;74;5
492;8.24383e-15;142;1683;19619;15724;1;841;479;3533;262;58;1777;784;204;993;78;74;5
492;8.10953e-15;160;1691;19379;15575;1;787;426;3533;221;74;1745;864;147;881;78;74;5
493;8.28426e-15;143;1594;19680;15794;1;855;486;3533;247;71;1799;812;176;987;78;73;5
493;8.16632e-15;140;1677;19446;15642;1;800;455;3533;200;49;1776;861;151;915;78;73;5
494;8.33986e-15;154;1696;19755;15842;1;860;488;3533;231;87;1868;819;144;1049;78;73;5
494;8.21928e-15;154;1716;19508;15696;1;811;461;3533;243;61;1767;843;182;924;78;73;5
495;8.37806e-15;132;1717;19862;15887;1;851;477;3534;236;87;1795;819;149;976;78;73;5
495;8.26205e-15;169;1702;19584;15757;1;818;451;3534;238;82;1737;864;156;873;78;73;5
496;8.41392e-15;136;1770;19925;15944;1;864;473;3534;222;76;1813;850;146;963;78;73;5
496;8.31045e-15;154;1680;19657;15826;1;831;450;3534;233;81;1678;851;152;827;78;73;5
497;8.45943e-15;157;1699;20004;16003;1;875;482;3534;231;65;1783;831;166;952;78;72;5
497;8.36532e-15;132;1738;19744;15876;1;818;434;3534;248;91;1751;787;157;964;78;72;5
498;8.50661e-15;151;1738;20108;16065;1;866;478;3535;266;79;1717;870;187;847;77;72;5
498;8.40515e-15;131;1674;19854;15953;1;795;430;3535;200;60;1681;910;140;771;77;72;5
499;8.55629e-15;148;1602;20196;16116;1;863;461;3535;235;73;1688;889;162;799;77;72;5
499;8.46662e-15;136;1653;19931;16007;1;791;436;3535;234;71;1768;831;163;937;77;72;5
500;8.59723e-15;153;1652;20258;16177;1;877;479;3535;205;71;1738;804;134;934;77;73;5
500;8.50981e-15;139;1694;19986;16058;1;805;471;3535;233;71;1781;851;162;930;77;72;5
501;8.64628e-15;147;1628;20366;16229;1;861;474;3536;231;70;1795;863;161;932;76;73;5
501;8.55068e-15;126;1751;20058;16120;1;815;449;3536;236;79;1740;808;157;932;76;73;5
502;8.68817e-15;147;1589;20430;16295;1;878;378;3436;240;79;1745;826;161;919;77;72;5
502;8.59964e-15;130;1669;20158;16177;1;806;347;3436;206;56;1844;863;150;981;77;72;5
503;8.74143e-15;110;1580;20516;16351;1;874;381;3436;184;76;1662;824;108;838;77;72;5
503;8.64628e-15;132;1614;20267;16231;1;783;362;3436;170;53;1711;814;117;897;77;72;5
504;8.78671e-15;134;1608;20597;16412;1;872;485;3537;193;58;1709;826;135;883;75;72;5
504;8.68978e-15;124;1636;20337;16295;1;788;471;3537;155;59;1742;851;96;891;75;72;5
505;8.83612e-15;152;1643;20672;16464;1;881;384;3437;261;85;1696;849;176;847;76;72;5
505;8.74143e-15;138;1718;20398;16357;1;809;361;3437;239;76;1688;833;163;855;76;72;5
506;8.87831e-15;133;1621;20745;16519;1;889;490;3537;179;63;1752;816;116;936;74;73;5
506;8.79156e-15;125;1675;20506;16414;1;789;478;3537;188;61;1758;791;127;967;74;73;5
507;8.92301e-15;172;1583;20844;16581;1;872;401;3437;260;79;1752;827;181;925;75;71;5
507;8.83774e-15;126;1617;20552;16466;1;814;376;3437;230;66;1744;823;164;921;75;71;5
508;8.97349e-15;138;1630;20905;16641;1;883;496;3538;203;72;1806;797;131;1009;75;72;5
508;8.87993e-15;122;1608;20629;16528;1;806;474;3538;194;47;1664;820;147;844;75;72;5
509;9.02243e-15;153;1621;21007;16686;1;876;428;3538;256;68;1749;835;188;914;74;71;5
509;8.93033e-15;166;1593;20698;16575;1;809;412;3538;215;66;1769;814;149;955;74;71;5
510;9.05919e-15;126;1677;21112;16748;1;862;414;3538;233;83;1791;799;150;992;74;71;5
510;8.9686e-15;142;1697;20754;16639;1;821;401;3538;200;76;1686;810;124;876;74;71;5
511;9.10993e-15;140;1658;21208;16803;1;849;383;3539;214;61;1704;859;153;845;73;71;5
511;9.02079e-15;123;1719;20836;16706;1;823;376;3539;201;68;1719;835;133;884;73;71;5
512;9.15501e-15;134;1681;21286;16851;1;845;408;3539;186;66;1786;855;120;931;72;71;5
512;9.07555e-15;132;1658;20914;16759;1;824;388;3539;191;78;1774;878;113;896;72;71;5
513;9.19442e-15;129;1657;21380;16908;1;825;413;3539;218;66;1827;911;152;916;72;70;5
513;9.11894e-15;141;1658;20965;16802;1;840;393;3539;181;65;1780;856;116;924;72;70;5
514;9.24129e-15;125;1729;21459;16965;1;828;384;3540;200;65;1756;810;135;946;72;70;5
514;9.15419e-15;116;1682;21050;16862;1;840;336;3540;186;71;1778;838;115;940;72;70;5
515;9.28824e-15;101;1709;21506;17024;1;847;346;3540;185;54;1815;888;131;927;72;69;5
515;9.20346e-15;119;1689;21159;16917;1;814;336;3540;152;67;1839;810;85;1029;72;69;5
516;9.33692e-15;115;1663;21593;17078;1;831;352;3540;195;49;1758;829;146;929;72;70;5
516;9.2487e-15;115;1731;21248;16972;1;806;335;3540;161;61;1774;833;100;941;72;70;5
517;9.38155e-15;120;1702;21691;17130;1;813;367;3541;163;56;1826;843;107;983;73;70;5
517;9.29401e-15;110;1722;21332;17023;1;793;349;3541;172;53;1769;857;119;912;73;70;5
518;9.4246e-15;104;1684;21749;17198;1;824;343;3541;186;49;1794;838;137;956;72;70;5
518;9.3361e-15;108;1792;21436;17100;1;780;324;3541;202;43;1752;852;159;900;72;70;5
519;9.48099e-15;130;1743;21836;17263;1;800;364;3541;188;53;1725;831;135;894;71;70;5
519;9.39976e-15;103;1742;21509;17157;1;776;322;3541;150;47;1794;922;103;872;71;70;5
520;9.53499e-15;138;1811;21907;17315;1;800;347;3541;156;59;1722;849;97;873;72;69;5
520;9.44698e-15;96;1650;21572;17212;1;771;330;3541;140;50;1861;879;90;982;72;69;5
521;9.57827e-15;96;1735;21968;17363;1;813;343;3542;153;50;1772;907;103;865;71;69;5
521;9.49261e-15;102;1679;21640;17258;1;767;312;3542;167;58;1721;855;109;866;71;69;5
522;9.61828e-15;122;1734;22035;17410;1;814;333;3542;172;53;1712;863;119;849;71;68;5
522;9.53084e-15;103;1707;21714;17300;1;761;321;3542;169;53;1778;843;116;935;71;68;5
523;9.65751e-15;118;1674;22125;17461;1;797;358;3542;174;59;1745;852;115;893;70;69;5
523;9.56578e-15;101;1688;21798;17355;1;744;341;3542;158;54;1681;845;104;836;70;69;5
524;9.70014e-15;109;1727;22183;17509;1;801;350;3543;171;60;1760;868;111;892;70;68;5
524;9.61161e-15;106;1702;21857;17416;1;750;333;3543;173;56;1783;833;117;950;70;68;5
525;9.74032e-15;128;1704;22268;17568;1;790;346;3543;181;52;1730;858;129;872;70;68;5
525;9.66252e-15;113;1619;21945;17470;1;730;317;3543;172;48;1787;901;124;886;70;68;5
526;9.78978e-15;116;1630;22310;17615;1;804;359;3543;156;53;1785;863;103;922;70;68;5
526;9.70767e-15;112;1625;22021;17537;1;720;348;3543;143;60;1773;872;83;901;70;68;5
527;9.82924e-15;121;1711;22361;17671;1;813;355;3544;179;65;1759;803;114;956;69;68;5
527;9.76378e-15;119;1789;22062;17597;1;728;343;3544;169;59;1745;821;110;924;69;68;5
528;9.87632e-15;122;1614;22439;17741;1;813;337;3544;190;54;1774;903;136;871;70;68;5
528;9.81412e-15;111;1784;22142;17642;1;722;325;3544;174;55;1810;891;119;919;70;68;5
529;9.93529e-15;106;1650;22502;17796;1;814;348;3544;168;54;1842;825;114;1017;70;67;5
529;9.85193e-15;124;1699;22218;17698;1;717;333;3544;179;53;1764;879;126;885;70;67;5
530;9.9817e-15;112;1734;22577;17857;1;805;342;3544;159;46;1738;798;113;940;70;68;5
530;9.89905e-15;114;1666;22300;17744;1;703;331;3544;169;56;1833;900;113;933;70;68;5
531;1.00333e-14;91;1685;22630;17928;1;813;325;3545;184;61;1769;841;123;928;70;68;5
531;9.93782e-15;115;1737;22384;17805;1;694;314;3545;161;52;1858;816;109;1042;70;68;5
532;1.00934e-14;94;1709;22691;17987;1;808;349;3545;173;39;1793;825;134;968;70;68;5
532;9.9893e-15;97;1739;22464;17877;1;686;338;3545;163;60;1816;833;103;983;70;68;5
533;1.01434e-14;117;1682;22753;18059;1;808;303;3545;192;46;1826;875;146;951;69;68;5
533;1.00502e-14;104;1744;22515;17938;1;686;279;3545;166;40;1755;904;126;851;69;68;5
534;1.02046e-14;89;1720;22812;18116;1;814;318;3546;161;51;1760;839;110;921;69;68;5
534;1.01019e-14;101;1757;22570;18005;1;690;306;3546;141;57;1723;868;84;855;69;68;5
535;1.02532e-14;102;1703;22929;18175;1;780;302;3546;164;42;1752;806;122;946;69;68;5
535;1.01587e-14;83;1666;22650;18057;1;680;290;3546;166;54;1744;858;112;886;69;68;5
536;1.03035e-14;113;1714;22993;18236;1;772;318;3546;146;45;1826;868;101;958;69;68;5
536;1.02029e-14;101;1743;22737;18101;1;658;302;3546;133;50;1832;834;83;998;69;68;5
537;1.03556e-14;104;1683;23018;18293;1;790;308;3546;157;51;1796;916;106;880;68;68;5
537;1.02404e-14;87;1848;22807;18153;1;643;295;3546;134;60;1715;841;74;874;68;68;5
538;1.04044e-14;95;1691;23093;18342;1;786;300;3547;156;47;1751;831;109;920;68;68;5
538;1.02847e-14;97;1723;22915;18217;1;610;285;3547;123;55;1795;907;68;888;68;68;5
539;1.04463e-14;91;1723;23181;18403;1;769;318;3547;151;45;1824;813;106;1011;68;67;6
539;1.03393e-14;95;1783;22967;18271;1;606;307;3547;157;50;1797;827;107;970;68;67;6
540;1.04987e-14;95;1677;23234;18446;1;771;311;3547;150;49;1780;821;101;959;68;67;6
540;1.03855e-14;105;1734;23017;18322;1;611;296;3547;141;44;1834;862;97;972;68;67;6
541;1.05356e-14;107;1686;23295;18498;1;764;329;3548;159;61;1809;833;98;976;68;66;6
541;1.04292e-14;76;1778;23074;18384;1;612;321;3548;126;58;1754;852;68;902;68;66;6
542;1.05804e-14;102;1664;23375;18558;1;746;324;3548;147;52;1816;835;95;981;68;67;6
542;1.04824e-14;95;1820;23111;18441;1;620;317;3548;175;40;1792;887;135;905;68;67;6
543;1.06321e-14;90;1702;23447;18600;1;741;267;3548;160;43;1789;829;117;960;68;66;6
543;1.05313e-14;106;1766;23153;18494;1;627;259;3548;159;60;1883;806;99;1077;68;66;6
544;1.06683e-14;84;1696;23515;18670;1;729;272;3548;125;39;1811;884;86;927;67;67;6
544;1.05769e-14;64;1712;23191;18550;1;629;258;3548;134;60;1812;889;74;923;67;67;6
545;1.07288e-14;83;1735;23569;18733;1;728;281;3549;148;47;1816;811;101;1005;68;67;6
545;1.06252e-14;75;1760;23241;18601;1;624;267;3549;124;41;1832;844;83;988;68;67;6
546;1.07834e-14;84;1795;23656;18781;1;712;254;3549;118;41;1779;874;77;905;68;65;6
546;1.06692e-14;79;1776;23283;18651;1;626;249;3549;130;39;1743;880;91;863;68;65;6
547;1.0825e-14;68;1767;23717;18826;1;700;251;3549;147;40;1793;860;107;933;68;66;6
547;1.07124e-14;75;1706;23342;18713;1;616;247;3549;140;49;1699;876;91;823;68;66;6
548;1.08641e-14;77;1712;23782;18892;1;687;248;3550;119;39;1792;856;80;936;67;66;6
548;1.07661e-14;75;1720;23391;18764;1;616;243;3550;119;33;1763;879;86;884;67;66;6
549;1.09215e-14;78;1766;23865;18947;1;663;296;3550;125;47;1765;818;78;947;67;66;6
549;1.08103e-14;85;1701;23450;18805;1;608;248;3550;132;26;1768;860;106;908;67;66;6
550;1.09694e-14;110;1759;23942;18994;1;646;289;3550;142;45;1811;846;97;965;67;66;6
550;1.08459e-14;91;1691;23500;18853;1;611;271;3550;117;45;1719;856;72;863;67;65;6
551;1.10104e-14;101;1821;23964;19038;1;666;310;3550;136;56;1755;855;80;900;67;66;6
551;1.08876e-14;77;1714;23534;18914;1;621;301;3550;129;36;1711;844;93;867;67;66;6
552;1.10488e-14;107;1785;24020;19087;1;668;273;3551;172;60;1812;860;112;952;67;65;6
552;1.09406e-14;84;1698;23580;18965;1;622;268;3551;152;38;1741;824;114;917;67;65;6
553;1.10916e-14;89;1710;24088;19145;1;658;303;3551;145;53;1897;905;92;992;66;65;6
553;1.09851e-14;90;1615;23646;19018;1;611;299;3551;141;46;1755;904;95;851;66;65;6
554;1.11424e-14;88;1722;24149;19200;1;653;261;3551;142;43;1785;883;99;902;66;65;6
554;1.10313e-14;81;1692;23693;19086;1;618;251;3551;152;46;1769;832;106;937;66;65;6
555;1.11906e-14;85;1652;24224;19269;1;638;303;3551;140;40;1719;892;100;827;66;65;6
555;1.10908e-14;74;1682;23734;19138;1;623;285;3551;138;37;1737;819;101;918;66;65;6
556;1.12512e-14;82;1715;24250;19315;1;654;295;3552;153;44;1832;846;109;986;66;65;6
556;1.11363e-14;94;1721;23801;19197;1;610;285;3552;145;45;1823;797;100;1026;66;65;6
557;1.12917e-14;93;1770;24311;19365;1;646;301;3552;143;50;1760;813;93;947;66;64;6
557;1.1188e-14;89;1760;23839;19255;1;617;284;3552;150;39;1718;872;111;846;66;64;6
558;1.13357e-14;101;1788;24357;19412;1;647;284;3552;142;47;1875;854;95;1021;66;63;6
558;1.12389e-14;95;1756;23890;19311;1;615;275;3552;144;48;1761;855;96;906;66;63;6
559;1.13772e-14;87;1680;24426;19465;1;644;295;3553;132;54;1768;916;78;852;66;64;6
559;1.12882e-14;90;1717;23943;19361;1;608;285;3553;151;51;1814;891;100;923;66;64;6
560;1.1424e-14;75;1709;24491;19515;1;638;200;3453;144;43;1802;840;101;962;66;64;6
560;1.13322e-14;96;1690;23989;19413;1;606;253;3553;121;49;1770;870;72;900;65;63;6
561;1.14682e-14;67;1663;24556;19570;1;621;315;3553;97;37;1703;823;60;880;65;64;6
561;1.1378e-14;86;1705;24047;19458;1;598;306;3553;101;49;1739;830;52;909;65;64;6
562;1.15168e-14;101;1754;24597;19618;1;622;271;3553;168;52;1698;831;116;867;65;63;6
562;1.14178e-14;100;1672;24102;19505;1;598;264;3553;162;33;1709;881;129;828;65;63;6
563;1.15594e-14;95;1741;24660;19684;1;612;203;3554;109;49;1723;866;60;857;64;62;6
563;1.14593e-14;90;1724;24135;19551;1;604;198;3554;135;50;1698;858;85;840;64;62;6
564;1.1618e-14;76;1716;24706;19733;1;610;1.07374e+08;-2.14748e+09;98;32;1763;917;66;846;64;63;6
564;1.15e-14;39;1637;24192;19613;1;594;1.07374e+08;-2.14748e+09;114;43;1722;859;71;863;64;63;6
565;1.16616e-14;76;1715;24706;19733;1;610;1.032e+08;-2.06399e+09;0;0;-1;0;0;-1;65;63;6
565;1.1555e-14;39;1637;24192;19613;1;594;1.032e+08;-2.06399e+09;0;0;-1;0;0;-1;65;63;6
566;1.16616e-14;76;1715;24706;19733;1;610;3.09788e+08;-1.98428e+09;0;0;-1;0;0;-1;64;62;6
566;1.1555e-14;39;1636;24192;19613;1;594;3.09788e+08;-1.98428e+09;0;0;-1;0;0;-1;64;62;6
567;1.16616e-14;76;1713;24706;19733;1;610;4.05197e+08;-1.90817e+09;0;0;-1;0;0;-1;239;238;6
567;1.1555e-14;39;1634;24192;19613;1;594;4.05197e+08;-1.90817e+09;0;0;-1;0;0;-1;239;238;6
568;1.16616e-14;76;1711;24706;19733;1;610;4.96971e+08;-1.83548e+09;0;0;-1;0;0;-1;913;913;6
568;1.1555e-14;39;1634;24192;19613;1;594;4.96971e+08;-1.83548e+09;0;0;-1;0;0;-1;913;913;6
569;1.16616e-14;76;1710;24706;19733;1;610;5.85273e+08;-1.76604e+09;0;0;-1;0;0;-1;2534;2533;6
569;1.1555e-14;39;1634;24192;19613;1;594;5.85273e+08;-1.76604e+09;0;0;-1;0;0;-1;2534;2533;6
570;1.16616e-14;76;1707;24706;19733;1;610;5.62884e+08;-1.69969e+09;2;0;-1;0;2;-1;5648;5647;6
570;1.1555e-14;39;1633;24192;19613;1;594;5.62884e+08;-1.69969e+09;1;0;-1;0;1;-1;5648;5647;6
571;1.16616e-14;76;1706;24706;19733;1;610;7.52072e+08;-1.63627e+09;0;0;-1;0;0;-1;10888;10887;6
571;1.1555e-14;41;1631;24192;19613;1;594;7.52072e+08;-1.63627e+09;3;0;-1;0;3;-1;10888;10887;6
572;1.16616e-14;76;1705;24706;19733;1;610;8.30855e+08;-1.57565e+09;0;0;-1;0;0;-1;18951;18950;6
572;1.1555e-14;42;1631;24192;19613;1;594;8.30855e+08;-1.57565e+09;0;0;-1;0;0;-1;18951;18950;6
573;1.16616e-14;76;1705;24706;19733;1;610;9.06739e+08;-1.51768e+09;0;0;-1;0;0;-1;30582;30581;6
573;1.1555e-14;43;1629;24192;19613;1;594;9.06739e+08;-1.51768e+09;0;0;-1;0;0;-1;30582;30581;6
574;1.16616e-14;76;1705;24706;19733;1;610;9.79851e+08;-1.46224e+09;0;0;-1;0;0;-1;46565;46564;6
574;1.1555e-14;43;1629;24192;19613;1;594;9.79851e+08;-1.46224e+09;0;0;-1;0;0;-1;46565;46564;6
575;1.16616e-14;76;1705;24706;19733;1;610;1.05031e+09;-1.40921e+09;0;0;-1;0;0;-1;67707;67706;6
575;1.1555e-14;45;1627;24192;19613;1;594;1.05031e+09;-1.40921e+09;1;0;-1;0;1;-1;67707;67706;6
576;1.16616e-14;77;1703;24706;19733;1;610;1.11824e+09;-1.35846e+09;0;0;-1;0;0;-1;94830;94828;6
576;1.1555e-14;46;1627;24192;19613;1;594;1.11824e+09;-1.35846e+09;0;0;-1;0;0;-1;94830;94828;6
577;1.16616e-14;77;1701;24706;19733;1;610;1.18373e+09;-1.30989e+09;0;0;-1;0;0;-1;128760;128758;6
577;1.1555e-14;46;1626;24192;19613;1;594;1.18373e+09;-1.30989e+09;1;0;-1;0;1;-1;128760;128758;6
578;1.16616e-14;77;1701;24706;19733;1;610;1.13953e+09;-1.2634e+09;0;0;-1;0;0;-1;170321;170319;6
578;1.1555e-14;46;1626;24192;19613;1;594;1.2469e+09;-1.2634e+09;2;0;-1;0;2;-1;170321;170319;6
579;1.16616e-14;77;1701;24706;19733;1;610;1.30785e+09;-1.21888e+09;0;0;-1;0;0;-1;220327;220326;6
579;1.1555e-14;47;1625;24192;19613;1;594;1.30785e+09;-1.21888e+09;0;0;-1;0;0;-1;220327;220326;6
580;1.16616e-14;78;1701;24706;19733;1;610;1.25928e+09;-1.17625e+09;0;0;-1;0;0;-1;279577;279575;6
580;1.1555e-14;47;1624;24192;19613;1;594;1.25928e+09;-1.17625e+09;1;0;-1;0;1;-1;279577;279575;6
581;1.16616e-14;80;1701;24706;19733;1;610;1.31605e+09;-1.13541e+09;1;0;-1;0;1;-1;348848;348846;6
581;1.1555e-14;48;1622;24192;19613;1;594;1.31605e+09;-1.13541e+09;2;0;-1;0;2;-1;348848;348846;6
582;1.16616e-14;80;1698;24706;19733;1;610;1.37087e+09;-1.09627e+09;4;0;-1;0;4;-1;428893;428891;6
582;1.1555e-14;49;1619;24192;19613;1;594;1.37087e+09;-1.09627e+09;0;0;-1;0;0;-1;428893;428891;6
583;1.16616e-14;83;1698;24706;19733;1;610;1.53118e+09;-1.05877e+09;2;0;-1;0;2;-1;520437;520436;6
583;1.1555e-14;51;1618;24192;19613;1;594;1.53118e+09;-1.05877e+09;0;0;-1;0;0;-1;520437;520436;6
584;1.16616e-14;83;1698;24706;19733;1;610;1.47495e+09;-1.02281e+09;0;0;-1;0;0;-1;624174;624173;6
584;1.1555e-14;52;1614;24192;19613;1;594;1.47495e+09;-1.02281e+09;5;0;-1;0;5;-1;624174;624173;6
585;1.16616e-14;83;1698;24706;19733;1;610;1.52436e+09;-9.88342e+08;0;0;-1;0;0;-1;740763;740762;6
585;1.1555e-14;54;1611;24192;19613;1;594;1.52436e+09;-9.88342e+08;3;0;-1;0;3;-1;740763;740762;6
586;1.16616e-14;92;1695;24706;19733;1;610;1.6795e+09;-9.5528e+08;7;0;-1;0;7;-1;870830;870828;6
586;1.1555e-14;54;1611;24192;19613;1;594;1.6795e+09;-9.5528e+08;0;0;-1;0;0;-1;870830;870828;6
587;1.16616e-14;93;1693;24706;19733;1;610;1.72568e+09;-9.23566e+08;4;0;-1;0;4;-1;1014962;1014960;6
587;1.1555e-14;54;1611;24192;19613;1;594;1.72568e+09;-9.23566e+08;0;0;-1;0;0;-1;1014962;1014960;6
588;1.16616e-14;95;1691;24706;19733;1;610;1.66296e+09;-8.93136e+08;1;0;-1;0;1;-1;1173709;1173707;6
588;1.1555e-14;54;1609;24192;19613;1;594;1.66296e+09;-8.93136e+08;2;0;-1;0;2;-1;1173709;1173707;6
589;1.16616e-14;95;1691;24706;19733;1;610;1.70616e+09;-8.63933e+08;0;0;-1;0;0;-1;1347583;1347581;6
589;1.1555e-14;59;1609;24192;19613;1;594;1.70616e+09;-8.63933e+08;0;0;-1;0;0;-1;1347583;1347581;6
590;1.16616e-14;99;1690;24706;19733;1;610;1.74796e+09;-8.359e+08;4;0;-1;0;4;-1;1537058;1537056;6
590;1.1555e-14;60;1609;24192;19613;1;594;1.85533e+09;-8.359e+08;0;0;-1;0;0;-1;1537058;1537056;6
591;1.16616e-14;100;1690;24706;19733;1;610;1.78841e+09;-8.08984e+08;1;0;-1;0;1;-1;1742568;1742566;6
591;1.1555e-14;64;1609;24192;19613;1;594;1.78841e+09;-8.08984e+08;5;0;-1;0;5;-1;1742568;1742566;6
592;1.16616e-14;100;1689;24706;19733;1;610;1.82756e+09;-7.83135e+08;1;0;-1;0;1;-1;1964509;1964508;6
592;1.1555e-14;64;1607;24192;19613;1;594;1.82756e+09;-7.83135e+08;0;0;-1;0;0;-1;1964509;1964508;6
593;1.16616e-14;107;1687;24706;19733;1;610;1.97285e+09;-7.58305e+08;6;0;-1;0;6;-1;2203240;2203238;6
593;1.1555e-14;68;1607;24192;19613;1;594;1.97285e+09;-7.58305e+08;1;0;-1;0;1;-1;2203240;2203238;6
594;1.16616e-14;108;1687;24706;19733;1;610;1.9022e+09;-7.34449e+08;0;0;-1;0;0;-1;2459079;2459077;6
594;1.1555e-14;75;1606;24192;19613;1;594;1.9022e+09;-7.34449e+08;2;0;-1;0;2;-1;2459079;2459077;6
595;1.16616e-14;109;1685;24706;19733;1;610;1.93778e+09;-7.11523e+08;0;0;-1;0;0;-1;2732311;2732309;6
595;1.1555e-14;77;1606;24192;19613;1;594;1.93778e+09;-7.11523e+08;1;0;-1;0;1;-1;2732311;2732309;6
596;1.16616e-14;113;1682;24706;19733;1;610;1.97225e+09;-6.89486e+08;5;0;-1;0;5;-1;3023183;3023181;7
596;1.1555e-14;81;1604;24192;19613;1;594;2.07963e+09;-6.89486e+08;7;0;-1;0;7;-1;3023183;3023181;7
597;1.16616e-14;113;1682;24706;19733;1;610;2.11304e+09;-6.68298e+08;0;0;-1;0;0;-1;3331907;3331905;7
597;1.1555e-14;83;1604;24192;19613;1;594;2.11304e+09;-6.68298e+08;4;0;-1;0;4;-1;3331907;3331905;7
598;1.16616e-14;114;1681;24706;19733;1;610;2.03806e+09;-6.47923e+08;1;0;-1;0;1;-1;3658661;3658659;7
598;1.1555e-14;85;1603;24192;19613;1;594;2.03806e+09;-6.47923e+08;2;0;-1;0;2;-1;3658661;3658659;7
599;1.16616e-14;115;1681;24706;19733;1;610;2.06948e+09;-6.28325e+08;1;0;-1;0;1;-1;4003589;4003587;7
599;1.1555e-14;106;1599;24192;19613;1;594;-2.14748e+09;-6.28325e+08;9;0;-1;0;9;-1;4003589;4003587;7
600;1.16616e-14;120;1681;24706;19733;1;610;2.09995e+09;-6.0947e+08;6;0;-1;0;6;-1;4366806;4366804;7
600;1.1555e-14;105;1599;24192;19613;1;594;2.09995e+09;-6.0947e+08;-1;0;0;0;-1;0;4366806;4366804;7
601;1.16616e-14;121;1681;24706;19733;1;610;-2.14748e+09;-5.91326e+08;1;0;-1;0;1;-1;4748392;4748390;7
601;1.1555e-14;112;1597;24192;19613;1;594;-2.14748e+09;-5.91326e+08;4;0;-1;0;4;-1;4748392;4748390;7
602;1.16616e-14;121;1681;24706;19733;1;610;-2.14748e+09;-5.73862e+08;0;0;-1;0;0;-1;5148402;5148400;7
602;1.1555e-14;112;1597;24192;19613;1;594;-2.14748e+09;-5.73862e+08;-1;0;0;0;-1;0;5148402;5148400;7
603;1.16616e-14;119;1681;24706;19733;1;610;-2.14748e+09;-5.57049e+08;-1;0;0;0;-1;0;5566860;5566858;8
603;1.1555e-14;112;1597;24192;19613;1;594;-2.14748e+09;-5.57049e+08;0;0;-1;0;0;-1;5566860;5566858;8
604;1.16616e-14;118;1681;24706;19733;1;610;-2.14748e+09;-5.40859e+08;-1;0;0;0;-1;0;6003764;6003762;8
604;1.1555e-14;112;1597;24192;19613;1;594;-2.14748e+09;-5.40859e+08;-1;0;0;0;-1;0;6003764;6003762;8
605;1.16616e-14;117;1681;24706;19733;1;610;-2.14748e+09;-5.25265e+08;-1;0;0;0;-1;0;6459086;6459085;8
605;1.1555e-14;112;1597;24192;19613;1;594;-2.14748e+09;-5.25265e+08;0;0;-1;0;0;-1;6459086;6459085;8
606;1.16616e-14;117;1681;24706;19733;1;610;-2.14748e+09;-5.10244e+08;0;0;-1;0;0;-1;6932775;6932773;9
606;1.1555e-14;112;1596;24192;19613;1;594;-2.14748e+09;-5.10244e+08;0;0;-1;0;0;-1;6932775;6932773;9
607;1.16616e-14;116;1681;24706;19733;1;610;-2.14748e+09;-4.95769e+08;0;0;-1;0;0;-1;7424755;7424753;9
607;1.1555e-14;112;1596;24192;19613;1;594;-2.14748e+09;-4.95769e+08;-1;0;0;0;-1;0;7424755;7424753;9
608;1.16616e-14;115;1681;24706;19733;1;610;-2.14748e+09;-4.81819e+08;0;0;-1;0;0;-1;7934928;7934927;10
608;1.1555e-14;112;1596;24192;19613;1;594;-2.14748e+09;-4.81819e+08;-1;0;0;0;-1;0;7934928;7934927;10
609;1.16616e-14;114;1681;24706;19733;1;610;-2.14748e+09;-4.68371e+08;-1;0;0;0;-1;0;8463179;8463177;11
609;1.1555e-14;112;1596;24192;19613;1;594;-2.14748e+09;-4.68371e+08;-1;0;0;0;-1;0;8463179;8463177;11
610;1.16616e-14;112;1681;24706;19733;1;610;-2.14748e+09;-4.55404e+08;-1;0;0;0;-1;0;9009369;9009367;12
610;1.1555e-14;111;1596;24192;19613;1;594;-2.14748e+09;-4.55404e+08;0;0;-1;0;0;-1;9009369;9009367;12
611;1.16616e-14;111;1681;24706;19733;1;610;-2.14748e+09;-4.429e+08;-1;0;0;0;-1;0;9573344;9573342;13
611;1.1555e-14;111;1596;24192;19613;1;594;-2.14748e+09;-4.429e+08;-1;0;0;0;-1;0;9573344;9573342;13
612;1.16616e-14;111;1681;24706;19733;1;610;-2.14748e+09;-4.30837e+08;0;0;-1;0;0;-1;10154931;10154930;14
612;1.1555e-14;111;1596;24192;19613;1;594;-2.14748e+09;-4.30837e+08;-1;0;0;0;-1;0;10154931;10154930;14
613;1.16616e-14;110;1681;24706;19733;1;610;-2.14748e+09;-4.192e+08;-1;0;0;0;-1;0;10753944;10753942;16
613;1.1555e-14;111;1596;24192;19613;1;594;-2.14748e+09;-4.192e+08;-1;0;0;0;-1;0;10753944;10753942;16
614;1.16616e-14;108;1680;24706;19733;1;610;-2.14748e+09;-4.07969e+08;-1;0;0;0;-1;0;11370178;11370177;18
614;1.1555e-14;111;1596;24192;19613;1;594;-2.14748e+09;-4.07969e+08;-1;0;0;0;-1;0;11370178;11370177;18
615;1.16616e-14;105;1680;24706;19733;1;610;-2.14748e+09;-3.97129e+08;-1;0;0;0;-1;0;12003419;12003417;20
615;1.1555e-14;111;1596;24192;19613;1;594;-2.14748e+09;-3.97129e+08;-1;0;0;0;-1;0;12003419;12003417;20
616;1.16616e-14;104;1679;24706;19733;1;610;-2.14748e+09;-3.86664e+08;-1;0;0;0;-1;0;12653436;12653435;23
616;1.1555e-14;111;1596;24192;19613;1;594;-2.14748e+09;-3.86664e+08;-1;0;0;0;-1;0;12653436;12653435;23
617;1.16616e-14;104;1679;24706;19733;1;610;-2.14748e+09;-3.76558e+08;-1;0;0;0;-1;0;13319990;13319989;26
617;1.1555e-14;109;1596;24192;19613;1;594;-2.14748e+09;-3.76558e+08;-1;0;0;0;-1;0;13319990;13319989;26
618;1.16616e-14;102;1679;24706;19733;1;610;-2.14748e+09;-3.66798e+08;-1;0;0;0;-1;0;14002829;14002828;29
618;1.1555e-14;108;1596;24192;19613;1;594;-2.14748e+09;-3.66798e+08;0;0;-1;0;0;-1;14002829;14002828;29
619;1.16616e-14;101;1679;24706;19733;1;610;-2.14748e+09;-3.57369e+08;-1;0;0;0;-1;0;14701692;14701692;33
619;1.1555e-14;108;1595;24192;19613;1;594;-2.14748e+09;-3.57369e+08;-1;0;0;0;-1;0;14701692;14701692;33
620;1.16616e-14;101;1679;24706;19733;1;610;-2.14748e+09;-3.48258e+08;-1;0;0;0;-1;0;15416310;15416309;38
620;1.1555e-14;107;1595;24192;19613;1;594;-2.14748e+09;-3.48258e+08;-1;0;0;0;-1;0;15416310;15416309;38
621;1.16616e-14;101;1679;24706;19733;1;610;-2.14748e+09;-3.39454e+08;-1;0;0;0;-1;0;16146404;16146404;43
621;1.1555e-14;107;1595;24192;19613;1;594;-2.14748e+09;-3.39454e+08;-1;0;0;0;-1;0;16146404;16146404;43
622;1.16616e-14;101;1679;24706;19733;1;610;-2.14748e+09;-3.30943e+08;-1;0;0;0;-1;0;16891690;16891690;49
622;1.1555e-14;107;1595;24192;19613;1;594;-2.14748e+09;-3.30943e+08;-1;0;0;0;-1;0;16891690;16891690;49
623;1.16616e-14;100;1679;24706;19733;1;610;-2.14748e+09;-3.22714e+08;0;0;-1;0;0;-1;17651876;17651876;56
623;1.1555e-14;107;1595;24192;19613;1;594;-2.14748e+09;-3.22714e+08;-1;0;0;0;-1;0;17651876;17651876;56
624;1.16616e-14;98;1679;24706;19733;1;610;-2.14748e+09;-3.14757e+08;0;0;-1;0;0;-1;18426665;18426666;64
624;1.1555e-14;106;1595;24192;19613;1;594;-2.14748e+09;-3.14757e+08;-1;0;0;0;-1;0;18426665;18426666;64
625;1.16616e-14;98;1679;24706;19733;1;610;-2.14748e+09;-3.07061e+08;-1;0;0;0;-1;0;19215756;19215757;72
625;1.1555e-14;104;1595;24192;19613;1;594;-2.14748e+09;-3.07061e+08;-1;0;0;0;-1;0;19215756;19215757;72
626;1.16616e-14;98;1679;24706;19733;1;610;-2.14748e+09;-2.99615e+08;-1;0;0;0;-1;0;20018843;20018844;82
626;1.1555e-14;103;1595;24192;19613;1;594;-2.14748e+09;-2.99615e+08;-1;0;0;0;-1;0;20018843;20018844;82
627;1.16616e-14;97;1679;24706;19733;1;610;-2.14748e+09;-2.92411e+08;-1;0;0;0;-1;0;20835615;20835617;93
627;1.1555e-14;103;1595;24192;19613;1;594;-2.14748e+09;-2.92411e+08;-1;0;0;0;-1;0;20835615;20835617;93
628;1.16616e-14;97;1679;24706;19733;1;610;-2.14748e+09;-2.85438e+08;-1;0;0;0;-1;0;21665761;21665763;106
628;1.1555e-14;103;1595;24192;19613;1;594;-2.14748e+09;-2.85438e+08;-1;0;0;0;-1;0;21665761;21665763;106
629;1.16616e-14;97;1679;24706;19733;1;610;-2.14748e+09;-2.78689e+08;-1;0;0;0;-1;0;22508964;22508967;120
629;1.1555e-14;103;1594;24192;19613;1;594;-2.14748e+09;-2.78689e+08;-1;0;0;0;-1;0;22508964;22508967;120
630;1.16616e-14;97;1679;24706;19733;1;610;-2.14748e+09;-2.72154e+08;-1;0;0;0;-1;0;23364909;23364913;136
630;1.1555e-14;99;1594;24192;19613;1;594;-2.14748e+09;-2.72154e+08;-1;0;0;0;-1;0;23364909;23364913;136
631;1.16616e-14;97;1679;24706;19733;1;610;-2.14748e+09;-2.65826e+08;-1;0;0;0;-1;0;24233278;24233283;153
631;1.1555e-14;99;1594;24192;19613;1;594;-2.14748e+09;-2.65826e+08;-1;0;0;0;-1;0;24233278;24233283;153
632;1.16616e-14;97;1679;24706;19733;1;610;-2.14748e+09;-2.59696e+08;-1;0;0;0;-1;0;25113751;25113756;172
632;1.1555e-14;98;1594;24192;19613;1;594;-2.14748e+09;-2.59696e+08;-1;0;0;0;-1;0;25113751;25113756;172
633;1.16616e-14;92;1679;24706;19733;1;610;-2.14748e+09;-2.53759e+08;-1;0;0;0;-1;0;26006008;26006015;194
633;1.1555e-14;97;1594;24192;19613;1;594;-2.14748e+09;-2.53759e+08;-1;0;0;0;-1;0;26006008;26006015;194
634;1.16616e-14;92;1679;24706;19733;1;610;-2.14748e+09;-2.48005e+08;-1;0;0;0;-1;0;26909732;26909739;218
634;1.1555e-14;95;1594;24192;19613;1;594;-2.14748e+09;-2.48005e+08;-1;0;0;0;-1;0;26909732;26909739;218
635;1.16616e-14;92;1679;24706;19733;1;610;-2.14748e+09;-2.42429e+08;-1;0;0;0;-1;0;27824602;27824611;244
635;1.1555e-14;93;1593;24192;19613;1;594;-2.14748e+09;-2.42429e+08;-1;0;0;0;-1;0;27824602;27824611;244
636;1.16616e-14;92;1679;24706;19733;1;610;-2.14748e+09;-2.37024e+08;-1;0;0;0;-1;0;28750301;28750312;273
636;1.1555e-14;93;1593;24192;19613;1;594;-2.14748e+09;-2.37024e+08;-1;0;0;0;-1;0;28750301;28750312;273
637;1.16616e-14;92;1679;24706;19733;1;610;-2.14748e+09;-2.31784e+08;-1;0;0;0;-1;0;29686513;29686525;305
637;1.1555e-14;93;1593;24192;19613;1;594;-2.14748e+09;-2.31784e+08;-1;0;0;0;-1;0;29686513;29686525;305
638;1.16616e-14;89;1679;24706;19733;1;610;-2.14748e+09;-2.26703e+08;-1;0;0;0;-1;0;30632922;30632935;340
638;1.1555e-14;92;1593;24192;19613;1;594;-2.14748e+09;-2.26703e+08;-1;0;0;0;-1;0;30632922;30632935;340
639;1.16616e-14;86;1679;24706;19733;1;610;-2.14748e+09;-2.21775e+08;0;0;-1;0;0;-1;31589215;31589230;379
639;1.1555e-14;90;1593;24192;19613;1;594;-2.14748e+09;-2.21775e+08;-1;0;0;0;-1;0;31589215;31589230;379
640;1.16616e-14;86;1679;24706;19733;1;610;-2.14748e+09;-2.16994e+08;-1;0;0;0;-1;0;32555081;32555098;421
640;1.1555e-14;84;1593;24192;19613;1;594;-2.14748e+09;-2.16994e+08;-1;0;0;0;-1;0;32555081;32555098;421
641;1.16616e-14;84;1678;24706;19733;1;610;-2.14748e+09;-2.12356e+08;-1;0;0;0;-1;0;33530210;33530230;467
641;1.1555e-14;84;1593;24192;19613;1;594;-2.14748e+09;-2.12356e+08;-1;0;0;0;-1;0;33530210;33530230;467
642;1.16616e-14;83;1678;24706;19733;1;610;-2.14748e+09;-2.07855e+08;-1;0;0;0;-1;0;34514298;34514320;517
642;1.1555e-14;82;1593;24192;19613;1;594;-2.14748e+09;-2.07855e+08;0;0;-1;0;0;-1;34514298;34514320;517
643;1.16616e-14;80;1678;24706;19733;1;610;-2.14748e+09;-2.03486e+08;-1;0;0;0;-1;0;35507041;35507065;572
643;1.1555e-14;81;1593;24192;19613;1;594;-2.14748e+09;-2.03486e+08;-1;0;0;0;-1;0;35507041;35507065;572
644;1.16616e-14;79;1678;24706;19733;1;610;-2.14748e+09;-1.99245e+08;-1;0;0;0;-1;0;36508138;36508166;632
644;1.1555e-14;81;1593;24192;19613;1;594;-2.14748e+09;-1.99245e+08;-1;0;0;0;-1;0;36508138;36508166;632
645;1.16616e-14;79;1678;24706;19733;1;610;-2.14748e+09;-1.95127e+08;-1;0;0;0;-1;0;37517293;37517324;697
645;1.1555e-14;81;1593;24192;19613;1;594;-2.14748e+09;-1.95127e+08;-1;0;0;0;-1;0;37517293;37517324;697
646;1.16616e-14;79;1678;24706;19733;1;610;-2.14748e+09;-1.91128e+08;-1;0;0;0;-1;0;38534214;38534248;767
646;1.1555e-14;80;1593;24192;19613;1;594;-2.14748e+09;-1.91128e+08;-1;0;0;0;-1;0;38534214;38534248;767
647;1.16616e-14;79;1678;24706;19733;1;610;-2.14748e+09;-1.87243e+08;-1;0;0;0;-1;0;39558609;39558647;843
647;1.1555e-14;77;1593;24192;19613;1;594;-2.14748e+09;-1.87243e+08;-1;0;0;0;-1;0;39558609;39558647;843
648;1.16616e-14;78;1678;24706;19733;1;610;-2.14748e+09;-1.83469e+08;-1;0;0;0;-1;0;40590194;40590236;926
648;1.1555e-14;77;1593;24192;19613;1;594;-2.14748e+09;-1.83469e+08;-1;0;0;0;-1;0;40590194;40590236;926
649;1.16616e-14;78;1678;24706;19733;1;610;-2.14748e+09;-1.79803e+08;-1;0;0;0;-1;0;41628686;41628732;1015
649;1.1555e-14;77;1593;24192;19613;1;594;-2.14748e+09;-1.79803e+08;-1;0;0;0;-1;0;41628686;41628732;1015
650;1.16616e-14;78;1678;24706;19733;1;610;-2.14748e+09;-1.76239e+08;-1;0;0;0;-1;0;42673808;42673858;1111
650;1.1555e-14;76;1593;24192;19613;1;594;-2.14748e+09;-1.76239e+08;-1;0;0;0;-1;0;42673808;42673858;1111
651;1.16616e-14;78;1677;24706;19733;1;610;-2.14748e+09;-1.72776e+08;-1;0;0;0;-1;0;43725285;43725340;1214
651;1.1555e-14;75;1592;24192;19613;1;594;-2.14748e+09;-1.72776e+08;-1;0;0;0;-1;0;43725285;43725340;1214
652;1.16616e-14;78;1677;24706;19733;1;610;-2.14748e+09;-1.69408e+08;0;0;-1;0;0;-1;44782848;44782908;1326
652;1.1555e-14;75;1592;24192;19613;1;594;-2.14748e+09;-1.69408e+08;-1;0;0;0;-1;0;44782848;44782908;1326
653;1.16616e-14;77;1677;24706;19733;1;610;-2.14748e+09;-1.66134e+08;-1;0;0;0;-1;0;45846232;45846298;1445
653;1.1555e-14;75;1592;24192;19613;1;594;-2.14748e+09;-1.66134e+08;-1;0;0;0;-1;0;45846232;45846298;1445
654;1.16616e-14;76;1677;24706;19733;1;610;-2.14748e+09;-1.6295e+08;-1;0;0;0;-1;0;46915175;46915248;1574
654;1.1555e-14;73;1592;24192;19613;1;594;-2.14748e+09;-1.6295e+08;-1;0;0;0;-1;0;46915175;46915248;1574
655;1.16616e-14;76;1677;24706;19733;1;610;-2.14748e+09;-1.59852e+08;-1;0;0;0;-1;0;47989423;47989502;1712
655;1.1555e-14;73;1592;24192;19613;1;594;-2.14748e+09;-1.59852e+08;-1;0;0;0;-1;0;47989423;47989502;1712
656;1.16616e-14;74;1677;24706;19733;1;610;-2.14748e+09;-1.56839e+08;-1;0;0;0;-1;0;49068721;49068807;1860
656;1.1555e-14;72;1592;24192;19613;1;594;-2.14748e+09;-1.56839e+08;-1;0;0;0;-1;0;49068721;49068807;1860
657;1.16616e-14;74;1677;24706;19733;1;610;-2.14748e+09;-1.53907e+08;-1;0;0;0;-1;0;50152824;50152917;2018
657;1.1555e-14;71;1592;24192;19613;1;594;-2.14748e+09;-1.53907e+08;-1;0;0;0;-1;0;50152824;50152917;2018
658;1.16616e-14;72;1677;24706;19733;1;610;-2.14748e+09;-1.51054e+08;-1;0;0;0;-1;0;51241487;51241589;2186
658;1.1555e-14;70;1592;24192;19613;1;594;-2.14748e+09;-1.51054e+08;-1;0;0;0;-1;0;51241487;51241589;2186
659;1.16616e-14;71;1677;24706;19733;1;610;-2.14748e+09;-1.48277e+08;-1;0;0;0;-1;0;52334473;52334584;2367
659;1.1555e-14;68;1592;24192;19613;1;594;-2.14748e+09;-1.48277e+08;-1;0;0;0;-1;0;52334473;52334584;2367
660;1.16616e-14;70;1677;24706;19733;1;610;-2.14748e+09;-1.45573e+08;0;0;-1;0;0;-1;53431548;53431668;2559
660;1.1555e-14;67;1592;24192;19613;1;594;-2.14748e+09;-1.45573e+08;0;0;-1;0;0;-1;53431548;53431668;2559
661;1.16616e-14;67;1677;24706;19733;1;610;-2.14748e+09;-1.42941e+08;-1;0;0;0;-1;0;54532483;54532613;2764
661;1.1555e-14;66;1592;24192;19613;1;594;-2.14748e+09;-1.42941e+08;-1;0;0;0;-1;0;54532483;54532613;2764
662;1.16616e-14;64;1677;24706;19733;1;610;-2.14748e+09;-1.40378e+08;-1;0;0;0;-1;0;55637054;55637194;2982
662;1.1555e-14;65;1592;24192;19613;1;594;-2.14748e+09;-1.40378e+08;-1;0;0;0;-1;0;55637054;55637194;2982
663;1.16616e-14;64;1677;24706;19733;1;610;-2.14748e+09;-1.37881e+08;-1;0;0;0;-1;0;56745040;56745192;3214
663;1.1555e-14;64;1592;24192;19613;1;594;-2.14748e+09;-1.37881e+08;-1;0;0;0;-1;0;56745040;56745192;3214
664;1.16616e-14;62;1677;24706;19733;1;610;-2.14748e+09;-1.35448e+08;-1;0;0;0;-1;0;57856226;57856390;3461
664;1.1555e-14;58;1592;24192;19613;1;594;-2.14748e+09;-1.35448e+08;-1;0;0;0;-1;0;57856226;57856390;3461
665;1.16616e-14;62;1677;24706;19733;1;610;-2.14748e+09;-1.33079e+08;-1;0;0;0;-1;0;58970402;58970579;3722
665;1.1555e-14;58;1592;24192;19613;1;594;-2.14748e+09;-1.33079e+08;-1;0;0;0;-1;0;58970402;58970579;3722
666;1.16616e-14;62;1677;24706;19733;1;610;-2.14748e+09;-1.30769e+08;-1;0;0;0;-1;0;60087362;60087552;4000
666;1.1555e-14;58;1592;24192;19613;1;594;-2.14748e+09;-1.30769e+08;-1;0;0;0;-1;0;60087362;60087552;4000
667;1.16616e-14;62;1677;24706;19733;1;610;-2.14748e+09;-1.28519e+08;-1;0;0;0;-1;0;61206903;61207107;4294
667;1.1555e-14;57;1592;24192;19613;1;594;-2.14748e+09;-1.28519e+08;-1;0;0;0;-1;0;61206903;61207107;4294
668;1.16616e-14;57;1676;24706;19733;1;610;-2.14748e+09;-1.26325e+08;-1;0;0;0;-1;0;62328829;62329048;4605
668;1.1555e-14;57;1592;24192;19613;1;594;-2.14748e+09;-1.26325e+08;0;0;-1;0;0;-1;62328829;62329048;4605
669;1.16616e-14;57;1676;24706;19733;1;610;-2.14748e+09;-1.24186e+08;-1;0;0;0;-1;0;63452947;63453183;4935
669;1.1555e-14;56;1592;24192;19613;1;594;-2.14748e+09;-1.24186e+08;-1;0;0;0;-1;0;63452947;63453183;4935
670;1.16616e-14;57;1676;24706;19733;1;610;-2.14748e+09;-1.221e+08;-1;0;0;0;-1;0;64579069;64579322;5283
670;1.1555e-14;56;1592;24192;19613;1;594;-2.14748e+09;-1.221e+08;-1;0;0;0;-1;0;64579069;64579322;5283
671;1.16616e-14;56;1675;24706;19733;1;610;-2.14748e+09;-1.20066e+08;-1;0;0;0;-1;0;65707012;65707284;5651
671;1.1555e-14;56;1591;24192;19613;1;594;-2.14748e+09;-1.20066e+08;-1;0;0;0;-1;0;65707012;65707284;5651
672;1.16616e-14;54;1675;24706;19733;1;610;-2.14748e+09;-1.18082e+08;-1;0;0;0;-1;0;66836596;66836887;6039
672;1.1555e-14;56;1591;24192;19613;1;594;-2.14748e+09;-1.18082e+08;-1;0;0;0;-1;0;66836596;66836887;6039
673;1.16616e-14;52;1675;24706;19733;1;610;-2.14748e+09;-1.16147e+08;-1;0;0;0;-1;0;67967647;67967958;6448
673;1.1555e-14;55;1590;24192;19613;1;594;-2.14748e+09;-1.16147e+08;-1;0;0;0;-1;0;67967647;67967958;6448
674;1.16616e-14;52;1675;24706;19733;1;610;-2.14748e+09;-1.14258e+08;-1;0;0;0;-1;0;69099992;69100325;6879
674;1.1555e-14;55;1590;24192;19613;1;594;-2.14748e+09;-1.14258e+08;-1;0;0;0;-1;0;69099992;69100325;6879
675;1.16616e-14;51;1675;24706;19733;1;610;-2.14748e+09;-1.12415e+08;-1;0;0;0;-1;0;70233467;70233822;7333
675;1.1555e-14;52;1590;24192;19613;1;594;-2.14748e+09;-1.12415e+08;-1;0;0;0;-1;0;70233467;70233822;7333
676;1.16616e-14;51;1675;24706;19733;1;610;-2.14748e+09;-1.10617e+08;-1;0;0;0;-1;0;71367907;71368288;7811
676;1.1555e-14;52;1590;24192;19613;1;594;-2.14748e+09;-1.10617e+08;-1;0;0;0;-1;0;71367907;71368288;7811
677;1.16616e-14;46;1675;24706;19733;1;610;-2.14748e+09;-1.08861e+08;-1;0;0;0;-1;0;72503157;72503563;8313
677;1.1555e-14;52;1590;24192;19613;1;594;-2.14748e+09;-1.08861e+08;-1;0;0;0;-1;0;72503157;72503563;8313
678;1.16616e-14;46;1675;24706;19733;1;610;-2.14748e+09;-1.07148e+08;-1;0;0;0;-1;0;73639061;73639493;8841
678;1.1555e-14;52;1590;24192;19613;1;594;-2.14748e+09;-1.07148e+08;-1;0;0;0;-1;0;73639061;73639493;8841
679;1.16616e-14;45;1675;24706;19733;1;610;-2.14748e+09;-1.05474e+08;-1;0;0;0;-1;0;74775469;74775930;9395
679;1.1555e-14;48;1590;24192;19613;1;594;-2.14748e+09;-1.05474e+08;-1;0;0;0;-1;0;74775469;74775930;9395
680;1.16616e-14;45;1675;24706;19733;1;610;-2.14748e+09;-1.0384e+08;-1;0;0;0;-1;0;75912236;75912726;9976
680;1.1555e-14;46;1590;24192;19613;1;594;-2.14748e+09;-1.0384e+08;-1;0;0;0;-1;0;75912236;75912726;9976
681;1.16616e-14;41;1675;24706;19733;1;610;-2.14748e+09;-1.02244e+08;-1;0;0;0;-1;0;77049218;77049740;10585
681;1.1555e-14;46;1590;24192;19613;1;594;-2.14748e+09;-1.02244e+08;-1;0;0;0;-1;0;77049218;77049740;10585
682;1.16616e-14;41;1675;24706;19733;1;610;-2.14748e+09;-1.00684e+08;-1;0;0;0;-1;0;78186278;78186832;11224
682;1.1555e-14;40;1590;24192;19613;1;594;-2.14748e+09;-1.00684e+08;-1;0;0;0;-1;0;78186278;78186832;11224
683;1.16616e-14;41;1675;24706;19733;1;610;-2.14748e+09;-9.9161e+07;-1;0;0;0;-1;0;79323281;79323869;11893
683;1.1555e-14;39;1590;24192;19613;1;594;-2.14748e+09;-9.9161e+07;-1;0;0;0;-1;0;79323281;79323869;11893
684;1.16616e-14;38;1675;24706;19733;1;610;-2.14748e+09;-9.76725e+07;-1;0;0;0;-1;0;80460095;80460720;12593
684;1.1555e-14;39;1590;24192;19613;1;594;-2.14748e+09;-9.76725e+07;-1;0;0;0;-1;0;80460095;80460720;12593
685;1.16616e-14;37;1675;24706;19733;1;610;-2.14748e+09;-9.62178e+07;-1;0;0;0;-1;0;81596595;81597258;13325
685;1.1555e-14;39;1590;24192;19613;1;594;-2.14748e+09;-9.62178e+07;-1;0;0;0;-1;0;81596595;81597258;13325
686;1.16616e-14;37;1675;24706;19733;1;610;-2.14748e+09;-9.4796e+07;-1;0;0;0;-1;0;82732656;82733358;14091
686;1.1555e-14;38;1590;24192;19613;1;594;-2.14748e+09;-9.4796e+07;-1;0;0;0;-1;0;82732656;82733358;14091
687;1.16616e-14;37;1675;24706;19733;1;610;-2.14748e+09;-9.34062e+07;-1;0;0;0;-1;0;83868157;83868901;14890
687;1.1555e-14;33;1590;24192;19613;1;594;-2.14748e+09;-9.34062e+07;-1;0;0;0;-1;0;83868157;83868901;14890
688;1.16616e-14;35;1675;24706;19733;1;610;-2.14748e+09;-9.20473e+07;-1;0;0;0;-1;0;85002983;85003771;15725
688;1.1555e-14;33;1590;24192;19613;1;594;-2.14748e+09;-9.20473e+07;0;0;-1;0;0;-1;85002983;85003771;15725
689;1.16616e-14;35;1675;24706;19733;1;610;-2.14748e+09;-9.07186e+07;-1;0;0;0;-1;0;86137020;86137853;16596
689;1.1555e-14;32;1590;24192;19613;1;594;-2.14748e+09;-9.07186e+07;-1;0;0;0;-1;0;86137020;86137853;16596
690;1.16616e-14;27;1675;24706;19733;1;610;-2.14748e+09;-8.94192e+07;-1;0;0;0;-1;0;87270158;87271039;17505
690;1.1555e-14;32;1590;24192;19613;1;594;-2.14748e+09;-8.94192e+07;-1;0;0;0;-1;0;87270158;87271039;17505
691;1.16616e-14;26;1675;24706;19733;1;610;-2.14748e+09;-8.81483e+07;-1;0;0;0;-1;0;88402290;88403222;18452
691;1.1555e-14;32;1590;24192;19613;1;594;-2.14748e+09;-8.81483e+07;-1;0;0;0;-1;0;88402290;88403222;18452
692;1.16616e-14;26;1675;24706;19733;1;610;-2.14748e+09;-8.69051e+07;0;0;-1;0;0;-1;89533314;89534297;19438
692;1.1555e-14;31;1590;24192;19613;1;594;-2.14748e+09;-8.69051e+07;-1;0;0;0;-1;0;89533314;89534297;19438
693;1.16616e-14;21;1674;24706;19733;1;610;-2.14748e+09;-8.56888e+07;-1;0;0;0;-1;0;90663128;90664166;20466
693;1.1555e-14;30;1590;24192;19613;1;594;-2.14748e+09;-8.56888e+07;-1;0;0;0;-1;0;90663128;90664166;20466
694;1.16616e-14;20;1674;24706;19733;1;610;-2.14748e+09;-8.44987e+07;-1;0;0;0;-1;0;91791635;91792731;21535
694;1.1555e-14;29;1590;24192;19613;1;594;-2.14748e+09;-8.44987e+07;-1;0;0;0;-1;0;91791635;91792731;21535
695;1.16616e-14;18;1674;24706;19733;1;610;-2.14748e+09;-8.33341e+07;-1;0;0;0;-1;0;92918742;92919898;22647
695;1.1555e-14;28;1590;24192;19613;1;594;-2.14748e+09;-8.33341e+07;-1;0;0;0;-1;0;92918742;92919898;22647
696;1.16616e-14;17;1674;24706;19733;1;610;-2.14748e+09;-8.21942e+07;-1;0;0;0;-1;0;94044357;94045575;23804
696;1.1555e-14;27;1590;24192;19613;1;594;-2.14748e+09;-8.21942e+07;-1;0;0;0;-1;0;94044357;94045575;23804
697;1.16616e-14;17;1674;24706;19733;1;610;-2.14748e+09;-8.10785e+07;-1;0;0;0;-1;0;95168392;95169675;25005
697;1.1555e-14;27;1590;24192;19613;1;594;-2.14748e+09;-8.10785e+07;-1;0;0;0;-1;0;95168392;95169675;25005
698;1.16616e-14;17;1674;24706;19733;1;610;-2.14748e+09;-7.99863e+07;-1;0;0;0;-1;0;96290761;96292112;26253
698;1.1555e-14;27;1590;24192;19613;1;594;-2.14748e+09;-7.99863e+07;-1;0;0;0;-1;0;96290761;96292112;26253
699;1.16616e-14;17;1674;24706;19733;1;610;-2.14748e+09;-7.89168e+07;-1;0;0;0;-1;0;97411382;97412803;27549
699;1.1555e-14;26;1590;24192;19613;1;594;-2.14748e+09;-7.89168e+07;-1;0;0;0;-1;0;97411382;97412803;27549
700;1.16616e-14;14;1674;24706;19733;1;610;-2.14748e+09;-7.78695e+07;-1;0;0;0;-1;0;98530174;98531668;28894
700;1.1555e-14;26;1589;24192;19613;1;594;-2.14748e+09;-7.78695e+07;-1;0;0;0;-1;0;98530174;98531668;28894
701;1.16616e-14;14;1674;24706;19733;1;610;-2.14748e+09;-7.68437e+07;-1;0;0;0;-1;0;99647061;99648631;30288
701;1.1555e-14;25;1589;24192;19613;1;594;-2.14748e+09;-7.68437e+07;-1;0;0;0;-1;0;99647061;99648631;30288
702;1.16616e-14;13;1674;24706;19733;1;610;-2.14748e+09;-7.58392e+07;0;0;-1;0;0;-1;100761967;100763617;31734
702;1.1555e-14;20;1589;24192;19613;1;594;-2.14748e+09;-7.58392e+07;-1;0;0;0;-1;0;100761967;100763617;31734
703;1.16616e-14;12;1674;24706;19733;1;610;-2.14748e+09;-7.4855e+07;-1;0;0;0;-1;0;101874821;101876553;33233
703;1.1555e-14;16;1589;24192;19613;1;594;-2.14748e+09;-7.4855e+07;-1;0;0;0;-1;0;101874821;101876553;33233
704;1.16616e-14;11;1674;24706;19733;1;610;-2.14748e+09;-7.38908e+07;-1;0;0;0;-1;0;102985552;102987370;34785
704;1.1555e-14;16;1589;24192;19613;1;594;-2.14748e+09;-7.38908e+07;-1;0;0;0;-1;0;102985552;102987370;34785
705;1.16616e-14;11;1674;24706;19733;1;610;-2.14748e+09;-7.2946e+07;-1;0;0;0;-1;0;104094094;104096000;36392
705;1.1555e-14;12;1589;24192;19613;1;594;-2.14748e+09;-7.2946e+07;-1;0;0;0;-1;0;104094094;104096000;36392
706;1.16616e-14;11;1674;24706;19733;1;610;-2.14748e+09;-7.20203e+07;0;0;-1;0;0;-1;105200381;105202380;38055
706;1.1555e-14;12;1589;24192;19613;1;594;-2.14748e+09;-7.20203e+07;-1;0;0;0;-1;0;105200381;105202380;38055
707;1.16616e-14;11;1674;24706;19733;1;610;-2.14748e+09;-7.11128e+07;-1;0;0;0;-1;0;106304350;106306446;39776
707;1.1555e-14;12;1589;24192;19613;1;594;-2.14748e+09;-7.11128e+07;-1;0;0;0;-1;0;106304350;106306446;39776
708;1.16616e-14;10;1674;24706;19733;1;610;-2.14748e+09;-7.02234e+07;-1;0;0;0;-1;0;107405942;107408137;41555
708;1.1555e-14;11;1589;24192;19613;1;594;-2.14748e+09;-7.02234e+07;-1;0;0;0;-1;0;107405942;107408137;41555
709;1.16616e-14;10;1674;24706;19733;1;610;-2.14748e+09;-6.93515e+07;-1;0;0;0;-1;0;108505098;108507397;43394
709;1.1555e-14;10;1589;24192;19613;1;594;-2.14748e+09;-6.93515e+07;-1;0;0;0;-1;0;108505098;108507397;43394
710;1.16616e-14;9;1674;24706;19733;1;610;-2.14748e+09;-6.84966e+07;-1;0;0;0;-1;0;109601763;109604169;45295
710;1.1555e-14;9;1589;24192;19613;1;594;-2.14748e+09;-6.84966e+07;-1;0;0;0;-1;0;109601763;109604169;45295
711;1.16616e-14;6;1674;24706;19733;1;610;-2.14748e+09;-6.76584e+07;-1;0;0;0;-1;0;110695882;110698399;47258
711;1.1555e-14;7;1589;24192;19613;1;594;-2.14748e+09;-6.76584e+07;-1;0;0;0;-1;0;110695882;110698399;47258
712;1.16616e-14;6;1674;24706;19733;1;610;-2.14748e+09;-6.68363e+07;-1;0;0;0;-1;0;111787404;111790036;49285
712;1.1555e-14;5;1589;24192;19613;1;594;-2.14748e+09;-6.68363e+07;-1;0;0;0;-1;0;111787404;111790035;49285
713;1.16616e-14;4;1674;24706;19733;1;610;-2.14748e+09;-6.60301e+07;-1;0;0;0;-1;0;112876279;112879028;51377
713;1.1555e-14;2;1589;24192;19613;1;594;-2.14748e+09;-6.60301e+07;-1;0;0;0;-1;0;112876279;112879028;51377
714;1.16616e-14;4;1674;24706;19733;1;610;-2.14748e+09;-6.52393e+07;-1;0;0;0;-1;0;113962459;113965331;53535
714;1.1555e-14;0;1589;24192;19613;1;594;-2.14748e+09;-6.52393e+07;-1;0;0;0;-1;0;113962459;113965331;53535
715;1.16616e-14;4;1674;24706;19733;1;610;-2.14748e+09;-6.44635e+07;-1;0;0;0;-1;0;115045897;115048897;55762
715;1.1555e-14;0;1589;24192;19613;1;594;-2.14748e+09;-6.44635e+07;-1;0;0;0;-1;0;115045897;115048897;55762
716;1.16616e-14;2;1674;24706;19733;1;610;-2.14748e+09;-6.37024e+07;-1;0;0;0;-1;0;116126550;116129683;58057
716;1.1555e-14;-1;1589;24192;19613;1;594;-2.14748e+09;-6.37024e+07;0;0;0;0;0;0;116126550;116129683;58057
717;1.16616e-14;0;1674;24706;19733;1;610;-2.14748e+09;-6.29556e+07;-1;0;0;0;-1;0;117204376;117207645;60422
717;1.1555e-14;-1;1588;24192;19613;1;594;-2.14748e+09;-6.29556e+07;0;0;0;0;0;0;117204376;117207645;60422
718;1.16616e-14;0;1674;24706;19733;1;610;-2.14748e+09;-6.22226e+07;-1;0;0;0;-1;0;118279333;118282744;62859
718;1.1555e-14;-1;1588;24192;19613;1;594;-2.14748e+09;-6.22226e+07;-1;0;0;0;-1;0;118279333;118282744;62859
719;1.16616e-14;-1;1674;24706;19733;1;610;-2.14748e+09;-6.15032e+07;0;0;0;0;0;0;119351383;119354940;65369
719;1.1555e-14;-1;1588;24192;19613;1;594;-2.14748e+09;-6.15032e+07;-1;0;0;0;-1;0;119351383;119354940;65369
720;1.16616e-14;-2;1674;24706;19733;1;610;-2.14748e+09;-6.07972e+07;0;0;0;0;0;0;120420489;120424197;67953
720;1.1555e-14;-1;1588;24192;19613;1;594;-2.14748e+09;-6.07972e+07;-1;0;0;0;-1;0;120420489;120424197;67953
721;1.16616e-14;-2;1674;24706;19733;1;610;-2.14748e+09;-6.01041e+07;-1;0;0;0;-1;0;121486616;121490479;70612
721;1.1555e-14;-2;1588;24192;19613;1;594;-2.14748e+09;-6.01041e+07;0;0;0;0;0;0;121486616;121490479;70612
722;1.16616e-14;-3;1674;24706;19733;1;610;-2.14748e+09;-5.94236e+07;0;0;0;0;0;0;122549729;122553753;73348
722;1.1555e-14;-2;1588;24192;19613;1;594;-2.14748e+09;-5.94236e+07;-1;0;0;0;-1;0;122549729;122553753;73348
723;1.16616e-14;-4;1674;24706;19733;1;610;-2.14748e+09;-5.87556e+07;0;0;0;0;0;0;123609795;123613985;76163
723;1.1555e-14;-3;1588;24192;19613;1;594;-2.14748e+09;-5.87555e+07;0;0;0;0;0;0;123609795;123613985;76163
724;1.16616e-14;-5;1674;24706;19733;1;610;-2.14748e+09;-5.80994e+07;0;0;0;0;0;0;124666785;124671146;79057
724;1.1555e-14;-4;1588;24192;19613;1;594;-2.14748e+09;-5.80994e+07;0;0;0;0;0;0;124666785;124671146;79057
725;1.16616e-14;-5;1674;24706;19733;1;610;-2.14748e+09;-5.74551e+07;-1;0;0;0;-1;0;125720668;125725205;82031
725;1.1555e-14;-4;1588;24192;19613;1;594;-2.14748e+09;-5.74551e+07;-1;0;0;0;-1;0;125720668;125725205;82031
726;1.16616e-14;-6;1674;24706;19733;1;610;-2.14748e+09;-5.68223e+07;0;0;0;0;0;0;126771416;126776136;85088
726;1.1555e-14;-5;1588;24192;19613;1;594;-2.14748e+09;-5.68223e+07;0;0;0;0;0;0;126771416;126776136;85088
727;1.16616e-14;-6;1674;24706;19733;1;610;-2.14748e+09;-5.62006e+07;-1;0;0;0;-1;0;127819003;127823911;88228
727;1.1555e-14;-5;1588;24192;19613;1;594;-2.14748e+09;-5.62006e+07;-1;0;0;0;-1;0;127819003;127823911;88228
728;1.16616e-14;-7;1674;24706;19733;1;610;-2.14748e+09;-5.55901e+07;0;0;0;0;0;0;128863404;128868505;91453
728;1.1555e-14;-5;1588;24192;19613;1;594;-2.14748e+09;-5.55901e+07;-1;0;0;0;-1;0;128863404;128868505;91453
729;1.16616e-14;-8;1674;24706;19733;1;610;-2.14748e+09;-5.499e+07;0;0;0;0;0;0;129904594;129909895;94763
729;1.1555e-14;-5;1588;24192;19613;1;594;-2.14748e+09;-5.499e+07;-1;0;0;0;-1;0;129904594;129909894;94763
730;1.16616e-14;-9;1674;24706;19733;1;610;-2.14748e+09;-5.44004e+07;0;0;0;0;0;0;130942550;130948056;98161
730;1.1555e-14;-5;1587;24192;19613;1;594;-2.14748e+09;-5.44004e+07;0;0;0;0;0;0;130942550;130948056;98161
731;1.16616e-14;-10;1674;24706;19733;1;610;-2.14748e+09;-5.38211e+07;0;0;0;0;0;0;131977251;131982970;101648
731;1.1555e-14;-5;1587;24192;19613;1;594;-2.14748e+09;-5.38211e+07;-1;0;0;0;-1;0;131977251;131982970;101648
732;1.16616e-14;-10;1674;24706;19733;1;610;-2.14748e+09;-5.32518e+07;-1;0;0;0;-1;0;133008677;133014614;105224
732;1.1555e-14;-5;1587;24192;19613;1;594;-2.14748e+09;-5.32518e+07;-1;0;0;0;-1;0;133008677;133014614;105224
733;1.16616e-14;-11;1674;24706;19733;1;610;-2.14748e+09;-5.26921e+07;0;0;0;0;0;0;134036809;134042970;108892
733;1.1555e-14;-5;1587;24192;19613;1;594;-2.14748e+09;-5.26921e+07;-1;0;0;0;-1;0;134036809;134042970;108892
734;1.16616e-14;-12;1674;24706;19733;1;610;-2.14748e+09;-5.2142e+07;0;0;0;0;0;0;135061629;135068021;112652
734;1.1555e-14;-5;1587;24192;19613;1;594;-2.14748e+09;-5.2142e+07;-1;0;0;0;-1;0;135061629;135068021;112652
735;1.16616e-14;-12;1674;24706;19733;1;610;-2.14748e+09;-5.16013e+07;-1;0;0;0;-1;0;136083119;136089749;116505
735;1.1555e-14;-5;1587;24192;19613;1;594;-2.14748e+09;-5.16013e+07;-1;0;0;0;-1;0;136083119;136089749;116505
736;1.16616e-14;-13;1674;24706;19733;1;610;-2.14748e+09;-5.10696e+07;0;0;0;0;0;0;137101264;137108138;120454
736;1.1555e-14;-5;1587;24192;19613;1;594;-2.14748e+09;-5.10696e+07;-1;0;0;0;-1;0;137101264;137108138;120454
737;1.16616e-14;-14;1674;24706;19733;1;610;-2.14748e+09;-5.05468e+07;0;0;0;0;0;0;138116049;138123175;124499
737;1.1555e-14;-5;1587;24192;19613;1;594;-2.14748e+09;-5.05468e+07;-1;0;0;0;-1;0;138116049;138123175;124499
738;1.16616e-14;-15;1674;24706;19733;1;610;-2.14748e+09;-5.00327e+07;0;0;0;0;0;0;139127460;139134844;128642
738;1.1555e-14;-5;1587;24192;19613;1;594;-2.14748e+09;-5.00327e+07;-1;0;0;0;-1;0;139127460;139134844;128642
739;1.16616e-14;-16;1674;24706;19733;1;610;-2.14748e+09;-4.95272e+07;0;0;0;0;0;0;140135485;140143135;132884
739;1.1555e-14;-5;1587;24192;19613;1;594;-2.14748e+09;-4.95272e+07;-1;0;0;0;-1;0;140135485;140143135;132884
740;1.16616e-14;-16;1674;24706;19733;1;610;-2.14748e+09;-4.90299e+07;-1;0;0;0;-1;0;141140112;141148035;137225
740;1.1555e-14;-6;1587;24192;19613;1;594;-2.14748e+09;-4.90299e+07;0;0;0;0;0;0;141140112;141148035;137225
741;1.16616e-14;-17;1674;24706;19733;1;610;-2.14748e+09;-4.85408e+07;0;0;0;0;0;0;142141329;142149532;141668
741;1.1555e-14;-6;1587;24192;19613;1;594;-2.14748e+09;-4.85408e+07;-1;0;0;0;-1;0;142141329;142149532;141668
742;1.16616e-14;-17;1674;24706;19733;1;610;-2.14748e+09;-4.80597e+07;-1;0;0;0;-1;0;143139127;143147618;146214
742;1.1555e-14;-6;1587;24192;19613;1;594;-2.14748e+09;-4.80597e+07;-1;0;0;0;-1;0;143139127;143147618;146214
743;1.16616e-14;-17;1674;24706;19733;1;610;-2.14748e+09;-4.75863e+07;-1;0;0;0;-1;0;144133496;144142283;150864
743;1.1555e-14;-6;1587;24192;19613;1;594;-2.14748e+09;-4.75863e+07;-1;0;0;0;-1;0;144133496;144142283;150864
744;1.16616e-14;-17;1674;24706;19733;1;610;-2.14748e+09;-4.71205e+07;-1;0;0;0;-1;0;145124429;145133519;155618
744;1.1555e-14;-7;1587;24192;19613;1;594;-2.14748e+09;-4.71205e+07;0;0;0;0;0;0;145124429;145133519;155618
745;1.16616e-14;-17;1674;24706;19733;1;610;-2.14748e+09;-4.66622e+07;-1;0;0;0;-1;0;146111917;146121319;160479
745;1.1555e-14;-7;1587;24192;19613;1;594;-2.14748e+09;-4.66622e+07;-1;0;0;0;-1;0;146111917;146121319;160479
746;1.16616e-14;-17;1674;24706;19733;1;610;-2.14748e+09;-4.62112e+07;-1;0;0;0;-1;0;147095954;147105676;165448
746;1.1555e-14;-8;1587;24192;19613;1;594;-2.14748e+09;-4.62112e+07;0;0;0;0;0;0;147095954;147105676;165448
747;1.16616e-14;-17;1674;24706;19733;1;610;-2.14748e+09;-4.57674e+07;-1;0;0;0;-1;0;148076534;148086584;170525
747;1.1555e-14;-8;1587;24192;19613;1;594;-2.14748e+09;-4.57674e+07;-1;0;0;0;-1;0;148076534;148086584;170525
748;1.16616e-14;-17;1674;24706;19733;1;610;-2.14748e+09;-4.53305e+07;-1;0;0;0;-1;0;149053653;149064038;175712
748;1.1555e-14;-9;1587;24192;19613;1;594;-2.14748e+09;-4.53305e+07;0;0;0;0;0;0;149053653;149064038;175712
749;1.16616e-14;-17;1674;24706;19733;1;610;-2.14748e+09;-4.49004e+07;-1;0;0;0;-1;0;150027304;150038034;181010
749;1.1555e-14;-9;1587;24192;19613;1;594;-2.14748e+09;-4.49004e+07;-1;0;0;0;-1;0;150027304;150038034;181010
750;1.16616e-14;-17;1674;24706;19733;1;610;-2.14748e+09;-4.44771e+07;-1;0;0;0;-1;0;150997485;151008568;186421
750;1.1555e-14;-10;1587;24192;19613;1;594;-2.14748e+09;-4.44771e+07;0;0;0;0;0;0;150997485;151008568;186421
751;1.16616e-14;-17;1674;24706;19733;1;610;-2.14748e+09;-4.40603e+07;-1;0;0;0;-1;0;151964192;151975638;191945
751;1.1555e-14;-10;1587;24192;19613;1;594;-2.14748e+09;-4.40603e+07;-1;0;0;0;-1;0;151964192;151975638;191945
752;1.16616e-14;-18;1674;24706;19733;1;610;-2.14748e+09;-4.36499e+07;0;0;0;0;0;0;152927424;152939241;197584
752;1.1555e-14;-10;1587;24192;19613;1;594;-2.14748e+09;-4.36499e+07;-1;0;0;0;-1;0;152927424;152939241;197584
753;1.16616e-14;-19;1674;24706;19733;1;610;-2.14748e+09;-4.32458e+07;0;0;0;0;0;0;153887177;153899375;203339
753;1.1555e-14;-10;1587;24192;19613;1;594;-2.14748e+09;-4.32458e+07;-1;0;0;0;-1;0;153887177;153899375;203339
754;1.16616e-14;-20;1674;24706;19733;1;610;-2.14748e+09;-4.28479e+07;0;0;0;0;0;0;154843452;154856039;209211
754;1.1555e-14;-10;1587;24192;19613;1;594;-2.14748e+09;-4.28479e+07;-1;0;0;0;-1;0;154843452;154856039;209211
755;1.16616e-14;-21;1674;24706;19733;1;610;-2.14748e+09;-4.2456e+07;0;0;0;0;0;0;155796247;155809233;215201
755;1.1555e-14;-10;1587;24192;19613;1;594;-2.14748e+09;-4.2456e+07;-1;0;0;0;-1;0;155796247;155809233;215201
756;1.16616e-14;-21;1674;24706;19733;1;610;-2.14748e+09;-4.207e+07;-1;0;0;0;-1;0;156745562;156758957;221310
756;1.1555e-14;-10;1587;24192;19613;1;594;-2.14748e+09;-4.207e+07;-1;0;0;0;-1;0;156745562;156758957;221310
757;1.16616e-14;-22;1674;24706;19733;1;610;-2.14748e+09;-4.16897e+07;0;0;0;0;0;0;157691398;157705212;227539
757;1.1555e-14;-10;1587;24192;19613;1;594;-2.14748e+09;-4.16897e+07;-1;0;0;0;-1;0;157691398;157705212;227539
758;1.16616e-14;-23;1674;24706;19733;1;610;-2.14748e+09;-4.13152e+07;0;0;0;0;0;0;158633756;158647998;233890
758;1.1555e-14;-10;1587;24192;19613;1;594;-2.14748e+09;-4.13152e+07;-1;0;0;0;-1;0;158633756;158647998;233890
759;1.16616e-14;-23;1674;24706;19733;1;610;-2.14748e+09;-4.09462e+07;-1;0;0;0;-1;0;159572638;159587318;240364
759;1.1555e-14;-11;1587;24192;19613;1;594;-2.14748e+09;-4.09462e+07;0;0;0;0;0;0;159572638;159587318;240364
760;1.16616e-14;-24;1674;24706;19733;1;610;-2.14748e+09;-4.05826e+07;0;0;0;0;0;0;160508045;160523173;246961
760;1.1555e-14;-11;1587;24192;19613;1;594;-2.14748e+09;-4.05826e+07;-1;0;0;0;-1;0;160508045;160523173;246961
761;1.16616e-14;-24;1674;24706;19733;1;610;-2.14748e+09;-4.02244e+07;-1;0;0;0;-1;0;161439981;161455567;253684
761;1.1555e-14;-12;1587;24192;19613;1;594;-2.14748e+09;-4.02244e+07;0;0;0;0;0;0;161439981;161455567;253684
762;1.16616e-14;-25;1674;24706;19733;1;610;-2.14748e+09;-3.98714e+07;0;0;0;0;0;0;162368447;162384503;260532
762;1.1555e-14;-12;1587;24192;19613;1;594;-2.14748e+09;-3.98714e+07;-1;0;0;0;-1;0;162368447;162384503;260532
763;1.16616e-14;-26;1674;24706;19733;1;610;-2.14748e+09;-3.95235e+07;0;0;0;0;0;0;163293449;163309984;267506
763;1.1555e-14;-13;1587;24192;19613;1;594;-2.14748e+09;-3.95235e+07;0;0;0;0;0;0;163293449;163309984;267506
764;1.16616e-14;-27;1674;24706;19733;1;610;-2.14748e+09;-3.91808e+07;0;0;0;0;0;0;164214989;164232014;274609
764;1.1555e-14;-14;1587;24192;19613;1;594;-2.14748e+09;-3.91808e+07;0;0;0;0;0;0;164214989;164232014;274609
765;1.16616e-14;-28;1674;24706;19733;1;610;-2.14748e+09;-3.88428e+07;0;0;0;0;0;0;165133072;165150598;281841
765;1.1555e-14;-15;1587;24192;19613;1;594;-2.14748e+09;-3.88428e+07;0;0;0;0;0;0;165133072;165150598;281841
766;1.16616e-14;-29;1674;24706;19733;1;610;-2.14748e+09;-3.85097e+07;0;0;0;0;0;0;166047702;166065741;289202
766;1.1555e-14;-16;1587;24192;19613;1;594;-2.14748e+09;-3.85097e+07;0;0;0;0;0;0;166047702;166065741;289202
767;1.16616e-14;-29;1674;24706;19733;1;610;-2.14748e+09;-3.81813e+07;-1;0;0;0;-1;0;166958886;166977448;296695
767;1.1555e-14;-16;1587;24192;19613;1;594;-2.14748e+09;-3.81813e+07;-1;0;0;0;-1;0;166958886;166977448;296695
768;1.16616e-14;-30;1674;24706;19733;1;610;-2.14748e+09;-3.78576e+07;0;0;0;0;0;0;167866628;167885724;304320
768;1.1555e-14;-17;1587;24192;19613;1;594;-2.14748e+09;-3.78576e+07;0;0;0;0;0;0;167866628;167885724;304320
769;1.16616e-14;-31;1674;24706;19733;1;610;-2.14748e+09;-3.75384e+07;0;0;0;0;0;0;168770934;168790577;312077
769;1.1555e-14;-18;1587;24192;19613;1;594;-2.14748e+09;-3.75384e+07;0;0;0;0;0;0;168770934;168790577;312077
770;1.16616e-14;-31;1674;24706;19733;1;610;-2.14748e+09;-3.72237e+07;-1;0;0;0;-1;0;169671811;169692012;319969
770;1.1555e-14;-19;1587;24192;19613;1;594;-2.14748e+09;-3.72237e+07;0;0;0;0;0;0;169671811;169692012;319969
771;1.16616e-14;-31;1674;24706;19733;1;610;-2.14748e+09;-3.69134e+07;-1;0;0;0;-1;0;170569266;170590035;327995
771;1.1555e-14;-20;1587;24192;19613;1;594;-2.14748e+09;-3.69134e+07;0;0;0;0;0;0;170569266;170590035;327995
772;1.16616e-14;-31;1674;24706;19733;1;610;-2.14748e+09;-3.66073e+07;-1;0;0;0;-1;0;171463304;171484655;336157
772;1.1555e-14;-21;1587;24192;19613;1;594;-2.14748e+09;-3.66073e+07;0;0;0;0;0;0;171463304;171484655;336157
773;1.16616e-14;-31;1674;24706;19733;1;610;-2.14748e+09;-3.63055e+07;-1;0;0;0;-1;0;172353933;172375878;344456
773;1.1555e-14;-21;1587;24192;19613;1;594;-2.14748e+09;-3.63055e+07;-1;0;0;0;-1;0;172353933;172375878;344456
774;1.16616e-14;-32;1674;24706;19733;1;610;-2.14748e+09;-3.60078e+07;0;0;0;0;0;0;173241162;173263712;352892
774;1.1555e-14;-21;1587;24192;19613;1;594;-2.14748e+09;-3.60078e+07;-1;0;0;0;-1;0;173241162;173263712;352892
775;1.16616e-14;-32;1674;24706;19733;1;610;-2.14748e+09;-3.57142e+07;-1;0;0;0;-1;0;174124997;174148165;361467
775;1.1555e-14;-22;1587;24192;19613;1;594;-2.14748e+09;-3.57142e+07;0;0;0;0;0;0;174124997;174148165;361467
776;1.16616e-14;-32;1674;24706;19733;1;610;-2.14748e+09;-3.54246e+07;-1;0;0;0;-1;0;175005447;175029246;370182
776;1.1555e-14;-22;1587;24192;19613;1;594;-2.14748e+09;-3.54246e+07;-1;0;0;0;-1;0;175005447;175029246;370182
777;1.16616e-14;-33;1674;24706;19733;1;610;-2.14748e+09;-3.51389e+07;0;0;0;0;0;0;175882520;175906962;379036
777;1.1555e-14;-22;1586;24192;19613;1;594;-2.14748e+09;-3.51389e+07;0;0;0;0;0;0;175882520;175906962;379036
778;1.16616e-14;-33;1674;24706;19733;1;610;-2.14748e+09;-3.4857e+07;-1;0;0;0;-1;0;176756225;176781323;388032
778;1.1555e-14;-23;1586;24192;19613;1;594;-2.14748e+09;-3.4857e+07;0;0;0;0;0;0;176756225;176781323;388032
779;1.16616e-14;-33;1674;24706;19733;1;610;-2.14748e+09;-3.45788e+07;-1;0;0;0;-1;0;177626570;177652338;397170
779;1.1555e-14;-24;1586;24192;19613;1;594;-2.14748e+09;-3.45788e+07;0;0;0;0;0;0;177626570;177652338;397170
780;1.16616e-14;-33;1674;24706;19733;1;610;-2.14748e+09;-3.43044e+07;-1;0;0;0;-1;0;178493566;178520015;406451
780;1.1555e-14;-25;1586;24192;19613;1;594;-2.14748e+09;-3.43044e+07;0;0;0;0;0;0;178493566;178520015;406451
781;1.16616e-14;-34;1674;24706;19733;1;610;-2.14748e+09;-3.40337e+07;0;0;0;0;0;0;179357220;179384365;415876
781;1.1555e-14;-25;1586;24192;19613;1;594;-2.14748e+09;-3.40336e+07;-1;0;0;0;-1;0;179357220;179384365;415876
782;1.16616e-14;-35;1674;24706;19733;1;610;-2.14748e+09;-3.37664e+07;0;0;0;0;0;0;180217543;180245398;425445
782;1.1555e-14;-26;1586;24192;19613;1;594;-2.14748e+09;-3.37664e+07;0;0;0;0;0;0;180217543;180245398;425445
783;1.16616e-14;-35;1674;24706;19733;1;610;-2.14748e+09;-3.35027e+07;-1;0;0;0;-1;0;181074545;181103122;435159
783;1.1555e-14;-26;1586;24192;19613;1;594;-2.14748e+09;-3.35027e+07;-1;0;0;0;-1;0;181074545;181103122;435159
784;1.16616e-14;-35;1674;24706;19733;1;610;-2.14748e+09;-3.32423e+07;-1;0;0;0;-1;0;181928235;181957549;445019
784;1.1555e-14;-27;1586;24192;19613;1;594;-2.14748e+09;-3.32423e+07;0;0;0;0;0;0;181928235;181957549;445019
785;1.16616e-14;-36;1674;24706;19733;1;610;-2.14748e+09;-3.29854e+07;0;0;0;0;0;0;182778623;182808688;455026
785;1.1555e-14;-28;1586;24192;19613;1;594;-2.14748e+09;-3.29854e+07;0;0;0;0;0;0;182778623;182808688;455026
786;1.16616e-14;-36;1674;24706;19733;1;610;-2.14748e+09;-3.27317e+07;-1;0;0;0;-1;0;183625721;183656550;465181
786;1.1555e-14;-29;1586;24192;19613;1;594;-2.14748e+09;-3.27317e+07;0;0;0;0;0;0;183625721;183656550;465181
787;1.16616e-14;-37;1674;24706;19733;1;610;-2.14748e+09;-3.24814e+07;0;0;0;0;0;0;184469538;184501146;475484
787;1.1555e-14;-30;1586;24192;19613;1;594;-2.14748e+09;-3.24814e+07;0;0;0;0;0;0;184469538;184501146;475484
788;1.16616e-14;-37;1674;24706;19733;1;610;-2.14748e+09;-3.22343e+07;-1;0;0;0;-1;0;185310085;185342486;485936
788;1.1555e-14;-30;1586;24192;19613;1;594;-2.14748e+09;-3.22343e+07;-1;0;0;0;-1;0;185310085;185342486;485936
789;1.16616e-14;-37;1673;24706;19733;1;610;-2.14748e+09;-3.19902e+07;0;0;0;0;0;0;186147373;186180582;496537
789;1.1555e-14;-31;1586;24192;19613;1;594;-2.14748e+09;-3.19902e+07;0;0;0;0;0;0;186147373;186180582;496537
790;1.16616e-14;-37;1673;24706;19733;1;610;-2.14748e+09;-3.17492e+07;-1;0;0;0;-1;0;186981414;187015445;507289
790;1.1555e-14;-32;1586;24192;19613;1;594;-2.14748e+09;-3.17492e+07;0;0;0;0;0;0;186981414;187015445;507289
791;1.16616e-14;-38;1673;24706;19733;1;610;-2.14748e+09;-3.15113e+07;0;0;0;0;0;0;187812217;187847086;518192
791;1.1555e-14;-32;1586;24192;19613;1;594;-2.14748e+09;-3.15113e+07;-1;0;0;0;-1;0;187812217;187847086;518192
792;1.16616e-14;-38;1673;24706;19733;1;610;-2.14748e+09;-3.12764e+07;-1;0;0;0;-1;0;188639795;188675517;529247
792;1.1555e-14;-32;1586;24192;19613;1;594;-2.14748e+09;-3.12764e+07;-1;0;0;0;-1;0;188639795;188675517;529247
793;1.16616e-14;-39;1673;24706;19733;1;610;-2.14748e+09;-3.10444e+07;0;0;0;0;0;0;189464159;189500748;540455
793;1.1555e-14;-33;1586;24192;19613;1;594;-2.14748e+09;-3.10444e+07;0;0;0;0;0;0;189464159;189500748;540455
794;1.16616e-14;-39;1673;24706;19733;1;610;-2.14748e+09;-3.08153e+07;-1;0;0;0;-1;0;190285320;190322793;551815
794;1.1555e-14;-34;1586;24192;19613;1;594;-2.14748e+09;-3.08153e+07;0;0;0;0;0;0;190285320;190322793;551815
795;1.16616e-14;-40;1673;24706;19733;1;610;-2.14748e+09;-3.0589e+07;0;0;0;0;0;0;191103291;191141662;563329
795;1.1555e-14;-34;1586;24192;19613;1;594;-2.14748e+09;-3.0589e+07;-1;0;0;0;-1;0;191103291;191141662;563329
796;1.16616e-14;-40;1673;24706;19733;1;610;-2.14748e+09;-3.03654e+07;-1;0;0;0;-1;0;191918082;191957367;574997
796;1.1555e-14;-35;1586;24192;19613;1;594;-2.14748e+09;-3.03654e+07;0;0;0;0;0;0;191918082;191957367;574997
797;1.16616e-14;-40;1673;24706;19733;1;610;-2.14748e+09;-3.01447e+07;-1;0;0;0;-1;0;192729706;192769921;586820
797;1.1555e-14;-36;1586;24192;19613;1;594;-2.14748e+09;-3.01447e+07;0;0;0;0;0;0;192729706;192769921;586820
798;1.16616e-14;-41;1673;24706;19733;1;610;-2.14748e+09;-2.99265e+07;0;0;0;0;0;0;193538174;193579336;598799
798;1.1555e-14;-37;1586;24192;19613;1;594;-2.14748e+09;-2.99265e+07;0;0;0;0;0;0;193538174;193579336;598799
799;1.16616e-14;-41;1673;24706;19733;1;610;-2.14748e+09;-2.97111e+07;-1;0;0;0;-1;0;194343500;194385624;610933
799;1.1555e-14;-37;1586;24192;19613;1;594;-2.14748e+09;-2.97111e+07;-1;0;0;0;-1;0;194343500;194385624;610933
800;1.16616e-14;-42;1673;24706;19733;1;610;-2.14748e+09;-2.94982e+07;0;0;0;0;0;0;195145695;195188797;623224
800;1.1555e-14;-37;1586;24192;19613;1;594;-2.14748e+09;-2.94982e+07;-1;0;0;0;-1;0;195145695;195188797;623224
801;1.16616e-14;-42;1673;24706;19733;1;610;-2.14748e+09;-2.92879e+07;-1;0;0;0;-1;0;195944770;195988868;635672
801;1.1555e-14;-38;1586;24192;19613;1;594;-2.14748e+09;-2.92879e+07;0;0;0;0;0;0;195944770;195988868;635672
802;1.16616e-14;-42;1673;24706;19733;1;610;-2.14748e+09;-2.90801e+07;-1;0;0;0;-1;0;196740740;196785849;648278
802;1.1555e-14;-38;1586;24192;19613;1;594;-2.14748e+09;-2.90801e+07;-1;0;0;0;-1;0;196740740;196785849;648278
803;1.16616e-14;-42;1673;24706;19733;1;610;-2.14748e+09;-2.88747e+07;-1;0;0;0;-1;0;197533615;197579753;661042
803;1.1555e-14;-38;1586;24192;19613;1;594;-2.14748e+09;-2.88747e+07;-1;0;0;0;-1;0;197533615;197579753;661042
804;1.16616e-14;-42;1673;24706;19733;1;610;-2.14748e+09;-2.86718e+07;-1;0;0;0;-1;0;198323408;198370592;673964
804;1.1555e-14;-38;1586;24192;19613;1;594;-2.14748e+09;-2.86718e+07;-1;0;0;0;-1;0;198323408;198370592;673964
805;1.16616e-14;-42;1673;24706;19733;1;610;-2.14748e+09;-2.84713e+07;-1;0;0;0;-1;0;199110133;199158379;687046
805;1.1555e-14;-38;1586;24192;19613;1;594;-2.14748e+09;-2.84713e+07;-1;0;0;0;-1;0;199110133;199158379;687046
806;1.16616e-14;-42;1673;24706;19733;1;610;-2.14748e+09;-2.82731e+07;-1;0;0;0;-1;0;199893801;199943127;700287
806;1.1555e-14;-38;1586;24192;19613;1;594;-2.14748e+09;-2.82731e+07;-1;0;0;0;-1;0;199893801;199943127;700287
807;1.16616e-14;-43;1673;24706;19733;1;610;-2.14748e+09;-2.80773e+07;0;0;0;0;0;0;200674426;200724848;713688
807;1.1555e-14;-39;1586;24192;19613;1;594;-2.14748e+09;-2.80773e+07;0;0;0;0;0;0;200674426;200724848;713688
808;1.16616e-14;-44;1673;24706;19733;1;610;-2.14748e+09;-2.78837e+07;0;0;0;0;0;0;201452019;201503556;727249
808;1.1555e-14;-40;1586;24192;19613;1;594;-2.14748e+09;-2.78837e+07;0;0;0;0;0;0;201452019;201503556;727249
809;1.16616e-14;-45;1673;24706;19733;1;610;-2.14748e+09;-2.76923e+07;0;0;0;0;0;0;202226593;202279263;740971
809;1.1555e-14;-41;1586;24192;19613;1;594;-2.14748e+09;-2.76923e+07;0;0;0;0;0;0;202226593;202279263;740971
810;1.16616e-14;-46;1673;24706;19733;1;610;-2.14748e+09;-2.75033e+07;0;0;0;0;0;0;202998163;203051983;754854
810;1.1555e-14;-42;1586;24192;19613;1;594;-2.14748e+09;-2.75033e+07;0;0;0;0;0;0;202998163;203051983;754854
811;1.16616e-14;-47;1673;24706;19733;1;610;-2.14748e+09;-2.73162e+07;0;0;0;0;0;0;203766739;203821727;768899
811;1.1555e-14;-43;1586;24192;19613;1;594;-2.14748e+09;-2.73162e+07;0;0;0;0;0;0;203766739;203821727;768899
812;1.16616e-14;-47;1673;24706;19733;1;610;-2.14748e+09;-2.71313e+07;-1;0;0;0;-1;0;204532335;204588510;783106
812;1.1555e-14;-43;1586;24192;19613;1;594;-2.14748e+09;-2.71313e+07;-1;0;0;0;-1;0;204532335;204588510;783106
813;1.16616e-14;-48;1673;24706;19733;1;610;-2.14748e+09;-2.69485e+07;0;0;0;0;0;0;205294965;205352345;797476
813;1.1555e-14;-43;1586;24192;19613;1;594;-2.14748e+09;-2.69485e+07;-1;0;0;0;-1;0;205294965;205352345;797476
814;1.16616e-14;-49;1673;24706;19733;1;610;-2.14748e+09;-2.67678e+07;0;0;0;0;0;0;206054640;206113243;812008
814;1.1555e-14;-44;1586;24192;19613;1;594;-2.14748e+09;-2.67678e+07;0;0;0;0;0;0;206054640;206113243;812008
815;1.16616e-14;-50;1673;24706;19733;1;610;-2.14748e+09;-2.65892e+07;0;0;0;0;0;0;206811374;206871219;826703
815;1.1555e-14;-44;1586;24192;19613;1;594;-2.14748e+09;-2.65892e+07;-1;0;0;0;-1;0;206811374;206871219;826703
816;1.16616e-14;-50;1673;24706;19733;1;610;-2.14748e+09;-2.64125e+07;-1;0;0;0;-1;0;207565180;207626286;841561
816;1.1555e-14;-45;1586;24192;19613;1;594;-2.14748e+09;-2.64125e+07;0;0;0;0;0;0;207565180;207626286;841561
817;1.16616e-14;-51;1673;24706;19733;1;610;-2.14748e+09;-2.62378e+07;0;0;0;0;0;0;208316071;208378456;856583
817;1.1555e-14;-45;1586;24192;19613;1;594;-2.14748e+09;-2.62378e+07;-1;0;0;0;-1;0;208316071;208378456;856583
818;1.16616e-14;-51;1673;24706;19733;1;610;-2.14748e+09;-2.6065e+07;-1;0;0;0;-1;0;209064059;209127744;871769
818;1.1555e-14;-45;1586;24192;19613;1;594;-2.14748e+09;-2.6065e+07;-1;0;0;0;-1;0;209064059;209127744;871769
819;1.16616e-14;-51;1673;24706;19733;1;610;-2.14748e+09;-2.58941e+07;-1;0;0;0;-1;0;209809158;209874161;887120
819;1.1555e-14;-45;1586;24192;19613;1;594;-2.14748e+09;-2.58941e+07;-1;0;0;0;-1;0;209809158;209874161;887120
820;1.16616e-14;-52;1673;24706;19733;1;610;-2.14748e+09;-2.57251e+07;0;0;0;0;0;0;210551381;210617721;902634
820;1.1555e-14;-45;1586;24192;19613;1;594;-2.14748e+09;-2.57251e+07;-1;0;0;0;-1;0;210551381;210617721;902634
821;1.16616e-14;-53;1673;24706;19733;1;610;-2.14748e+09;-2.5558e+07;0;0;0;0;0;0;211290741;211358438;918314
821;1.1555e-14;-46;1586;24192;19613;1;594;-2.14748e+09;-2.5558e+07;0;0;0;0;0;0;211290741;211358438;918314
822;1.16616e-14;-53;1673;24706;19733;1;610;-2.14748e+09;-2.53927e+07;-1;0;0;0;-1;0;212027250;212096324;934158
822;1.1555e-14;-46;1586;24192;19613;1;594;-2.14748e+09;-2.53927e+07;-1;0;0;0;-1;0;212027250;212096324;934158
823;1.16616e-14;-53;1673;24706;19733;1;610;-2.14748e+09;-2.52292e+07;-1;0;0;0;-1;0;212760922;212831393;950168
823;1.1555e-14;-46;1586;24192;19613;1;594;-2.14748e+09;-2.52292e+07;-1;0;0;0;-1;0;212760922;212831393;950168
824;1.16616e-14;-53;1673;24706;19733;1;610;-2.14748e+09;-2.50674e+07;-1;0;0;0;-1;0;213491770;213563658;966343
824;1.1555e-14;-47;1586;24192;19613;1;594;-2.14748e+09;-2.50674e+07;0;0;0;0;0;0;213491770;213563658;966343
825;1.16616e-14;-53;1673;24706;19733;1;610;-2.14748e+09;-2.49074e+07;-1;0;0;0;-1;0;214219807;214293132;982684
825;1.1555e-14;-47;1586;24192;19613;1;594;-2.14748e+09;-2.49074e+07;-1;0;0;0;-1;0;214219807;214293132;982684
826;1.16616e-14;-53;1673;24706;19733;1;610;-2.14748e+09;-2.47491e+07;-1;0;0;0;-1;0;214945046;215019828;999191
826;1.1555e-14;-47;1586;24192;19613;1;594;-2.14748e+09;-2.47491e+07;-1;0;0;0;-1;0;214945046;215019828;999191
827;1.16616e-14;-53;1673;24706;19733;1;610;-2.14748e+09;-2.45925e+07;-1;0;0;0;-1;0;215667500;215743759;1015864
827;1.1555e-14;-47;1586;24192;19613;1;594;-2.14748e+09;-2.45924e+07;-1;0;0;0;-1;0;215667500;215743759;1015864
828;1.16616e-14;-53;1673;24706;19733;1;610;-2.14748e+09;-2.44375e+07;-1;0;0;0;-1;0;216387181;216464939;1032703
828;1.1555e-14;-47;1586;24192;19613;1;594;-2.14748e+09;-2.44375e+07;-1;0;0;0;-1;0;216387181;216464939;1032703
829;1.16616e-14;-53;1673;24706;19733;1;610;-2.14748e+09;-2.42842e+07;-1;0;0;0;-1;0;217104103;217183380;1049708
829;1.1555e-14;-47;1586;24192;19613;1;594;-2.14748e+09;-2.42841e+07;-1;0;0;0;-1;0;217104103;217183380;1049708
830;1.16616e-14;-53;1673;24706;19733;1;610;-2.14748e+09;-2.41324e+07;-1;0;0;0;-1;0;217818279;217899096;1066879
830;1.1555e-14;-47;1586;24192;19613;1;594;-2.14748e+09;-2.41324e+07;-1;0;0;0;-1;0;217818279;217899096;1066879
831;1.16616e-14;-54;1673;24706;19733;1;610;-2.14748e+09;-2.39823e+07;0;0;0;0;0;0;218529722;218612100;1084217
831;1.1555e-14;-48;1586;24192;19613;1;594;-2.14748e+09;-2.39823e+07;0;0;0;0;0;0;218529722;218612100;1084217
832;1.16616e-14;-54;1673;24706;19733;1;610;-2.14748e+09;-2.38337e+07;-1;0;0;0;-1;0;219238444;219322404;1101722
832;1.1555e-14;-49;1586;24192;19613;1;594;-2.14748e+09;-2.38337e+07;0;0;0;0;0;0;219238444;219322404;1101722
833;1.16616e-14;-55;1673;24706;19733;1;610;-2.14748e+09;-2.36867e+07;0;0;0;0;0;0;219944459;220030023;1119394
833;1.1555e-14;-49;1586;24192;19613;1;594;-2.14748e+09;-2.36867e+07;-1;0;0;0;-1;0;219944459;220030023;1119394
834;1.16616e-14;-56;1673;24706;19733;1;610;-2.14748e+09;-2.35412e+07;0;0;0;0;0;0;220647779;220734968;1137232
834;1.1555e-14;-50;1586;24192;19613;1;594;-2.14748e+09;-2.35412e+07;0;0;0;0;0;0;220647779;220734968;1137232
835;1.16616e-14;-57;1673;24706;19733;1;610;-2.14748e+09;-2.33972e+07;0;0;0;0;0;0;221348418;221437254;1155238
835;1.1555e-14;-50;1586;24192;19613;1;594;-2.14748e+09;-2.33972e+07;-1;0;0;0;-1;0;221348418;221437254;1155238
836;1.16616e-14;-57;1673;24706;19733;1;610;-2.14748e+09;-2.32547e+07;-1;0;0;0;-1;0;222046388;222136892;1173410
836;1.1555e-14;-50;1586;24192;19613;1;594;-2.14748e+09;-2.32547e+07;-1;0;0;0;-1;0;222046388;222136892;1173410
837;1.16616e-14;-58;1673;24706;19733;1;610;-2.14748e+09;-2.31136e+07;0;0;0;0;0;0;222741701;222833896;1191750
837;1.1555e-14;-51;1586;24192;19613;1;594;-2.14748e+09;-2.31136e+07;0;0;0;0;0;0;222741701;222833896;1191750
838;1.16616e-14;-58;1673;24706;19733;1;610;-2.14748e+09;-2.29739e+07;-1;0;0;0;-1;0;223434371;223528279;1210256
838;1.1555e-14;-51;1586;24192;19613;1;594;-2.14748e+09;-2.29739e+07;-1;0;0;0;-1;0;223434371;223528279;1210256
839;1.16616e-14;-59;1673;24706;19733;1;610;-2.14748e+09;-2.28357e+07;0;0;0;0;0;0;224124411;224220053;1228930
839;1.1555e-14;-51;1586;24192;19613;1;594;-2.14748e+09;-2.28357e+07;-1;0;0;0;-1;0;224124411;224220053;1228930
840;1.16616e-14;-59;1673;24706;19733;1;610;-2.14748e+09;-2.26989e+07;-1;0;0;0;-1;0;224811832;224909232;1247771
840;1.1555e-14;-51;1586;24192;19613;1;594;-2.14748e+09;-2.26989e+07;-1;0;0;0;-1;0;224811832;224909232;1247771
841;1.16616e-14;-60;1673;24706;19733;1;610;-2.14748e+09;-2.25634e+07;0;0;0;0;0;0;225496649;225595828;1266779
841;1.1555e-14;-51;1586;24192;19613;1;594;-2.14748e+09;-2.25634e+07;-1;0;0;0;-1;0;225496649;225595828;1266779
842;1.16616e-14;-61;1673;24706;19733;1;610;-2.14748e+09;-2.24293e+07;0;0;0;0;0;0;226178873;226279854;1285954
842;1.1555e-14;-52;1586;24192;19613;1;594;-2.14748e+09;-2.24293e+07;0;0;0;0;0;0;226178873;226279854;1285954
843;1.16616e-14;-62;1673;24706;19733;1;610;-2.14748e+09;-2.22966e+07;0;0;0;0;0;0;226858517;226961324;1305296
843;1.1555e-14;-52;1586;24192;19613;1;594;-2.14748e+09;-2.22966e+07;-1;0;0;0;-1;0;226858517;226961324;1305296
844;1.16616e-14;-63;1673;24706;19733;1;610;-2.14748e+09;-2.21651e+07;0;0;0;0;0;0;227535593;227640248;1324805
844;1.1555e-14;-52;1586;24192;19613;1;594;-2.14748e+09;-2.21651e+07;-1;0;0;0;-1;0;227535593;227640248;1324805
845;1.16616e-14;-63;1673;24706;19733;1;610;-2.14748e+09;-2.20349e+07;-1;0;0;0;-1;0;228210115;228316641;1344482
845;1.1555e-14;-53;1586;24192;19613;1;594;-2.14748e+09;-2.20349e+07;0;0;0;0;0;0;228210115;228316641;1344482
846;1.16616e-14;-63;1672;24706;19733;1;610;-2.14748e+09;-2.1906e+07;0;0;0;0;0;0;228882094;228990515;1364325
846;1.1555e-14;-53;1586;24192;19613;1;594;-2.14748e+09;-2.1906e+07;-1;0;0;0;-1;0;228882094;228990515;1364325
847;1.16616e-14;-63;1672;24706;19733;1;610;-2.14748e+09;-2.17784e+07;-1;0;0;0;-1;0;229551544;229661882;1384335
847;1.1555e-14;-53;1586;24192;19613;1;594;-2.14748e+09;-2.17784e+07;-1;0;0;0;-1;0;229551544;229661882;1384335
848;1.16616e-14;-63;1672;24706;19733;1;610;-2.14748e+09;-2.16521e+07;-1;0;0;0;-1;0;230218475;230330755;1404512
848;1.1555e-14;-53;1586;24192;19613;1;594;-2.14748e+09;-2.16521e+07;-1;0;0;0;-1;0;230218475;230330755;1404512
849;1.16616e-14;-64;1672;24706;19733;1;610;-2.14748e+09;-2.15269e+07;0;0;0;0;0;0;230882902;230997147;1424856
849;1.1555e-14;-54;1586;24192;19613;1;594;-2.14748e+09;-2.15269e+07;0;0;0;0;0;0;230882902;230997147;1424856
850;1.16616e-14;-64;1672;24706;19733;1;610;-2.14748e+09;-2.1403e+07;-1;0;0;0;-1;0;231544836;231661069;1445366
850;1.1555e-14;-55;1586;24192;19613;1;594;-2.14748e+09;-2.1403e+07;0;0;0;0;0;0;231544836;231661069;1445366
851;1.16616e-14;-65;1672;24706;19733;1;610;-2.14748e+09;-2.12802e+07;0;0;0;0;0;0;232204289;232322535;1466043
851;1.1555e-14;-56;1586;24192;19613;1;594;-2.14748e+09;-2.12802e+07;0;0;0;0;0;0;232204289;232322535;1466043
852;1.16616e-14;-65;1672;24706;19733;1;610;-2.14748e+09;-2.11587e+07;-1;0;0;0;-1;0;232861274;232981557;1486886
852;1.1555e-14;-56;1586;24192;19613;1;594;-2.14748e+09;-2.11587e+07;-1;0;0;0;-1;0;232861274;232981557;1486886
853;1.16616e-14;-65;1672;24706;19733;1;610;-2.14748e+09;-2.10383e+07;-1;0;0;0;-1;0;233515803;233638146;1507896
853;1.1555e-14;-56;1586;24192;19613;1;594;-2.14748e+09;-2.10383e+07;-1;0;0;0;-1;0;233515803;233638146;1507896
854;1.16616e-14;-66;1672;24706;19733;1;610;-2.14748e+09;-2.0919e+07;0;0;0;0;0;0;234167888;234292317;1529072
854;1.1555e-14;-57;1586;24192;19613;1;594;-2.14748e+09;-2.0919e+07;0;0;0;0;0;0;234167888;234292317;1529072
855;1.16616e-14;-67;1672;24706;19733;1;610;-2.14748e+09;-2.08009e+07;0;0;0;0;0;0;234817541;234944079;1550414
855;1.1555e-14;-57;1586;24192;19613;1;594;-2.14748e+09;-2.08009e+07;-1;0;0;0;-1;0;234817541;234944079;1550414
856;1.16616e-14;-68;1672;24706;19733;1;610;-2.14748e+09;-2.06839e+07;0;0;0;0;0;0;235464775;235593447;1571921
856;1.1555e-14;-57;1586;24192;19613;1;594;-2.14748e+09;-2.06839e+07;-1;0;0;0;-1;0;235464775;235593447;1571921
857;1.16616e-14;-69;1672;24706;19733;1;610;-2.14748e+09;-2.05679e+07;0;0;0;0;0;0;236109600;236240431;1593595
857;1.1555e-14;-58;1586;24192;19613;1;594;-2.14748e+09;-2.05679e+07;0;0;0;0;0;0;236109600;236240431;1593595
858;1.16616e-14;-69;1672;24706;19733;1;610;-2.14748e+09;-2.04531e+07;-1;0;0;0;-1;0;236752030;236885044;1615433
858;1.1555e-14;-59;1586;24192;19613;1;594;-2.14748e+09;-2.04531e+07;0;0;0;0;0;0;236752030;236885044;1615433
859;1.16616e-14;-69;1672;24706;19733;1;610;-2.14748e+09;-2.03394e+07;-1;0;0;0;-1;0;237392075;237527299;1637437
859;1.1555e-14;-60;1586;24192;19613;1;594;-2.14748e+09;-2.03394e+07;0;0;0;0;0;0;237392075;237527299;1637437
860;1.16616e-14;-69;1672;24706;19733;1;610;-2.14748e+09;-2.02267e+07;-1;0;0;0;-1;0;238029749;238167206;1659607
860;1.1555e-14;-61;1586;24192;19613;1;594;-2.14748e+09;-2.02267e+07;0;0;0;0;0;0;238029749;238167206;1659607
861;1.16616e-14;-69;1672;24706;19733;1;610;-2.14748e+09;-2.0115e+07;-1;0;0;0;-1;0;238665062;238804778;1681941
861;1.1555e-14;-61;1586;24192;19613;1;594;-2.14748e+09;-2.0115e+07;-1;0;0;0;-1;0;238665062;238804778;1681941
862;1.16616e-14;-70;1672;24706;19733;1;610;-2.14748e+09;-2.00044e+07;0;0;0;0;0;0;239298027;239440027;1704440
862;1.1555e-14;-62;1586;24192;19613;1;594;-2.14748e+09;-2.00044e+07;0;0;0;0;0;0;239298027;239440027;1704440
863;1.16616e-14;-71;1672;24706;19733;1;610;-2.14748e+09;-1.98948e+07;0;0;0;0;0;0;239928655;240072965;1727103
863;1.1555e-14;-62;1586;24192;19613;1;594;-2.14748e+09;-1.98948e+07;-1;0;0;0;-1;0;239928655;240072965;1727103
864;1.16616e-14;-71;1672;24706;19733;1;610;-2.14748e+09;-1.97862e+07;-1;0;0;0;-1;0;240556958;240703603;1749930
864;1.1555e-14;-62;1586;24192;19613;1;594;-2.14748e+09;-1.97862e+07;-1;0;0;0;-1;0;240556958;240703603;1749930
865;1.16616e-14;-72;1672;24706;19733;1;610;-2.14748e+09;-1.96787e+07;0;0;0;0;0;0;241182947;241331953;1772922
865;1.1555e-14;-63;1586;24192;19613;1;594;-2.14748e+09;-1.96787e+07;0;0;0;0;0;0;241182947;241331953;1772922
866;1.16616e-14;-72;1672;24706;19733;1;610;-2.14748e+09;-1.95719e+07;-1;0;0;0;-1;0;241806634;241958027;1796077
866;1.1555e-14;-63;1586;24192;19613;1;594;-2.14748e+09;-1.95719e+07;-1;0;0;0;-1;0;241806634;241958027;1796077
867;1.16616e-14;-73;1672;24706;19733;1;610;-2.14748e+09;-1.94663e+07;0;0;0;0;0;0;242428031;242581837;1819396
867;1.1555e-14;-63;1586;24192;19613;1;594;-2.14748e+09;-1.94663e+07;-1;0;0;0;-1;0;242428031;242581837;1819396
868;1.16616e-14;-74;1672;24706;19733;1;610;-2.14748e+09;-1.93615e+07;0;0;0;0;0;0;243047148;243203394;1842878
868;1.1555e-14;-64;1586;24192;19613;1;594;-2.14748e+09;-1.93615e+07;0;0;0;0;0;0;243047148;243203394;1842878
869;1.16616e-14;-75;1672;24706;19733;1;610;-2.14748e+09;-1.92578e+07;0;0;0;0;0;0;243663998;243822709;1866523
869;1.1555e-14;-65;1586;24192;19613;1;594;-2.14748e+09;-1.92578e+07;0;0;0;0;0;0;243663998;243822709;1866523
870;1.16616e-14;-75;1672;24706;19733;1;610;-2.14748e+09;-1.91549e+07;-1;0;0;0;-1;0;244278591;244439794;1890330
870;1.1555e-14;-65;1586;24192;19613;1;594;-2.14748e+09;-1.91549e+07;-1;0;0;0;-1;0;244278591;244439794;1890330
871;1.16616e-14;-76;1672;24706;19733;1;610;-2.14748e+09;-1.9053e+07;0;0;0;0;0;0;244890940;245054660;1914300
871;1.1555e-14;-65;1586;24192;19613;1;594;-2.14748e+09;-1.9053e+07;-1;0;0;0;-1;0;244890940;245054660;1914300
872;1.16616e-14;-77;1672;24706;19733;1;610;-2.14748e+09;-1.89519e+07;0;0;0;0;0;0;245501054;245667319;1938432
872;1.1555e-14;-65;1586;24192;19613;1;594;-2.14748e+09;-1.89519e+07;-1;0;0;0;-1;0;245501054;245667319;1938432
873;1.16616e-14;-78;1672;24706;19733;1;610;-2.14748e+09;-1.88518e+07;0;0;0;0;0;0;246108946;246277782;1962725
873;1.1555e-14;-65;1586;24192;19613;1;594;-2.14748e+09;-1.88518e+07;0;0;-1;0;0;-1;246108946;246277782;1962725
874;1.16616e-14;-79;1672;24706;19733;1;610;-2.14748e+09;-1.87526e+07;0;0;0;0;0;0;246714626;246886061;1987180
874;1.1555e-14;-66;1586;24192;19613;1;594;-2.14748e+09;-1.87526e+07;0;0;0;0;0;0;246714626;246886061;1987180
875;1.16616e-14;-80;1672;24706;19733;1;610;-2.14748e+09;-1.86542e+07;0;0;0;0;0;0;247318106;247492166;2011796
875;1.1555e-14;-66;1586;24192;19613;1;594;-2.14748e+09;-1.86542e+07;-1;0;0;0;-1;0;247318106;247492166;2011796
876;1.16616e-14;-81;1672;24706;19733;1;610;-2.14748e+09;-1.85566e+07;0;0;0;0;0;0;247919396;248096108;2036573
876;1.1555e-14;-67;1586;24192;19613;1;594;-2.14748e+09;-1.85566e+07;0;0;0;0;0;0;247919396;248096108;2036573
877;1.16616e-14;-81;1672;24706;19733;1;610;-2.14748e+09;-1.846e+07;-1;0;0;0;-1;0;248518508;248697899;2061510
877;1.1555e-14;-68;1586;24192;19613;1;594;-2.14748e+09;-1.846e+07;0;0;0;0;0;0;248518508;248697899;2061510
878;1.16616e-14;-81;1672;24706;19733;1;610;-2.14748e+09;-1.83641e+07;-1;0;0;0;-1;0;249115452;249297549;2086608
878;1.1555e-14;-69;1586;24192;19613;1;594;-2.14748e+09;-1.83641e+07;0;0;0;0;0;0;249115452;249297549;2086608
879;1.16616e-14;-82;1672;24706;19733;1;610;-2.14748e+09;-1.82691e+07;0;0;0;0;0;0;249710239;249895070;2111865
879;1.1555e-14;-69;1586;24192;19613;1;594;-2.14748e+09;-1.82691e+07;-1;0;0;0;-1;0;249710239;249895070;2111865
880;1.16616e-14;-83;1672;24706;19733;1;610;-2.14748e+09;-1.8175e+07;0;0;0;0;0;0;250302880;250490473;2137281
880;1.1555e-14;-70;1586;24192;19613;1;594;-2.14748e+09;-1.8175e+07;0;0;0;0;0;0;250302880;250490473;2137281
881;1.16616e-14;-83;1672;24706;19733;1;610;-2.14748e+09;-1.80816e+07;-1;0;0;0;-1;0;250893386;251083768;2162856
881;1.1555e-14;-70;1586;24192;19613;1;594;-2.14748e+09;-1.80816e+07;-1;0;0;0;-1;0;250893386;251083768;2162856
882;1.16616e-14;-83;1672;24706;19733;1;610;-2.14748e+09;-1.7989e+07;-1;0;0;0;-1;0;251481767;251674966;2188590
882;1.1555e-14;-70;1586;24192;19613;1;594;-2.14748e+09;-1.7989e+07;-1;0;0;0;-1;0;251481767;251674966;2188590
883;1.16616e-14;-83;1672;24706;19733;1;610;-2.14748e+09;-1.78972e+07;-1;0;0;0;-1;0;252068034;252264077;2214482
883;1.1555e-14;-71;1586;24192;19613;1;594;-2.14748e+09;-1.78972e+07;0;0;0;0;0;0;252068034;252264077;2214482
884;1.16616e-14;-84;1672;24706;19733;1;610;-2.14748e+09;-1.78062e+07;0;0;0;0;0;0;252652197;252851113;2240532
884;1.1555e-14;-71;1586;24192;19613;1;594;-2.14748e+09;-1.78062e+07;-1;0;0;0;-1;0;252652197;252851113;2240532
885;1.16616e-14;-84;1672;24706;19733;1;610;-2.14748e+09;-1.7716e+07;-1;0;0;0;-1;0;253234268;253436085;2266739
885;1.1555e-14;-71;1586;24192;19613;1;594;-2.14748e+09;-1.7716e+07;-1;0;0;0;-1;0;253234268;253436085;2266739
886;1.16616e-14;-85;1672;24706;19733;1;610;-2.14748e+09;-1.76265e+07;0;0;0;0;0;0;253814256;254019002;2293103
886;1.1555e-14;-72;1586;24192;19613;1;594;-2.14748e+09;-1.76265e+07;0;0;0;0;0;0;253814256;254019002;2293103
887;1.16616e-14;-85;1672;24706;19733;1;610;-2.14748e+09;-1.75378e+07;-1;0;0;0;-1;0;254392172;254599875;2319624
887;1.1555e-14;-72;1586;24192;19613;1;594;-2.14748e+09;-1.75378e+07;-1;0;0;0;-1;0;254392172;254599875;2319624
888;1.16616e-14;-85;1672;24706;19733;1;610;-2.14748e+09;-1.74498e+07;-1;0;0;0;-1;0;254968026;255178714;2346301
888;1.1555e-14;-73;1586;24192;19613;1;594;-2.14748e+09;-1.74498e+07;0;0;0;0;0;0;254968026;255178714;2346301
889;1.16616e-14;-85;1672;24706;19733;1;610;-2.14748e+09;-1.73625e+07;-1;0;0;0;-1;0;255541829;255755531;2373134
889;1.1555e-14;-74;1586;24192;19613;1;594;-2.14748e+09;-1.73625e+07;0;0;0;0;0;0;255541829;255755531;2373134
890;1.16616e-14;-85;1672;24706;19733;1;610;-2.14748e+09;-1.72761e+07;-1;0;0;0;-1;0;256113590;256330335;2400122
890;1.1555e-14;-75;1586;24192;19613;1;594;-2.14748e+09;-1.7276e+07;0;0;0;0;0;0;256113590;256330335;2400122
891;1.16616e-14;-85;1672;24706;19733;1;610;-2.14748e+09;-1.71902e+07;-1;0;0;0;-1;0;256683320;256903136;2427265
891;1.1555e-14;-75;1586;24192;19613;1;594;-2.14748e+09;-1.71902e+07;-1;0;0;0;-1;0;256683320;256903136;2427265
892;1.16616e-14;-85;1672;24706;19733;1;610;-2.14748e+09;-1.71052e+07;-1;0;0;0;-1;0;257251030;257473946;2454562
892;1.1555e-14;-76;1586;24192;19613;1;594;-2.14748e+09;-1.71051e+07;0;0;0;0;0;0;257251030;257473946;2454562
893;1.16616e-14;-85;1672;24706;19733;1;610;-2.14748e+09;-1.70207e+07;-1;0;0;0;-1;0;257816728;258042773;2482013
893;1.1555e-14;-77;1586;24192;19613;1;594;-2.14748e+09;-1.70207e+07;0;0;0;0;0;0;257816728;258042773;2482013
894;1.16616e-14;-85;1672;24706;19733;1;610;-2.14748e+09;-1.6937e+07;-1;0;0;0;-1;0;258380425;258609628;2509618
894;1.1555e-14;-78;1586;24192;19613;1;594;-2.14748e+09;-1.6937e+07;0;0;0;0;0;0;258380425;258609628;2509618
895;1.16616e-14;-85;1672;24706;19733;1;610;-2.14748e+09;-1.6854e+07;-1;0;0;0;-1;0;258942132;259174521;2537376
895;1.1555e-14;-79;1586;24192;19613;1;594;-2.14748e+09;-1.6854e+07;0;0;0;0;0;0;258942132;259174521;2537376
896;1.16616e-14;-86;1672;24706;19733;1;610;-2.14748e+09;-1.67716e+07;0;0;0;0;0;0;259501857;259737463;2565286
896;1.1555e-14;-80;1586;24192;19613;1;594;-2.14748e+09;-1.67716e+07;0;0;0;0;0;0;259501857;259737463;2565286
897;1.16616e-14;-86;1672;24706;19733;1;610;-2.14748e+09;-1.66899e+07;-1;0;0;0;-1;0;260059611;260298462;2593349
897;1.1555e-14;-81;1586;24192;19613;1;594;-2.14748e+09;-1.66899e+07;0;0;0;0;0;0;260059611;260298462;2593349
898;1.16616e-14;-86;1672;24706;19733;1;610;-2.14748e+09;-1.66089e+07;-1;0;0;0;-1;0;260615404;260857530;2621563
898;1.1555e-14;-81;1586;24192;19613;1;594;-2.14748e+09;-1.66089e+07;-1;0;0;0;-1;0;260615404;260857530;2621563
899;1.16616e-14;-86;1672;24706;19733;1;610;-2.14748e+09;-1.65285e+07;-1;0;0;0;-1;0;261169244;261414675;2649928
899;1.1555e-14;-82;1586;24192;19613;1;594;-2.14748e+09;-1.65285e+07;0;0;0;0;0;0;261169244;261414675;2649928
900;1.16616e-14;-86;1672;24706;19733;1;610;-2.14748e+09;-1.64488e+07;-1;0;0;0;-1;0;261721143;261969907;2678444
900;1.1555e-14;-82;1586;24192;19613;1;594;-2.14748e+09;-1.64488e+07;-1;0;0;0;-1;0;261721143;261969907;2678444
901;1.16616e-14;-86;1672;24706;19733;1;610;-2.14748e+09;-1.63697e+07;-1;0;0;0;-1;0;262271109;262523237;2707110
901;1.1555e-14;-83;1586;24192;19613;1;594;-2.14748e+09;-1.63697e+07;0;0;0;0;0;0;262271109;262523237;2707110
902;1.16616e-14;-86;1672;24706;19733;1;610;-2.14748e+09;-1.62913e+07;-1;0;0;0;-1;0;262819153;263074673;2735926
902;1.1555e-14;-84;1586;24192;19613;1;594;-2.14748e+09;-1.62913e+07;0;0;0;0;0;0;262819153;263074673;2735926
903;1.16616e-14;-87;1672;24706;19733;1;610;-2.14748e+09;-1.62134e+07;0;0;0;0;0;0;263365283;263624226;2764891
903;1.1555e-14;-85;1586;24192;19613;1;594;-2.14748e+09;-1.62134e+07;0;0;0;0;0;0;263365283;263624226;2764891
904;1.16616e-14;-88;1672;24706;19733;1;610;-2.14748e+09;-1.61362e+07;0;0;0;0;0;0;263909509;264171905;2794005
904;1.1555e-14;-86;1586;24192;19613;1;594;-2.14748e+09;-1.61362e+07;0;0;0;0;0;0;263909509;264171905;2794005
905;1.16616e-14;-88;1672;24706;19733;1;610;-2.14748e+09;-1.60596e+07;-1;0;0;0;-1;0;264451840;264717720;2823266
905;1.1555e-14;-86;1586;24192;19613;1;594;-2.14748e+09;-1.60596e+07;-1;0;0;0;-1;0;264451840;264717720;2823266
906;1.16616e-14;-88;1672;24706;19733;1;610;-2.14748e+09;-1.59836e+07;-1;0;0;0;-1;0;264992286;265261679;2852676
906;1.1555e-14;-86;1586;24192;19613;1;594;-2.14748e+09;-1.59836e+07;-1;0;0;0;-1;0;264992286;265261679;2852676
907;1.16616e-14;-89;1672;24706;19733;1;610;-2.14748e+09;-1.59082e+07;0;0;0;0;0;0;265530857;265803793;2882232
907;1.1555e-14;-87;1586;24192;19613;1;594;-2.14748e+09;-1.59082e+07;0;0;0;0;0;0;265530857;265803793;2882232
908;1.16616e-14;-90;1672;24706;19733;1;610;-2.14748e+09;-1.58334e+07;0;0;0;0;0;0;266067560;266344070;2911936
908;1.1555e-14;-88;1586;24192;19613;1;594;-2.14748e+09;-1.58334e+07;0;0;0;0;0;0;266067560;266344070;2911936
909;1.16616e-14;-90;1672;24706;19733;1;610;-2.14748e+09;-1.57592e+07;-1;0;0;0;-1;0;266602406;266882520;2941785
909;1.1555e-14;-89;1586;24192;19613;1;594;-2.14748e+09;-1.57592e+07;0;0;0;0;0;0;266602406;266882520;2941785
910;1.16616e-14;-91;1672;24706;19733;1;610;-2.14748e+09;-1.56855e+07;0;0;0;0;0;0;267135404;267419152;2971779
910;1.1555e-14;-90;1586;24192;19613;1;594;-2.14748e+09;-1.56855e+07;0;0;0;0;0;0;267135404;267419152;2971779
911;1.16616e-14;-92;1672;24706;19733;1;610;-2.14748e+09;-1.56124e+07;0;0;0;0;0;0;267666563;267953975;3001919
911;1.1555e-14;-90;1586;24192;19613;1;594;-2.14748e+09;-1.56124e+07;-1;0;0;0;-1;0;267666563;267953975;3001919
912;1.16616e-14;-92;1672;24706;19733;1;610;-2.14748e+09;-1.55399e+07;-1;0;0;0;-1;0;268195891;268486999;3032203
912;1.1555e-14;-90;1586;24192;19613;1;594;-2.14748e+09;-1.55399e+07;-1;0;0;0;-1;0;268195891;268486999;3032203
913;1.16616e-14;-93;1672;24706;19733;1;610;-2.14748e+09;-1.54679e+07;0;0;0;0;0;0;268723398;269018232;3062631
913;1.1555e-14;-90;1586;24192;19613;1;594;-2.14748e+09;-1.54679e+07;-1;0;0;0;-1;0;268723398;269018232;3062631
914;1.16616e-14;-94;1672;24706;19733;1;610;-2.14748e+09;-1.53965e+07;0;0;0;0;0;0;269249092;269547683;3093202
914;1.1555e-14;-90;1586;24192;19613;1;594;-2.14748e+09;-1.53965e+07;-1;0;0;0;-1;0;269249092;269547683;3093202
915;1.16616e-14;-95;1672;24706;19733;1;610;-2.14748e+09;-1.53256e+07;0;0;0;0;0;0;269772983;270075362;3123916
915;1.1555e-14;-90;1586;24192;19613;1;594;-2.14748e+09;-1.53256e+07;-1;0;0;0;-1;0;269772983;270075362;3123916
916;1.16616e-14;-95;1672;24706;19733;1;610;-2.14748e+09;-1.52553e+07;-1;0;0;0;-1;0;270295079;270601277;3154773
916;1.1555e-14;-90;1586;24192;19613;1;594;-2.14748e+09;-1.52553e+07;-1;0;0;0;-1;0;270295079;270601277;3154773
917;1.16616e-14;-95;1672;24706;19733;1;610;-2.14748e+09;-1.51855e+07;-1;0;0;0;-1;0;270815390;271125437;3185771
917;1.1555e-14;-90;1586;24192;19613;1;594;-2.14748e+09;-1.51855e+07;-1;0;0;0;-1;0;270815390;271125437;3185771
918;1.16616e-14;-95;1672;24706;19733;1;610;-2.14748e+09;-1.51163e+07;-1;0;0;0;-1;0;271333923;271647851;3216910
918;1.1555e-14;-91;1586;24192;19613;1;594;-2.14748e+09;-1.51163e+07;0;0;0;0;0;0;271333923;271647851;3216910
919;1.16616e-14;-95;1672;24706;19733;1;610;-2.14748e+09;-1.50475e+07;-1;0;0;0;-1;0;271850687;272168527;3248189
919;1.1555e-14;-92;1586;24192;19613;1;594;-2.14748e+09;-1.50475e+07;0;0;0;0;0;0;271850687;272168527;3248189
920;1.16616e-14;-95;1672;24706;19733;1;610;-2.14748e+09;-1.49792e+07;-1;0;0;0;-1;0;272365692;272687474;3279608
920;1.1555e-14;-92;1586;24192;19613;1;594;-2.14748e+09;-1.49792e+07;-1;0;0;0;-1;0;272365692;272687474;3279608
921;1.16616e-14;-95;1672;24706;19733;1;610;-2.14748e+09;-1.49115e+07;-1;0;0;0;-1;0;272878945;273204702;3311167
921;1.1555e-14;-93;1586;24192;19613;1;594;-2.14748e+09;-1.49115e+07;0;0;0;0;0;0;272878945;273204702;3311167
922;1.16616e-14;-95;1672;24706;19733;1;610;-2.14748e+09;-1.48443e+07;-1;0;0;0;-1;0;273390455;273720218;3342865
922;1.1555e-14;-93;1586;24192;19613;1;594;-2.14748e+09;-1.48443e+07;-1;0;0;0;-1;0;273390455;273720218;3342865
923;1.16616e-14;-95;1672;24706;19733;1;610;-2.14748e+09;-1.47776e+07;-1;0;0;0;-1;0;273900230;274234031;3374701
923;1.1555e-14;-94;1586;24192;19613;1;594;-2.14748e+09;-1.47776e+07;0;0;0;0;0;0;273900230;274234031;3374701
924;1.16616e-14;-95;1672;24706;19733;1;610;-2.14748e+09;-1.47113e+07;-1;0;0;0;-1;0;274408280;274746149;3406674
924;1.1555e-14;-95;1586;24192;19613;1;594;-2.14748e+09;-1.47113e+07;0;0;0;0;0;0;274408280;274746149;3406674
925;1.16616e-14;-95;1672;24706;19733;1;610;-2.14748e+09;-1.46457e+07;-1;0;0;0;-1;0;274914612;275256581;3438784
925;1.1555e-14;-96;1586;24192;19613;1;594;-2.14748e+09;-1.46457e+07;0;0;0;0;0;0;274914612;275256581;3438784
926;1.16616e-14;-96;1672;24706;19733;1;610;-2.14748e+09;-1.45803e+07;0;0;0;0;0;0;275419234;275765336;3471031
926;1.1555e-14;-97;1586;24192;19613;1;594;-2.14748e+09;-1.45803e+07;0;0;0;0;0;0;275419234;275765336;3471031
927;1.16616e-14;-96;1672;24706;19733;1;610;-2.14748e+09;-1.45156e+07;-1;0;0;0;-1;0;275922155;276272421;3503414
927;1.1555e-14;-97;1586;24192;19613;1;594;-2.14748e+09;-1.45156e+07;-1;0;0;0;-1;0;275922155;276272421;3503414
928;1.16616e-14;-97;1672;24706;19733;1;610;-2.14748e+09;-1.44513e+07;0;0;0;0;0;0;276423384;276777845;3535932
928;1.1555e-14;-97;1586;24192;19613;1;594;-2.14748e+09;-1.44513e+07;-1;0;0;0;-1;0;276423384;276777845;3535932
929;1.16616e-14;-97;1672;24706;19733;1;610;-2.14748e+09;-1.43874e+07;-1;0;0;0;-1;0;276922927;277281615;3568584
929;1.1555e-14;-98;1586;24192;19613;1;594;-2.14748e+09;-1.43874e+07;0;0;0;0;0;0;276922927;277281615;3568584
930;1.16616e-14;-98;1672;24706;19733;1;610;-2.14748e+09;-1.43242e+07;0;0;0;0;0;0;277420794;277783741;3601371
930;1.1555e-14;-99;1586;24192;19613;1;594;-2.14748e+09;-1.43242e+07;0;0;0;0;0;0;277420794;277783741;3601371
931;1.16616e-14;-98;1672;24706;19733;1;610;-2.14748e+09;-1.42612e+07;-1;0;0;0;-1;0;277916992;278284231;3634291
931;1.1555e-14;-100;1586;24192;19613;1;594;-2.14748e+09;-1.42612e+07;0;0;0;0;0;0;277916992;278284231;3634291
932;1.16616e-14;-99;1672;24706;19733;1;610;-2.14748e+09;-1.41987e+07;0;0;0;0;0;0;278411530;278783091;3667344
932;1.1555e-14;-100;1586;24192;19613;1;594;-2.14748e+09;-1.41987e+07;-1;0;0;0;-1;0;278411530;278783091;3667344
933;1.16616e-14;-99;1672;24706;19733;1;610;-2.14748e+09;-1.41367e+07;-1;0;0;0;-1;0;278904415;279280332;3700529
933;1.1555e-14;-100;1586;24192;19613;1;594;-2.14748e+09;-1.41367e+07;-1;0;0;0;-1;0;278904415;279280332;3700529
934;1.16616e-14;-100;1672;24706;19733;1;610;-2.14748e+09;-1.40752e+07;0;0;0;0;0;0;279395655;279775959;3733845
934;1.1555e-14;-101;1586;24192;19613;1;594;-2.14748e+09;-1.40752e+07;0;0;0;0;0;0;279395655;279775959;3733845
935;1.16616e-14;-100;1672;24706;19733;1;610;-2.14748e+09;-1.4014e+07;-1;0;0;0;-1;0;279885258;280269982;3767293
935;1.1555e-14;-101;1586;24192;19613;1;594;-2.14748e+09;-1.4014e+07;-1;0;0;0;-1;0;279885258;280269982;3767293
936;1.16616e-14;-101;1672;24706;19733;1;610;-2.14748e+09;-1.39534e+07;0;0;0;0;0;0;280373232;280762408;3800871
936;1.1555e-14;-101;1586;24192;19613;1;594;-2.14748e+09;-1.39534e+07;-1;0;0;0;-1;0;280373232;280762408;3800871
937;1.16616e-14;-102;1672;24706;19733;1;610;-2.14748e+09;-1.38932e+07;0;0;0;0;0;0;280859584;281253245;3834578
937;1.1555e-14;-101;1586;24192;19613;1;594;-2.14748e+09;-1.38932e+07;-1;0;0;0;-1;0;280859584;281253245;3834578
938;1.16616e-14;-103;1672;24706;19733;1;610;-2.14748e+09;-1.38333e+07;0;0;0;0;0;0;281344324;281742501;3868415
938;1.1555e-14;-102;1586;24192;19613;1;594;-2.14748e+09;-1.38333e+07;0;0;0;0;0;0;281344324;281742501;3868415
939;1.16616e-14;-103;1672;24706;19733;1;610;-2.14748e+09;-1.37739e+07;-1;0;0;0;-1;0;281827457;282230183;3902380
939;1.1555e-14;-102;1586;24192;19613;1;594;-2.14748e+09;-1.37739e+07;-1;0;0;0;-1;0;281827457;282230183;3902380
940;1.16616e-14;-104;1672;24706;19733;1;610;-2.14748e+09;-1.3715e+07;0;0;0;0;0;0;282308992;282716300;3936473
940;1.1555e-14;-103;1586;24192;19613;1;594;-2.14748e+09;-1.3715e+07;0;0;0;0;0;0;282308992;282716300;3936473
941;1.16616e-14;-105;1672;24706;19733;1;610;-2.14748e+09;-1.36564e+07;0;0;0;0;0;0;282788936;283200858;3970693
941;1.1555e-14;-103;1586;24192;19613;1;594;-2.14748e+09;-1.36564e+07;-1;0;0;0;-1;0;282788936;283200858;3970693
942;1.16616e-14;-106;1672;24706;19733;1;610;-2.14748e+09;-1.35982e+07;0;0;0;0;0;0;283267297;283683866;4005040
942;1.1555e-14;-104;1586;24192;19613;1;594;-2.14748e+09;-1.35982e+07;0;0;0;0;0;0;283267297;283683866;4005040
943;1.16616e-14;-106;1672;24706;19733;1;610;-2.14748e+09;-1.35405e+07;-1;0;0;0;-1;0;283744082;284165331;4039513
943;1.1555e-14;-104;1586;24192;19613;1;594;-2.14748e+09;-1.35405e+07;-1;0;0;0;-1;0;283744082;284165331;4039513
944;1.16616e-14;-107;1672;24706;19733;1;610;-2.14748e+09;-1.34831e+07;0;0;0;0;0;0;284219299;284645260;4074111
944;1.1555e-14;-105;1586;24192;19613;1;594;-2.14748e+09;-1.34831e+07;0;0;0;0;0;0;284219299;284645260;4074111
945;1.16616e-14;-107;1672;24706;19733;1;610;-2.14748e+09;-1.34262e+07;-1;0;0;0;-1;0;284692955;285123661;4108834
945;1.1555e-14;-106;1586;24192;19613;1;594;-2.14748e+09;-1.34262e+07;0;0;0;0;0;0;284692955;285123661;4108834
946;1.16616e-14;-108;1672;24706;19733;1;610;-2.14748e+09;-1.33696e+07;0;0;0;0;0;0;285165058;285600541;4143681
946;1.1555e-14;-106;1586;24192;19613;1;594;-2.14748e+09;-1.33696e+07;-1;0;0;0;-1;0;285165058;285600541;4143681
947;1.16616e-14;-108;1672;24706;19733;1;610;-2.14748e+09;-1.33134e+07;-1;0;0;0;-1;0;285635615;286075908;4178652
947;1.1555e-14;-107;1586;24192;19613;1;594;-2.14748e+09;-1.33134e+07;0;0;0;0;0;0;285635615;286075908;4178652
948;1.16616e-14;-109;1672;24706;19733;1;610;-2.14748e+09;-1.32577e+07;0;0;0;0;0;0;286104632;286549770;4213745
948;1.1555e-14;-108;1586;24192;19613;1;594;-2.14748e+09;-1.32577e+07;0;0;0;0;0;0;286104632;286549770;4213745
949;1.16616e-14;-109;1672;24706;19733;1;610;-2.14748e+09;-1.32023e+07;-1;0;0;0;-1;0;286572118;287022132;4248960
949;1.1555e-14;-108;1586;24192;19613;1;594;-2.14748e+09;-1.32023e+07;-1;0;0;0;-1;0;286572118;287022132;4248960
950;1.16616e-14;-110;1672;24706;19733;1;610;-2.14748e+09;-1.31473e+07;0;0;0;0;0;0;287038080;287493003;4284297
950;1.1555e-14;-108;1586;24192;19613;1;594;-2.14748e+09;-1.31473e+07;-1;0;0;0;-1;0;287038080;287493003;4284297
951;1.16616e-14;-111;1672;24706;19733;1;610;-2.14748e+09;-1.30926e+07;0;0;0;0;0;0;287502524;287962389;4319755
951;1.1555e-14;-109;1586;24192;19613;1;594;-2.14748e+09;-1.30926e+07;0;0;0;0;0;0;287502524;287962389;4319755
952;1.16616e-14;-111;1672;24706;19733;1;610;-2.14748e+09;-1.30384e+07;-1;0;0;0;-1;0;287965458;288430298;4355333
952;1.1555e-14;-110;1586;24192;19613;1;594;-2.14748e+09;-1.30384e+07;0;0;0;0;0;0;287965458;288430298;4355333
953;1.16616e-14;-111;1672;24706;19733;1;610;-2.14748e+09;-1.29846e+07;-1;0;0;0;-1;0;288426888;288896737;4391030
953;1.1555e-14;-111;1586;24192;19613;1;594;-2.14748e+09;-1.29845e+07;0;0;0;0;0;0;288426888;288896737;4391030
954;1.16616e-14;-112;1672;24706;19733;1;610;-2.14748e+09;-1.29309e+07;0;0;0;0;0;0;288886823;289361713;4426846
954;1.1555e-14;-111;1586;24192;19613;1;594;-2.14748e+09;-1.29309e+07;-1;0;0;0;-1;0;288886823;289361713;4426846
955;1.16616e-14;-113;1672;24706;19733;1;610;-2.14748e+09;-1.28777e+07;0;0;0;0;0;0;289345268;289825233;4462781
955;1.1555e-14;-111;1586;24192;19613;1;594;-2.14748e+09;-1.28777e+07;-1;0;0;0;-1;0;289345268;289825233;4462781
956;1.16616e-14;-113;1672;24706;19733;1;610;-2.14748e+09;-1.28249e+07;-1;0;0;0;-1;0;289802231;290287304;4498833
956;1.1555e-14;-111;1586;24192;19613;1;594;-2.14748e+09;-1.28249e+07;-1;0;0;0;-1;0;289802231;290287304;4498833
957;1.16616e-14;-113;1672;24706;19733;1;610;-2.14748e+09;-1.27725e+07;-1;0;0;0;-1;0;290257718;290747933;4535003
957;1.1555e-14;-112;1586;24192;19613;1;594;-2.14748e+09;-1.27725e+07;0;0;0;0;0;0;290257718;290747933;4535003
958;1.16616e-14;-114;1672;24706;19733;1;610;-2.14748e+09;-1.27203e+07;0;0;0;0;0;0;290711737;291207126;4571288
958;1.1555e-14;-113;1586;24192;19613;1;594;-2.14748e+09;-1.27203e+07;0;0;0;0;0;0;290711737;291207126;4571288
959;1.16616e-14;-115;1672;24706;19733;1;610;-2.14748e+09;-1.26686e+07;0;0;0;0;0;0;291164294;291664891;4607689
959;1.1555e-14;-114;1586;24192;19613;1;594;-2.14748e+09;-1.26686e+07;0;0;0;0;0;0;291164294;291664891;4607689
960;1.16616e-14;-115;1672;24706;19733;1;610;-2.14748e+09;-1.26172e+07;-1;0;0;0;-1;0;291615395;292121234;4644206
960;1.1555e-14;-114;1586;24192;19613;1;594;-2.14748e+09;-1.26172e+07;-1;0;0;0;-1;0;291615395;292121234;4644206
961;1.16616e-14;-116;1672;24706;19733;1;610;-2.14748e+09;-1.25661e+07;0;0;0;0;0;0;292065049;292576162;4680836
961;1.1555e-14;-115;1586;24192;19613;1;594;-2.14748e+09;-1.25661e+07;0;0;0;0;0;0;292065049;292576162;4680836
962;1.16616e-14;-117;1672;24706;19733;1;610;-2.14748e+09;-1.25153e+07;0;0;0;0;0;0;292513260;293029682;4717581
962;1.1555e-14;-116;1586;24192;19613;1;594;-2.14748e+09;-1.25153e+07;0;0;0;0;0;0;292513260;293029682;4717581
963;1.16616e-14;-117;1672;24706;19733;1;610;-2.14748e+09;-1.24649e+07;-1;0;0;0;-1;0;292960037;293481800;4754438
963;1.1555e-14;-116;1586;24192;19613;1;594;-2.14748e+09;-1.24649e+07;-1;0;0;0;-1;0;292960037;293481800;4754438
964;1.16616e-14;-117;1672;24706;19733;1;610;-2.14748e+09;-1.24148e+07;-1;0;0;0;-1;0;293405385;293932523;4791408
964;1.1555e-14;-116;1586;24192;19613;1;594;-2.14748e+09;-1.24148e+07;-1;0;0;0;-1;0;293405385;293932523;4791408
965;1.16616e-14;-118;1672;24706;19733;1;610;-2.14748e+09;-1.23651e+07;0;0;0;0;0;0;293849312;294381858;4828489
965;1.1555e-14;-117;1586;24192;19613;1;594;-2.14748e+09;-1.23651e+07;0;0;0;0;0;0;293849312;294381858;4828489
966;1.16616e-14;-119;1672;24706;19733;1;610;-2.14748e+09;-1.23157e+07;0;0;0;0;0;0;294291823;294829811;4865682
966;1.1555e-14;-118;1586;24192;19613;1;594;-2.14748e+09;-1.23157e+07;0;0;0;0;0;0;294291823;294829811;4865682
967;1.16616e-14;-120;1672;24706;19733;1;610;-2.14748e+09;-1.22665e+07;0;0;0;0;0;0;294732925;295276388;4902985
967;1.1555e-14;-119;1586;24192;19613;1;594;-2.14748e+09;-1.22665e+07;0;0;0;0;0;0;294732925;295276388;4902985
968;1.16616e-14;-120;1672;24706;19733;1;610;-2.14748e+09;-1.22179e+07;-1;0;0;0;-1;0;295172624;295721597;4940398
968;1.1555e-14;-120;1586;24192;19613;1;594;-2.14748e+09;-1.22178e+07;0;0;0;0;0;0;295172624;295721597;4940398
969;1.16616e-14;-121;1672;24706;19733;1;610;-2.14748e+09;-1.21694e+07;0;0;0;0;0;0;295610927;296165443;4977920
969;1.1555e-14;-120;1586;24192;19613;1;594;-2.14748e+09;-1.21694e+07;-1;0;0;0;-1;0;295610927;296165443;4977920
970;1.16616e-14;-121;1672;24706;19733;1;610;-2.14748e+09;-1.21211e+07;-1;0;0;0;-1;0;296047841;296607933;5015550
970;1.1555e-14;-121;1586;24192;19613;1;594;-2.14748e+09;-1.21211e+07;0;0;0;0;0;0;296047841;296607933;5015550
971;1.16616e-14;-122;1672;24706;19733;1;610;-2.14748e+09;-1.20733e+07;0;0;0;0;0;0;296483371;297049074;5053288
971;1.1555e-14;-121;1586;24192;19613;1;594;-2.14748e+09;-1.20733e+07;-1;0;0;0;-1;0;296483371;297049074;5053288
972;1.16616e-14;-123;1672;24706;19733;1;610;-2.14748e+09;-1.20257e+07;0;0;0;0;0;0;296917524;297488871;5091134
972;1.1555e-14;-122;1586;24192;19613;1;594;-2.14748e+09;-1.20257e+07;0;0;0;0;0;0;296917524;297488871;5091134
973;1.16616e-14;-123;1672;24706;19733;1;610;-2.14748e+09;-1.19785e+07;-1;0;0;0;-1;0;297350307;297927331;5129086
973;1.1555e-14;-123;1586;24192;19613;1;594;-2.14748e+09;-1.19785e+07;0;0;0;0;0;0;297350307;297927331;5129086
974;1.16616e-14;-123;1672;24706;19733;1;610;-2.14748e+09;-1.19316e+07;-1;0;0;0;-1;0;297781724;298364459;5167143
974;1.1555e-14;-124;1586;24192;19613;1;594;-2.14748e+09;-1.19316e+07;0;0;0;0;0;0;297781724;298364459;5167143
975;1.16616e-14;-124;1672;24706;19733;1;610;-2.14748e+09;-1.18849e+07;0;0;0;0;0;0;298211783;298800263;5205306
975;1.1555e-14;-125;1586;24192;19613;1;594;-2.14748e+09;-1.18849e+07;0;0;0;0;0;0;298211783;298800263;5205306
976;1.16616e-14;-125;1672;24706;19733;1;610;-2.14748e+09;-1.18386e+07;0;0;0;0;0;0;298640490;299234749;5243574
976;1.1555e-14;-126;1586;24192;19613;1;594;-2.14748e+09;-1.18386e+07;0;0;0;0;0;0;298640490;299234749;5243574
977;1.16616e-14;-126;1672;24706;19733;1;610;-2.14748e+09;-1.17926e+07;0;0;0;0;0;0;299067850;299667922;5281945
977;1.1555e-14;-127;1586;24192;19613;1;594;-2.14748e+09;-1.17926e+07;0;0;0;0;0;0;299067850;299667922;5281945
978;1.16616e-14;-127;1672;24706;19733;1;610;-2.14748e+09;-1.17468e+07;0;0;0;0;0;0;299493870;300099788;5320419
978;1.1555e-14;-127;1586;24192;19613;1;594;-2.14748e+09;-1.17468e+07;-1;0;0;0;-1;0;299493870;300099788;5320419
979;1.16616e-14;-128;1672;24706;19733;1;610;-2.14748e+09;-1.17013e+07;0;0;0;0;0;0;299918556;300530354;5358996
979;1.1555e-14;-127;1586;24192;19613;1;594;-2.14748e+09;-1.17013e+07;-1;0;0;0;-1;0;299918556;300530354;5358996
980;1.16616e-14;-129;1672;24706;19733;1;610;-2.14748e+09;-1.16562e+07;0;0;0;0;0;0;300341913;300959626;5397675
980;1.1555e-14;-127;1586;24192;19613;1;594;-2.14748e+09;-1.16562e+07;-1;0;0;0;-1;0;300341913;300959626;5397675
981;1.16616e-14;-129;1672;24706;19733;1;610;-2.14748e+09;-1.16112e+07;-1;0;0;0;-1;0;300763949;301387609;5436455
981;1.1555e-14;-128;1586;24192;19613;1;594;-2.14748e+09;-1.16112e+07;0;0;0;0;0;0;300763949;301387609;5436455
982;1.16616e-14;-130;1672;24706;19733;1;610;-2.14748e+09;-1.15666e+07;0;0;0;0;0;0;301184668;301814310;5475336
982;1.1555e-14;-128;1586;24192;19613;1;594;-2.14748e+09;-1.15666e+07;-1;0;0;0;-1;0;301184668;301814310;5475336
983;1.16616e-14;-130;1672;24706;19733;1;610;-2.14748e+09;-1.15224e+07;-1;0;0;0;-1;0;301604076;302239734;5514317
983;1.1555e-14;-129;1586;24192;19613;1;594;-2.14748e+09;-1.15223e+07;0;0;0;0;0;0;301604076;302239734;5514317
984;1.16616e-14;-131;1672;24706;19733;1;610;-2.14748e+09;-1.14782e+07;0;0;0;0;0;0;302022180;302663887;5553396
984;1.1555e-14;-129;1586;24192;19613;1;594;-2.14748e+09;-1.14782e+07;-1;0;0;0;-1;0;302022180;302663887;5553396
985;1.16616e-14;-132;1672;24706;19733;1;610;-2.14748e+09;-1.14344e+07;0;0;0;0;0;0;302438984;303086775;5592575
985;1.1555e-14;-130;1586;24192;19613;1;594;-2.14748e+09;-1.14344e+07;0;0;0;0;0;0;302438984;303086775;5592575
986;1.16616e-14;-132;1672;24706;19733;1;610;-2.14748e+09;-1.13909e+07;-1;0;0;0;-1;0;302854496;303508405;5631851
986;1.1555e-14;-131;1586;24192;19613;1;594;-2.14748e+09;-1.13909e+07;0;0;0;0;0;0;302854496;303508405;5631851
987;1.16616e-14;-132;1672;24706;19733;1;610;-2.14748e+09;-1.13476e+07;-1;0;0;0;-1;0;303268721;303928780;5671225
987;1.1555e-14;-132;1586;24192;19613;1;594;-2.14748e+09;-1.13476e+07;0;0;0;0;0;0;303268721;303928780;5671225
988;1.16616e-14;-133;1672;24706;19733;1;610;-2.14748e+09;-1.13046e+07;0;0;0;0;0;0;303681663;304347908;5710695
988;1.1555e-14;-132;1586;24192;19613;1;594;-2.14748e+09;-1.13046e+07;-1;0;0;0;-1;0;303681663;304347908;5710695
989;1.16616e-14;-133;1672;24706;19733;1;610;-2.14748e+09;-1.12619e+07;-1;0;0;0;-1;0;304093330;304765794;5750262
989;1.1555e-14;-132;1586;24192;19613;1;594;-2.14748e+09;-1.12619e+07;-1;0;0;0;-1;0;304093330;304765794;5750262
990;1.16616e-14;-133;1672;24706;19733;1;610;-2.14748e+09;-1.12194e+07;-1;0;0;0;-1;0;304503727;305182444;5789923
990;1.1555e-14;-132;1586;24192;19613;1;594;-2.14748e+09;-1.12194e+07;-1;0;0;0;-1;0;304503727;305182444;5789923
991;1.16616e-14;-134;1672;24706;19733;1;610;-2.14748e+09;-1.11772e+07;0;0;0;0;0;0;304912858;305597862;5829680
991;1.1555e-14;-133;1586;24192;19613;1;594;-2.14748e+09;-1.11772e+07;0;0;0;0;0;0;304912858;305597862;5829680
992;1.16616e-14;-135;1672;24706;19733;1;610;-2.14748e+09;-1.11352e+07;0;0;0;0;0;0;305320731;306012056;5869530
992;1.1555e-14;-133;1586;24192;19613;1;594;-2.14748e+09;-1.11352e+07;-1;0;0;0;-1;0;305320731;306012056;5869530
993;1.16616e-14;-136;1672;24706;19733;1;610;-2.14748e+09;-1.10935e+07;0;0;0;0;0;0;305727349;306425029;5909474
993;1.1555e-14;-133;1586;24192;19613;1;594;-2.14748e+09;-1.10935e+07;-1;0;0;0;-1;0;305727349;306425029;5909474
994;1.16616e-14;-136;1672;24706;19733;1;610;-2.14748e+09;-1.10521e+07;-1;0;0;0;-1;0;306132720;306836789;5949510
994;1.1555e-14;-133;1586;24192;19613;1;594;-2.14748e+09;-1.10521e+07;-1;0;0;0;-1;0;306132720;306836789;5949510
995;1.16616e-14;-137;1672;24706;19733;1;610;-2.14748e+09;-1.10109e+07;0;0;0;0;0;0;306536848;307247340;5989639
995;1.1555e-14;-133;1586;24192;19613;1;594;-2.14748e+09;-1.10109e+07;-1;0;0;0;-1;0;306536848;307247340;5989639
996;1.16616e-14;-137;1672;24706;19733;1;610;-2.14748e+09;-1.09699e+07;-1;0;0;0;-1;0;306939739;307656687;6029859
996;1.1555e-14;-134;1586;24192;19613;1;594;-2.14748e+09;-1.09699e+07;0;0;0;0;0;0;306939739;307656687;6029859
997;1.16616e-14;-137;1672;24706;19733;1;610;-2.14748e+09;-1.09292e+07;-1;0;0;0;-1;0;307341398;308064837;6070169
997;1.1555e-14;-134;1586;24192;19613;1;594;-2.14748e+09;-1.09292e+07;-1;0;0;0;-1;0;307341398;308064837;6070169
998;1.16616e-14;-138;1672;24706;19733;1;610;-2.14748e+09;-1.08888e+07;0;0;0;0;0;0;307741830;308471794;6110570
998;1.1555e-14;-134;1586;24192;19613;1;594;-2.14748e+09;-1.08888e+07;-1;0;0;0;-1;0;307741830;308471794;6110570
999;1.16616e-14;-139;1672;24706;19733;1;610;-2.14748e+09;-1.08486e+07;0;0;0;0;0;0;308141042;308877564;6151060
999;1.1555e-14;-134;1586;24192;19613;1;594;-2.14748e+09;-1.08486e+07;-1;0;0;0;-1;0;308141042;308877564;6151060
1000;1.16616e-14;-140;1672;24706;19733;1;610;-2.14748e+09;-1.08086e+07;0;0;0;0;0;0;308539037;309282152;6191639
1000;1.1555e-14;-134;1586;24192;19613;1;594;-2.14748e+09;-1.08086e+07;-1;0;0;0;-1;0;308539037;309282152;6191639
1001;1.16616e-14;-140;1672;24706;19733;1;610;-2.14748e+09;-1.07688e+07;-1;0;0;0;-1;0;308935822;309685563;6232307
1001;1.1555e-14;-134;1586;24192;19613;1;594;-2.14748e+09;-1.07688e+07;-1;0;0;0;-1;0;308935822;309685563;6232307
1002;1.16616e-14;-141;1672;24706;19733;1;610;-2.14748e+09;-1.07293e+07;0;0;0;0;0;0;309331402;310087803;6273061
1002;1.1555e-14;-135;1586;24192;19613;1;594;-2.14748e+09;-1.07293e+07;0;0;0;0;0;0;309331402;310087803;6273061
1003;1.16616e-14;-141;1672;24706;19733;1;610;-2.14748e+09;-1.069e+07;-1;0;0;0;-1;0;309725781;310488877;6313903
1003;1.1555e-14;-136;1586;24192;19613;1;594;-2.14748e+09;-1.069e+07;0;0;0;0;0;0;309725781;310488877;6313903
1004;1.16616e-14;-141;1672;24706;19733;1;610;-2.14748e+09;-1.0651e+07;-1;0;0;0;-1;0;310118966;310888790;6354831
1004;1.1555e-14;-136;1586;24192;19613;1;594;-2.14748e+09;-1.0651e+07;-1;0;0;0;-1;0;310118966;310888790;6354831
1005;1.16616e-14;-141;1672;24706;19733;1;610;-2.14748e+09;-1.06122e+07;-1;0;0;0;-1;0;310510961;311287548;6395845
1005;1.1555e-14;-137;1586;24192;19613;1;594;-2.14748e+09;-1.06122e+07;0;0;0;0;0;0;310510961;311287548;6395845
1006;1.16616e-14;-142;1672;24706;19733;1;610;-2.14748e+09;-1.05736e+07;0;0;0;0;0;0;310901771;311685154;6436943
1006;1.1555e-14;-138;1586;24192;19613;1;594;-2.14748e+09;-1.05736e+07;0;0;0;0;0;0;310901771;311685154;6436943
1007;1.16616e-14;-143;1672;24706;19733;1;610;-2.14748e+09;-1.05352e+07;0;0;0;0;0;0;311291402;312081615;6478126
1007;1.1555e-14;-138;1586;24192;19613;1;594;-2.14748e+09;-1.05352e+07;-1;0;0;0;-1;0;311291402;312081615;6478126
1008;1.16616e-14;-143;1672;24706;19733;1;610;-2.14748e+09;-1.04971e+07;-1;0;0;0;-1;0;311679858;312476935;6519392
1008;1.1555e-14;-138;1586;24192;19613;1;594;-2.14748e+09;-1.04971e+07;-1;0;0;0;-1;0;311679858;312476935;6519392
1009;1.16616e-14;-143;1672;24706;19733;1;610;-2.14748e+09;-1.04593e+07;-1;0;0;0;-1;0;312067145;312871120;6560742
1009;1.1555e-14;-139;1586;24192;19613;1;594;-2.14748e+09;-1.04593e+07;0;0;0;0;0;0;312067145;312871120;6560742
1010;1.16616e-14;-143;1672;24706;19733;1;610;-2.14748e+09;-1.04215e+07;-1;0;0;0;-1;0;312453268;313264174;6602174
1010;1.1555e-14;-140;1586;24192;19613;1;594;-2.14748e+09;-1.04215e+07;0;0;0;0;0;0;312453268;313264174;6602174
1011;1.16616e-14;-144;1672;24706;19733;1;610;-2.14748e+09;-1.0384e+07;0;0;0;0;0;0;312838231;313656102;6643688
1011;1.1555e-14;-141;1586;24192;19613;1;594;-2.14748e+09;-1.0384e+07;0;0;0;0;0;0;312838231;313656102;6643688
1012;1.16616e-14;-145;1672;24706;19733;1;610;-2.14748e+09;-1.03467e+07;0;0;0;0;0;0;313222039;314046910;6685282
1012;1.1555e-14;-141;1586;24192;19613;1;594;-2.14748e+09;-1.03467e+07;-1;0;0;0;-1;0;313222039;314046910;6685282
1013;1.16616e-14;-146;1672;24706;19733;1;610;-2.14748e+09;-1.03096e+07;0;0;0;0;0;0;313604698;314436602;6726958
1013;1.1555e-14;-142;1586;24192;19613;1;594;-2.14748e+09;-1.03096e+07;0;0;0;0;0;0;313604698;314436602;6726958
1014;1.16616e-14;-147;1672;24706;19733;1;610;-2.14748e+09;-1.02728e+07;0;0;0;0;0;0;313986212;314825184;6768713
1014;1.1555e-14;-142;1586;24192;19613;1;594;-2.14748e+09;-1.02728e+07;-1;0;0;0;-1;0;313986212;314825184;6768713
1015;1.16616e-14;-148;1672;24706;19733;1;610;-2.14748e+09;-1.02362e+07;0;0;0;0;0;0;314366586;315212659;6810547
1015;1.1555e-14;-143;1586;24192;19613;1;594;-2.14748e+09;-1.02362e+07;0;0;0;0;0;0;314366586;315212659;6810547
1016;1.16616e-14;-148;1672;24706;19733;1;610;-2.14748e+09;-1.01998e+07;-1;0;0;0;-1;0;314745826;315599033;6852460
1016;1.1555e-14;-144;1586;24192;19613;1;594;-2.14748e+09;-1.01998e+07;0;0;0;0;0;0;314745826;315599033;6852460
1017;1.16616e-14;-148;1672;24706;19733;1;610;-2.14748e+09;-1.01635e+07;-1;0;0;0;-1;0;315123935;315984310;6894451
1017;1.1555e-14;-144;1586;24192;19613;1;594;-2.14748e+09;-1.01635e+07;-1;0;0;0;-1;0;315123935;315984310;6894451
1018;1.16616e-14;-149;1672;24706;19733;1;610;-2.14748e+09;-1.01275e+07;0;0;0;0;0;0;315500919;316368496;6936520
1018;1.1555e-14;-144;1586;24192;19613;1;594;-2.14748e+09;-1.01275e+07;-1;0;0;0;-1;0;315500919;316368496;6936520
1019;1.16616e-14;-150;1672;24706;19733;1;610;-2.14748e+09;-1.00917e+07;0;0;0;0;0;0;315876782;316751595;6978665
1019;1.1555e-14;-144;1586;24192;19613;1;594;-2.14748e+09;-1.00917e+07;-1;0;0;0;-1;0;315876782;316751595;6978665
1020;1.16616e-14;-150;1672;24706;19733;1;610;-2.14748e+09;-1.00561e+07;-1;0;0;0;-1;0;316251529;317133611;7020886
1020;1.1555e-14;-145;1586;24192;19613;1;594;-2.14748e+09;-1.00561e+07;0;0;0;0;0;0;316251529;317133611;7020886
1021;1.16616e-14;-151;1672;24706;19733;1;610;-2.14748e+09;-1.00207e+07;0;0;0;0;0;0;316625164;317514550;7063183
1021;1.1555e-14;-146;1586;24192;19613;1;594;-2.14748e+09;-1.00207e+07;0;0;0;0;0;0;316625164;317514550;7063183
1022;1.16616e-14;-151;1672;24706;19733;1;610;-2.14748e+09;-9.98552e+06;-1;0;0;0;-1;0;316997693;317894416;7105554
1022;1.1555e-14;-146;1586;24192;19613;1;594;-2.14748e+09;-9.98552e+06;-1;0;0;0;-1;0;316997693;317894416;7105554
1023;1.16616e-14;-151;1672;24706;19733;1;610;-2.14748e+09;-9.95051e+06;-1;0;0;0;-1;0;317369120;318273214;7148000
1023;1.1555e-14;-146;1586;24192;19613;1;594;-2.14748e+09;-9.95051e+06;-1;0;0;0;-1;0;317369120;318273214;7148000
1024;1.16616e-14;-151;1672;24706;19733;1;610;-2.14748e+09;-9.9157e+06;-1;0;0;0;-1;0;317739450;318650948;7190519
1024;1.1555e-14;-146;1586;24192;19613;1;594;-2.14748e+09;-9.9157e+06;-1;0;0;0;-1;0;317739450;318650948;7190519
1025;1.16616e-14;-152;1672;24706;19733;1;610;-2.14748e+09;-9.88108e+06;0;0;0;0;0;0;318108687;319027623;7233112
1025;1.1555e-14;-146;1586;24192;19613;1;594;-2.14748e+09;-9.88108e+06;-1;0;0;0;-1;0;318108687;319027623;7233112
1026;1.16616e-14;-152;1672;24706;19733;1;610;-2.14748e+09;-9.84666e+06;-1;0;0;0;-1;0;318476836;319403243;7275777
1026;1.1555e-14;-147;1586;24192;19613;1;594;-2.14748e+09;-9.84666e+06;0;0;0;0;0;0;318476836;319403243;7275777
1027;1.16616e-14;-153;1672;24706;19733;1;610;-2.14748e+09;-9.81242e+06;0;0;0;0;0;0;318843901;319777813;7318513
1027;1.1555e-14;-147;1586;24192;19613;1;594;-2.14748e+09;-9.81242e+06;-1;0;0;0;-1;0;318843901;319777813;7318513
1028;1.16616e-14;-154;1672;24706;19733;1;610;-2.14748e+09;-9.77838e+06;0;0;0;0;0;0;319209887;320151337;7361321
1028;1.1555e-14;-147;1586;24192;19613;1;594;-2.14748e+09;-9.77838e+06;-1;0;0;0;-1;0;319209887;320151337;7361321
1029;1.16616e-14;-154;1672;24706;19733;1;610;-2.14748e+09;-9.74452e+06;-1;0;0;0;-1;0;319574798;320523820;7404199
1029;1.1555e-14;-147;1586;24192;19613;1;594;-2.14748e+09;-9.74452e+06;-1;0;0;0;-1;0;319574798;320523820;7404199
1030;1.16616e-14;-155;1672;24706;19733;1;610;-2.14748e+09;-9.71095e+06;0;0;0;0;0;0;319938639;320895267;7447147
1030;1.1555e-14;-147;1586;24192;19613;1;594;-2.14748e+09;-9.71095e+06;-1;0;0;0;-1;0;319938639;320895267;7447147
1031;1.16616e-14;-155;1672;24706;19733;1;610;-2.14748e+09;-9.67736e+06;-1;0;0;0;-1;0;320301414;321265681;7490164
1031;1.1555e-14;-147;1586;24192;19613;1;594;-2.14748e+09;-9.67736e+06;-1;0;0;0;-1;0;320301414;321265681;7490164
1032;1.16616e-14;-155;1672;24706;19733;1;610;-2.14748e+09;-9.64416e+06;-1;0;0;0;-1;0;320663127;321635067;7533251
1032;1.1555e-14;-147;1586;24192;19613;1;594;-2.14748e+09;-9.64416e+06;-1;0;0;0;-1;0;320663127;321635067;7533251
1033;1.16616e-14;-156;1672;24706;19733;1;610;-2.14748e+09;-9.61104e+06;0;0;0;0;0;0;321023784;322003429;7576405
1033;1.1555e-14;-147;1586;24192;19613;1;594;-2.14748e+09;-9.61104e+06;-1;0;0;0;-1;0;321023784;322003429;7576405
1034;1.16616e-14;-157;1672;24706;19733;1;610;-2.14748e+09;-9.578e+06;0;0;0;0;0;0;321383388;322370772;7619627
1034;1.1555e-14;-148;1586;24192;19613;1;594;-2.14748e+09;-9.578e+06;0;0;0;0;0;0;321383388;322370772;7619627
1035;1.16616e-14;-157;1672;24706;19733;1;610;-2.14748e+09;-9.54524e+06;-1;0;0;0;-1;0;321741944;322737100;7662915
1035;1.1555e-14;-148;1586;24192;19613;1;594;-2.14748e+09;-9.54524e+06;-1;0;0;0;-1;0;321741944;322737100;7662915
1036;1.16616e-14;-158;1672;24706;19733;1;610;-2.14748e+09;-9.51266e+06;0;0;0;0;0;0;322099455;323102417;7706270
1036;1.1555e-14;-149;1586;24192;19613;1;594;-2.14748e+09;-9.51266e+06;0;0;0;0;0;0;322099455;323102417;7706270
1037;1.16616e-14;-159;1672;24706;19733;1;610;-2.14748e+09;-9.48025e+06;0;0;0;0;0;0;322455927;323466728;7749691
1037;1.1555e-14;-150;1586;24192;19613;1;594;-2.14748e+09;-9.48025e+06;0;0;0;0;0;0;322455927;323466728;7749691
1038;1.16616e-14;-160;1672;24706;19733;1;610;-2.14748e+09;-9.44802e+06;0;0;0;0;0;0;322811363;323830036;7793176
1038;1.1555e-14;-150;1586;24192;19613;1;594;-2.14748e+09;-9.44802e+06;-1;0;0;0;-1;0;322811363;323830036;7793176
1039;1.16616e-14;-161;1672;24706;19733;1;610;-2.14748e+09;-9.41596e+06;0;0;0;0;0;0;323165768;324192347;7836727
1039;1.1555e-14;-151;1586;24192;19613;1;594;-2.14748e+09;-9.41596e+06;0;0;0;0;0;0;323165768;324192347;7836727
1040;1.16616e-14;-161;1672;24706;19733;1;610;-2.14748e+09;-9.38407e+06;-1;0;0;0;-1;0;323519146;324553663;7880341
1040;1.1555e-14;-151;1586;24192;19613;1;594;-2.14748e+09;-9.38407e+06;-1;0;0;0;-1;0;323519146;324553663;7880341
1041;1.16616e-14;-161;1672;24706;19733;1;610;-2.14748e+09;-9.35236e+06;-1;0;0;0;-1;0;323871501;324913990;7924018
1041;1.1555e-14;-151;1586;24192;19613;1;594;-2.14748e+09;-9.35236e+06;-1;0;0;0;-1;0;323871501;324913990;7924018
1042;1.16616e-14;-161;1672;24706;19733;1;610;-2.14748e+09;-9.32081e+06;-1;0;0;0;-1;0;324222837;325273331;7967758
1042;1.1555e-14;-152;1586;24192;19613;1;594;-2.14748e+09;-9.32081e+06;0;0;0;0;0;0;324222837;325273331;7967758
1043;1.16616e-14;-162;1672;24706;19733;1;610;-2.14748e+09;-9.28953e+06;0;0;0;0;0;0;324573159;325631690;8011560
1043;1.1555e-14;-153;1586;24192;19613;1;594;-2.14748e+09;-9.28953e+06;0;0;0;0;0;0;324573159;325631690;8011560
1044;1.16616e-14;-162;1672;24706;19733;1;610;-2.14748e+09;-9.25832e+06;-1;0;0;0;-1;0;324922470;325989072;8055424
1044;1.1555e-14;-154;1586;24192;19613;1;594;-2.14748e+09;-9.25832e+06;0;0;0;0;0;0;324922470;325989072;8055424
1045;1.16616e-14;-163;1672;24706;19733;1;610;-2.14748e+09;-9.22718e+06;0;0;0;0;0;0;325270774;326345481;8099349
1045;1.1555e-14;-155;1586;24192;19613;1;594;-2.14748e+09;-9.22718e+06;0;0;0;0;0;0;325270774;326345481;8099349
1046;1.16616e-14;-164;1672;24706;19733;1;610;-2.14748e+09;-9.1963e+06;0;0;0;0;0;0;325618077;326700920;8143334
1046;1.1555e-14;-155;1586;24192;19613;1;594;-2.14748e+09;-9.1963e+06;-1;0;0;0;-1;0;325618077;326700920;8143334
1047;1.16616e-14;-165;1672;24706;19733;1;610;-2.14748e+09;-9.16558e+06;0;0;0;0;0;0;325964381;327055394;8187379
1047;1.1555e-14;-155;1586;24192;19613;1;594;-2.14748e+09;-9.16558e+06;-1;0;0;0;-1;0;325964381;327055394;8187379
1048;1.16616e-14;-165;1672;24706;19733;1;610;-2.14748e+09;-9.13502e+06;-1;0;0;0;-1;0;326309691;327408906;8231483
1048;1.1555e-14;-155;1586;24192;19613;1;594;-2.14748e+09;-9.13502e+06;-1;0;0;0;-1;0;326309691;327408906;8231483
1049;1.16616e-14;-166;1672;24706;19733;1;610;-2.14748e+09;-9.10463e+06;0;0;0;0;0;0;326654010;327761461;8275646
1049;1.1555e-14;-156;1586;24192;19613;1;594;-2.14748e+09;-9.10463e+06;0;0;0;0;0;0;326654010;327761461;8275646
1050;1.16616e-14;-167;1672;24706;19733;1;610;-2.14748e+09;-9.07439e+06;0;0;0;0;0;0;326997343;328113063;8319866
1050;1.1555e-14;-157;1586;24192;19613;1;594;-2.14748e+09;-9.07439e+06;0;0;0;0;0;0;326997343;328113063;8319866
1051;1.16616e-14;-168;1672;24706;19733;1;610;-2.14748e+09;-9.04441e+06;0;0;0;0;0;0;327339694;328463715;8364145
1051;1.1555e-14;-158;1586;24192;19613;1;594;-2.14748e+09;-9.04441e+06;0;0;0;0;0;0;327339694;328463715;8364145
1052;1.16616e-14;-168;1672;24706;19733;1;610;-2.14748e+09;-9.01439e+06;-1;0;0;0;-1;0;327681067;328813421;8408480
1052;1.1555e-14;-158;1586;24192;19613;1;594;-2.14748e+09;-9.01439e+06;-1;0;0;0;-1;0;327681067;328813421;8408480
1053;1.16616e-14;-168;1672;24706;19733;1;610;-2.14748e+09;-8.98462e+06;-1;0;0;0;-1;0;328021465;329162185;8452871
1053;1.1555e-14;-158;1586;24192;19613;1;594;-2.14748e+09;-8.98462e+06;-1;0;0;0;-1;0;328021465;329162185;8452871
1054;1.16616e-14;-169;1672;24706;19733;1;610;-2.14748e+09;-8.95501e+06;0;0;0;0;0;0;328360892;329510012;8497318
1054;1.1555e-14;-159;1586;24192;19613;1;594;-2.14748e+09;-8.95501e+06;0;0;0;0;0;0;328360892;329510012;8497318
1055;1.16616e-14;-170;1672;24706;19733;1;610;-2.14748e+09;-8.92556e+06;0;0;0;0;0;0;328699352;329856904;8541821
1055;1.1555e-14;-159;1586;24192;19613;1;594;-2.14748e+09;-8.92556e+06;-1;0;0;0;-1;0;328699352;329856904;8541821
1056;1.16616e-14;-170;1672;24706;19733;1;610;-2.14748e+09;-8.89625e+06;-1;0;0;0;-1;0;329036850;330202866;8586378
1056;1.1555e-14;-160;1586;24192;19613;1;594;-2.14748e+09;-8.89625e+06;0;0;0;0;0;0;329036850;330202866;8586378
1057;1.16616e-14;-170;1672;24706;19733;1;610;-2.14748e+09;-8.8671e+06;-1;0;0;0;-1;0;329373389;330547901;8630989
1057;1.1555e-14;-161;1586;24192;19613;1;594;-2.14748e+09;-8.8671e+06;0;0;0;0;0;0;329373389;330547901;8630989
1058;1.16616e-14;-170;1672;24706;19733;1;610;-2.14748e+09;-8.83809e+06;-1;0;0;0;-1;0;329708972;330892014;8675653
1058;1.1555e-14;-162;1586;24192;19613;1;594;-2.14748e+09;-8.83809e+06;0;0;0;0;0;0;329708972;330892014;8675653
1059;1.16616e-14;-170;1672;24706;19733;1;610;-2.14748e+09;-8.80924e+06;-1;0;0;0;-1;0;330043604;331235207;8720370
1059;1.1555e-14;-162;1586;24192;19613;1;594;-2.14748e+09;-8.80924e+06;-1;0;0;0;-1;0;330043604;331235207;8720370
1060;1.16616e-14;-171;1672;24706;19733;1;610;-2.14748e+09;-8.78053e+06;0;0;0;0;0;0;330377288;331577485;8765140
1060;1.1555e-14;-163;1586;24192;19613;1;594;-2.14748e+09;-8.78053e+06;0;0;0;0;0;0;330377288;331577485;8765140
1061;1.16616e-14;-172;1672;24706;19733;1;610;-2.14748e+09;-8.75197e+06;0;0;0;0;0;0;330710029;331918851;8809962
1061;1.1555e-14;-163;1586;24192;19613;1;594;-2.14748e+09;-8.75197e+06;-1;0;0;0;-1;0;330710029;331918851;8809962
1062;1.16616e-14;-172;1672;24706;19733;1;610;-2.14748e+09;-8.72355e+06;-1;0;0;0;-1;0;331041828;332259309;8854835
1062;1.1555e-14;-164;1586;24192;19613;1;594;-2.14748e+09;-8.72355e+06;0;0;0;0;0;0;331041828;332259309;8854835
1063;1.16616e-14;-173;1672;24706;19733;1;610;-2.14748e+09;-8.69528e+06;0;0;0;0;0;0;331372692;332598863;8899758
1063;1.1555e-14;-165;1586;24192;19613;1;594;-2.14748e+09;-8.69528e+06;0;0;0;0;0;0;331372692;332598863;8899758
1064;1.16616e-14;-173;1672;24706;19733;1;610;-2.14748e+09;-8.66715e+06;-1;0;0;0;-1;0;331702622;332937516;8944732
1064;1.1555e-14;-166;1586;24192;19613;1;594;-2.14748e+09;-8.66715e+06;0;0;0;0;0;0;331702622;332937516;8944732
1065;1.16616e-14;-173;1672;24706;19733;1;610;-2.14748e+09;-8.63917e+06;-1;0;0;0;-1;0;332031624;333275272;8989755
1065;1.1555e-14;-167;1586;24192;19613;1;594;-2.14748e+09;-8.63917e+06;0;0;0;0;0;0;332031624;333275272;8989755
1066;1.16616e-14;-173;1672;24706;19733;1;610;-2.14748e+09;-8.61132e+06;-1;0;0;0;-1;0;332359699;333612135;9034827
1066;1.1555e-14;-167;1586;24192;19613;1;594;-2.14748e+09;-8.61132e+06;-1;0;0;0;-1;0;332359699;333612135;9034827
1067;1.16616e-14;-174;1672;24706;19733;1;610;-2.14748e+09;-8.58362e+06;0;0;0;0;0;0;332686853;333948107;9079948
1067;1.1555e-14;-167;1586;24192;19613;1;594;-2.14748e+09;-8.58362e+06;-1;0;0;0;-1;0;332686853;333948107;9079948
1068;1.16616e-14;-174;1672;24706;19733;1;610;-2.14748e+09;-8.55606e+06;-1;0;0;0;-1;0;333013088;334283193;9125117
1068;1.1555e-14;-167;1586;24192;19613;1;594;-2.14748e+09;-8.55606e+06;-1;0;0;0;-1;0;333013088;334283193;9125117
1069;1.16616e-14;-174;1672;24706;19733;1;610;-2.14748e+09;-8.52863e+06;-1;0;0;0;-1;0;333338409;334617397;9170333
1069;1.1555e-14;-167;1586;24192;19613;1;594;-2.14748e+09;-8.52863e+06;-1;0;0;0;-1;0;333338409;334617397;9170333
1070;1.16616e-14;-175;1672;24706;19733;1;610;-2.14748e+09;-8.50134e+06;0;0;0;0;0;0;333662818;334950720;9215596
1070;1.1555e-14;-167;1586;24192;19613;1;594;-2.14748e+09;-8.50134e+06;-1;0;0;0;-1;0;333662818;334950720;9215596
1071;1.16616e-14;-175;1672;24706;19733;1;610;-2.14748e+09;-8.47419e+06;-1;0;0;0;-1;0;333986320;335283168;9260905
1071;1.1555e-14;-167;1586;24192;19613;1;594;-2.14748e+09;-8.47419e+06;-1;0;0;0;-1;0;333986320;335283168;9260905
1072;1.16616e-14;-176;1672;24706;19733;1;610;-2.14748e+09;-8.44717e+06;0;0;0;0;0;0;334308917;335614744;9306260
1072;1.1555e-14;-168;1586;24192;19613;1;594;-2.14748e+09;-8.44717e+06;0;0;0;0;0;0;334308917;335614744;9306260
1073;1.16616e-14;-176;1672;24706;19733;1;610;-2.14748e+09;-8.42028e+06;-1;0;0;0;-1;0;334630614;335945450;9351661
1073;1.1555e-14;-169;1586;24192;19613;1;594;-2.14748e+09;-8.42028e+06;0;0;0;0;0;0;334630614;335945450;9351661
1074;1.16616e-14;-176;1672;24706;19733;1;610;-2.14748e+09;-8.39354e+06;-1;0;0;0;-1;0;334951413;336275291;9397106
1074;1.1555e-14;-170;1586;24192;19613;1;594;-2.14748e+09;-8.39354e+06;0;0;0;0;0;0;334951413;336275291;9397106
1075;1.16616e-14;-176;1672;24706;19733;1;610;-2.14748e+09;-8.36702e+06;-1;0;0;0;-1;0;335271319;336604270;9442595
1075;1.1555e-14;-171;1586;24192;19613;1;594;-2.14748e+09;-8.36702e+06;0;0;0;0;0;0;335271319;336604270;9442595
1076;1.16616e-14;-177;1672;24706;19733;1;610;-2.14748e+09;-8.34043e+06;0;0;0;0;0;0;335590335;336932390;9488128
1076;1.1555e-14;-172;1586;24192;19613;1;594;-2.14748e+09;-8.34043e+06;0;0;0;0;0;0;335590335;336932390;9488128
1077;1.16616e-14;-177;1672;24706;19733;1;610;-2.14748e+09;-8.31407e+06;-1;0;0;0;-1;0;335908463;337259654;9533704
1077;1.1555e-14;-173;1586;24192;19613;1;594;-2.14748e+09;-8.31407e+06;0;0;0;0;0;0;335908463;337259654;9533704
1078;1.16616e-14;-178;1672;24706;19733;1;610;-2.14748e+09;-8.28785e+06;0;0;0;0;0;0;336225709;337586067;9579323
1078;1.1555e-14;-174;1586;24192;19613;1;594;-2.14748e+09;-8.28785e+06;0;0;0;0;0;0;336225709;337586067;9579323
1079;1.16616e-14;-179;1672;24706;19733;1;610;-2.14748e+09;-8.26175e+06;0;0;0;0;0;0;336542074;337911631;9624983
1079;1.1555e-14;-175;1586;24192;19613;1;594;-2.14748e+09;-8.26175e+06;0;0;0;0;0;0;336542074;337911631;9624983
1080;1.16616e-14;-179;1672;24706;19733;1;610;-2.14748e+09;-8.23578e+06;-1;0;0;0;-1;0;336857563;338236349;9670686
1080;1.1555e-14;-175;1586;24192;19613;1;594;-2.14748e+09;-8.23578e+06;-1;0;0;0;-1;0;336857563;338236349;9670686
1081;1.16616e-14;-179;1672;24706;19733;1;610;-2.14748e+09;-8.20994e+06;-1;0;0;0;-1;0;337172178;338560226;9716429
1081;1.1555e-14;-175;1586;24192;19613;1;594;-2.14748e+09;-8.20994e+06;-1;0;0;0;-1;0;337172178;338560226;9716429
1082;1.16616e-14;-180;1672;24706;19733;1;610;-2.14748e+09;-8.18422e+06;0;0;0;0;0;0;337485923;338883263;9762213
1082;1.1555e-14;-175;1586;24192;19613;1;594;-2.14748e+09;-8.18422e+06;-1;0;0;0;-1;0;337485923;338883263;9762213
1083;1.16616e-14;-181;1672;24706;19733;1;610;-2.14748e+09;-8.15862e+06;0;0;0;0;0;0;337798802;339205465;9808037
1083;1.1555e-14;-175;1586;24192;19613;1;594;-2.14748e+09;-8.15862e+06;-1;0;0;0;-1;0;337798802;339205465;9808037
1084;1.16616e-14;-182;1672;24706;19733;1;610;-2.14748e+09;-8.13315e+06;0;0;0;0;0;0;338110817;339526835;9853900
1084;1.1555e-14;-175;1586;24192;19613;1;594;-2.14748e+09;-8.13316e+06;-1;0;0;0;-1;0;338110817;339526835;9853900
1085;1.16616e-14;-183;1672;24706;19733;1;610;-2.14748e+09;-8.10781e+06;0;0;0;0;0;0;338421972;339847375;9899802
1085;1.1555e-14;-175;1586;24192;19613;1;594;-2.14748e+09;-8.10781e+06;-1;0;0;0;-1;0;338421972;339847375;9899802
1086;1.16616e-14;-183;1672;24706;19733;1;610;-2.14748e+09;-8.08268e+06;-1;0;0;0;-1;0;338732271;340167090;9945743
1086;1.1555e-14;-175;1586;24192;19613;1;594;-2.14748e+09;-8.08268e+06;-1;0;0;0;-1;0;338732271;340167090;9945743
1087;1.16616e-14;-183;1672;24706;19733;1;610;-2.14748e+09;-8.05748e+06;-1;0;0;0;-1;0;339041716;340485982;9991722
1087;1.1555e-14;-175;1586;24192;19613;1;594;-2.14748e+09;-8.05748e+06;-1;0;0;0;-1;0;339041716;340485982;9991722
1088;1.16616e-14;-183;1672;24706;19733;1;610;-2.14748e+09;-8.0325e+06;-1;0;0;0;-1;0;339350310;340804054;10037738
1088;1.1555e-14;-175;1586;24192;19613;1;594;-2.14748e+09;-8.0325e+06;-1;0;0;0;-1;0;339350310;340804054;10037738
1089;1.16616e-14;-184;1672;24706;19733;1;610;-2.14748e+09;-8.00774e+06;0;0;0;0;0;0;339658057;341121310;10083791
1089;1.1555e-14;-175;1586;24192;19613;1;594;-2.14748e+09;-8.00774e+06;-1;0;0;0;-1;0;339658057;341121310;10083791
1090;1.16616e-14;-184;1672;24706;19733;1;610;-2.14748e+09;-7.9829e+06;-1;0;0;0;-1;0;339964961;341437753;10129881
1090;1.1555e-14;-176;1586;24192;19613;1;594;-2.14748e+09;-7.9829e+06;0;0;0;0;0;0;339964961;341437753;10129881
1091;1.16616e-14;-185;1672;24706;19733;1;610;-2.14748e+09;-7.95827e+06;0;0;0;0;0;0;340271024;341753386;10176006
1091;1.1555e-14;-176;1586;24192;19613;1;594;-2.14748e+09;-7.95827e+06;-1;0;0;0;-1;0;340271024;341753386;10176006
1092;1.16616e-14;-186;1672;24706;19733;1;610;-2.14748e+09;-7.93376e+06;0;0;0;0;0;0;340576249;342068211;10222167
1092;1.1555e-14;-177;1586;24192;19613;1;594;-2.14748e+09;-7.93376e+06;0;0;0;0;0;0;340576249;342068211;10222167
1093;1.16616e-14;-186;1672;24706;19733;1;610;-2.14748e+09;-7.90937e+06;-1;0;0;0;-1;0;340880640;342382233;10268363
1093;1.1555e-14;-178;1586;24192;19613;1;594;-2.14748e+09;-7.90937e+06;0;0;0;0;0;0;340880640;342382233;10268363
1094;1.16616e-14;-187;1672;24706;19733;1;610;-2.14748e+09;-7.8851e+06;0;0;0;0;0;0;341184199;342695454;10314594
1094;1.1555e-14;-179;1586;24192;19613;1;594;-2.14748e+09;-7.8851e+06;0;0;0;0;0;0;341184199;342695454;10314594
1095;1.16616e-14;-188;1672;24706;19733;1;610;-2.14748e+09;-7.86094e+06;0;0;0;0;0;0;341486930;343007877;10360858
1095;1.1555e-14;-180;1586;24192;19613;1;594;-2.14748e+09;-7.86094e+06;0;0;0;0;0;0;341486930;343007877;10360858
1096;1.16616e-14;-189;1672;24706;19733;1;610;-2.14748e+09;-7.83699e+06;0;0;0;0;0;0;341788837;343319505;10407156
1096;1.1555e-14;-180;1586;24192;19613;1;594;-2.14748e+09;-7.83699e+06;-1;0;0;0;-1;0;341788837;343319505;10407156
1097;1.16616e-14;-189;1672;24706;19733;1;610;-2.14748e+09;-7.81296e+06;-1;0;0;0;-1;0;342089921;343630341;10453487
1097;1.1555e-14;-181;1586;24192;19613;1;594;-2.14748e+09;-7.81296e+06;0;0;0;0;0;0;342089921;343630341;10453487
1098;1.16616e-14;-190;1672;24706;19733;1;610;-2.14748e+09;-7.78914e+06;0;0;0;0;0;0;342390186;343940389;10499850
1098;1.1555e-14;-181;1586;24192;19613;1;594;-2.14748e+09;-7.78914e+06;-1;0;0;0;-1;0;342390186;343940389;10499850
1099;1.16616e-14;-190;1672;24706;19733;1;610;-2.14748e+09;-7.76543e+06;-1;0;0;0;-1;0;342689636;344249650;10546245
1099;1.1555e-14;-181;1586;24192;19613;1;594;-2.14748e+09;-7.76543e+06;-1;0;0;0;-1;0;342689636;344249650;10546245
1100;1.16616e-14;-191;1672;24706;19733;1;610;-2.14748e+09;-7.74183e+06;0;0;0;0;0;0;342988272;344558129;10592672
1100;1.1555e-14;-181;1586;24192;19613;1;594;-2.14748e+09;-7.74183e+06;-1;0;0;0;-1;0;342988272;344558129;10592672
1101;1.16616e-14;-191;1672;24706;19733;1;610;-2.14748e+09;-7.71834e+06;-1;0;0;0;-1;0;343286099;344865828;10639130
1101;1.1555e-14;-182;1586;24192;19613;1;594;-2.14748e+09;-7.71834e+06;0;0;0;0;0;0;343286099;344865828;10639130
1102;1.16616e-14;-191;1672;24706;19733;1;610;-2.14748e+09;-7.69496e+06;-1;0;0;0;-1;0;343583119;345172750;10685619
1102;1.1555e-14;-182;1586;24192;19613;1;594;-2.14748e+09;-7.69496e+06;-1;0;0;0;-1;0;343583119;345172750;10685619
1103;1.16616e-14;-191;1672;24706;19733;1;610;-2.14748e+09;-7.67169e+06;-1;0;0;0;-1;0;343879335;345478898;10732137
1103;1.1555e-14;-182;1586;24192;19613;1;594;-2.14748e+09;-7.67169e+06;-1;0;0;0;-1;0;343879335;345478898;10732137
1104;1.16616e-14;-191;1672;24706;19733;1;610;-2.14748e+09;-7.64853e+06;-1;0;0;0;-1;0;344174750;345784275;10778685
1104;1.1555e-14;-182;1586;24192;19613;1;594;-2.14748e+09;-7.64853e+06;-1;0;0;0;-1;0;344174750;345784275;10778685
1105;1.16616e-14;-192;1672;24706;19733;1;610;-2.14748e+09;-7.62547e+06;0;0;0;0;0;0;344469367;346088884;10825263
1105;1.1555e-14;-182;1586;24192;19613;1;594;-2.14748e+09;-7.62547e+06;-1;0;0;0;-1;0;344469367;346088884;10825263
1106;1.16616e-14;-192;1672;24706;19733;1;610;-2.14748e+09;-7.60252e+06;-1;0;0;0;-1;0;344763189;346392727;10871869
1106;1.1555e-14;-183;1586;24192;19613;1;594;-2.14748e+09;-7.60252e+06;0;0;0;0;0;0;344763189;346392727;10871869
1107;1.16616e-14;-192;1672;24706;19733;1;610;-2.14748e+09;-7.57968e+06;-1;0;0;0;-1;0;345056220;346695807;10918503
1107;1.1555e-14;-183;1586;24192;19613;1;594;-2.14748e+09;-7.57968e+06;-1;0;0;0;-1;0;345056220;346695807;10918503
1108;1.16616e-14;-192;1672;24706;19733;1;610;-2.14748e+09;-7.55694e+06;-1;0;0;0;-1;0;345348461;346998128;10965165
1108;1.1555e-14;-184;1586;24192;19613;1;594;-2.14748e+09;-7.55694e+06;0;0;0;0;0;0;345348461;346998128;10965165
1109;1.16616e-14;-192;1672;24706;19733;1;610;-2.14748e+09;-7.53431e+06;-1;0;0;0;-1;0;345639916;347299692;11011854
1109;1.1555e-14;-184;1586;24192;19613;1;594;-2.14748e+09;-7.53431e+06;-1;0;0;0;-1;0;345639916;347299692;11011854
1110;1.16616e-14;-193;1672;24706;19733;1;610;-2.14748e+09;-7.51178e+06;0;0;0;0;0;0;345930587;347600502;11058571
1110;1.1555e-14;-184;1586;24192;19613;1;594;-2.14748e+09;-7.51178e+06;-1;0;0;0;-1;0;345930587;347600502;11058571
1111;1.16616e-14;-194;1672;24706;19733;1;610;-2.14748e+09;-7.48936e+06;0;0;0;0;0;0;346220478;347900561;11105313
1111;1.1555e-14;-185;1586;24192;19613;1;594;-2.14748e+09;-7.48935e+06;0;0;0;0;0;0;346220478;347900561;11105313
1112;1.16616e-14;-194;1672;24706;19733;1;610;-2.14748e+09;-7.46703e+06;-1;0;0;0;-1;0;346509591;348199871;11152081
1112;1.1555e-14;-186;1586;24192;19613;1;594;-2.14748e+09;-7.46703e+06;0;0;0;0;0;0;346509591;348199871;11152081
1113;1.16616e-14;-194;1672;24706;19733;1;610;-2.14748e+09;-7.44481e+06;-1;0;0;0;-1;0;346797930;348498436;11198875
1113;1.1555e-14;-186;1586;24192;19613;1;594;-2.14748e+09;-7.44481e+06;-1;0;0;0;-1;0;346797930;348498436;11198875
1114;1.16616e-14;-195;1672;24706;19733;1;610;-2.14748e+09;-7.42278e+06;0;0;0;0;0;0;347085497;348796257;11245694
1114;1.1555e-14;-187;1586;24192;19613;1;594;-2.14748e+09;-7.42278e+06;0;0;0;0;0;0;347085497;348796257;11245694
1115;1.16616e-14;-196;1672;24706;19733;1;610;-2.14748e+09;-7.40076e+06;0;0;0;0;0;0;347372294;349093338;11292537
1115;1.1555e-14;-187;1586;24192;19613;1;594;-2.14748e+09;-7.40076e+06;-1;0;0;0;-1;0;347372294;349093338;11292537
1116;1.16616e-14;-197;1672;24706;19733;1;610;-2.14748e+09;-7.37874e+06;0;0;0;0;0;0;347658325;349389682;11339405
1116;1.1555e-14;-188;1586;24192;19613;1;594;-2.14748e+09;-7.37874e+06;0;0;0;0;0;0;347658325;349389682;11339405
1117;1.16616e-14;-197;1672;24706;19733;1;610;-2.14748e+09;-7.35692e+06;-1;0;0;0;-1;0;347943592;349685291;11386296
1117;1.1555e-14;-189;1586;24192;19613;1;594;-2.14748e+09;-7.35692e+06;0;0;0;0;0;0;347943592;349685291;11386296
1118;1.16616e-14;-198;1672;24706;19733;1;610;-2.14748e+09;-7.33519e+06;0;0;0;0;0;0;348228099;349980168;11433210
1118;1.1555e-14;-189;1586;24192;19613;1;594;-2.14748e+09;-7.33519e+06;-1;0;0;0;-1;0;348228099;349980168;11433210
1119;1.16616e-14;-199;1672;24706;19733;1;610;-2.14748e+09;-7.31357e+06;0;0;0;0;0;0;348511847;350274315;11480147
1119;1.1555e-14;-190;1586;24192;19613;1;594;-2.14748e+09;-7.31357e+06;0;0;0;0;0;0;348511847;350274315;11480147
1120;1.16616e-14;-200;1672;24706;19733;1;610;-2.14748e+09;-7.29203e+06;0;0;0;0;0;0;348794840;350567736;11527107
1120;1.1555e-14;-190;1586;24192;19613;1;594;-2.14748e+09;-7.29204e+06;-1;0;0;0;-1;0;348794840;350567736;11527107
1121;1.16616e-14;-201;1672;24706;19733;1;610;-2.14748e+09;-7.2706e+06;0;0;0;0;0;0;349077081;350860432;11574088
1121;1.1555e-14;-190;1586;24192;19613;1;594;-2.14748e+09;-7.2706e+06;-1;0;0;0;-1;0;349077081;350860432;11574088
1122;1.16616e-14;-202;1672;24706;19733;1;610;-2.14748e+09;-7.24926e+06;0;0;0;0;0;0;349358571;351152407;11621091
1122;1.1555e-14;-191;1586;24192;19613;1;594;-2.14748e+09;-7.24926e+06;0;0;0;0;0;0;349358571;351152407;11621091
1123;1.16616e-14;-203;1672;24706;19733;1;610;-2.14748e+09;-7.22802e+06;0;0;0;0;0;0;349639315;351443663;11668114
1123;1.1555e-14;-191;1586;24192;19613;1;594;-2.14748e+09;-7.22802e+06;-1;0;0;0;-1;0;349639315;351443663;11668114
1124;1.16616e-14;-203;1672;24706;19733;1;610;-2.14748e+09;-7.20687e+06;-1;0;0;0;-1;0;349919313;351734202;11715158
1124;1.1555e-14;-192;1586;24192;19613;1;594;-2.14748e+09;-7.20687e+06;0;0;0;0;0;0;349919313;351734202;11715158
1125;1.16616e-14;-203;1672;24706;19733;1;610;-2.14748e+09;-7.18582e+06;-1;0;0;0;-1;0;350198570;352024028;11762223
1125;1.1555e-14;-193;1586;24192;19613;1;594;-2.14748e+09;-7.18582e+06;0;0;0;0;0;0;350198570;352024028;11762223
1126;1.16616e-14;-203;1672;24706;19733;1;610;-2.14748e+09;-7.16485e+06;-1;0;0;0;-1;0;350477088;352313143;11809307
1126;1.1555e-14;-193;1586;24192;19613;1;594;-2.14748e+09;-7.16485e+06;-1;0;0;0;-1;0;350477088;352313143;11809307
1127;1.16616e-14;-204;1672;24706;19733;1;610;-2.14748e+09;-7.14398e+06;0;0;0;0;0;0;350754869;352601549;11856410
1127;1.1555e-14;-194;1586;24192;19613;1;594;-2.14748e+09;-7.14398e+06;0;0;0;0;0;0;350754869;352601549;11856410
1128;1.16616e-14;-205;1672;24706;19733;1;610;-2.14748e+09;-7.12321e+06;0;0;0;0;0;0;351031916;352889249;11903532
1128;1.1555e-14;-194;1586;24192;19613;1;594;-2.14748e+09;-7.12321e+06;-1;0;0;0;-1;0;351031916;352889249;11903532
1129;1.16616e-14;-205;1672;24706;19733;1;610;-2.14748e+09;-7.10252e+06;-1;0;0;0;-1;0;351308232;353176246;11950673
1129;1.1555e-14;-194;1586;24192;19613;1;594;-2.14748e+09;-7.10252e+06;-1;0;0;0;-1;0;351308232;353176246;11950673
1130;1.16616e-14;-206;1672;24706;19733;1;610;-2.14748e+09;-7.08193e+06;0;0;0;0;0;0;351583819;353462542;11997831
1130;1.1555e-14;-195;1586;24192;19613;1;594;-2.14748e+09;-7.08193e+06;0;0;0;0;0;0;351583819;353462542;11997831
1131;1.16616e-14;-207;1672;24706;19733;1;610;-2.14748e+09;-7.06142e+06;0;0;0;0;0;0;351858680;353748139;12045007
1131;1.1555e-14;-196;1586;24192;19613;1;594;-2.14748e+09;-7.06142e+06;0;0;0;0;0;0;351858680;353748139;12045007
1132;1.16616e-14;-208;1672;24706;19733;1;610;-2.14748e+09;-7.04101e+06;0;0;0;0;0;0;352132818;354033040;12092200
1132;1.1555e-14;-197;1586;24192;19613;1;594;-2.14748e+09;-7.04101e+06;0;0;0;0;0;0;352132818;354033040;12092200
1133;1.16616e-14;-209;1672;24706;19733;1;610;-2.14748e+09;-7.02068e+06;0;0;0;0;0;0;352406234;354317248;12139410
1133;1.1555e-14;-198;1586;24192;19613;1;594;-2.14748e+09;-7.02068e+06;0;0;0;0;0;0;352406234;354317248;12139410
1134;1.16616e-14;-209;1672;24706;19733;1;610;-2.14748e+09;-7.00044e+06;-1;0;0;0;-1;0;352678932;354600765;12186637
1134;1.1555e-14;-198;1586;24192;19613;1;594;-2.14748e+09;-7.00044e+06;-1;0;0;0;-1;0;352678932;354600765;12186637
1135;1.16616e-14;-209;1672;24706;19733;1;610;-2.14748e+09;-6.98029e+06;-1;0;0;0;-1;0;352950915;354883593;12233879
1135;1.1555e-14;-198;1586;24192;19613;1;594;-2.14748e+09;-6.98029e+06;-1;0;0;0;-1;0;352950915;354883593;12233879
1136;1.16616e-14;-210;1672;24706;19733;1;610;-2.14748e+09;-6.96023e+06;0;0;0;0;0;0;353222183;355165736;12281136
1136;1.1555e-14;-199;1586;24192;19613;1;594;-2.14748e+09;-6.96023e+06;0;0;0;0;0;0;353222183;355165736;12281136
1137;1.16616e-14;-211;1672;24706;19733;1;610;-2.14748e+09;-6.94026e+06;0;0;0;0;0;0;353492741;355447194;12328409
1137;1.1555e-14;-199;1586;24192;19613;1;594;-2.14748e+09;-6.94026e+06;-1;0;0;0;-1;0;353492741;355447194;12328409
1138;1.16616e-14;-212;1672;24706;19733;1;610;-2.14748e+09;-6.92037e+06;0;0;0;0;0;0;353762591;355727971;12375697
1138;1.1555e-14;-199;1586;24192;19613;1;594;-2.14748e+09;-6.92037e+06;-1;0;0;0;-1;0;353762591;355727971;12375697
1139;1.16616e-14;-212;1672;24706;19733;1;610;-2.14748e+09;-6.90056e+06;-1;0;0;0;-1;0;354031735;356008070;12422998
1139;1.1555e-14;-199;1586;24192;19613;1;594;-2.14748e+09;-6.90056e+06;-1;0;0;0;-1;0;354031735;356008070;12422998
1140;1.16616e-14;-212;1672;24706;19733;1;610;-2.14748e+09;-6.88085e+06;-1;0;0;0;-1;0;354300175;356287492;12470314
1140;1.1555e-14;-199;1586;24192;19613;1;594;-2.14748e+09;-6.88085e+06;-1;0;0;0;-1;0;354300175;356287492;12470314
1141;1.16616e-14;-212;1672;24706;19733;1;610;-2.14748e+09;-6.86121e+06;-1;0;0;0;-1;0;354567914;356566240;12517643
1141;1.1555e-14;-199;1586;24192;19613;1;594;-2.14748e+09;-6.86121e+06;-1;0;0;0;-1;0;354567914;356566240;12517643
1142;1.16616e-14;-213;1672;24706;19733;1;610;-2.14748e+09;-6.84166e+06;0;0;0;0;0;0;354834955;356844316;12564985
1142;1.1555e-14;-200;1586;24192;19613;1;594;-2.14748e+09;-6.84166e+06;0;0;0;0;0;0;354834955;356844316;12564985
1143;1.16616e-14;-214;1672;24706;19733;1;610;-2.14748e+09;-6.8222e+06;0;0;0;0;0;0;355101300;357121723;12612340
1143;1.1555e-14;-200;1586;24192;19613;1;594;-2.14748e+09;-6.8222e+06;-1;0;0;0;-1;0;355101300;357121723;12612340
1144;1.16616e-14;-214;1672;24706;19733;1;610;-2.14748e+09;-6.80282e+06;-1;0;0;0;-1;0;355366951;357398463;12659707
1144;1.1555e-14;-200;1586;24192;19613;1;594;-2.14748e+09;-6.80282e+06;-1;0;0;0;-1;0;355366951;357398463;12659707
1145;1.16616e-14;-215;1672;24706;19733;1;610;-2.14748e+09;-6.78352e+06;0;0;0;0;0;0;355631911;357674539;12707086
1145;1.1555e-14;-201;1586;24192;19613;1;594;-2.14748e+09;-6.78352e+06;0;0;0;0;0;0;355631911;357674539;12707086
1146;1.16616e-14;-215;1672;24706;19733;1;610;-2.14748e+09;-6.7643e+06;-1;0;0;0;-1;0;355896183;357949952;12754476
1146;1.1555e-14;-201;1586;24192;19613;1;594;-2.14748e+09;-6.7643e+06;-1;0;0;0;-1;0;355896183;357949952;12754476
1147;1.16616e-14;-216;1672;24706;19733;1;610;-2.14748e+09;-6.74516e+06;0;0;0;0;0;0;356159768;358224705;12801877
1147;1.1555e-14;-202;1586;24192;19613;1;594;-2.14748e+09;-6.74516e+06;0;0;0;0;0;0;356159768;358224705;12801877
1148;1.16616e-14;-217;1672;24706;19733;1;610;-2.14748e+09;-6.72611e+06;0;0;0;0;0;0;356422668;358498800;12849290
1148;1.1555e-14;-202;1586;24192;19613;1;594;-2.14748e+09;-6.72611e+06;-1;0;0;0;-1;0;356422668;358498800;12849290
1149;1.16616e-14;-217;1672;24706;19733;1;610;-2.14748e+09;-6.70723e+06;-1;0;0;0;-1;0;356684888;358772240;12896712
1149;1.1555e-14;-202;1586;24192;19613;1;594;-2.14748e+09;-6.70723e+06;-1;0;0;0;-1;0;356684888;358772240;12896712
1150;1.16616e-14;-217;1672;24706;19733;1;610;-2.14748e+09;-6.68834e+06;-1;0;0;0;-1;0;356946428;359045027;12944145
1150;1.1555e-14;-202;1586;24192;19613;1;594;-2.14748e+09;-6.68834e+06;-1;0;0;0;-1;0;356946428;359045027;12944145
1151;1.16616e-14;-218;1672;24706;19733;1;610;-2.14748e+09;-6.66942e+06;0;0;0;0;0;0;357207291;359317163;12991587
1151;1.1555e-14;-202;1586;24192;19613;1;594;-2.14748e+09;-6.66942e+06;-1;0;0;0;-1;0;357207291;359317163;12991587
1152;1.16616e-14;-219;1672;24706;19733;1;610;-2.14748e+09;-6.65069e+06;0;0;0;0;0;0;357467479;359588650;13039038
1152;1.1555e-14;-202;1586;24192;19613;1;594;-2.14748e+09;-6.65069e+06;-1;0;0;0;-1;0;357467479;359588650;13039038
1153;1.16616e-14;-220;1672;24706;19733;1;610;-2.14748e+09;-6.63203e+06;0;0;0;0;0;0;357726996;359859490;13086498
1153;1.1555e-14;-203;1586;24192;19613;1;594;-2.14748e+09;-6.63203e+06;0;0;0;0;0;0;357726996;359859490;13086498
1154;1.16616e-14;-220;1672;24706;19733;1;610;-2.14748e+09;-6.61345e+06;-1;0;0;0;-1;0;357985842;360129687;13133966
1154;1.1555e-14;-204;1586;24192;19613;1;594;-2.14748e+09;-6.61345e+06;0;0;0;0;0;0;357985842;360129687;13133966
1155;1.16616e-14;-221;1672;24706;19733;1;610;-2.14748e+09;-6.59495e+06;0;0;0;0;0;0;358244021;360399242;13181442
1155;1.1555e-14;-204;1586;24192;19613;1;594;-2.14748e+09;-6.59495e+06;-1;0;0;0;-1;0;358244021;360399242;13181442
1156;1.16616e-14;-222;1672;24706;19733;1;610;-2.14748e+09;-6.57652e+06;0;0;0;0;0;0;358501534;360668156;13228927
1156;1.1555e-14;-205;1586;24192;19613;1;594;-2.14748e+09;-6.57652e+06;0;0;0;0;0;0;358501534;360668156;13228927
1157;1.16616e-14;-222;1672;24706;19733;1;610;-2.14748e+09;-6.55818e+06;-1;0;0;0;-1;0;358758384;360936434;13276418
1157;1.1555e-14;-206;1586;24192;19613;1;594;-2.14748e+09;-6.55818e+06;0;0;0;0;0;0;358758384;360936434;13276418
1158;1.16616e-14;-223;1672;24706;19733;1;610;-2.14748e+09;-6.5399e+06;0;0;0;0;0;0;359014574;361204076;13323916
1158;1.1555e-14;-206;1586;24192;19613;1;594;-2.14748e+09;-6.5399e+06;-1;0;0;0;-1;0;359014574;361204076;13323916
1159;1.16616e-14;-224;1672;24706;19733;1;610;-2.14748e+09;-6.52171e+06;0;0;0;0;0;0;359270105;361471084;13371421
1159;1.1555e-14;-207;1586;24192;19613;1;594;-2.14748e+09;-6.52171e+06;0;0;0;0;0;0;359270105;361471084;13371421
1160;1.16616e-14;-225;1672;24706;19733;1;610;-2.14748e+09;-6.50359e+06;0;0;0;0;0;0;359524979;361737462;13418932
1160;1.1555e-14;-208;1586;24192;19613;1;594;-2.14748e+09;-6.50359e+06;0;0;0;0;0;0;359524979;361737462;13418932
1161;1.16616e-14;-226;1672;24706;19733;1;610;-2.14748e+09;-6.48564e+06;0;0;0;0;0;0;359779200;362003211;13466449
1161;1.1555e-14;-209;1586;24192;19613;1;594;-2.14748e+09;-6.48564e+06;0;0;0;0;0;0;359779200;362003211;13466449
1162;1.16616e-14;-227;1672;24706;19733;1;610;-2.14748e+09;-6.46757e+06;0;0;0;0;0;0;360032769;362268333;13513972
1162;1.1555e-14;-209;1586;24192;19613;1;594;-2.14748e+09;-6.46757e+06;-1;0;0;0;-1;0;360032769;362268333;13513972
1163;1.16616e-14;-228;1672;24706;19733;1;610;-2.14748e+09;-6.44967e+06;0;0;0;0;0;0;360285688;362532830;13561499
1163;1.1555e-14;-210;1586;24192;19613;1;594;-2.14748e+09;-6.44967e+06;0;0;0;0;0;0;360285688;362532830;13561499
1164;1.16616e-14;-229;1672;24706;19733;1;610;-2.14748e+09;-6.43184e+06;0;0;0;0;0;0;360537959;362796705;13609031
1164;1.1555e-14;-211;1586;24192;19613;1;594;-2.14748e+09;-6.43184e+06;0;0;0;0;0;0;360537959;362796705;13609031
1165;1.16616e-14;-229;1672;24706;19733;1;610;-2.14748e+09;-6.41419e+06;-1;0;0;0;-1;0;360789586;363059959;13656568
1165;1.1555e-14;-211;1586;24192;19613;1;594;-2.14748e+09;-6.41419e+06;-1;0;0;0;-1;0;360789586;363059959;13656568
1166;1.16616e-14;-229;1672;24706;19733;1;610;-2.14748e+09;-6.39642e+06;-1;0;0;0;-1;0;361040569;363322595;13704109
1166;1.1555e-14;-211;1586;24192;19613;1;594;-2.14748e+09;-6.39642e+06;-1;0;0;0;-1;0;361040569;363322595;13704109
1167;1.16616e-14;-230;1672;24706;19733;1;610;-2.14748e+09;-6.37881e+06;0;0;0;0;0;0;361290912;363584615;13751653
1167;1.1555e-14;-212;1586;24192;19613;1;594;-2.14748e+09;-6.37881e+06;0;0;0;0;0;0;361290912;363584615;13751653
1168;1.16616e-14;-231;1672;24706;19733;1;610;-2.14748e+09;-6.36127e+06;0;0;0;0;0;0;361540616;363846021;13799201
1168;1.1555e-14;-212;1586;24192;19613;1;594;-2.14748e+09;-6.36127e+06;-1;0;0;0;-1;0;361540616;363846021;13799201
1169;1.16616e-14;-232;1672;24706;19733;1;610;-2.14748e+09;-6.34381e+06;0;0;0;0;0;0;361789684;364106814;13846751
1169;1.1555e-14;-213;1586;24192;19613;1;594;-2.14748e+09;-6.34381e+06;0;0;0;0;0;0;361789684;364106814;13846751
1170;1.16616e-14;-232;1672;24706;19733;1;610;-2.14748e+09;-6.32642e+06;-1;0;0;0;-1;0;362038117;364366998;13894305
1170;1.1555e-14;-214;1586;24192;19613;1;594;-2.14748e+09;-6.32642e+06;0;0;0;0;0;0;362038117;364366998;13894305
1171;1.16616e-14;-232;1672;24706;19733;1;610;-2.14748e+09;-6.30909e+06;-1;0;0;0;-1;0;362285918;364626574;13941860
1171;1.1555e-14;-215;1586;24192;19613;1;594;-2.14748e+09;-6.30909e+06;0;0;0;0;0;0;362285918;364626574;13941860
1172;1.16616e-14;-232;1672;24706;19733;1;610;-2.14748e+09;-6.29184e+06;-1;0;0;0;-1;0;362533088;364885543;13989418
1172;1.1555e-14;-215;1586;24192;19613;1;594;-2.14748e+09;-6.29184e+06;-1;0;0;0;-1;0;362533088;364885543;13989418
1173;1.16616e-14;-232;1672;24706;19733;1;610;-2.14748e+09;-6.27466e+06;-1;0;0;0;-1;0;362779631;365143909;14036977
1173;1.1555e-14;-215;1586;24192;19613;1;594;-2.14748e+09;-6.27466e+06;-1;0;0;0;-1;0;362779631;365143909;14036977
1174;1.16616e-14;-232;1672;24706;19733;1;610;-2.14748e+09;-6.25754e+06;-1;0;0;0;-1;0;363025548;365401673;14084537
1174;1.1555e-14;-215;1586;24192;19613;1;594;-2.14748e+09;-6.25754e+06;-1;0;0;0;-1;0;363025548;365401673;14084537
1175;1.16616e-14;-232;1672;24706;19733;1;610;-2.14748e+09;-6.2405e+06;-1;0;0;0;-1;0;363270841;365658837;14132099
1175;1.1555e-14;-216;1586;24192;19613;1;594;-2.14748e+09;-6.2405e+06;0;0;0;0;0;0;363270841;365658837;14132099
1176;1.16616e-14;-233;1672;24706;19733;1;610;-2.14748e+09;-6.22352e+06;0;0;0;0;0;0;363515512;365915403;14179661
1176;1.1555e-14;-217;1586;24192;19613;1;594;-2.14748e+09;-6.22352e+06;0;0;0;0;0;0;363515512;365915403;14179661
1177;1.16616e-14;-234;1672;24706;19733;1;610;-2.14748e+09;-6.20661e+06;0;0;0;0;0;0;363759564;366171373;14227223
1177;1.1555e-14;-218;1586;24192;19613;1;594;-2.14748e+09;-6.20661e+06;0;0;0;0;0;0;363759564;366171373;14227223
1178;1.16616e-14;-234;1672;24706;19733;1;610;-2.14748e+09;-6.18977e+06;-1;0;0;0;-1;0;364002998;366426749;14274785
1178;1.1555e-14;-218;1586;24192;19613;1;594;-2.14748e+09;-6.18977e+06;-1;0;0;0;-1;0;364002998;366426749;14274785
1179;1.16616e-14;-235;1672;24706;19733;1;610;-2.14748e+09;-6.173e+06;0;0;0;0;0;0;364245816;366681533;14322347
1179;1.1555e-14;-219;1586;24192;19613;1;594;-2.14748e+09;-6.173e+06;0;0;0;0;0;0;364245816;366681533;14322347
1180;1.16616e-14;-235;1672;24706;19733;1;610;-2.14748e+09;-6.15629e+06;-1;0;0;0;-1;0;364488022;366935727;14369908
1180;1.1555e-14;-220;1586;24192;19613;1;594;-2.14748e+09;-6.15629e+06;0;0;0;0;0;0;364488022;366935727;14369908
1181;1.16616e-14;-235;1672;24706;19733;1;610;-2.14748e+09;-6.13965e+06;-1;0;0;0;-1;0;364729615;367189333;14417467
1181;1.1555e-14;-221;1586;24192;19613;1;594;-2.14748e+09;-6.13965e+06;0;0;0;0;0;0;364729615;367189333;14417467
1182;1.16616e-14;-236;1672;24706;19733;1;610;-2.14748e+09;-6.12307e+06;0;0;0;0;0;0;364970599;367442353;14465026
1182;1.1555e-14;-221;1586;24192;19613;1;594;-2.14748e+09;-6.12307e+06;-1;0;0;0;-1;0;364970599;367442353;14465026
1183;1.16616e-14;-236;1672;24706;19733;1;610;-2.14748e+09;-6.10656e+06;-1;0;0;0;-1;0;365210976;367694789;14512583
1183;1.1555e-14;-221;1586;24192;19613;1;594;-2.14748e+09;-6.10656e+06;-1;0;0;0;-1;0;365210976;367694789;14512583
1184;1.16616e-14;-237;1672;24706;19733;1;610;-2.14748e+09;-6.09012e+06;0;0;0;0;0;0;365450748;367946642;14560138
1184;1.1555e-14;-221;1586;24192;19613;1;594;-2.14748e+09;-6.09012e+06;-1;0;0;0;-1;0;365450748;367946642;14560138
1185;1.16616e-14;-237;1672;24706;19733;1;610;-2.14748e+09;-6.07374e+06;-1;0;0;0;-1;0;365689916;368197915;14607690
1185;1.1555e-14;-222;1586;24192;19613;1;594;-2.14748e+09;-6.07374e+06;0;0;0;0;0;0;365689916;368197915;14607690
1186;1.16616e-14;-238;1672;24706;19733;1;610;-2.14748e+09;-6.05743e+06;0;0;0;0;0;0;365928482;368448610;14655240
1186;1.1555e-14;-222;1586;24192;19613;1;594;-2.14748e+09;-6.05743e+06;-1;0;0;0;-1;0;365928482;368448610;14655240
1187;1.16616e-14;-238;1672;24706;19733;1;610;-2.14748e+09;-6.04118e+06;-1;0;0;0;-1;0;366166450;368698728;14702786
1187;1.1555e-14;-223;1586;24192;19613;1;594;-2.14748e+09;-6.04118e+06;0;0;0;0;0;0;366166450;368698728;14702786
1188;1.16616e-14;-239;1672;24706;19733;1;610;-2.14748e+09;-6.02499e+06;0;0;0;0;0;0;366403820;368948271;14750330
1188;1.1555e-14;-224;1586;24192;19613;1;594;-2.14748e+09;-6.02499e+06;0;0;0;0;0;0;366403820;368948271;14750330
1189;1.16616e-14;-239;1672;24706;19733;1;610;-2.14748e+09;-6.00886e+06;-1;0;0;0;-1;0;366640594;369197241;14797870
1189;1.1555e-14;-225;1586;24192;19613;1;594;-2.14748e+09;-6.00886e+06;0;0;0;0;0;0;366640594;369197241;14797870
1190;1.16616e-14;-239;1672;24706;19733;1;610;-2.14748e+09;-5.9928e+06;-1;0;0;0;-1;0;366876775;369445640;14845405
1190;1.1555e-14;-226;1586;24192;19613;1;594;-2.14748e+09;-5.9928e+06;0;0;0;0;0;0;366876775;369445640;14845405
1191;1.16616e-14;-239;1672;24706;19733;1;610;-2.14748e+09;-5.97681e+06;-1;0;0;0;-1;0;367112364;369693471;14892937
1191;1.1555e-14;-227;1586;24192;19613;1;594;-2.14748e+09;-5.97681e+06;0;0;0;0;0;0;367112364;369693471;14892937
1192;1.16616e-14;-240;1672;24706;19733;1;610;-2.14748e+09;-5.96087e+06;0;0;0;0;0;0;367347364;369940734;14940464
1192;1.1555e-14;-228;1586;24192;19613;1;594;-2.14748e+09;-5.96087e+06;0;0;0;0;0;0;367347364;369940734;14940464
1193;1.16616e-14;-240;1672;24706;19733;1;610;-2.14748e+09;-5.945e+06;-1;0;0;0;-1;0;367581776;370187431;14987986
1193;1.1555e-14;-229;1586;24192;19613;1;594;-2.14748e+09;-5.945e+06;0;0;0;0;0;0;367581776;370187431;14987986
1194;1.16616e-14;-240;1672;24706;19733;1;610;-2.14748e+09;-5.92918e+06;-1;0;0;0;-1;0;367815602;370433565;15035503
1194;1.1555e-14;-230;1586;24192;19613;1;594;-2.14748e+09;-5.92918e+06;0;0;0;0;0;0;367815602;370433565;15035503
1195;1.16616e-14;-240;1672;24706;19733;1;610;-2.14748e+09;-5.91343e+06;-1;0;0;0;-1;0;368048844;370679137;15083015
1195;1.1555e-14;-231;1586;24192;19613;1;594;-2.14748e+09;-5.91343e+06;0;0;0;0;0;0;368048844;370679137;15083015
1196;1.16616e-14;-240;1672;24706;19733;1;610;-2.14748e+09;-5.89774e+06;-1;0;0;0;-1;0;368281505;370924149;15130520
1196;1.1555e-14;-232;1586;24192;19613;1;594;-2.14748e+09;-5.89774e+06;0;0;0;0;0;0;368281505;370924149;15130520
1197;1.16616e-14;-241;1672;24706;19733;1;610;-2.14748e+09;-5.88211e+06;0;0;0;0;0;0;368513585;371168602;15178020
1197;1.1555e-14;-232;1586;24192;19613;1;594;-2.14748e+09;-5.88211e+06;-1;0;0;0;-1;0;368513585;371168602;15178020
1198;1.16616e-14;-242;1672;24706;19733;1;610;-2.14748e+09;-5.86654e+06;0;0;0;0;0;0;368745087;371412500;15225513
1198;1.1555e-14;-232;1586;24192;19613;1;594;-2.14748e+09;-5.86654e+06;-1;0;0;0;-1;0;368745087;371412500;15225513
1199;1.16616e-14;-243;1672;24706;19733;1;610;-2.14748e+09;-5.85103e+06;0;0;0;0;0;0;368976013;371655843;15273000
1199;1.1555e-14;-233;1586;24192;19613;1;594;-2.14748e+09;-5.85103e+06;0;0;0;0;0;0;368976013;371655843;15273000
1200;1.16616e-14;-243;1672;24706;19733;1;610;-2.14748e+09;-5.83558e+06;-1;0;0;0;-1;0;369206364;371898632;15320479
1200;1.1555e-14;-233;1586;24192;19613;1;594;-2.14748e+09;-5.83558e+06;-1;0;0;0;-1;0;369206364;371898632;15320479
1201;1.16616e-14;-243;1672;24706;19733;1;610;-2.14748e+09;-5.82019e+06;-1;0;0;0;-1;0;369436143;372140871;15367952
1201;1.1555e-14;-233;1586;24192;19613;1;594;-2.14748e+09;-5.82019e+06;-1;0;0;0;-1;0;369436143;372140871;15367952
1202;1.16616e-14;-243;1672;24706;19733;1;610;-2.14748e+09;-5.80496e+06;-1;0;0;0;-1;0;369665351;372382561;15415416
1202;1.1555e-14;-234;1586;24192;19613;1;594;-2.14748e+09;-5.80496e+06;0;0;0;0;0;0;369665351;372382561;15415416
1203;1.16616e-14;-244;1672;24706;19733;1;610;-2.14748e+09;-5.78968e+06;0;0;0;0;0;0;369893990;372623702;15462873
1203;1.1555e-14;-235;1586;24192;19613;1;594;-2.14748e+09;-5.78968e+06;0;0;0;0;0;0;369893990;372623702;15462873
1204;1.16616e-14;-245;1672;24706;19733;1;610;-2.14748e+09;-5.77447e+06;0;0;0;0;0;0;370122062;372864299;15510322
1204;1.1555e-14;-236;1586;24192;19613;1;594;-2.14748e+09;-5.77447e+06;0;0;0;0;0;0;370122062;372864299;15510322
1205;1.16616e-14;-245;1672;24706;19733;1;610;-2.14748e+09;-5.75921e+06;-1;0;0;0;-1;0;370349569;373104350;15557762
1205;1.1555e-14;-237;1586;24192;19613;1;594;-2.14748e+09;-5.75921e+06;0;0;0;0;0;0;370349569;373104350;15557762
1206;1.16616e-14;-246;1672;24706;19733;1;610;-2.14748e+09;-5.74411e+06;0;0;0;0;0;0;370576513;373343860;15605194
1206;1.1555e-14;-238;1586;24192;19613;1;594;-2.14748e+09;-5.74411e+06;0;0;0;0;0;0;370576513;373343860;15605194
1207;1.16616e-14;-246;1672;24706;19733;1;610;-2.14748e+09;-5.72907e+06;-1;0;0;0;-1;0;370802895;373582829;15652617
1207;1.1555e-14;-239;1586;24192;19613;1;594;-2.14748e+09;-5.72907e+06;0;0;0;0;0;0;370802895;373582829;15652617
1208;1.16616e-14;-247;1672;24706;19733;1;610;-2.14748e+09;-5.71408e+06;0;0;0;0;0;0;371028717;373821259;15700030
1208;1.1555e-14;-240;1586;24192;19613;1;594;-2.14748e+09;-5.71408e+06;0;0;0;0;0;0;371028717;373821259;15700030
1209;1.16616e-14;-247;1672;24706;19733;1;610;-2.14748e+09;-5.69915e+06;-1;0;0;0;-1;0;371253981;374059151;15747434
1209;1.1555e-14;-240;1586;24192;19613;1;594;-2.14748e+09;-5.69915e+06;-1;0;0;0;-1;0;371253981;374059151;15747434
1210;1.16616e-14;-248;1672;24706;19733;1;610;-2.14748e+09;-5.68428e+06;0;0;0;0;0;0;371478689;374296508;15794828
1210;1.1555e-14;-240;1586;24192;19613;1;594;-2.14748e+09;-5.68428e+06;-1;0;0;0;-1;0;371478689;374296508;15794828
1211;1.16616e-14;-248;1672;24706;19733;1;610;-2.14748e+09;-5.66946e+06;-1;0;0;0;-1;0;371702842;374533332;15842212
1211;1.1555e-14;-240;1586;24192;19613;1;594;-2.14748e+09;-5.66946e+06;-1;0;0;0;-1;0;371702842;374533332;15842212
1212;1.16616e-14;-248;1672;24706;19733;1;610;-2.14748e+09;-5.6547e+06;-1;0;0;0;-1;0;371926443;374769623;15889585
1212;1.1555e-14;-241;1586;24192;19613;1;594;-2.14748e+09;-5.6547e+06;0;0;0;0;0;0;371926443;374769623;15889585
1213;1.16616e-14;-248;1672;24706;19733;1;610;-2.14748e+09;-5.63999e+06;-1;0;0;0;-1;0;372149493;375005383;15936948
1213;1.1555e-14;-241;1586;24192;19613;1;594;-2.14748e+09;-5.63999e+06;-1;0;0;0;-1;0;372149493;375005383;15936948
1214;1.16616e-14;-249;1672;24706;19733;1;610;-2.14748e+09;-5.62534e+06;0;0;0;0;0;0;372371994;375240615;15984300
1214;1.1555e-14;-241;1586;24192;19613;1;594;-2.14748e+09;-5.62534e+06;-1;0;0;0;-1;0;372371994;375240615;15984300
1215;1.16616e-14;-249;1672;24706;19733;1;610;-2.14748e+09;-5.61074e+06;-1;0;0;0;-1;0;372593947;375475319;16031640
1215;1.1555e-14;-241;1586;24192;19613;1;594;-2.14748e+09;-5.61074e+06;-1;0;0;0;-1;0;372593947;375475319;16031640
1216;1.16616e-14;-249;1672;24706;19733;1;610;-2.14748e+09;-5.5962e+06;-1;0;0;0;-1;0;372815355;375709498;16078969
1216;1.1555e-14;-242;1586;24192;19613;1;594;-2.14748e+09;-5.5962e+06;0;0;0;0;0;0;372815355;375709498;16078969
1217;1.16616e-14;-249;1672;24706;19733;1;610;-2.14748e+09;-5.58181e+06;-1;0;0;0;-1;0;373036219;375943153;16126287
1217;1.1555e-14;-243;1586;24192;19613;1;594;-2.14748e+09;-5.58181e+06;0;0;0;0;0;0;373036219;375943153;16126287
1218;1.16616e-14;-249;1672;24706;19733;1;610;-2.14748e+09;-5.56728e+06;-1;0;0;0;-1;0;373256540;376176285;16173592
1218;1.1555e-14;-243;1586;24192;19613;1;594;-2.14748e+09;-5.56728e+06;-1;0;0;0;-1;0;373256540;376176285;16173592
1219;1.16616e-14;-249;1672;24706;19733;1;610;-2.14748e+09;-5.5529e+06;-1;0;0;0;-1;0;373476321;376408897;16220885
1219;1.1555e-14;-244;1586;24192;19613;1;594;-2.14748e+09;-5.5529e+06;0;0;0;0;0;0;373476321;376408897;16220885
1220;1.16616e-14;-249;1672;24706;19733;1;610;-2.14748e+09;-5.53857e+06;-1;0;0;0;-1;0;373695564;376640990;16268166
1220;1.1555e-14;-244;1586;24192;19613;1;594;-2.14748e+09;-5.53857e+06;-1;0;0;0;-1;0;373695564;376640990;16268166
1221;1.16616e-14;-250;1672;24706;19733;1;610;-2.14748e+09;-5.5243e+06;0;0;0;0;0;0;373914269;376872565;16315434
1221;1.1555e-14;-245;1586;24192;19613;1;594;-2.14748e+09;-5.5243e+06;0;0;0;0;0;0;373914269;376872565;16315434
1222;1.16616e-14;-251;1672;24706;19733;1;610;-2.14748e+09;-5.51007e+06;0;0;0;0;0;0;374132439;377103625;16362688
1222;1.1555e-14;-246;1586;24192;19613;1;594;-2.14748e+09;-5.51007e+06;0;0;0;0;0;0;374132439;377103625;16362688
1223;1.16616e-14;-251;1672;24706;19733;1;610;-2.14748e+09;-5.4959e+06;-1;0;0;0;-1;0;374350075;377334170;16409929
1223;1.1555e-14;-247;1586;24192;19613;1;594;-2.14748e+09;-5.4959e+06;0;0;0;0;0;0;374350075;377334170;16409929
1224;1.16616e-14;-252;1672;24706;19733;1;610;-2.14748e+09;-5.48179e+06;0;0;0;0;0;0;374567180;377564203;16457157
1224;1.1555e-14;-248;1586;24192;19613;1;594;-2.14748e+09;-5.48179e+06;0;0;0;0;0;0;374567180;377564203;16457157
1225;1.16616e-14;-253;1672;24706;19733;1;610;-2.14748e+09;-5.46772e+06;0;0;0;0;0;0;374783754;377793724;16504371
1225;1.1555e-14;-249;1586;24192;19613;1;594;-2.14748e+09;-5.46772e+06;0;0;0;0;0;0;374783754;377793724;16504371
1226;1.16616e-14;-254;1672;24706;19733;1;610;-2.14748e+09;-5.45371e+06;0;0;0;0;0;0;374999799;378022736;16551571
1226;1.1555e-14;-249;1586;24192;19613;1;594;-2.14748e+09;-5.45371e+06;-1;0;0;0;-1;0;374999799;378022736;16551571
1227;1.16616e-14;-255;1672;24706;19733;1;610;-2.14748e+09;-5.43974e+06;0;0;0;0;0;0;375215317;378251240;16598756
1227;1.1555e-14;-250;1586;24192;19613;1;594;-2.14748e+09;-5.43974e+06;0;0;0;0;0;0;375215317;378251240;16598756
1228;1.16616e-14;-255;1672;24706;19733;1;610;-2.14748e+09;-5.42583e+06;-1;0;0;0;-1;0;375430310;378479237;16645927
1228;1.1555e-14;-250;1586;24192;19613;1;594;-2.14748e+09;-5.42583e+06;-1;0;0;0;-1;0;375430310;378479237;16645927
1229;1.16616e-14;-255;1672;24706;19733;1;610;-2.14748e+09;-5.41197e+06;-1;0;0;0;-1;0;375644779;378706730;16693083
1229;1.1555e-14;-250;1586;24192;19613;1;594;-2.14748e+09;-5.41197e+06;-1;0;0;0;-1;0;375644779;378706730;16693083
1230;1.16616e-14;-256;1672;24706;19733;1;610;-2.14748e+09;-5.39816e+06;0;0;0;0;0;0;375858727;378933719;16740224
1230;1.1555e-14;-251;1586;24192;19613;1;594;-2.14748e+09;-5.39816e+06;0;0;0;0;0;0;375858727;378933719;16740224
1231;1.16616e-14;-257;1672;24706;19733;1;610;-2.14748e+09;-5.3844e+06;0;0;0;0;0;0;376072153;379160207;16787349
1231;1.1555e-14;-252;1586;24192;19613;1;594;-2.14748e+09;-5.3844e+06;0;0;0;0;0;0;376072153;379160207;16787349
1232;1.16616e-14;-258;1672;24706;19733;1;610;-2.14748e+09;-5.37069e+06;0;0;0;0;0;0;376285061;379386194;16834459
1232;1.1555e-14;-253;1586;24192;19613;1;594;-2.14748e+09;-5.37069e+06;0;0;0;0;0;0;376285061;379386194;16834459
1233;1.16616e-14;-258;1672;24706;19733;1;610;-2.14748e+09;-5.35702e+06;-1;0;0;0;-1;0;376497452;379611683;16881553
1233;1.1555e-14;-253;1586;24192;19613;1;594;-2.14748e+09;-5.35702e+06;-1;0;0;0;-1;0;376497452;379611683;16881553
1234;1.16616e-14;-258;1672;24706;19733;1;610;-2.14748e+09;-5.34341e+06;-1;0;0;0;-1;0;376709327;379836674;16928631
1234;1.1555e-14;-254;1586;24192;19613;1;594;-2.14748e+09;-5.34341e+06;0;0;0;0;0;0;376709327;379836674;16928631
1235;1.16616e-14;-259;1672;24706;19733;1;610;-2.14748e+09;-5.32985e+06;0;0;0;0;0;0;376920689;380061170;16975693
1235;1.1555e-14;-255;1586;24192;19613;1;594;-2.14748e+09;-5.32985e+06;0;0;0;0;0;0;376920689;380061170;16975693
1236;1.16616e-14;-259;1672;24706;19733;1;610;-2.14748e+09;-5.31634e+06;-1;0;0;0;-1;0;377131537;380285171;17022738
1236;1.1555e-14;-255;1586;24192;19613;1;594;-2.14748e+09;-5.31634e+06;-1;0;0;0;-1;0;377131537;380285171;17022738
1237;1.16616e-14;-260;1672;24706;19733;1;610;-2.14748e+09;-5.30287e+06;0;0;0;0;0;0;377341875;380508680;17069767
1237;1.1555e-14;-255;1586;24192;19613;1;594;-2.14748e+09;-5.30287e+06;-1;0;0;0;-1;0;377341875;380508680;17069767
1238;1.16616e-14;-261;1672;24706;19733;1;610;-2.14748e+09;-5.28945e+06;0;0;0;0;0;0;377551704;380731697;17116778
1238;1.1555e-14;-255;1586;24192;19613;1;594;-2.14748e+09;-5.28945e+06;-1;0;0;0;-1;0;377551704;380731697;17116778
1239;1.16616e-14;-262;1672;24706;19733;1;610;-2.14748e+09;-5.27608e+06;0;0;0;0;0;0;377761025;380954225;17163772
1239;1.1555e-14;-256;1586;24192;19613;1;594;-2.14748e+09;-5.27608e+06;0;0;0;0;0;0;377761025;380954225;17163772
1240;1.16616e-14;-263;1672;24706;19733;1;610;-2.14748e+09;-5.26276e+06;0;0;0;0;0;0;377969841;381176264;17210748
1240;1.1555e-14;-256;1586;24192;19613;1;594;-2.14748e+09;-5.26276e+06;-1;0;0;0;-1;0;377969841;381176264;17210748
1241;1.16616e-14;-263;1672;24706;19733;1;610;-2.14748e+09;-5.24949e+06;-1;0;0;0;-1;0;378178151;381397817;17257707
1241;1.1555e-14;-257;1586;24192;19613;1;594;-2.14748e+09;-5.24949e+06;0;0;0;0;0;0;378178151;381397817;17257707
1242;1.16616e-14;-263;1672;24706;19733;1;610;-2.14748e+09;-5.23626e+06;-1;0;0;0;-1;0;378385959;381618884;17304648
1242;1.1555e-14;-258;1586;24192;19613;1;594;-2.14748e+09;-5.23626e+06;0;0;0;0;0;0;378385959;381618884;17304648
1243;1.16616e-14;-264;1672;24706;19733;1;610;-2.14748e+09;-5.22308e+06;0;0;0;0;0;0;378593265;381839467;17351570
1243;1.1555e-14;-259;1586;24192;19613;1;594;-2.14748e+09;-5.22308e+06;0;0;0;0;0;0;378593265;381839467;17351570
1244;1.16616e-14;-264;1672;24706;19733;1;610;-2.14748e+09;-5.21005e+06;-1;0;0;0;-1;0;378800072;382059568;17398474
1244;1.1555e-14;-259;1586;24192;19613;1;594;-2.14748e+09;-5.21005e+06;-1;0;0;0;-1;0;378800072;382059568;17398474
1245;1.16616e-14;-265;1672;24706;19733;1;610;-2.14748e+09;-5.19686e+06;0;0;0;0;0;0;379006380;382279188;17445360
1245;1.1555e-14;-259;1586;24192;19613;1;594;-2.14748e+09;-5.19686e+06;-1;0;0;0;-1;0;379006380;382279188;17445360
1246;1.16616e-14;-265;1672;24706;19733;1;610;-2.14748e+09;-5.18382e+06;-1;0;0;0;-1;0;379212191;382498328;17492226
1246;1.1555e-14;-260;1586;24192;19613;1;594;-2.14748e+09;-5.18382e+06;0;0;0;0;0;0;379212191;382498328;17492226
1247;1.16616e-14;-266;1672;24706;19733;1;610;-2.14748e+09;-5.17083e+06;0;0;0;0;0;0;379417507;382716991;17539074
1247;1.1555e-14;-261;1586;24192;19613;1;594;-2.14748e+09;-5.17083e+06;0;0;0;0;0;0;379417507;382716991;17539074
1248;1.16616e-14;-267;1672;24706;19733;1;610;-2.14748e+09;-5.15788e+06;0;0;0;0;0;0;379622330;382935176;17585902
1248;1.1555e-14;-262;1586;24192;19613;1;594;-2.14748e+09;-5.15788e+06;0;0;0;0;0;0;379622330;382935176;17585902
1249;1.16616e-14;-267;1672;24706;19733;1;610;-2.14748e+09;-5.14498e+06;-1;0;0;0;-1;0;379826660;383152886;17632711
1249;1.1555e-14;-263;1586;24192;19613;1;594;-2.14748e+09;-5.14498e+06;0;0;0;0;0;0;379826660;383152886;17632711
1250;1.16616e-14;-268;1672;24706;19733;1;610;-2.14748e+09;-5.13212e+06;0;0;0;0;0;0;380030499;383370122;17679500
1250;1.1555e-14;-263;1586;24192;19613;1;594;-2.14748e+09;-5.13212e+06;-1;0;0;0;-1;0;380030499;383370122;17679500
1251;1.16616e-14;-269;1672;24706;19733;1;610;-2.14748e+09;-5.11931e+06;0;0;0;0;0;0;380233849;383586886;17726268
1251;1.1555e-14;-264;1586;24192;19613;1;594;-2.14748e+09;-5.11931e+06;0;0;0;0;0;0;380233849;383586886;17726268
1252;1.16616e-14;-270;1672;24706;19733;1;610;-2.14748e+09;-5.10655e+06;0;0;0;0;0;0;380436712;383803179;17773017
1252;1.1555e-14;-265;1586;24192;19613;1;594;-2.14748e+09;-5.10655e+06;0;0;0;0;0;0;380436712;383803179;17773017
1253;1.16616e-14;-270;1672;24706;19733;1;610;-2.14748e+09;-5.09382e+06;-1;0;0;0;-1;0;380639088;384019002;17819745
1253;1.1555e-14;-265;1586;24192;19613;1;594;-2.14748e+09;-5.09382e+06;-1;0;0;0;-1;0;380639088;384019002;17819745
1254;1.16616e-14;-270;1672;24706;19733;1;610;-2.14748e+09;-5.08115e+06;-1;0;0;0;-1;0;380840979;384234356;17866453
1254;1.1555e-14;-265;1586;24192;19613;1;594;-2.14748e+09;-5.08115e+06;-1;0;0;0;-1;0;380840979;384234356;17866453
1255;1.16616e-14;-271;1672;24706;19733;1;610;-2.14748e+09;-5.06861e+06;0;0;0;0;0;0;381042388;384449244;17913139
1255;1.1555e-14;-266;1586;24192;19613;1;594;-2.14748e+09;-5.06861e+06;0;0;0;0;0;0;381042388;384449244;17913139
1256;1.16616e-14;-271;1672;24706;19733;1;610;-2.14748e+09;-5.05592e+06;-1;0;0;0;-1;0;381243314;384663666;17959805
1256;1.1555e-14;-266;1585;24192;19613;1;594;-2.14748e+09;-5.05592e+06;0;0;0;0;0;0;381243314;384663666;17959805
1257;1.16616e-14;-272;1672;24706;19733;1;610;-2.14748e+09;-5.04338e+06;0;0;0;0;0;0;381443760;384877624;18006449
1257;1.1555e-14;-266;1585;24192;19613;1;594;-2.14748e+09;-5.04338e+06;-1;0;0;0;-1;0;381443760;384877624;18006449
1258;1.16616e-14;-272;1672;24706;19733;1;610;-2.14748e+09;-5.03088e+06;-1;0;0;0;-1;0;381643727;385091119;18053072
1258;1.1555e-14;-266;1585;24192;19613;1;594;-2.14748e+09;-5.03088e+06;-1;0;0;0;-1;0;381643727;385091119;18053072
1259;1.16616e-14;-273;1672;24706;19733;1;610;-2.14748e+09;-5.01842e+06;0;0;0;0;0;0;381843216;385304152;18099674
1259;1.1555e-14;-266;1585;24192;19613;1;594;-2.14748e+09;-5.01842e+06;0;0;-1;0;0;-1;381843216;385304152;18099674
1260;1.16616e-14;-274;1672;24706;19733;1;610;-2.14748e+09;-5.006e+06;0;0;0;0;0;0;382042230;385516726;18146253
1260;1.1555e-14;-266;1585;24192;19613;1;594;-2.14748e+09;-5.006e+06;-1;0;0;0;-1;0;382042230;385516726;18146253
1261;1.16616e-14;-275;1672;24706;19733;1;610;-2.14748e+09;-4.99363e+06;0;0;0;0;0;0;382240769;385728840;18192810
1261;1.1555e-14;-267;1585;24192;19613;1;594;-2.14748e+09;-4.99363e+06;0;0;0;0;0;0;382240769;385728840;18192810
1262;1.16616e-14;-275;1672;24706;19733;1;610;-2.14748e+09;-4.9813e+06;-1;0;0;0;-1;0;382438834;385940497;18239345
1262;1.1555e-14;-267;1585;24192;19613;1;594;-2.14748e+09;-4.9813e+06;-1;0;0;0;-1;0;382438834;385940497;18239345
1263;1.16616e-14;-275;1672;24706;19733;1;610;-2.14748e+09;-4.96901e+06;-1;0;0;0;-1;0;382636428;386151698;18285857
1263;1.1555e-14;-267;1585;24192;19613;1;594;-2.14748e+09;-4.96901e+06;-1;0;0;0;-1;0;382636428;386151698;18285857
1264;1.16616e-14;-276;1672;24706;19733;1;610;-2.14748e+09;-4.95677e+06;0;0;0;0;0;0;382833552;386362445;18332347
1264;1.1555e-14;-267;1585;24192;19613;1;594;-2.14748e+09;-4.95677e+06;-1;0;0;0;-1;0;382833552;386362445;18332347
1265;1.16616e-14;-276;1672;24706;19733;1;610;-2.14748e+09;-4.94456e+06;-1;0;0;0;-1;0;383030207;386572737;18378814
1265;1.1555e-14;-268;1585;24192;19613;1;594;-2.14748e+09;-4.94456e+06;0;0;0;0;0;0;383030207;386572737;18378814
1266;1.16616e-14;-277;1672;24706;19733;1;610;-2.14748e+09;-4.9324e+06;0;0;0;0;0;0;383226394;386782578;18425257
1266;1.1555e-14;-269;1585;24192;19613;1;594;-2.14748e+09;-4.9324e+06;0;0;0;0;0;0;383226394;386782578;18425257
1267;1.16616e-14;-278;1672;24706;19733;1;610;-2.14748e+09;-4.92028e+06;0;0;0;0;0;0;383422116;386991967;18471678
1267;1.1555e-14;-270;1585;24192;19613;1;594;-2.14748e+09;-4.92028e+06;0;0;0;0;0;0;383422116;386991967;18471678
1268;1.16616e-14;-278;1672;24706;19733;1;610;-2.14748e+09;-4.9082e+06;-1;0;0;0;-1;0;383617372;387200908;18518074
1268;1.1555e-14;-271;1585;24192;19613;1;594;-2.14748e+09;-4.9082e+06;0;0;0;0;0;0;383617372;387200908;18518074
1269;1.16616e-14;-279;1672;24706;19733;1;610;-2.14748e+09;-4.89617e+06;0;0;0;0;0;0;383812166;387409399;18564448
1269;1.1555e-14;-272;1585;24192;19613;1;594;-2.14748e+09;-4.89617e+06;0;0;0;0;0;0;383812166;387409399;18564448
1270;1.16616e-14;-279;1672;24706;19733;1;610;-2.14748e+09;-4.88417e+06;-1;0;0;0;-1;0;384006497;387617444;18610797
1270;1.1555e-14;-272;1585;24192;19613;1;594;-2.14748e+09;-4.88417e+06;-1;0;0;0;-1;0;384006497;387617444;18610797
1271;1.16616e-14;-279;1672;24706;19733;1;610;-2.14748e+09;-4.87222e+06;-1;0;0;0;-1;0;384200368;387825043;18657122
1271;1.1555e-14;-272;1585;24192;19613;1;594;-2.14748e+09;-4.87222e+06;-1;0;0;0;-1;0;384200368;387825043;18657122
1272;1.16616e-14;-279;1672;24706;19733;1;610;-2.14748e+09;-4.8603e+06;-1;0;0;0;-1;0;384393780;388032198;18703423
1272;1.1555e-14;-272;1585;24192;19613;1;594;-2.14748e+09;-4.8603e+06;-1;0;0;0;-1;0;384393780;388032198;18703423
1273;1.16616e-14;-279;1672;24706;19733;1;610;-2.14748e+09;-4.84843e+06;-1;0;0;0;-1;0;384586734;388238910;18749699
1273;1.1555e-14;-273;1585;24192;19613;1;594;-2.14748e+09;-4.84843e+06;0;0;0;0;0;0;384586734;388238910;18749699
1274;1.16616e-14;-279;1672;24706;19733;1;610;-2.14748e+09;-4.83659e+06;-1;0;0;0;-1;0;384779231;388445179;18795951
1274;1.1555e-14;-274;1585;24192;19613;1;594;-2.14748e+09;-4.83659e+06;0;0;0;0;0;0;384779231;388445179;18795951
1275;1.16616e-14;-280;1672;24706;19733;1;610;-2.14748e+09;-4.8248e+06;0;0;0;0;0;0;384971273;388651008;18842178
1275;1.1555e-14;-274;1585;24192;19613;1;594;-2.14748e+09;-4.8248e+06;-1;0;0;0;-1;0;384971273;388651008;18842178
1276;1.16616e-14;-281;1672;24706;19733;1;610;-2.14748e+09;-4.81304e+06;0;0;0;0;0;0;385162862;388856398;18888380
1276;1.1555e-14;-274;1585;24192;19613;1;594;-2.14748e+09;-4.81304e+06;-1;0;0;0;-1;0;385162862;388856398;18888380
1277;1.16616e-14;-281;1672;24706;19733;1;610;-2.14748e+09;-4.80133e+06;-1;0;0;0;-1;0;385353998;389061350;18934557
1277;1.1555e-14;-274;1585;24192;19613;1;594;-2.14748e+09;-4.80133e+06;-1;0;0;0;-1;0;385353998;389061350;18934557
1278;1.16616e-14;-282;1672;24706;19733;1;610;-2.14748e+09;-4.78965e+06;0;0;0;0;0;0;385544684;389265865;18980708
1278;1.1555e-14;-275;1585;24192;19613;1;594;-2.14748e+09;-4.78965e+06;0;0;0;0;0;0;385544684;389265865;18980708
1279;1.16616e-14;-282;1672;24706;19733;1;610;-2.14748e+09;-4.77802e+06;-1;0;0;0;-1;0;385734919;389469944;19026834
1279;1.1555e-14;-276;1585;24192;19613;1;594;-2.14748e+09;-4.77802e+06;0;0;0;0;0;0;385734919;389469944;19026834
1280;1.16616e-14;-282;1672;24706;19733;1;610;-2.14748e+09;-4.76642e+06;-1;0;0;0;-1;0;385924707;389673589;19072933
1280;1.1555e-14;-277;1585;24192;19613;1;594;-2.14748e+09;-4.76642e+06;0;0;0;0;0;0;385924707;389673589;19072933
1281;1.16616e-14;-282;1672;24706;19733;1;610;-2.14748e+09;-4.75486e+06;-1;0;0;0;-1;0;386114047;389876800;19119007
1281;1.1555e-14;-278;1585;24192;19613;1;594;-2.14748e+09;-4.75486e+06;0;0;0;0;0;0;386114047;389876800;19119007
1282;1.16616e-14;-282;1672;24706;19733;1;610;-2.14748e+09;-4.74334e+06;-1;0;0;0;-1;0;386302942;390079580;19165055
1282;1.1555e-14;-278;1585;24192;19613;1;594;-2.14748e+09;-4.74334e+06;-1;0;0;0;-1;0;386302942;390079580;19165055
1283;1.16616e-14;-282;1672;24706;19733;1;610;-2.14748e+09;-4.73186e+06;-1;0;0;0;-1;0;386491392;390281929;19211077
1283;1.1555e-14;-278;1585;24192;19613;1;594;-2.14748e+09;-4.73186e+06;-1;0;0;0;-1;0;386491392;390281929;19211077
1284;1.16616e-14;-282;1672;24706;19733;1;610;-2.14748e+09;-4.72042e+06;-1;0;0;0;-1;0;386679399;390483849;19257072
1284;1.1555e-14;-279;1585;24192;19613;1;594;-2.14748e+09;-4.72042e+06;0;0;0;0;0;0;386679399;390483849;19257072
1285;1.16616e-14;-283;1672;24706;19733;1;610;-2.14748e+09;-4.70901e+06;0;0;0;0;0;0;386866964;390685340;19303041
1285;1.1555e-14;-279;1585;24192;19613;1;594;-2.14748e+09;-4.70901e+06;-1;0;0;0;-1;0;386866964;390685340;19303041
1286;1.16616e-14;-284;1672;24706;19733;1;610;-2.14748e+09;-4.69764e+06;0;0;0;0;0;0;387054089;390886404;19348982
1286;1.1555e-14;-279;1585;24192;19613;1;594;-2.14748e+09;-4.69764e+06;-1;0;0;0;-1;0;387054089;390886404;19348982
1287;1.16616e-14;-284;1672;24706;19733;1;610;-2.14748e+09;-4.68631e+06;-1;0;0;0;-1;0;387240775;391087043;19394897
1287;1.1555e-14;-279;1585;24192;19613;1;594;-2.14748e+09;-4.68631e+06;-1;0;0;0;-1;0;387240775;391087043;19394897
1288;1.16616e-14;-284;1672;24706;19733;1;610;-2.14748e+09;-4.67512e+06;-1;0;0;0;-1;0;387427022;391287257;19440784
1288;1.1555e-14;-279;1585;24192;19613;1;594;-2.14748e+09;-4.67512e+06;-1;0;0;0;-1;0;387427022;391287257;19440784
1289;1.16616e-14;-285;1672;24706;19733;1;610;-2.14748e+09;-4.66377e+06;0;0;0;0;0;0;387612833;391487047;19486644
1289;1.1555e-14;-279;1585;24192;19613;1;594;-2.14748e+09;-4.66377e+06;-1;0;0;0;-1;0;387612833;391487047;19486644
1290;1.16616e-14;-285;1672;24706;19733;1;610;-2.14748e+09;-4.65255e+06;-1;0;0;0;-1;0;387798209;391686415;19532477
1290;1.1555e-14;-280;1585;24192;19613;1;594;-2.14748e+09;-4.65255e+06;0;0;0;0;0;0;387798209;391686415;19532477
1291;1.16616e-14;-285;1672;24706;19733;1;610;-2.14748e+09;-4.64137e+06;-1;0;0;0;-1;0;387983151;391885362;19578282
1291;1.1555e-14;-281;1585;24192;19613;1;594;-2.14748e+09;-4.64137e+06;0;0;0;0;0;0;387983151;391885362;19578282
1292;1.16616e-14;-286;1672;24706;19733;1;610;-2.14748e+09;-4.63022e+06;0;0;0;0;0;0;388167660;392083889;19624059
1292;1.1555e-14;-282;1585;24192;19613;1;594;-2.14748e+09;-4.63022e+06;0;0;0;0;0;0;388167660;392083889;19624059
1293;1.16616e-14;-287;1672;24706;19733;1;610;-2.14748e+09;-4.61912e+06;0;0;0;0;0;0;388351737;392281997;19669808
1293;1.1555e-14;-282;1585;24192;19613;1;594;-2.14748e+09;-4.61912e+06;-1;0;0;0;-1;0;388351737;392281997;19669808
1294;1.16616e-14;-287;1672;24706;19733;1;610;-2.14748e+09;-4.60805e+06;-1;0;0;0;-1;0;388535384;392479688;19715529
1294;1.1555e-14;-283;1585;24192;19613;1;594;-2.14748e+09;-4.60805e+06;0;0;0;0;0;0;388535384;392479688;19715529
1295;1.16616e-14;-288;1672;24706;19733;1;610;-2.14748e+09;-4.59701e+06;0;0;0;0;0;0;388718602;392676962;19761222
1295;1.1555e-14;-283;1585;24192;19613;1;594;-2.14748e+09;-4.59701e+06;-1;0;0;0;-1;0;388718602;392676962;19761222
1296;1.16616e-14;-288;1672;24706;19733;1;610;-2.14748e+09;-4.58601e+06;-1;0;0;0;-1;0;388901393;392873821;19806886
1296;1.1555e-14;-284;1585;24192;19613;1;594;-2.14748e+09;-4.58601e+06;0;0;0;0;0;0;388901393;392873821;19806886
1297;1.16616e-14;-289;1672;24706;19733;1;610;-2.14748e+09;-4.57505e+06;0;0;0;0;0;0;389083757;393070266;19852521
1297;1.1555e-14;-285;1585;24192;19613;1;594;-2.14748e+09;-4.57505e+06;0;0;0;0;0;0;389083757;393070266;19852521
1298;1.16616e-14;-289;1672;24706;19733;1;610;-2.14748e+09;-4.56412e+06;-1;0;0;0;-1;0;389265695;393266298;19898128
1298;1.1555e-14;-286;1585;24192;19613;1;594;-2.14748e+09;-4.56412e+06;0;0;0;0;0;0;389265695;393266298;19898128
1299;1.16616e-14;-290;1672;24706;19733;1;610;-2.14748e+09;-4.55323e+06;0;0;0;0;0;0;389447210;393461918;19943706
1299;1.1555e-14;-287;1585;24192;19613;1;594;-2.14748e+09;-4.55323e+06;0;0;0;0;0;0;389447210;393461918;19943706
1300;1.16616e-14;-290;1672;24706;19733;1;610;-2.14748e+09;-4.54238e+06;-1;0;0;0;-1;0;389628301;393657127;19989254
1300;1.1555e-14;-288;1585;24192;19613;1;594;-2.14748e+09;-4.54238e+06;0;0;0;0;0;0;389628301;393657127;19989254
1301;1.16616e-14;-291;1672;24706;19733;1;610;-2.14748e+09;-4.53156e+06;0;0;0;0;0;0;389808971;393851927;20034774
1301;1.1555e-14;-289;1585;24192;19613;1;594;-2.14748e+09;-4.53156e+06;0;0;0;0;0;0;389808971;393851927;20034774
1302;1.16616e-14;-291;1672;24706;19733;1;610;-2.14748e+09;-4.52077e+06;-1;0;0;0;-1;0;389989221;394046318;20080263
1302;1.1555e-14;-289;1585;24192;19613;1;594;-2.14748e+09;-4.52077e+06;-1;0;0;0;-1;0;389989221;394046318;20080263
1303;1.16616e-14;-292;1672;24706;19733;1;610;-2.14748e+09;-4.51002e+06;0;0;0;0;0;0;390169052;394240303;20125724
1303;1.1555e-14;-289;1585;24192;19613;1;594;-2.14748e+09;-4.51002e+06;-1;0;0;0;-1;0;390169052;394240303;20125724
1304;1.16616e-14;-293;1672;24706;19733;1;610;-2.14748e+09;-4.4993e+06;0;0;0;0;0;0;390348464;394433880;20171154
1304;1.1555e-14;-290;1585;24192;19613;1;594;-2.14748e+09;-4.4993e+06;0;0;0;0;0;0;390348464;394433880;20171154
1305;1.16616e-14;-293;1672;24706;19733;1;610;-2.14748e+09;-4.48862e+06;-1;0;0;0;-1;0;390527460;394627053;20216554
1305;1.1555e-14;-290;1585;24192;19613;1;594;-2.14748e+09;-4.48862e+06;-1;0;0;0;-1;0;390527460;394627053;20216554
1306;1.16616e-14;-293;1672;24706;19733;1;610;-2.14748e+09;-4.47798e+06;-1;0;0;0;-1;0;390706040;394819822;20261925
1306;1.1555e-14;-290;1585;24192;19613;1;594;-2.14748e+09;-4.47798e+06;-1;0;0;0;-1;0;390706040;394819822;20261925
1307;1.16616e-14;-293;1672;24706;19733;1;610;-2.14748e+09;-4.46746e+06;-1;0;0;0;-1;0;390884206;395012188;20307265
1307;1.1555e-14;-290;1585;24192;19613;1;594;-2.14748e+09;-4.46736e+06;-1;0;0;0;-1;0;390884206;395012188;20307265
1308;1.16616e-14;-293;1672;24706;19733;1;610;-2.14748e+09;-4.45678e+06;-1;0;0;0;-1;0;391061959;395204152;20352575
1308;1.1555e-14;-291;1585;24192;19613;1;594;-2.14748e+09;-4.45678e+06;0;0;0;0;0;0;391061959;395204152;20352575
1309;1.16616e-14;-294;1672;24706;19733;1;610;-2.14748e+09;-4.44624e+06;0;0;0;0;0;0;391239300;395395716;20397855
1309;1.1555e-14;-292;1585;24192;19613;1;594;-2.14748e+09;-4.44624e+06;0;0;0;0;0;0;391239300;395395716;20397855
1310;1.16616e-14;-295;1672;24706;19733;1;610;-2.14748e+09;-4.43573e+06;0;0;0;0;0;0;391416230;395586880;20443103
1310;1.1555e-14;-293;1585;24192;19613;1;594;-2.14748e+09;-4.43573e+06;0;0;0;0;0;0;391416230;395586880;20443103
1311;1.16616e-14;-295;1672;24706;19733;1;610;-2.14748e+09;-4.42525e+06;-1;0;0;0;-1;0;391592750;395777646;20488321
1311;1.1555e-14;-294;1585;24192;19613;1;594;-2.14748e+09;-4.42525e+06;0;0;0;0;0;0;391592750;395777646;20488321
1312;1.16616e-14;-296;1672;24706;19733;1;610;-2.14748e+09;-4.41481e+06;0;0;0;0;0;0;391768862;395968014;20533508
1312;1.1555e-14;-294;1585;24192;19613;1;594;-2.14748e+09;-4.41481e+06;-1;0;0;0;-1;0;391768862;395968014;20533508
1313;1.16616e-14;-297;1672;24706;19733;1;610;-2.14748e+09;-4.4044e+06;0;0;0;0;0;0;391944567;396157985;20578664
1313;1.1555e-14;-294;1585;24192;19613;1;594;-2.14748e+09;-4.4044e+06;-1;0;0;0;-1;0;391944567;396157985;20578664
1314;1.16616e-14;-298;1672;24706;19733;1;610;-2.14748e+09;-4.39412e+06;0;0;0;0;0;0;392119866;396347562;20623789
1314;1.1555e-14;-294;1585;24192;19613;1;594;-2.14748e+09;-4.39412e+06;-1;0;0;0;-1;0;392119866;396347562;20623789
1315;1.16616e-14;-298;1672;24706;19733;1;610;-2.14748e+09;-4.38378e+06;-1;0;0;0;-1;0;392294760;396536744;20668882
1315;1.1555e-14;-294;1585;24192;19613;1;594;-2.14748e+09;-4.38378e+06;-1;0;0;0;-1;0;392294760;396536744;20668882
1316;1.16616e-14;-298;1672;24706;19733;1;610;-2.14748e+09;-4.37336e+06;-1;0;0;0;-1;0;392469249;396725534;20713944
1316;1.1555e-14;-295;1585;24192;19613;1;594;-2.14748e+09;-4.37336e+06;0;0;0;0;0;0;392469249;396725534;20713944
1317;1.16616e-14;-299;1672;24706;19733;1;610;-2.14748e+09;-4.36308e+06;0;0;0;0;0;0;392643337;396913931;20758974
1317;1.1555e-14;-295;1585;24192;19613;1;594;-2.14748e+09;-4.36308e+06;-1;0;0;0;-1;0;392643337;396913931;20758974
1318;1.16616e-14;-300;1672;24706;19733;1;610;-2.14748e+09;-4.35284e+06;0;0;0;0;0;0;392817023;397101937;20803972
1318;1.1555e-14;-296;1585;24192;19613;1;594;-2.14748e+09;-4.35284e+06;0;0;0;0;0;0;392817023;397101937;20803972
1319;1.16616e-14;-301;1672;24706;19733;1;610;-2.14748e+09;-4.34272e+06;0;0;0;0;0;0;392990308;397289553;20848939
1319;1.1555e-14;-297;1585;24192;19613;1;594;-2.14748e+09;-4.34272e+06;0;0;0;0;0;0;392990308;397289553;20848939
1320;1.16616e-14;-301;1672;24706;19733;1;610;-2.14748e+09;-4.33244e+06;-1;0;0;0;-1;0;393163194;397476781;20893873
1320;1.1555e-14;-297;1585;24192;19613;1;594;-2.14748e+09;-4.33244e+06;-1;0;0;0;-1;0;393163194;397476781;20893873
1321;1.16616e-14;-302;1672;24706;19733;1;610;-2.14748e+09;-4.32229e+06;0;0;0;0;0;0;393335683;397663620;20938775
1321;1.1555e-14;-297;1585;24192;19613;1;594;-2.14748e+09;-4.32229e+06;-1;0;0;0;-1;0;393335683;397663620;20938775
1322;1.16616e-14;-302;1672;24706;19733;1;610;-2.14748e+09;-4.31218e+06;-1;0;0;0;-1;0;393507774;397850073;20983645
1322;1.1555e-14;-298;1585;24192;19613;1;594;-2.14748e+09;-4.31218e+06;0;0;0;0;0;0;393507774;397850073;20983645
1323;1.16616e-14;-302;1672;24706;19733;1;610;-2.14748e+09;-4.30209e+06;-1;0;0;0;-1;0;393679469;398036140;21028482
1323;1.1555e-14;-298;1585;24192;19613;1;594;-2.14748e+09;-4.30209e+06;-1;0;0;0;-1;0;393679469;398036140;21028482
1324;1.16616e-14;-303;1672;24706;19733;1;610;-2.14748e+09;-4.29204e+06;0;0;0;0;0;0;393850770;398221823;21073287
1324;1.1555e-14;-298;1585;24192;19613;1;594;-2.14748e+09;-4.29204e+06;-1;0;0;0;-1;0;393850770;398221823;21073287
1325;1.16616e-14;-303;1672;24706;19733;1;610;-2.14748e+09;-4.28201e+06;-1;0;0;0;-1;0;394021677;398407121;21118059
1325;1.1555e-14;-298;1585;24192;19613;1;594;-2.14748e+09;-4.28201e+06;-1;0;0;0;-1;0;394021677;398407121;21118059
1326;1.16616e-14;-304;1672;24706;19733;1;610;-2.14748e+09;-4.27202e+06;0;0;0;0;0;0;394192192;398592037;21162798
1326;1.1555e-14;-299;1585;24192;19613;1;594;-2.14748e+09;-4.27202e+06;0;0;0;0;0;0;394192192;398592037;21162798
1327;1.16616e-14;-305;1672;24706;19733;1;610;-2.14748e+09;-4.26206e+06;0;0;0;0;0;0;394362315;398776571;21207504
1327;1.1555e-14;-300;1585;24192;19613;1;594;-2.14748e+09;-4.26206e+06;0;0;0;0;0;0;394362315;398776571;21207504
1328;1.16616e-14;-306;1672;24706;19733;1;610;-2.14748e+09;-4.25213e+06;0;0;0;0;0;0;394532048;398960725;21252178
1328;1.1555e-14;-300;1585;24192;19613;1;594;-2.14748e+09;-4.25213e+06;-1;0;0;0;-1;0;394532048;398960725;21252178
1329;1.16616e-14;-307;1672;24706;19733;1;610;-2.14748e+09;-4.24224e+06;0;0;0;0;0;0;394701392;399144499;21296817
1329;1.1555e-14;-300;1585;24192;19613;1;594;-2.14748e+09;-4.24224e+06;-1;0;0;0;-1;0;394701392;399144499;21296817
1330;1.16616e-14;-308;1672;24706;19733;1;610;-2.14748e+09;-4.23237e+06;0;0;0;0;0;0;394870348;399327894;21341424
1330;1.1555e-14;-301;1585;24192;19613;1;594;-2.14748e+09;-4.23237e+06;0;0;0;0;0;0;394870348;399327894;21341424
1331;1.16616e-14;-308;1672;24706;19733;1;610;-2.14748e+09;-4.22253e+06;-1;0;0;0;-1;0;395038917;399510912;21385997
1331;1.1555e-14;-301;1585;24192;19613;1;594;-2.14748e+09;-4.22253e+06;-1;0;0;0;-1;0;395038917;399510912;21385997
1332;1.16616e-14;-309;1672;24706;19733;1;610;-2.14748e+09;-4.21272e+06;0;0;0;0;0;0;395207100;399693553;21430536
1332;1.1555e-14;-301;1585;24192;19613;1;594;-2.14748e+09;-4.21272e+06;-1;0;0;0;-1;0;395207100;399693553;21430536
1333;1.16616e-14;-310;1672;24706;19733;1;610;-2.14748e+09;-4.20295e+06;0;0;0;0;0;0;395374899;399875819;21475041
1333;1.1555e-14;-301;1585;24192;19613;1;594;-2.14748e+09;-4.20295e+06;-1;0;0;0;-1;0;395374899;399875819;21475041
1334;1.16616e-14;-310;1671;24706;19733;1;610;-2.14748e+09;-4.1932e+06;0;0;0;0;0;0;395542313;400057709;21519513
1334;1.1555e-14;-302;1585;24192;19613;1;594;-2.14748e+09;-4.1932e+06;0;0;0;0;0;0;395542313;400057709;21519513
1335;1.16616e-14;-310;1671;24706;19733;1;610;-2.14748e+09;-4.18359e+06;-1;0;0;0;-1;0;395709345;400239227;21563951
1335;1.1555e-14;-302;1585;24192;19613;1;594;-2.14748e+09;-4.18359e+06;-1;0;0;0;-1;0;395709345;400239227;21563951
1336;1.16616e-14;-311;1671;24706;19733;1;610;-2.14748e+09;-4.1738e+06;0;0;0;0;0;0;395875996;400420371;21608354
1336;1.1555e-14;-303;1585;24192;19613;1;594;-2.14748e+09;-4.1738e+06;0;0;0;0;0;0;395875996;400420371;21608354
1337;1.16616e-14;-312;1671;24706;19733;1;610;-2.14748e+09;-4.16415e+06;0;0;0;0;0;0;396042265;400601144;21652724
1337;1.1555e-14;-303;1585;24192;19613;1;594;-2.14748e+09;-4.16415e+06;-1;0;0;0;-1;0;396042265;400601144;21652724
1338;1.16616e-14;-313;1671;24706;19733;1;610;-2.14748e+09;-4.15452e+06;0;0;0;0;0;0;396208156;400781546;21697059
1338;1.1555e-14;-303;1585;24192;19613;1;594;-2.14748e+09;-4.15452e+06;-1;0;0;0;-1;0;396208156;400781546;21697059
1339;1.16616e-14;-313;1671;24706;19733;1;610;-2.14748e+09;-4.14502e+06;-1;0;0;0;-1;0;396373668;400961579;21741359
1339;1.1555e-14;-303;1585;24192;19613;1;594;-2.14748e+09;-4.14503e+06;-1;0;0;0;-1;0;396373668;400961579;21741359
1340;1.16616e-14;-313;1671;24706;19733;1;610;-2.14748e+09;-4.13536e+06;-1;0;0;0;-1;0;396538803;401141242;21785625
1340;1.1555e-14;-304;1585;24192;19613;1;594;-2.14748e+09;-4.13536e+06;0;0;0;0;0;0;396538803;401141242;21785625
1341;1.16616e-14;-314;1671;24706;19733;1;610;-2.14748e+09;-4.12592e+06;0;0;0;0;0;0;396703561;401320538;21829856
1341;1.1555e-14;-305;1585;24192;19613;1;594;-2.14748e+09;-4.12592e+06;0;0;0;0;0;0;396703561;401320538;21829856
1342;1.16616e-14;-314;1671;24706;19733;1;610;-2.14748e+09;-4.11631e+06;-1;0;0;0;-1;0;396867944;401499467;21874053
1342;1.1555e-14;-305;1585;24192;19613;1;594;-2.14748e+09;-4.11631e+06;-1;0;0;0;-1;0;396867944;401499467;21874053
1343;1.16616e-14;-315;1671;24706;19733;1;610;-2.14748e+09;-4.10683e+06;0;0;0;0;0;0;397031954;401678030;21918214
1343;1.1555e-14;-305;1585;24192;19613;1;594;-2.14748e+09;-4.10683e+06;-1;0;0;0;-1;0;397031954;401678030;21918214
1344;1.16616e-14;-315;1671;24706;19733;1;610;-2.14748e+09;-4.09738e+06;-1;0;0;0;-1;0;397195590;401856229;21962340
1344;1.1555e-14;-306;1585;24192;19613;1;594;-2.14748e+09;-4.09738e+06;0;0;0;0;0;0;397195590;401856229;21962340
1345;1.16616e-14;-316;1671;24706;19733;1;610;-2.14748e+09;-4.08796e+06;0;0;0;0;0;0;397358853;402034063;22006432
1345;1.1555e-14;-306;1585;24192;19613;1;594;-2.14748e+09;-4.08796e+06;-1;0;0;0;-1;0;397358853;402034063;22006432
1346;1.16616e-14;-317;1671;24706;19733;1;610;-2.14748e+09;-4.07857e+06;0;0;0;0;0;0;397521746;402211534;22050488
1346;1.1555e-14;-306;1585;24192;19613;1;594;-2.14748e+09;-4.07857e+06;-1;0;0;0;-1;0;397521746;402211534;22050488
1347;1.16616e-14;-318;1671;24706;19733;1;610;-2.14748e+09;-4.06931e+06;0;0;0;0;0;0;397684269;402388643;22094508
1347;1.1555e-14;-306;1585;24192;19613;1;594;-2.14748e+09;-4.0693e+06;-1;0;0;0;-1;0;397684269;402388643;22094508
1348;1.16616e-14;-319;1671;24706;19733;1;610;-2.14748e+09;-4.05997e+06;0;0;0;0;0;0;397846423;402565391;22138493
1348;1.1555e-14;-307;1585;24192;19613;1;594;-2.14748e+09;-4.05997e+06;0;0;0;0;0;0;397846423;402565391;22138493
1349;1.16616e-14;-320;1671;24706;19733;1;610;-2.14748e+09;-4.05056e+06;0;0;0;0;0;0;398008209;402741779;22182443
1349;1.1555e-14;-307;1585;24192;19613;1;594;-2.14748e+09;-4.05056e+06;-1;0;0;0;-1;0;398008209;402741779;22182443
1350;1.16616e-14;-321;1671;24706;19733;1;610;-2.14748e+09;-4.04128e+06;0;0;0;0;0;0;398169628;402917808;22226356
1350;1.1555e-14;-307;1585;24192;19613;1;594;-2.14748e+09;-4.04128e+06;-1;0;0;0;-1;0;398169628;402917808;22226356
1351;1.16616e-14;-322;1671;24706;19733;1;610;-2.14748e+09;-4.03203e+06;0;0;0;0;0;0;398330681;403093478;22270234
1351;1.1555e-14;-307;1585;24192;19613;1;594;-2.14748e+09;-4.03203e+06;-1;0;0;0;-1;0;398330681;403093478;22270234
1352;1.16616e-14;-323;1671;24706;19733;1;610;-2.14748e+09;-4.02281e+06;0;0;0;0;0;0;398491369;403268791;22314076
1352;1.1555e-14;-308;1585;24192;19613;1;594;-2.14748e+09;-4.02281e+06;0;0;0;0;0;0;398491369;403268791;22314076
1353;1.16616e-14;-324;1671;24706;19733;1;610;-2.14748e+09;-4.01361e+06;0;0;0;0;0;0;398651693;403443747;22357882
1353;1.1555e-14;-309;1585;24192;19613;1;594;-2.14748e+09;-4.01361e+06;0;0;0;0;0;0;398651693;403443747;22357882
1354;1.16616e-14;-325;1671;24706;19733;1;610;-2.14748e+09;-4.00444e+06;0;0;0;0;0;0;398811654;403618348;22401652
1354;1.1555e-14;-309;1585;24192;19613;1;594;-2.14748e+09;-4.00444e+06;-1;0;0;0;-1;0;398811654;403618348;22401652
1355;1.16616e-14;-326;1671;24706;19733;1;610;-2.14748e+09;-3.9953e+06;0;0;0;0;0;0;398971253;403792594;22445386
1355;1.1555e-14;-309;1585;24192;19613;1;594;-2.14748e+09;-3.9953e+06;-1;0;0;0;-1;0;398971253;403792594;22445386
1356;1.16616e-14;-327;1671;24706;19733;1;610;-2.14748e+09;-3.98619e+06;0;0;0;0;0;0;399130491;403966486;22489083
1356;1.1555e-14;-309;1585;24192;19613;1;594;-2.14748e+09;-3.98619e+06;-1;0;0;0;-1;0;399130491;403966486;22489083
1357;1.16616e-14;-327;1671;24706;19733;1;610;-2.14748e+09;-3.9772e+06;-1;0;0;0;-1;0;399289370;404140026;22532744
1357;1.1555e-14;-310;1585;24192;19613;1;594;-2.14748e+09;-3.9772e+06;0;0;0;0;0;0;399289370;404140026;22532744
1358;1.16616e-14;-327;1671;24706;19733;1;610;-2.14748e+09;-3.96815e+06;-1;0;0;0;-1;0;399447889;404313214;22576368
1358;1.1555e-14;-310;1585;24192;19613;1;594;-2.14748e+09;-3.96815e+06;-1;0;0;0;-1;0;399447889;404313214;22576368
1359;1.16616e-14;-327;1671;24706;19733;1;610;-2.14748e+09;-3.95912e+06;-1;0;0;0;-1;0;399606050;404486050;22619956
1359;1.1555e-14;-310;1585;24192;19613;1;594;-2.14748e+09;-3.95912e+06;-1;0;0;0;-1;0;399606050;404486050;22619956
1360;1.16616e-14;-328;1671;24706;19733;1;610;-2.14748e+09;-3.95001e+06;0;0;0;0;0;0;399763855;404658537;22663507
1360;1.1555e-14;-311;1585;24192;19613;1;594;-2.14748e+09;-3.95001e+06;0;0;0;0;0;0;399763855;404658537;22663507
1361;1.16616e-14;-328;1671;24706;19733;1;610;-2.14748e+09;-3.94103e+06;-1;0;0;0;-1;0;399921303;404830674;22707021
1361;1.1555e-14;-311;1585;24192;19613;1;594;-2.14748e+09;-3.94103e+06;-1;0;0;0;-1;0;399921303;404830674;22707021
1362;1.16616e-14;-328;1671;24706;19733;1;610;-2.14748e+09;-3.93218e+06;-1;0;0;0;-1;0;400078397;405002463;22750498
1362;1.1555e-14;-311;1585;24192;19613;1;594;-2.14748e+09;-3.93218e+06;-1;0;0;0;-1;0;400078397;405002463;22750498
1363;1.16616e-14;-328;1671;24706;19733;1;610;-2.14748e+09;-3.92316e+06;-1;0;0;0;-1;0;400235136;405173904;22793938
1363;1.1555e-14;-312;1585;24192;19613;1;594;-2.14748e+09;-3.92316e+06;0;0;0;0;0;0;400235136;405173904;22793938
1364;1.16616e-14;-328;1671;24706;19733;1;610;-2.14748e+09;-3.91426e+06;-1;0;0;0;-1;0;400391522;405344999;22837341
1364;1.1555e-14;-312;1585;24192;19613;1;594;-2.14748e+09;-3.91426e+06;-1;0;0;0;-1;0;400391522;405344999;22837341
1365;1.16616e-14;-329;1671;24706;19733;1;610;-2.14748e+09;-3.90539e+06;0;0;0;0;0;0;400547556;405515748;22880707
1365;1.1555e-14;-312;1585;24192;19613;1;594;-2.14748e+09;-3.90539e+06;-1;0;0;0;-1;0;400547556;405515748;22880707
1366;1.16616e-14;-330;1671;24706;19733;1;610;-2.14748e+09;-3.89655e+06;0;0;0;0;0;0;400703239;405686152;22924036
1366;1.1555e-14;-312;1585;24192;19613;1;594;-2.14748e+09;-3.89655e+06;-1;0;0;0;-1;0;400703239;405686152;22924036
1367;1.16616e-14;-330;1671;24706;19733;1;610;-2.14748e+09;-3.88783e+06;-1;0;0;0;-1;0;400858572;405856213;22967327
1367;1.1555e-14;-312;1585;24192;19613;1;594;-2.14748e+09;-3.88783e+06;-1;0;0;0;-1;0;400858572;405856213;22967327
1368;1.16616e-14;-331;1671;24706;19733;1;610;-2.14748e+09;-3.87893e+06;0;0;0;0;0;0;401013555;406025930;23010580
1368;1.1555e-14;-312;1585;24192;19613;1;594;-2.14748e+09;-3.87893e+06;-1;0;0;0;-1;0;401013555;406025930;23010580
1369;1.16616e-14;-331;1671;24706;19733;1;610;-2.14748e+09;-3.87017e+06;-1;0;0;0;-1;0;401168190;406195305;23053796
1369;1.1555e-14;-312;1585;24192;19613;1;594;-2.14748e+09;-3.87017e+06;-1;0;0;0;-1;0;401168190;406195305;23053796
1370;1.16616e-14;-331;1671;24706;19733;1;610;-2.14748e+09;-3.86153e+06;-1;0;0;0;-1;0;401322478;406364339;23096974
1370;1.1555e-14;-312;1585;24192;19613;1;594;-2.14748e+09;-3.86153e+06;-1;0;0;0;-1;0;401322478;406364339;23096974
1371;1.16616e-14;-332;1671;24706;19733;1;610;-2.14748e+09;-3.85271e+06;0;0;0;0;0;0;401476419;406533032;23140115
1371;1.1555e-14;-312;1585;24192;19613;1;594;-2.14748e+09;-3.85271e+06;-1;0;0;0;-1;0;401476419;406533032;23140115
1372;1.16616e-14;-332;1671;24706;19733;1;610;-2.14748e+09;-3.84412e+06;-1;0;0;0;-1;0;401630015;406701386;23183217
1372;1.1555e-14;-313;1585;24192;19613;1;594;-2.14748e+09;-3.84412e+06;0;0;0;0;0;0;401630015;406701386;23183217
1373;1.16616e-14;-333;1671;24706;19733;1;610;-2.14748e+09;-3.83536e+06;0;0;0;0;0;0;401783267;406869401;23226282
1373;1.1555e-14;-313;1585;24192;19613;1;594;-2.14748e+09;-3.83536e+06;-1;0;0;0;-1;0;401783267;406869401;23226282
1374;1.16616e-14;-333;1671;24706;19733;1;610;-2.14748e+09;-3.82672e+06;-1;0;0;0;-1;0;401936174;407037078;23269309
1374;1.1555e-14;-313;1585;24192;19613;1;594;-2.14748e+09;-3.82672e+06;-1;0;0;0;-1;0;401936174;407037078;23269309
1375;1.16616e-14;-333;1671;24706;19733;1;610;-2.14748e+09;-3.81811e+06;-1;0;0;0;-1;0;402088739;407204418;23312297
1375;1.1555e-14;-313;1585;24192;19613;1;594;-2.14748e+09;-3.81811e+06;-1;0;0;0;-1;0;402088739;407204418;23312297
1376;1.16616e-14;-334;1671;24706;19733;1;610;-2.14748e+09;-3.80952e+06;0;0;0;0;0;0;402240963;407371421;23355247
1376;1.1555e-14;-313;1585;24192;19613;1;594;-2.14748e+09;-3.80952e+06;-1;0;0;0;-1;0;402240963;407371421;23355247
1377;1.16616e-14;-335;1671;24706;19733;1;610;-2.14748e+09;-3.80096e+06;0;0;0;0;0;0;402392845;407538090;23398159
1377;1.1555e-14;-314;1585;24192;19613;1;594;-2.14748e+09;-3.80096e+06;0;0;0;0;0;0;402392845;407538090;23398159
1378;1.16616e-14;-335;1671;24706;19733;1;610;-2.14748e+09;-3.79242e+06;-1;0;0;0;-1;0;402544388;407704424;23441033
1378;1.1555e-14;-314;1585;24192;19613;1;594;-2.14748e+09;-3.79242e+06;-1;0;0;0;-1;0;402544388;407704424;23441033
1379;1.16616e-14;-335;1671;24706;19733;1;610;-2.14748e+09;-3.7839e+06;-1;0;0;0;-1;0;402695591;407870424;23483868
1379;1.1555e-14;-315;1585;24192;19613;1;594;-2.14748e+09;-3.7839e+06;0;0;0;0;0;0;402695591;407870424;23483868
1380;1.16616e-14;-335;1671;24706;19733;1;610;-2.14748e+09;-3.77542e+06;-1;0;0;0;-1;0;402846457;408036091;23526664
1380;1.1555e-14;-315;1585;24192;19613;1;594;-2.14748e+09;-3.77542e+06;-1;0;0;0;-1;0;402846457;408036091;23526664
1381;1.16616e-14;-336;1671;24706;19733;1;610;-2.14748e+09;-3.76695e+06;0;0;0;0;0;0;402996985;408201426;23569422
1381;1.1555e-14;-316;1585;24192;19613;1;594;-2.14748e+09;-3.76695e+06;0;0;0;0;0;0;402996985;408201426;23569422
1382;1.16616e-14;-337;1671;24706;19733;1;610;-2.14748e+09;-3.75851e+06;0;0;0;0;0;0;403147177;408366431;23612141
1382;1.1555e-14;-316;1585;24192;19613;1;594;-2.14748e+09;-3.75851e+06;-1;0;0;0;-1;0;403147177;408366431;23612141
1383;1.16616e-14;-338;1671;24706;19733;1;610;-2.14748e+09;-3.7501e+06;0;0;0;0;0;0;403297034;408531104;23654822
1383;1.1555e-14;-317;1585;24192;19613;1;594;-2.14748e+09;-3.7501e+06;0;0;0;0;0;0;403297034;408531104;23654822
1384;1.16616e-14;-338;1671;24706;19733;1;610;-2.14748e+09;-3.74171e+06;-1;0;0;0;-1;0;403446556;408695448;23697463
1384;1.1555e-14;-318;1585;24192;19613;1;594;-2.14748e+09;-3.74171e+06;0;0;0;0;0;0;403446556;408695448;23697463
1385;1.16616e-14;-338;1671;24706;19733;1;610;-2.14748e+09;-3.73334e+06;-1;0;0;0;-1;0;403595745;408859464;23740065
1385;1.1555e-14;-318;1585;24192;19613;1;594;-2.14748e+09;-3.73334e+06;-1;0;0;0;-1;0;403595745;408859464;23740065
1386;1.16616e-14;-338;1671;24706;19733;1;610;-2.14748e+09;-3.725e+06;-1;0;0;0;-1;0;403744601;409023151;23782629
1386;1.1555e-14;-319;1585;24192;19613;1;594;-2.14748e+09;-3.725e+06;0;0;0;0;0;0;403744601;409023151;23782629
1387;1.16616e-14;-338;1671;24706;19733;1;610;-2.14748e+09;-3.71668e+06;-1;0;0;0;-1;0;403893125;409186512;23825153
1387;1.1555e-14;-320;1585;24192;19613;1;594;-2.14748e+09;-3.71668e+06;0;0;0;0;0;0;403893125;409186512;23825153
1388;1.16616e-14;-339;1671;24706;19733;1;610;-2.14748e+09;-3.70839e+06;0;0;0;0;0;0;404041318;409349546;23867638
1388;1.1555e-14;-320;1585;24192;19613;1;594;-2.14748e+09;-3.70839e+06;-1;0;0;0;-1;0;404041318;409349546;23867638
1389;1.16616e-14;-340;1671;24706;19733;1;610;-2.14748e+09;-3.70012e+06;0;0;0;0;0;0;404189181;409512255;23910084
1389;1.1555e-14;-320;1585;24192;19613;1;594;-2.14748e+09;-3.70012e+06;-1;0;0;0;-1;0;404189181;409512255;23910084
1390;1.16616e-14;-341;1671;24706;19733;1;610;-2.14748e+09;-3.69197e+06;0;0;0;0;0;0;404336716;409674639;23952491
1390;1.1555e-14;-321;1585;24192;19613;1;594;-2.14748e+09;-3.69197e+06;0;0;0;0;0;0;404336716;409674639;23952491
1391;1.16616e-14;-342;1671;24706;19733;1;610;-2.14748e+09;-3.68365e+06;0;0;0;0;0;0;404483922;409836699;23994858
1391;1.1555e-14;-322;1585;24192;19613;1;594;-2.14748e+09;-3.68365e+06;0;0;0;0;0;0;404483922;409836699;23994858
1392;1.16616e-14;-342;1671;24706;19733;1;610;-2.14748e+09;-3.67545e+06;-1;0;0;0;-1;0;404630800;409998436;24037185
1392;1.1555e-14;-323;1585;24192;19613;1;594;-2.14748e+09;-3.67545e+06;0;0;0;0;0;0;404630800;409998436;24037185
1393;1.16616e-14;-342;1671;24706;19733;1;610;-2.14748e+09;-3.66728e+06;-1;0;0;0;-1;0;404777352;410159850;24079473
1393;1.1555e-14;-324;1585;24192;19613;1;594;-2.14748e+09;-3.66728e+06;0;0;0;0;0;0;404777352;410159850;24079473
1394;1.16616e-14;-342;1671;24706;19733;1;610;-2.14748e+09;-3.65922e+06;-1;0;0;0;-1;0;404923579;410320944;24121722
1394;1.1555e-14;-324;1585;24192;19613;1;594;-2.14748e+09;-3.65922e+06;-1;0;0;0;-1;0;404923579;410320944;24121722
1395;1.16616e-14;-343;1671;24706;19733;1;610;-2.14748e+09;-3.651e+06;0;0;0;0;0;0;405069481;410481716;24163930
1395;1.1555e-14;-325;1585;24192;19613;1;594;-2.14748e+09;-3.651e+06;0;0;0;0;0;0;405069481;410481716;24163930
1396;1.16616e-14;-344;1671;24706;19733;1;610;-2.14748e+09;-3.64289e+06;0;0;0;0;0;0;405215059;410642169;24206099
1396;1.1555e-14;-325;1585;24192;19613;1;594;-2.14748e+09;-3.64289e+06;-1;0;0;0;-1;0;405215059;410642169;24206099
1397;1.16616e-14;-345;1671;24706;19733;1;610;-2.14748e+09;-3.63481e+06;0;0;0;0;0;0;405360313;410802302;24248228
1397;1.1555e-14;-325;1585;24192;19613;1;594;-2.14748e+09;-3.63481e+06;-1;0;0;0;-1;0;405360313;410802302;24248228
1398;1.16616e-14;-345;1671;24706;19733;1;610;-2.14748e+09;-3.62675e+06;-1;0;0;0;-1;0;405505246;410962117;24290317
1398;1.1555e-14;-326;1585;24192;19613;1;594;-2.14748e+09;-3.62675e+06;0;0;0;0;0;0;405505246;410962117;24290317
1399;1.16616e-14;-346;1671;24706;19733;1;610;-2.14748e+09;-3.61871e+06;0;0;0;0;0;0;405649858;411121615;24332366
1399;1.1555e-14;-326;1585;24192;19613;1;594;-2.14748e+09;-3.61871e+06;-1;0;0;0;-1;0;405649858;411121615;24332366
1400;1.16616e-14;-347;1671;24706;19733;1;610;-2.14748e+09;-3.6107e+06;0;0;0;0;0;0;405794149;411280795;24374376
1400;1.1555e-14;-326;1585;24192;19613;1;594;-2.14748e+09;-3.6107e+06;-1;0;0;0;-1;0;405794149;411280795;24374376
1401;1.16616e-14;-348;1671;24706;19733;1;610;-2.14748e+09;-3.60271e+06;0;0;0;0;0;0;405938120;411439660;24416344
1401;1.1555e-14;-326;1585;24192;19613;1;594;-2.14748e+09;-3.60271e+06;-1;0;0;0;-1;0;405938120;411439660;24416344
1402;1.16616e-14;-348;1671;24706;19733;1;610;-2.14748e+09;-3.59474e+06;-1;0;0;0;-1;0;406081772;411598210;24458273
1402;1.1555e-14;-326;1585;24192;19613;1;594;-2.14748e+09;-3.59474e+06;-1;0;0;0;-1;0;406081772;411598210;24458273
1403;1.16616e-14;-348;1671;24706;19733;1;610;-2.14748e+09;-3.58679e+06;-1;0;0;0;-1;0;406225107;411756444;24500161
1403;1.1555e-14;-326;1585;24192;19613;1;594;-2.14748e+09;-3.58679e+06;-1;0;0;0;-1;0;406225107;411756444;24500161
1404;1.16616e-14;-349;1671;24706;19733;1;610;-2.14748e+09;-3.57897e+06;0;0;0;0;0;0;406368125;411914366;24542010
1404;1.1555e-14;-326;1585;24192;19613;1;594;-2.14748e+09;-3.57897e+06;-1;0;0;0;-1;0;406368125;411914366;24542010
1405;1.16616e-14;-350;1671;24706;19733;1;610;-2.14748e+09;-3.57097e+06;0;0;0;0;0;0;406510826;412071974;24583817
1405;1.1555e-14;-326;1585;24192;19613;1;594;-2.14748e+09;-3.57097e+06;-1;0;0;0;-1;0;406510826;412071974;24583817
1406;1.16616e-14;-351;1671;24706;19733;1;610;-2.14748e+09;-3.56309e+06;0;0;0;0;0;0;406653212;412229270;24625584
1406;1.1555e-14;-327;1585;24192;19613;1;594;-2.14748e+09;-3.56309e+06;0;0;0;0;0;0;406653212;412229270;24625584
1407;1.16616e-14;-352;1671;24706;19733;1;610;-2.14748e+09;-3.55533e+06;0;0;0;0;0;0;406795283;412386255;24667311
1407;1.1555e-14;-327;1585;24192;19613;1;594;-2.14748e+09;-3.55533e+06;-1;0;0;0;-1;0;406795283;412386255;24667311
1408;1.16616e-14;-353;1671;24706;19733;1;610;-2.14748e+09;-3.5474e+06;0;0;0;0;0;0;406937041;412542929;24708997
1408;1.1555e-14;-328;1585;24192;19613;1;594;-2.14748e+09;-3.5474e+06;0;0;0;0;0;0;406937041;412542929;24708997
1409;1.16616e-14;-354;1671;24706;19733;1;610;-2.14748e+09;-3.53959e+06;0;0;0;0;0;0;407078485;412699293;24750643
1409;1.1555e-14;-328;1585;24192;19613;1;594;-2.14748e+09;-3.53959e+06;-1;0;0;0;-1;0;407078485;412699293;24750643
1410;1.16616e-14;-354;1671;24706;19733;1;610;-2.14748e+09;-3.5318e+06;-1;0;0;0;-1;0;407219618;412855348;24792247
1410;1.1555e-14;-328;1585;24192;19613;1;594;-2.14748e+09;-3.5318e+06;-1;0;0;0;-1;0;407219618;412855348;24792247
1411;1.16616e-14;-355;1671;24706;19733;1;610;-2.14748e+09;-3.52403e+06;0;0;0;0;0;0;407360439;413011094;24833811
1411;1.1555e-14;-328;1585;24192;19613;1;594;-2.14748e+09;-3.52403e+06;-1;0;0;0;-1;0;407360439;413011094;24833811
1412;1.16616e-14;-355;1671;24706;19733;1;610;-2.14748e+09;-3.51628e+06;-1;0;0;0;-1;0;407500950;413166533;24875334
1412;1.1555e-14;-328;1585;24192;19613;1;594;-2.14748e+09;-3.51628e+06;-1;0;0;0;-1;0;407500950;413166533;24875334
1413;1.16616e-14;-355;1671;24706;19733;1;610;-2.14748e+09;-3.50856e+06;-1;0;0;0;-1;0;407641151;413321665;24916816
1413;1.1555e-14;-329;1585;24192;19613;1;594;-2.14748e+09;-3.50856e+06;0;0;0;0;0;0;407641151;413321665;24916816
1414;1.16616e-14;-355;1671;24706;19733;1;610;-2.14748e+09;-3.50085e+06;-1;0;0;0;-1;0;407781044;413476490;24958258
1414;1.1555e-14;-330;1585;24192;19613;1;594;-2.14748e+09;-3.50085e+06;0;0;0;0;0;0;407781044;413476490;24958258
1415;1.16616e-14;-355;1671;24706;19733;1;610;-2.14748e+09;-3.49317e+06;-1;0;0;0;-1;0;407920628;413631010;24999658
1415;1.1555e-14;-331;1585;24192;19613;1;594;-2.14748e+09;-3.49317e+06;0;0;0;0;0;0;407920628;413631010;24999658
1416;1.16616e-14;-356;1671;24706;19733;1;610;-2.14748e+09;-3.48551e+06;0;0;0;0;0;0;408059905;413785226;25041017
1416;1.1555e-14;-332;1585;24192;19613;1;594;-2.14748e+09;-3.48551e+06;0;0;0;0;0;0;408059905;413785226;25041017
1417;1.16616e-14;-356;1671;24706;19733;1;610;-2.14748e+09;-3.47787e+06;-1;0;0;0;-1;0;408198876;413939137;25082335
1417;1.1555e-14;-333;1585;24192;19613;1;594;-2.14748e+09;-3.47787e+06;0;0;0;0;0;0;408198876;413939137;25082335
1418;1.16616e-14;-356;1671;24706;19733;1;610;-2.14748e+09;-3.47025e+06;-1;0;0;0;-1;0;408337541;414092745;25123612
1418;1.1555e-14;-333;1585;24192;19613;1;594;-2.14748e+09;-3.47025e+06;-1;0;0;0;-1;0;408337541;414092745;25123612
1419;1.16616e-14;-356;1671;24706;19733;1;610;-2.14748e+09;-3.46265e+06;-1;0;0;0;-1;0;408475901;414246050;25164847
1419;1.1555e-14;-334;1585;24192;19613;1;594;-2.14748e+09;-3.46265e+06;0;0;0;0;0;0;408475901;414246050;25164847
1420;1.16616e-14;-356;1671;24706;19733;1;610;-2.14748e+09;-3.45508e+06;-1;0;0;0;-1;0;408613957;414399054;25206042
1420;1.1555e-14;-334;1585;24192;19613;1;594;-2.14748e+09;-3.45508e+06;-1;0;0;0;-1;0;408613957;414399054;25206042
1421;1.16616e-14;-356;1671;24706;19733;1;610;-2.14748e+09;-3.44752e+06;-1;0;0;0;-1;0;408751711;414551757;25247195
1421;1.1555e-14;-334;1585;24192;19613;1;594;-2.14748e+09;-3.44752e+06;-1;0;0;0;-1;0;408751711;414551757;25247195
1422;1.16616e-14;-357;1671;24706;19733;1;610;-2.14748e+09;-3.44009e+06;0;0;0;0;0;0;408889161;414704159;25288306
1422;1.1555e-14;-334;1585;24192;19613;1;594;-2.14748e+09;-3.44009e+06;-1;0;0;0;-1;0;408889161;414704159;25288306
1423;1.16616e-14;-357;1671;24706;19733;1;610;-2.14748e+09;-3.43248e+06;-1;0;0;0;-1;0;409026310;414856261;25329376
1423;1.1555e-14;-334;1585;24192;19613;1;594;-2.14748e+09;-3.43248e+06;-1;0;0;0;-1;0;409026310;414856261;25329376
1424;1.16616e-14;-357;1671;24706;19733;1;610;-2.14748e+09;-3.42508e+06;-1;0;0;0;-1;0;409163158;415008065;25370405
1424;1.1555e-14;-334;1585;24192;19613;1;594;-2.14748e+09;-3.42508e+06;-1;0;0;0;-1;0;409163158;415008065;25370405
1425;1.16616e-14;-358;1671;24706;19733;1;610;-2.14748e+09;-3.41751e+06;0;0;0;0;0;0;409299706;415159570;25411392
1425;1.1555e-14;-334;1585;24192;19613;1;594;-2.14748e+09;-3.41751e+06;-1;0;0;0;-1;0;409299706;415159570;25411392
1426;1.16616e-14;-359;1671;24706;19733;1;610;-2.14748e+09;-3.41016e+06;0;0;0;0;0;0;409435955;415310778;25452337
1426;1.1555e-14;-335;1585;24192;19613;1;594;-2.14748e+09;-3.41016e+06;0;0;0;0;0;0;409435955;415310778;25452337
1427;1.16616e-14;-360;1671;24706;19733;1;610;-2.14748e+09;-3.40263e+06;0;0;0;0;0;0;409571905;415461689;25493241
1427;1.1555e-14;-335;1585;24192;19613;1;594;-2.14748e+09;-3.40263e+06;-1;0;0;0;-1;0;409571905;415461689;25493241
1428;1.16616e-14;-361;1671;24706;19733;1;610;-2.14748e+09;-3.39522e+06;0;0;0;0;0;0;409707558;415612303;25534103
1428;1.1555e-14;-336;1585;24192;19613;1;594;-2.14748e+09;-3.39522e+06;0;0;0;0;0;0;409707558;415612303;25534103
1429;1.16616e-14;-361;1671;24706;19733;1;610;-2.14748e+09;-3.38783e+06;-1;0;0;0;-1;0;409842913;415762623;25574923
1429;1.1555e-14;-336;1585;24192;19613;1;594;-2.14748e+09;-3.38783e+06;-1;0;0;0;-1;0;409842913;415762623;25574923
1430;1.16616e-14;-361;1671;24706;19733;1;610;-2.14748e+09;-3.38046e+06;-1;0;0;0;-1;0;409977973;415912647;25615701
1430;1.1555e-14;-336;1585;24192;19613;1;594;-2.14748e+09;-3.38046e+06;-1;0;0;0;-1;0;409977973;415912647;25615701
1431;1.16616e-14;-361;1671;24706;19733;1;610;-2.14748e+09;-3.37311e+06;-1;0;0;0;-1;0;410112737;416062378;25656437
1431;1.1555e-14;-336;1585;24192;19613;1;594;-2.14748e+09;-3.37311e+06;-1;0;0;0;-1;0;410112737;416062378;25656437
1432;1.16616e-14;-362;1671;24706;19733;1;610;-2.14748e+09;-3.36578e+06;0;0;0;0;0;0;410247206;416211815;25697132
1432;1.1555e-14;-337;1585;24192;19613;1;594;-2.14748e+09;-3.36578e+06;0;0;0;0;0;0;410247206;416211815;25697132
1433;1.16616e-14;-362;1671;24706;19733;1;610;-2.14748e+09;-3.35847e+06;-1;0;0;0;-1;0;410381381;416360960;25737785
1433;1.1555e-14;-338;1585;24192;19613;1;594;-2.14748e+09;-3.35847e+06;0;0;0;0;0;0;410381381;416360960;25737785
1434;1.16616e-14;-362;1671;24706;19733;1;610;-2.14748e+09;-3.35128e+06;-1;0;0;0;-1;0;410515263;416509812;25778395
1434;1.1555e-14;-338;1585;24192;19613;1;594;-2.14748e+09;-3.35128e+06;-1;0;0;0;-1;0;410515263;416509812;25778395
1435;1.16616e-14;-363;1671;24706;19733;1;610;-2.14748e+09;-3.34391e+06;0;0;0;0;0;0;410648853;416658373;25818964
1435;1.1555e-14;-339;1585;24192;19613;1;594;-2.14748e+09;-3.34391e+06;0;0;0;0;0;0;410648853;416658373;25818964
1436;1.16616e-14;-363;1671;24706;19733;1;610;-2.14748e+09;-3.33666e+06;-1;0;0;0;-1;0;410782151;416806644;25859490
1436;1.1555e-14;-340;1585;24192;19613;1;594;-2.14748e+09;-3.33666e+06;0;0;0;0;0;0;410782151;416806644;25859490
1437;1.16616e-14;-364;1671;24706;19733;1;610;-2.14748e+09;-3.32943e+06;0;0;0;0;0;0;410915159;416954625;25899974
1437;1.1555e-14;-340;1585;24192;19613;1;594;-2.14748e+09;-3.32943e+06;-1;0;0;0;-1;0;410915159;416954625;25899974
1438;1.16616e-14;-365;1671;24706;19733;1;610;-2.14748e+09;-3.32222e+06;0;0;0;0;0;0;411047876;417102317;25940416
1438;1.1555e-14;-340;1585;24192;19613;1;594;-2.14748e+09;-3.32222e+06;-1;0;0;0;-1;0;411047876;417102317;25940416
1439;1.16616e-14;-365;1671;24706;19733;1;610;-2.14748e+09;-3.31503e+06;-1;0;0;0;-1;0;411180304;417249720;25980816
1439;1.1555e-14;-340;1585;24192;19613;1;594;-2.14748e+09;-3.31503e+06;-1;0;0;0;-1;0;411180304;417249720;25980816
1440;1.16616e-14;-365;1671;24706;19733;1;610;-2.14748e+09;-3.30786e+06;-1;0;0;0;-1;0;411312443;417396835;26021174
1440;1.1555e-14;-340;1585;24192;19613;1;594;-2.14748e+09;-3.30786e+06;-1;0;0;0;-1;0;411312443;417396835;26021174
1441;1.16616e-14;-365;1671;24706;19733;1;610;-2.14748e+09;-3.3007e+06;-1;0;0;0;-1;0;411444294;417543663;26061489
1441;1.1555e-14;-341;1585;24192;19613;1;594;-2.14748e+09;-3.3007e+06;0;0;0;0;0;0;411444294;417543663;26061489
1442;1.16616e-14;-365;1671;24706;19733;1;610;-2.14748e+09;-3.29357e+06;-1;0;0;0;-1;0;411575858;417690204;26101762
1442;1.1555e-14;-342;1585;24192;19613;1;594;-2.14748e+09;-3.29357e+06;0;0;0;0;0;0;411575858;417690204;26101762
1443;1.16616e-14;-366;1671;24706;19733;1;610;-2.14748e+09;-3.28646e+06;0;0;0;0;0;0;411707136;417836460;26141992
1443;1.1555e-14;-342;1585;24192;19613;1;594;-2.14748e+09;-3.28646e+06;-1;0;0;0;-1;0;411707136;417836460;26141992
1444;1.16616e-14;-366;1671;24706;19733;1;610;-2.14748e+09;-3.27936e+06;-1;0;0;0;-1;0;411838128;417982431;26182180
1444;1.1555e-14;-343;1585;24192;19613;1;594;-2.14748e+09;-3.27936e+06;0;0;0;0;0;0;411838128;417982431;26182180
1445;1.16616e-14;-366;1671;24706;19733;1;610;-2.14748e+09;-3.27229e+06;-1;0;0;0;-1;0;411968835;418128116;26222325
1445;1.1555e-14;-344;1585;24192;19613;1;594;-2.14748e+09;-3.27229e+06;0;0;0;0;0;0;411968835;418128116;26222325
1446;1.16616e-14;-366;1671;24706;19733;1;610;-2.14748e+09;-3.26533e+06;-1;0;0;0;-1;0;412099258;418273519;26262428
1446;1.1555e-14;-344;1585;24192;19613;1;594;-2.14748e+09;-3.26533e+06;-1;0;0;0;-1;0;412099258;418273519;26262428
1447;1.16616e-14;-366;1671;24706;19733;1;610;-2.14748e+09;-3.2582e+06;-1;0;0;0;-1;0;412229397;418418638;26302488
1447;1.1555e-14;-345;1585;24192;19613;1;594;-2.14748e+09;-3.2582e+06;0;0;0;0;0;0;412229397;418418638;26302488
1448;1.16616e-14;-367;1671;24706;19733;1;610;-2.14748e+09;-3.25118e+06;0;0;0;0;0;0;412359254;418563474;26342506
1448;1.1555e-14;-346;1585;24192;19613;1;594;-2.14748e+09;-3.25118e+06;0;0;0;0;0;0;412359254;418563474;26342506
1449;1.16616e-14;-368;1671;24706;19733;1;610;-2.14748e+09;-3.24418e+06;0;0;0;0;0;0;412488828;418708028;26382481
1449;1.1555e-14;-346;1585;24192;19613;1;594;-2.14748e+09;-3.24418e+06;-1;0;0;0;-1;0;412488828;418708028;26382481
1450;1.16616e-14;-368;1671;24706;19733;1;610;-2.14748e+09;-3.2373e+06;-1;0;0;0;-1;0;412618121;418852302;26422414
1450;1.1555e-14;-347;1585;24192;19613;1;594;-2.14748e+09;-3.2372e+06;0;0;0;0;0;0;412618121;418852302;26422414
1451;1.16616e-14;-369;1671;24706;19733;1;610;-2.14748e+09;-3.23024e+06;0;0;0;0;0;0;412747134;418996294;26462303
1451;1.1555e-14;-347;1585;24192;19613;1;594;-2.14748e+09;-3.23024e+06;-1;0;0;0;-1;0;412747134;418996294;26462303
1452;1.16616e-14;-369;1671;24706;19733;1;610;-2.14748e+09;-3.22329e+06;-1;0;0;0;-1;0;412875867;419140007;26502150
1452;1.1555e-14;-348;1585;24192;19613;1;594;-2.14748e+09;-3.22329e+06;0;0;0;0;0;0;412875867;419140007;26502150
1453;1.16616e-14;-369;1671;24706;19733;1;610;-2.14748e+09;-3.21647e+06;-1;0;0;0;-1;0;413004320;419283441;26541954
1453;1.1555e-14;-349;1585;24192;19613;1;594;-2.14748e+09;-3.21647e+06;0;0;0;0;0;0;413004320;419283441;26541954
1454;1.16616e-14;-369;1671;24706;19733;1;610;-2.14748e+09;-3.20956e+06;-1;0;0;0;-1;0;413132495;419426595;26581715
1454;1.1555e-14;-350;1585;24192;19613;1;594;-2.14748e+09;-3.20956e+06;0;0;0;0;0;0;413132495;419426595;26581715
1455;1.16616e-14;-370;1671;24706;19733;1;610;-2.14748e+09;-3.20257e+06;0;0;0;0;0;0;413260392;419569472;26621434
1455;1.1555e-14;-351;1585;24192;19613;1;594;-2.14748e+09;-3.20257e+06;0;0;0;0;0;0;413260392;419569472;26621434
1456;1.16616e-14;-370;1671;24706;19733;1;610;-2.14748e+09;-3.1957e+06;-1;0;0;0;-1;0;413388013;419712072;26661109
1456;1.1555e-14;-352;1585;24192;19613;1;594;-2.14748e+09;-3.1957e+06;0;0;0;0;0;0;413388013;419712072;26661109
1457;1.16616e-14;-371;1671;24706;19733;1;610;-2.14748e+09;-3.18885e+06;0;0;0;0;0;0;413515357;419854395;26700742
1457;1.1555e-14;-352;1585;24192;19613;1;594;-2.14748e+09;-3.18885e+06;-1;0;0;0;-1;0;413515357;419854395;26700742
1458;1.16616e-14;-371;1671;24706;19733;1;610;-2.14748e+09;-3.18202e+06;-1;0;0;0;-1;0;413642425;419996441;26740331
1458;1.1555e-14;-353;1585;24192;19613;1;594;-2.14748e+09;-3.18202e+06;0;0;0;0;0;0;413642425;419996441;26740331
1459;1.16616e-14;-371;1671;24706;19733;1;610;-2.14748e+09;-3.1752e+06;-1;0;0;0;-1;0;413769218;420138213;26779878
1459;1.1555e-14;-354;1585;24192;19613;1;594;-2.14748e+09;-3.1752e+06;0;0;0;0;0;0;413769218;420138213;26779878
1460;1.16616e-14;-372;1671;24706;19733;1;610;-2.14748e+09;-3.16841e+06;0;0;0;0;0;0;413895737;420279709;26819381
1460;1.1555e-14;-355;1585;24192;19613;1;594;-2.14748e+09;-3.16841e+06;0;0;0;0;0;0;413895737;420279709;26819381
1461;1.16616e-14;-372;1671;24706;19733;1;610;-2.14748e+09;-3.16163e+06;-1;0;0;0;-1;0;414021983;420420932;26858841
1461;1.1555e-14;-356;1585;24192;19613;1;594;-2.14748e+09;-3.16163e+06;0;0;0;0;0;0;414021983;420420932;26858841
1462;1.16616e-14;-373;1671;24706;19733;1;610;-2.14748e+09;-3.15487e+06;0;0;0;0;0;0;414147955;420561880;26898259
1462;1.1555e-14;-357;1585;24192;19613;1;594;-2.14748e+09;-3.15487e+06;0;0;0;0;0;0;414147955;420561880;26898259
1463;1.16616e-14;-374;1671;24706;19733;1;610;-2.14748e+09;-3.14812e+06;0;0;0;0;0;0;414273656;420702556;26937633
1463;1.1555e-14;-357;1585;24192;19613;1;594;-2.14748e+09;-3.14812e+06;-1;0;0;0;-1;0;414273656;420702556;26937633
1464;1.16616e-14;-375;1671;24706;19733;1;610;-2.14748e+09;-3.1414e+06;0;0;0;0;0;0;414399085;420842960;26976964
1464;1.1555e-14;-357;1585;24192;19613;1;594;-2.14748e+09;-3.1414e+06;-1;0;0;0;-1;0;414399085;420842960;26976964
1465;1.16616e-14;-375;1671;24706;19733;1;610;-2.14748e+09;-3.13479e+06;-1;0;0;0;-1;0;414524243;420983092;27016252
1465;1.1555e-14;-357;1585;24192;19613;1;594;-2.14748e+09;-3.13479e+06;-1;0;0;0;-1;0;414524243;420983092;27016252
1466;1.16616e-14;-376;1671;24706;19733;1;610;-2.14748e+09;-3.128e+06;0;0;0;0;0;0;414649131;421122953;27055496
1466;1.1555e-14;-357;1585;24192;19613;1;594;-2.14748e+09;-3.128e+06;-1;0;0;0;-1;0;414649131;421122953;27055496
1467;1.16616e-14;-377;1671;24706;19733;1;610;-2.14748e+09;-3.12133e+06;0;0;0;0;0;0;414773750;421262544;27094697
1467;1.1555e-14;-358;1585;24192;19613;1;594;-2.14748e+09;-3.12133e+06;0;0;0;0;0;0;414773750;421262544;27094697
1468;1.16616e-14;-378;1671;24706;19733;1;610;-2.14748e+09;-3.11468e+06;0;0;0;0;0;0;414898099;421401864;27133855
1468;1.1555e-14;-359;1585;24192;19613;1;594;-2.14748e+09;-3.11468e+06;0;0;0;0;0;0;414898099;421401864;27133855
1469;1.16616e-14;-379;1671;24706;19733;1;610;-2.14748e+09;-3.10804e+06;0;0;0;0;0;0;415022181;421540916;27172970
1469;1.1555e-14;-359;1585;24192;19613;1;594;-2.14748e+09;-3.10804e+06;-1;0;0;0;-1;0;415022181;421540916;27172970
1470;1.16616e-14;-380;1671;24706;19733;1;610;-2.14748e+09;-3.10152e+06;0;0;0;0;0;0;415145996;421679699;27212041
1470;1.1555e-14;-360;1585;24192;19613;1;594;-2.14748e+09;-3.10152e+06;0;0;0;0;0;0;415145996;421679699;27212041
1471;1.16616e-14;-380;1671;24706;19733;1;610;-2.14748e+09;-3.09482e+06;-1;0;0;0;-1;0;415269543;421818214;27251069
1471;1.1555e-14;-361;1585;24192;19613;1;594;-2.14748e+09;-3.09482e+06;0;0;0;0;0;0;415269543;421818214;27251069
1472;1.16616e-14;-380;1671;24706;19733;1;610;-2.14748e+09;-3.08823e+06;-1;0;0;0;-1;0;415392825;421956461;27290054
1472;1.1555e-14;-362;1585;24192;19613;1;594;-2.14748e+09;-3.08823e+06;0;0;0;0;0;0;415392825;421956461;27290054
1473;1.16616e-14;-381;1671;24706;19733;1;610;-2.14748e+09;-3.08166e+06;0;0;0;0;0;0;415515841;422094442;27328995
1473;1.1555e-14;-362;1585;24192;19613;1;594;-2.14748e+09;-3.08166e+06;-1;0;0;0;-1;0;415515841;422094442;27328995
1474;1.16616e-14;-382;1671;24706;19733;1;610;-2.14748e+09;-3.07511e+06;0;0;0;0;0;0;415638593;422232157;27367892
1474;1.1555e-14;-362;1585;24192;19613;1;594;-2.14748e+09;-3.07511e+06;-1;0;0;0;-1;0;415638593;422232157;27367892
1475;1.16616e-14;-382;1671;24706;19733;1;610;-2.14748e+09;-3.06858e+06;-1;0;0;0;-1;0;415761080;422369606;27406746
1475;1.1555e-14;-362;1585;24192;19613;1;594;-2.14748e+09;-3.06858e+06;-1;0;0;0;-1;0;415761080;422369606;27406746
1476;1.16616e-14;-383;1671;24706;19733;1;610;-2.14748e+09;-3.06206e+06;0;0;0;0;0;0;415883305;422506790;27445557
1476;1.1555e-14;-363;1585;24192;19613;1;594;-2.14748e+09;-3.06206e+06;0;0;0;0;0;0;415883305;422506790;27445557
1477;1.16616e-14;-383;1671;24706;19733;1;610;-2.14748e+09;-3.05566e+06;-1;0;0;0;-1;0;416005266;422643710;27484324
1477;1.1555e-14;-363;1585;24192;19613;1;594;-2.14748e+09;-3.05566e+06;-1;0;0;0;-1;0;416005266;422643710;27484324
1478;1.16616e-14;-384;1671;24706;19733;1;610;-2.14748e+09;-3.04908e+06;0;0;0;0;0;0;416126965;422780366;27523048
1478;1.1555e-14;-363;1585;24192;19613;1;594;-2.14748e+09;-3.04908e+06;-1;0;0;0;-1;0;416126965;422780366;27523048
1479;1.16616e-14;-385;1671;24706;19733;1;610;-2.14748e+09;-3.04262e+06;0;0;0;0;0;0;416248403;422916759;27561728
1479;1.1555e-14;-364;1585;24192;19613;1;594;-2.14748e+09;-3.04262e+06;0;0;0;0;0;0;416248403;422916759;27561728
1480;1.16616e-14;-386;1671;24706;19733;1;610;-2.14748e+09;-3.03617e+06;0;0;0;0;0;0;416369581;423052890;27600364
1480;1.1555e-14;-365;1585;24192;19613;1;594;-2.14748e+09;-3.03617e+06;0;0;0;0;0;0;416369581;423052890;27600364
1481;1.16616e-14;-387;1671;24706;19733;1;610;-2.14748e+09;-3.02974e+06;0;0;0;0;0;0;416490498;423188758;27638957
1481;1.1555e-14;-366;1585;24192;19613;1;594;-2.14748e+09;-3.02974e+06;0;0;0;0;0;0;416490498;423188758;27638957
1482;1.16616e-14;-388;1671;24706;19733;1;610;-2.14748e+09;-3.02332e+06;0;0;0;0;0;0;416611155;423324365;27677506
1482;1.1555e-14;-367;1585;24192;19613;1;594;-2.14748e+09;-3.02332e+06;0;0;0;0;0;0;416611155;423324365;27677506
1483;1.16616e-14;-389;1671;24706;19733;1;610;-2.14748e+09;-3.01692e+06;0;0;0;0;0;0;416731554;423459712;27716011
1483;1.1555e-14;-368;1585;24192;19613;1;594;-2.14748e+09;-3.01692e+06;0;0;0;0;0;0;416731554;423459712;27716011
1484;1.16616e-14;-389;1671;24706;19733;1;610;-2.14748e+09;-3.01054e+06;-1;0;0;0;-1;0;416851695;423594798;27754473
1484;1.1555e-14;-369;1585;24192;19613;1;594;-2.14748e+09;-3.01054e+06;0;0;0;0;0;0;416851695;423594798;27754473
1485;1.16616e-14;-389;1671;24706;19733;1;610;-2.14748e+09;-3.00417e+06;-1;0;0;0;-1;0;416971578;423729625;27792891
1485;1.1555e-14;-369;1585;24192;19613;1;594;-2.14748e+09;-3.00417e+06;-1;0;0;0;-1;0;416971578;423729625;27792891
1486;1.16616e-14;-390;1671;24706;19733;1;610;-2.14748e+09;-2.99782e+06;0;0;0;0;0;0;417091204;423864192;27831265
1486;1.1555e-14;-369;1585;24192;19613;1;594;-2.14748e+09;-2.99782e+06;-1;0;0;0;-1;0;417091204;423864192;27831265
1487;1.16616e-14;-391;1671;24706;19733;1;610;-2.14748e+09;-2.99159e+06;0;0;0;0;0;0;417210574;423998501;27869596
1487;1.1555e-14;-370;1585;24192;19613;1;594;-2.14748e+09;-2.99159e+06;0;0;0;0;0;0;417210574;423998501;27869596
1488;1.16616e-14;-391;1671;24706;19733;1;610;-2.14748e+09;-2.98518e+06;-1;0;0;0;-1;0;417329689;424132552;27907882
1488;1.1555e-14;-371;1585;24192;19613;1;594;-2.14748e+09;-2.98518e+06;0;0;0;0;0;0;417329689;424132552;27907882
1489;1.16616e-14;-391;1671;24706;19733;1;610;-2.14748e+09;-2.97888e+06;-1;0;0;0;-1;0;417448548;424266346;27946125
1489;1.1555e-14;-372;1585;24192;19613;1;594;-2.14748e+09;-2.97888e+06;0;0;0;0;0;0;417448548;424266346;27946125
1490;1.16616e-14;-391;1671;24706;19733;1;610;-2.14748e+09;-2.97259e+06;-1;0;0;0;-1;0;417567153;424399884;27984324
1490;1.1555e-14;-373;1585;24192;19613;1;594;-2.14748e+09;-2.97259e+06;0;0;0;0;0;0;417567153;424399884;27984324
1491;1.16616e-14;-392;1671;24706;19733;1;610;-2.14748e+09;-2.96632e+06;0;0;0;0;0;0;417685505;424533165;28022480
1491;1.1555e-14;-374;1585;24192;19613;1;594;-2.14748e+09;-2.96632e+06;0;0;0;0;0;0;417685505;424533165;28022480
1492;1.16616e-14;-393;1671;24706;19733;1;610;-2.14748e+09;-2.96007e+06;0;0;0;0;0;0;417803603;424666190;28060591
1492;1.1555e-14;-374;1585;24192;19613;1;594;-2.14748e+09;-2.96007e+06;-1;0;0;0;-1;0;417803603;424666190;28060591
1493;1.16616e-14;-393;1671;24706;19733;1;610;-2.14748e+09;-2.95384e+06;-1;0;0;0;-1;0;417921449;424798961;28098659
1493;1.1555e-14;-374;1585;24192;19613;1;594;-2.14748e+09;-2.95384e+06;-1;0;0;0;-1;0;417921449;424798961;28098659
1494;1.16616e-14;-393;1671;24706;19733;1;610;-2.14748e+09;-2.94762e+06;-1;0;0;0;-1;0;418039043;424931477;28136682
1494;1.1555e-14;-374;1585;24192;19613;1;594;-2.14748e+09;-2.94762e+06;-1;0;0;0;-1;0;418039043;424931477;28136682
1495;1.16616e-14;-393;1671;24706;19733;1;610;-2.14748e+09;-2.94151e+06;-1;0;0;0;-1;0;418156386;425063739;28174662
1495;1.1555e-14;-375;1585;24192;19613;1;594;-2.14748e+09;-2.94151e+06;0;0;0;0;0;0;418156386;425063739;28174662
1496;1.16616e-14;-394;1671;24706;19733;1;610;-2.14748e+09;-2.93522e+06;0;0;0;0;0;0;418273479;425195748;28212598
1496;1.1555e-14;-376;1585;24192;19613;1;594;-2.14748e+09;-2.93522e+06;0;0;0;0;0;0;418273479;425195748;28212598
1497;1.16616e-14;-394;1671;24706;19733;1;610;-2.14748e+09;-2.92905e+06;-1;0;0;0;-1;0;418390321;425327505;28250490
1497;1.1555e-14;-377;1585;24192;19613;1;594;-2.14748e+09;-2.92905e+06;0;0;0;0;0;0;418390321;425327505;28250490
1498;1.16616e-14;-395;1671;24706;19733;1;610;-2.14748e+09;-2.9229e+06;0;0;0;0;0;0;418506914;425459009;28288338
1498;1.1555e-14;-378;1585;24192;19613;1;594;-2.14748e+09;-2.9229e+06;0;0;0;0;0;0;418506914;425459009;28288338
1499;1.16616e-14;-396;1671;24706;19733;1;610;-2.14748e+09;-2.91676e+06;0;0;0;0;0;0;418623259;425590261;28326142
1499;1.1555e-14;-379;1585;24192;19613;1;594;-2.14748e+09;-2.91676e+06;0;0;0;0;0;0;418623259;425590261;28326142
1500;1.16616e-14;-397;1671;24706;19733;1;610;-2.14748e+09;-2.91063e+06;0;0;0;0;0;0;418739355;425721262;28363902
1500;1.1555e-14;-380;1585;24192;19613;1;594;-2.14748e+09;-2.91063e+06;0;0;0;0;0;0;418739355;425721262;28363902
1501;1.16616e-14;-397;1671;24706;19733;1;610;-2.14748e+09;-2.90452e+06;-1;0;0;0;-1;0;418855204;425852013;28401618
1501;1.1555e-14;-381;1585;24192;19613;1;594;-2.14748e+09;-2.90452e+06;0;0;0;0;0;0;418855204;425852013;28401618
1502;1.16616e-14;-397;1671;24706;19733;1;610;-2.14748e+09;-2.89843e+06;-1;0;0;0;-1;0;418970806;425982514;28439290
1502;1.1555e-14;-382;1585;24192;19613;1;594;-2.14748e+09;-2.89843e+06;0;0;0;0;0;0;418970806;425982514;28439290
1503;1.16616e-14;-398;1671;24706;19733;1;610;-2.14748e+09;-2.89235e+06;0;0;0;0;0;0;419086162;426112766;28476918
1503;1.1555e-14;-382;1585;24192;19613;1;594;-2.14748e+09;-2.89235e+06;-1;0;0;0;-1;0;419086162;426112766;28476918
1504;1.16616e-14;-398;1671;24706;19733;1;610;-2.14748e+09;-2.88629e+06;-1;0;0;0;-1;0;419201272;426242769;28514502
1504;1.1555e-14;-383;1585;24192;19613;1;594;-2.14748e+09;-2.88629e+06;0;0;0;0;0;0;419201272;426242769;28514502
1505;1.16616e-14;-398;1671;24706;19733;1;610;-2.14748e+09;-2.88024e+06;-1;0;0;0;-1;0;419316137;426372523;28552042
1505;1.1555e-14;-383;1585;24192;19613;1;594;-2.14748e+09;-2.88024e+06;-1;0;0;0;-1;0;419316137;426372523;28552042
1506;1.16616e-14;-398;1671;24706;19733;1;610;-2.14748e+09;-2.87431e+06;-1;0;0;0;-1;0;419430758;426502030;28589538
1506;1.1555e-14;-384;1585;24192;19613;1;594;-2.14748e+09;-2.87431e+06;0;0;0;0;0;0;419430758;426502030;28589538
1507;1.16616e-14;-399;1671;24706;19733;1;610;-2.14748e+09;-2.86829e+06;0;0;0;0;0;0;419545134;426631290;28626989
1507;1.1555e-14;-385;1585;24192;19613;1;594;-2.14748e+09;-2.86829e+06;0;0;0;0;0;0;419545134;426631290;28626989
1508;1.16616e-14;-400;1671;24706;19733;1;610;-2.14748e+09;-2.86219e+06;0;0;0;0;0;0;419659268;426760303;28664397
1508;1.1555e-14;-386;1585;24192;19613;1;594;-2.14748e+09;-2.86219e+06;0;0;0;0;0;0;419659268;426760303;28664397
1509;1.16616e-14;-400;1671;24706;19733;1;610;-2.14748e+09;-2.8562e+06;-1;0;0;0;-1;0;419773159;426889069;28701761
1509;1.1555e-14;-386;1585;24192;19613;1;594;-2.14748e+09;-2.8562e+06;-1;0;0;0;-1;0;419773159;426889069;28701761
1510;1.16616e-14;-401;1671;24706;19733;1;610;-2.14748e+09;-2.85033e+06;0;0;0;0;0;0;419886808;427017591;28739080
1510;1.1555e-14;-387;1585;24192;19613;1;594;-2.14748e+09;-2.85033e+06;0;0;0;0;0;0;419886808;427017591;28739080
1511;1.16616e-14;-402;1671;24706;19733;1;610;-2.14748e+09;-2.84427e+06;0;0;0;0;0;0;420000215;427145867;28776355
1511;1.1555e-14;-387;1585;24192;19613;1;594;-2.14748e+09;-2.84427e+06;-1;0;0;0;-1;0;420000215;427145867;28776355
1512;1.16616e-14;-403;1671;24706;19733;1;610;-2.14748e+09;-2.83833e+06;0;0;0;0;0;0;420113382;427273899;28813587
1512;1.1555e-14;-387;1585;24192;19613;1;594;-2.14748e+09;-2.83833e+06;-1;0;0;0;-1;0;420113382;427273899;28813587
1513;1.16616e-14;-404;1671;24706;19733;1;610;-2.14748e+09;-2.8324e+06;0;0;0;0;0;0;420226308;427401687;28850774
1513;1.1555e-14;-387;1585;24192;19613;1;594;-2.14748e+09;-2.8324e+06;-1;0;0;0;-1;0;420226308;427401687;28850774
1514;1.16616e-14;-405;1671;24706;19733;1;610;-2.14748e+09;-2.82659e+06;0;0;0;0;0;0;420338994;427529231;28887917
1514;1.1555e-14;-388;1585;24192;19613;1;594;-2.14748e+09;-2.82659e+06;0;0;0;0;0;0;420338994;427529231;28887917
1515;1.16616e-14;-405;1671;24706;19733;1;610;-2.14748e+09;-2.8206e+06;-1;0;0;0;-1;0;420451442;427656533;28925015
1515;1.1555e-14;-389;1585;24192;19613;1;594;-2.14748e+09;-2.8206e+06;0;0;0;0;0;0;420451442;427656533;28925015
1516;1.16616e-14;-405;1671;24706;19733;1;610;-2.14748e+09;-2.81472e+06;-1;0;0;0;-1;0;420563651;427783592;28962070
1516;1.1555e-14;-390;1585;24192;19613;1;594;-2.14748e+09;-2.81472e+06;0;0;0;0;0;0;420563651;427783592;28962070
1517;1.16616e-14;-405;1671;24706;19733;1;610;-2.14748e+09;-2.80885e+06;-1;0;0;0;-1;0;420675622;427910409;28999081
1517;1.1555e-14;-390;1585;24192;19613;1;594;-2.14748e+09;-2.80885e+06;-1;0;0;0;-1;0;420675622;427910409;28999081
1518;1.16616e-14;-406;1671;24706;19733;1;610;-2.14748e+09;-2.803e+06;0;0;0;0;0;0;420787355;428036985;29036047
1518;1.1555e-14;-391;1585;24192;19613;1;594;-2.14748e+09;-2.803e+06;0;0;0;0;0;0;420787355;428036985;29036047
1519;1.16616e-14;-407;1671;24706;19733;1;610;-2.14748e+09;-2.79716e+06;0;0;0;0;0;0;420898852;428163321;29072969
1519;1.1555e-14;-391;1585;24192;19613;1;594;-2.14748e+09;-2.79716e+06;-1;0;0;0;-1;0;420898852;428163321;29072969
1520;1.16616e-14;-408;1671;24706;19733;1;610;-2.14748e+09;-2.79134e+06;0;0;0;0;0;0;421010113;428289416;29109847
1520;1.1555e-14;-391;1585;24192;19613;1;594;-2.14748e+09;-2.79134e+06;-1;0;0;0;-1;0;421010113;428289416;29109847
1521;1.16616e-14;-409;1671;24706;19733;1;610;-2.14748e+09;-2.78553e+06;0;0;0;0;0;0;421121138;428415271;29146680
1521;1.1555e-14;-391;1585;24192;19613;1;594;-2.14748e+09;-2.78553e+06;-1;0;0;0;-1;0;421121138;428415271;29146680
1522;1.16616e-14;-409;1671;24706;19733;1;610;-2.14748e+09;-2.77983e+06;-1;0;0;0;-1;0;421231928;428540887;29183470
1522;1.1555e-14;-391;1585;24192;19613;1;594;-2.14748e+09;-2.77983e+06;-1;0;0;0;-1;0;421231928;428540887;29183470
1523;1.16616e-14;-409;1671;24706;19733;1;610;-2.14748e+09;-2.77395e+06;-1;0;0;0;-1;0;421342484;428666265;29220215
1523;1.1555e-14;-391;1585;24192;19613;1;594;-2.14748e+09;-2.77395e+06;-1;0;0;0;-1;0;421342484;428666265;29220215
1524;1.16616e-14;-410;1671;24706;19733;1;610;-2.14748e+09;-2.76819e+06;0;0;0;0;0;0;421452805;428791404;29256916
1524;1.1555e-14;-391;1585;24192;19613;1;594;-2.14748e+09;-2.76819e+06;-1;0;0;0;-1;0;421452805;428791404;29256916
1525;1.16616e-14;-411;1671;24706;19733;1;610;-2.14748e+09;-2.76244e+06;0;0;0;0;0;0;421562894;428916306;29293573
1525;1.1555e-14;-391;1585;24192;19613;1;594;-2.14748e+09;-2.76244e+06;-1;0;0;0;-1;0;421562894;428916306;29293573
1526;1.16616e-14;-412;1671;24706;19733;1;610;-2.14748e+09;-2.7567e+06;0;0;0;0;0;0;421672750;429040971;29330186
1526;1.1555e-14;-392;1585;24192;19613;1;594;-2.14748e+09;-2.7567e+06;0;0;0;0;0;0;421672750;429040971;29330186
1527;1.16616e-14;-413;1671;24706;19733;1;610;-2.14748e+09;-2.75098e+06;0;0;0;0;0;0;421782373;429165399;29366754
1527;1.1555e-14;-393;1585;24192;19613;1;594;-2.14748e+09;-2.75098e+06;0;0;0;0;0;0;421782373;429165399;29366754
1528;1.16616e-14;-413;1671;24706;19733;1;610;-2.14748e+09;-2.74527e+06;-1;0;0;0;-1;0;421891765;429289591;29403278
1528;1.1555e-14;-394;1585;24192;19613;1;594;-2.14748e+09;-2.74527e+06;0;0;0;0;0;0;421891765;429289591;29403278
1529;1.16616e-14;-413;1671;24706;19733;1;610;-2.14748e+09;-2.73958e+06;-1;0;0;0;-1;0;422000926;429413548;29439758
1529;1.1555e-14;-395;1585;24192;19613;1;594;-2.14748e+09;-2.73958e+06;0;0;0;0;0;0;422000926;429413548;29439758
1530;1.16616e-14;-413;1671;24706;19733;1;610;-2.14748e+09;-2.734e+06;-1;0;0;0;-1;0;422109856;429537269;29476193
1530;1.1555e-14;-396;1585;24192;19613;1;594;-2.14748e+09;-2.734e+06;0;0;0;0;0;0;422109856;429537269;29476193
1531;1.16616e-14;-414;1671;24706;19733;1;610;-2.14748e+09;-2.72833e+06;0;0;0;0;0;0;422218556;429660756;29512585
1531;1.1555e-14;-396;1585;24192;19613;1;594;-2.14748e+09;-2.72833e+06;-1;0;0;0;-1;0;422218556;429660756;29512585
1532;1.16616e-14;-414;1671;24706;19733;1;610;-2.14748e+09;-2.72258e+06;-1;0;0;0;-1;0;422327027;429784009;29548932
1532;1.1555e-14;-397;1585;24192;19613;1;594;-2.14748e+09;-2.72258e+06;0;0;0;0;0;0;422327027;429784009;29548932
1533;1.16616e-14;-414;1671;24706;19733;1;610;-2.14748e+09;-2.71694e+06;-1;0;0;0;-1;0;422435269;429907028;29585235
1533;1.1555e-14;-398;1585;24192;19613;1;594;-2.14748e+09;-2.71694e+06;0;0;0;0;0;0;422435269;429907028;29585235
1534;1.16616e-14;-414;1671;24706;19733;1;610;-2.14748e+09;-2.71132e+06;-1;0;0;0;-1;0;422543283;430029814;29621493
1534;1.1555e-14;-399;1585;24192;19613;1;594;-2.14748e+09;-2.71132e+06;0;0;0;0;0;0;422543283;430029814;29621493
1535;1.16616e-14;-414;1671;24706;19733;1;610;-2.14748e+09;-2.70571e+06;-1;0;0;0;-1;0;422651069;430152368;29657707
1535;1.1555e-14;-399;1585;24192;19613;1;594;-2.14748e+09;-2.70571e+06;-1;0;0;0;-1;0;422651069;430152368;29657707
1536;1.16616e-14;-414;1671;24706;19733;1;610;-2.14748e+09;-2.70011e+06;-1;0;0;0;-1;0;422758628;430274690;29693877
1536;1.1555e-14;-400;1585;24192;19613;1;594;-2.14748e+09;-2.70011e+06;0;0;0;0;0;0;422758628;430274690;29693877
1537;1.16616e-14;-415;1671;24706;19733;1;610;-2.14748e+09;-2.69453e+06;0;0;0;0;0;0;422865960;430396780;29730003
1537;1.1555e-14;-401;1585;24192;19613;1;594;-2.14748e+09;-2.69453e+06;0;0;0;0;0;0;422865960;430396780;29730003
1538;1.16616e-14;-416;1671;24706;19733;1;610;-2.14748e+09;-2.68896e+06;0;0;0;0;0;0;422973066;430518639;29766085
1538;1.1555e-14;-402;1585;24192;19613;1;594;-2.14748e+09;-2.68896e+06;0;0;0;0;0;0;422973066;430518639;29766085
1539;1.16616e-14;-417;1671;24706;19733;1;610;-2.14748e+09;-2.68341e+06;0;0;0;0;0;0;423079947;430640268;29802122
1539;1.1555e-14;-403;1585;24192;19613;1;594;-2.14748e+09;-2.68341e+06;0;0;0;0;0;0;423079947;430640268;29802122
1540;1.16616e-14;-418;1671;24706;19733;1;610;-2.14748e+09;-2.67786e+06;0;0;0;0;0;0;423186602;430761666;29838115
1540;1.1555e-14;-404;1585;24192;19613;1;594;-2.14748e+09;-2.67786e+06;0;0;0;0;0;0;423186602;430761666;29838115
1541;1.16616e-14;-418;1671;24706;19733;1;610;-2.14748e+09;-2.67234e+06;-1;0;0;0;-1;0;423293034;430882835;29874064
1541;1.1555e-14;-404;1585;24192;19613;1;594;-2.14748e+09;-2.67234e+06;-1;0;0;0;-1;0;423293034;430882835;29874064
1542;1.16616e-14;-418;1671;24706;19733;1;610;-2.14748e+09;-2.66682e+06;-1;0;0;0;-1;0;423399241;431003776;29909968
1542;1.1555e-14;-405;1585;24192;19613;1;594;-2.14748e+09;-2.66682e+06;0;0;0;0;0;0;423399241;431003776;29909968
1543;1.16616e-14;-419;1671;24706;19733;1;610;-2.14748e+09;-2.66132e+06;0;0;0;0;0;0;423505225;431124487;29945828
1543;1.1555e-14;-406;1585;24192;19613;1;594;-2.14748e+09;-2.66132e+06;0;0;0;0;0;0;423505225;431124487;29945828
1544;1.16616e-14;-420;1671;24706;19733;1;610;-2.14748e+09;-2.65584e+06;0;0;0;0;0;0;423610986;431244970;29981644
1544;1.1555e-14;-406;1585;24192;19613;1;594;-2.14748e+09;-2.65584e+06;-1;0;0;0;-1;0;423610986;431244970;29981644
1545;1.16616e-14;-421;1671;24706;19733;1;610;-2.14748e+09;-2.65036e+06;0;0;0;0;0;0;423716525;431365226;30017416
1545;1.1555e-14;-407;1585;24192;19613;1;594;-2.14748e+09;-2.65036e+06;0;0;0;0;0;0;423716525;431365226;30017416
1546;1.16616e-14;-422;1671;24706;19733;1;610;-2.14748e+09;-2.6449e+06;0;0;0;0;0;0;423821842;431485255;30053143
1546;1.1555e-14;-408;1585;24192;19613;1;594;-2.14748e+09;-2.6449e+06;0;0;0;0;0;0;423821842;431485255;30053143
1547;1.16616e-14;-423;1671;24706;19733;1;610;-2.14748e+09;-2.63946e+06;0;0;0;0;0;0;423926938;431605057;30088826
1547;1.1555e-14;-408;1585;24192;19613;1;594;-2.14748e+09;-2.63946e+06;-1;0;0;0;-1;0;423926938;431605057;30088826
1548;1.16616e-14;-423;1671;24706;19733;1;610;-2.14748e+09;-2.63402e+06;-1;0;0;0;-1;0;424031813;431724633;30124465
1548;1.1555e-14;-408;1585;24192;19613;1;594;-2.14748e+09;-2.63402e+06;-1;0;0;0;-1;0;424031813;431724633;30124465
1549;1.16616e-14;-424;1671;24706;19733;1;610;-2.14748e+09;-2.6286e+06;0;0;0;0;0;0;424136468;431843983;30160060
1549;1.1555e-14;-409;1585;24192;19613;1;594;-2.14748e+09;-2.6286e+06;0;0;0;0;0;0;424136468;431843983;30160060
1550;1.16616e-14;-424;1671;24706;19733;1;610;-2.14748e+09;-2.62319e+06;-1;0;0;0;-1;0;424240903;431963109;30195610
1550;1.1555e-14;-410;1585;24192;19613;1;594;-2.14748e+09;-2.62319e+06;0;0;0;0;0;0;424240903;431963109;30195610
1551;1.16616e-14;-424;1671;24706;19733;1;610;-2.14748e+09;-2.6178e+06;-1;0;0;0;-1;0;424345119;432082009;30231116
1551;1.1555e-14;-410;1585;24192;19613;1;594;-2.14748e+09;-2.6178e+06;-1;0;0;0;-1;0;424345119;432082009;30231116
1552;1.16616e-14;-424;1671;24706;19733;1;610;-2.14748e+09;-2.61242e+06;-1;0;0;0;-1;0;424449117;432200685;30266578
1552;1.1555e-14;-410;1585;24192;19613;1;594;-2.14748e+09;-2.61242e+06;-1;0;0;0;-1;0;424449117;432200685;30266578
1553;1.16616e-14;-424;1671;24706;19733;1;610;-2.14748e+09;-2.60705e+06;-1;0;0;0;-1;0;424552897;432319138;30301995
1553;1.1555e-14;-410;1585;24192;19613;1;594;-2.14748e+09;-2.60705e+06;-1;0;0;0;-1;0;424552897;432319138;30301995
1554;1.16616e-14;-424;1671;24706;19733;1;610;-2.14748e+09;-2.6017e+06;-1;0;0;0;-1;0;424656459;432437367;30337369
1554;1.1555e-14;-410;1585;24192;19613;1;594;-2.14748e+09;-2.6017e+06;-1;0;0;0;-1;0;424656459;432437367;30337369
1555;1.16616e-14;-424;1671;24706;19733;1;610;-2.14748e+09;-2.59636e+06;-1;0;0;0;-1;0;424759804;432555374;30372698
1555;1.1555e-14;-411;1585;24192;19613;1;594;-2.14748e+09;-2.59636e+06;0;0;0;0;0;0;424759804;432555374;30372698
1556;1.16616e-14;-424;1671;24706;19733;1;610;-2.14748e+09;-2.59103e+06;-1;0;0;0;-1;0;424862932;432673158;30407983
1556;1.1555e-14;-412;1585;24192;19613;1;594;-2.14748e+09;-2.59103e+06;0;0;0;0;0;0;424862932;432673158;30407983
1557;1.16616e-14;-425;1671;24706;19733;1;610;-2.14748e+09;-2.58571e+06;0;0;0;0;0;0;424965845;432790721;30443223
1557;1.1555e-14;-412;1585;24192;19613;1;594;-2.14748e+09;-2.58571e+06;-1;0;0;0;-1;0;424965845;432790721;30443223
1558;1.16616e-14;-426;1671;24706;19733;1;610;-2.14748e+09;-2.58041e+06;0;0;0;0;0;0;425068542;432908062;30478420
1558;1.1555e-14;-412;1585;24192;19613;1;594;-2.14748e+09;-2.58041e+06;-1;0;0;0;-1;0;425068542;432908062;30478420
1559;1.16616e-14;-426;1671;24706;19733;1;610;-2.14748e+09;-2.57512e+06;-1;0;0;0;-1;0;425171024;433025182;30513572
1559;1.1555e-14;-412;1585;24192;19613;1;594;-2.14748e+09;-2.57512e+06;-1;0;0;0;-1;0;425171024;433025182;30513572
1560;1.16616e-14;-426;1671;24706;19733;1;610;-2.14748e+09;-2.56984e+06;-1;0;0;0;-1;0;425273291;433142082;30548680
1560;1.1555e-14;-413;1585;24192;19613;1;594;-2.14748e+09;-2.56984e+06;0;0;0;0;0;0;425273291;433142082;30548680
1561;1.16616e-14;-427;1671;24706;19733;1;610;-2.14748e+09;-2.56458e+06;0;0;0;0;0;0;425375345;433258762;30583744
1561;1.1555e-14;-414;1585;24192;19613;1;594;-2.14748e+09;-2.56458e+06;0;0;0;0;0;0;425375345;433258762;30583744
1562;1.16616e-14;-427;1671;24706;19733;1;610;-2.14748e+09;-2.55932e+06;-1;0;0;0;-1;0;425477185;433375222;30618763
1562;1.1555e-14;-414;1585;24192;19613;1;594;-2.14748e+09;-2.55932e+06;-1;0;0;0;-1;0;425477185;433375222;30618763
1563;1.16616e-14;-428;1671;24706;19733;1;610;-2.14748e+09;-2.55408e+06;0;0;0;0;0;0;425578813;433491464;30653739
1563;1.1555e-14;-415;1585;24192;19613;1;594;-2.14748e+09;-2.55408e+06;0;0;0;0;0;0;425578813;433491464;30653739
1564;1.16616e-14;-428;1671;24706;19733;1;610;-2.14748e+09;-2.54886e+06;-1;0;0;0;-1;0;425680228;433607487;30688670
1564;1.1555e-14;-416;1585;24192;19613;1;594;-2.14748e+09;-2.54886e+06;0;0;0;0;0;0;425680228;433607487;30688670
1565;1.16616e-14;-429;1671;24706;19733;1;610;-2.14748e+09;-2.54364e+06;0;0;0;0;0;0;425781431;433723292;30723557
1565;1.1555e-14;-417;1585;24192;19613;1;594;-2.14748e+09;-2.54364e+06;0;0;0;0;0;0;425781431;433723292;30723557
1566;1.16616e-14;-429;1671;24706;19733;1;610;-2.14748e+09;-2.53854e+06;-1;0;0;0;-1;0;425882423;433838879;30758400
1566;1.1555e-14;-418;1585;24192;19613;1;594;-2.14748e+09;-2.53854e+06;0;0;0;0;0;0;425882423;433838879;30758400
1567;1.16616e-14;-429;1671;24706;19733;1;610;-2.14748e+09;-2.53325e+06;-1;0;0;0;-1;0;425983204;433954249;30793199
1567;1.1555e-14;-418;1585;24192;19613;1;594;-2.14748e+09;-2.53325e+06;-1;0;0;0;-1;0;425983204;433954249;30793199
1568;1.16616e-14;-430;1671;24706;19733;1;610;-2.14748e+09;-2.52808e+06;0;0;0;0;0;0;426083774;434069402;30827953
1568;1.1555e-14;-418;1585;24192;19613;1;594;-2.14748e+09;-2.52808e+06;-1;0;0;0;-1;0;426083774;434069402;30827953
1569;1.16616e-14;-431;1671;24706;19733;1;610;-2.14748e+09;-2.52291e+06;0;0;0;0;0;0;426184134;434184339;30862664
1569;1.1555e-14;-419;1585;24192;19613;1;594;-2.14748e+09;-2.52291e+06;0;0;0;0;0;0;426184134;434184339;30862664
1570;1.16616e-14;-432;1671;24706;19733;1;610;-2.14748e+09;-2.51776e+06;0;0;0;0;0;0;426284286;434299060;30897330
1570;1.1555e-14;-420;1585;24192;19613;1;594;-2.14748e+09;-2.51776e+06;0;0;0;0;0;0;426284286;434299060;30897330
1571;1.16616e-14;-432;1671;24706;19733;1;610;-2.14748e+09;-2.51262e+06;-1;0;0;0;-1;0;426384228;434413566;30931952
1571;1.1555e-14;-420;1585;24192;19613;1;594;-2.14748e+09;-2.51262e+06;-1;0;0;0;-1;0;426384228;434413566;30931952
1572;1.16616e-14;-433;1671;24706;19733;1;610;-2.14748e+09;-2.5075e+06;0;0;0;0;0;0;426483962;434527857;30966530
1572;1.1555e-14;-420;1585;24192;19613;1;594;-2.14748e+09;-2.5075e+06;-1;0;0;0;-1;0;426483962;434527857;30966530
1573;1.16616e-14;-433;1671;24706;19733;1;610;-2.14748e+09;-2.50238e+06;-1;0;0;0;-1;0;426583488;434641934;31001064
1573;1.1555e-14;-421;1585;24192;19613;1;594;-2.14748e+09;-2.50238e+06;0;0;0;0;0;0;426583488;434641934;31001064
1574;1.16616e-14;-434;1671;24706;19733;1;610;-2.14748e+09;-2.49728e+06;0;0;0;0;0;0;426682806;434755796;31035554
1574;1.1555e-14;-422;1585;24192;19613;1;594;-2.14748e+09;-2.49728e+06;0;0;0;0;0;0;426682806;434755796;31035554
1575;1.16616e-14;-435;1671;24706;19733;1;610;-2.14748e+09;-2.49219e+06;0;0;0;0;0;0;426781918;434869445;31070000
1575;1.1555e-14;-423;1585;24192;19613;1;594;-2.14748e+09;-2.49219e+06;0;0;0;0;0;0;426781918;434869445;31070000
1576;1.16616e-14;-436;1671;24706;19733;1;610;-2.14748e+09;-2.48711e+06;0;0;0;0;0;0;426880823;434982881;31104401
1576;1.1555e-14;-423;1585;24192;19613;1;594;-2.14748e+09;-2.48711e+06;-1;0;0;0;-1;0;426880823;434982881;31104401
1577;1.16616e-14;-436;1671;24706;19733;1;610;-2.14748e+09;-2.48204e+06;-1;0;0;0;-1;0;426979522;435096104;31138759
1577;1.1555e-14;-424;1585;24192;19613;1;594;-2.14748e+09;-2.48204e+06;0;0;0;0;0;0;426979522;435096104;31138759
1578;1.16616e-14;-437;1671;24706;19733;1;610;-2.14748e+09;-2.47699e+06;0;0;0;0;0;0;427078016;435209115;31173072
1578;1.1555e-14;-425;1585;24192;19613;1;594;-2.14748e+09;-2.47699e+06;0;0;0;0;0;0;427078016;435209115;31173072
1579;1.16616e-14;-438;1671;24706;19733;1;610;-2.14748e+09;-2.47195e+06;0;0;0;0;0;0;427176305;435321915;31207342
1579;1.1555e-14;-425;1585;24192;19613;1;594;-2.14748e+09;-2.47195e+06;-1;0;0;0;-1;0;427176305;435321915;31207342
1580;1.16616e-14;-438;1671;24706;19733;1;610;-2.14748e+09;-2.46692e+06;-1;0;0;0;-1;0;427274389;435434503;31241567
1580;1.1555e-14;-425;1585;24192;19613;1;594;-2.14748e+09;-2.46692e+06;-1;0;0;0;-1;0;427274389;435434503;31241567
1581;1.16616e-14;-438;1671;24706;19733;1;610;-2.14748e+09;-2.4619e+06;-1;0;0;0;-1;0;427372269;435546880;31275748
1581;1.1555e-14;-426;1585;24192;19613;1;594;-2.14748e+09;-2.4619e+06;0;0;0;0;0;0;427372269;435546880;31275748
1582;1.16616e-14;-439;1671;24706;19733;1;610;-2.14748e+09;-2.45689e+06;0;0;0;0;0;0;427469946;435659046;31309886
1582;1.1555e-14;-427;1585;24192;19613;1;594;-2.14748e+09;-2.45689e+06;0;0;0;0;0;0;427469946;435659046;31309886
1583;1.16616e-14;-440;1671;24706;19733;1;610;-2.14748e+09;-2.4519e+06;0;0;0;0;0;0;427567419;435771003;31343979
1583;1.1555e-14;-428;1585;24192;19613;1;594;-2.14748e+09;-2.4519e+06;0;0;0;0;0;0;427567419;435771003;31343979
1584;1.16616e-14;-441;1671;24706;19733;1;610;-2.14748e+09;-2.44692e+06;0;0;0;0;0;0;427664690;435882750;31378029
1584;1.1555e-14;-429;1585;24192;19613;1;594;-2.14748e+09;-2.44692e+06;0;0;0;0;0;0;427664690;435882750;31378029
1585;1.16616e-14;-441;1671;24706;19733;1;610;-2.14748e+09;-2.44194e+06;-1;0;0;0;-1;0;427761759;435994288;31412034
1585;1.1555e-14;-429;1585;24192;19613;1;594;-2.14748e+09;-2.44194e+06;-1;0;0;0;-1;0;427761759;435994288;31412034
1586;1.16616e-14;-441;1671;24706;19733;1;610;-2.14748e+09;-2.43699e+06;-1;0;0;0;-1;0;427858627;436105618;31445995
1586;1.1555e-14;-429;1585;24192;19613;1;594;-2.14748e+09;-2.43699e+06;-1;0;0;0;-1;0;427858627;436105618;31445995
1587;1.16616e-14;-441;1671;24706;19733;1;610;-2.14748e+09;-2.43204e+06;-1;0;0;0;-1;0;427955293;436216739;31479913
1587;1.1555e-14;-429;1585;24192;19613;1;594;-2.14748e+09;-2.43204e+06;-1;0;0;0;-1;0;427955293;436216739;31479913
1588;1.16616e-14;-441;1671;24706;19733;1;610;-2.14748e+09;-2.4272e+06;-1;0;0;0;-1;0;428051759;436327652;31513786
1588;1.1555e-14;-429;1585;24192;19613;1;594;-2.14748e+09;-2.4272e+06;-1;0;0;0;-1;0;428051759;436327652;31513786
1589;1.16616e-14;-441;1671;24706;19733;1;610;-2.14748e+09;-2.42218e+06;-1;0;0;0;-1;0;428148024;436438358;31547616
1589;1.1555e-14;-429;1585;24192;19613;1;594;-2.14748e+09;-2.42218e+06;-1;0;0;0;-1;0;428148024;436438358;31547616
1590;1.16616e-14;-441;1671;24706;19733;1;610;-2.14748e+09;-2.41727e+06;-1;0;0;0;-1;0;428244090;436548857;31581402
1590;1.1555e-14;-430;1585;24192;19613;1;594;-2.14748e+09;-2.41727e+06;0;0;0;0;0;0;428244090;436548857;31581402
1591;1.16616e-14;-441;1671;24706;19733;1;610;-2.14748e+09;-2.41237e+06;-1;0;0;0;-1;0;428339956;436659149;31615143
1591;1.1555e-14;-430;1585;24192;19613;1;594;-2.14748e+09;-2.41237e+06;-1;0;0;0;-1;0;428339956;436659149;31615143
1592;1.16616e-14;-442;1671;24706;19733;1;610;-2.14748e+09;-2.40748e+06;0;0;0;0;0;0;428435623;436769235;31648841
1592;1.1555e-14;-430;1585;24192;19613;1;594;-2.14748e+09;-2.40748e+06;-1;0;0;0;-1;0;428435623;436769235;31648841
1593;1.16616e-14;-443;1671;24706;19733;1;610;-2.14748e+09;-2.4026e+06;0;0;0;0;0;0;428531093;436879116;31682495
1593;1.1555e-14;-431;1585;24192;19613;1;594;-2.14748e+09;-2.4026e+06;0;0;0;0;0;0;428531093;436879116;31682495
1594;1.16616e-14;-444;1671;24706;19733;1;610;-2.14748e+09;-2.39784e+06;0;0;0;0;0;0;428626364;436988791;31716105
1594;1.1555e-14;-431;1585;24192;19613;1;594;-2.14748e+09;-2.39784e+06;-1;0;0;0;-1;0;428626364;436988791;31716105
1595;1.16616e-14;-444;1671;24706;19733;1;610;-2.14748e+09;-2.39288e+06;-1;0;0;0;-1;0;428721438;437098262;31749672
1595;1.1555e-14;-432;1585;24192;19613;1;594;-2.14748e+09;-2.39288e+06;0;0;0;0;0;0;428721438;437098262;31749672
1596;1.16616e-14;-444;1671;24706;19733;1;610;-2.14748e+09;-2.38804e+06;-1;0;0;0;-1;0;428816315;437207528;31783194
1596;1.1555e-14;-433;1585;24192;19613;1;594;-2.14748e+09;-2.38804e+06;0;0;0;0;0;0;428816315;437207528;31783194
1597;1.16616e-14;-444;1671;24706;19733;1;610;-2.14748e+09;-2.38331e+06;-1;0;0;0;-1;0;428910996;437316590;31816673
1597;1.1555e-14;-434;1585;24192;19613;1;594;-2.14748e+09;-2.38331e+06;0;0;0;0;0;0;428910996;437316590;31816673
1598;1.16616e-14;-444;1671;24706;19733;1;610;-2.14748e+09;-2.37838e+06;-1;0;0;0;-1;0;429005480;437425449;31850108
1598;1.1555e-14;-435;1585;24192;19613;1;594;-2.14748e+09;-2.37838e+06;0;0;0;0;0;0;429005480;437425449;31850108
1599;1.16616e-14;-445;1671;24706;19733;1;610;-2.14748e+09;-2.37368e+06;0;0;0;0;0;0;429099769;437534105;31883499
1599;1.1555e-14;-435;1585;24192;19613;1;594;-2.14748e+09;-2.37368e+06;-1;0;0;0;-1;0;429099769;437534105;31883499
1600;1.16616e-14;-446;1671;24706;19733;1;610;-2.14748e+09;-2.36878e+06;0;0;0;0;0;0;429193863;437642557;31916846
1600;1.1555e-14;-435;1585;24192;19613;1;594;-2.14748e+09;-2.36878e+06;-1;0;0;0;-1;0;429193863;437642557;31916846
1601;1.16616e-14;-447;1671;24706;19733;1;610;-2.14748e+09;-2.36399e+06;0;0;0;0;0;0;429287762;437750808;31950150
1601;1.1555e-14;-436;1585;24192;19613;1;594;-2.14748e+09;-2.36399e+06;0;0;0;0;0;0;429287762;437750808;31950150
1602;1.16616e-14;-447;1671;24706;19733;1;610;-2.14748e+09;-2.35922e+06;-1;0;0;0;-1;0;429381467;437858857;31983409
1602;1.1555e-14;-437;1585;24192;19613;1;594;-2.14748e+09;-2.35922e+06;0;0;0;0;0;0;429381467;437858857;31983409
1603;1.16616e-14;-447;1671;24706;19733;1;610;-2.14748e+09;-2.35445e+06;-1;0;0;0;-1;0;429474978;437966704;32016626
1603;1.1555e-14;-438;1585;24192;19613;1;594;-2.14748e+09;-2.35445e+06;0;0;0;0;0;0;429474978;437966704;32016626
1604;1.16616e-14;-448;1671;24706;19733;1;610;-2.14748e+09;-2.3497e+06;0;0;0;0;0;0;429568296;438074350;32049798
1604;1.1555e-14;-438;1585;24192;19613;1;594;-2.14748e+09;-2.3497e+06;-1;0;0;0;-1;0;429568296;438074350;32049798
1605;1.16616e-14;-448;1671;24706;19733;1;610;-2.14748e+09;-2.34496e+06;-1;0;0;0;-1;0;429661421;438181796;32082927
1605;1.1555e-14;-439;1585;24192;19613;1;594;-2.14748e+09;-2.34496e+06;0;0;0;0;0;0;429661421;438181796;32082927
1606;1.16616e-14;-448;1671;24706;19733;1;610;-2.14748e+09;-2.34023e+06;-1;0;0;0;-1;0;429754354;438289041;32116012
1606;1.1555e-14;-439;1585;24192;19613;1;594;-2.14748e+09;-2.34023e+06;-1;0;0;0;-1;0;429754354;438289041;32116012
1607;1.16616e-14;-449;1671;24706;19733;1;610;-2.14748e+09;-2.33551e+06;0;0;0;0;0;0;429847095;438396087;32149053
1607;1.1555e-14;-440;1585;24192;19613;1;594;-2.14748e+09;-2.33551e+06;0;0;0;0;0;0;429847095;438396087;32149053
1608;1.16616e-14;-450;1671;24706;19733;1;610;-2.14748e+09;-2.3308e+06;0;0;0;0;0;0;429939644;438502933;32182051
1608;1.1555e-14;-440;1585;24192;19613;1;594;-2.14748e+09;-2.3308e+06;-1;0;0;0;-1;0;429939644;438502933;32182051
1609;1.16616e-14;-451;1671;24706;19733;1;610;-2.14748e+09;-2.3261e+06;0;0;0;0;0;0;430032002;438609580;32215005
1609;1.1555e-14;-440;1585;24192;19613;1;594;-2.14748e+09;-2.3261e+06;-1;0;0;0;-1;0;430032002;438609580;32215005
1610;1.16616e-14;-452;1671;24706;19733;1;610;-2.14748e+09;-2.32141e+06;0;0;0;0;0;0;430124170;438716028;32247916
1610;1.1555e-14;-440;1585;24192;19613;1;594;-2.14748e+09;-2.32141e+06;-1;0;0;0;-1;0;430124170;438716028;32247916
1611;1.16616e-14;-453;1671;24706;19733;1;610;-2.14748e+09;-2.31674e+06;0;0;0;0;0;0;430216148;438822279;32280783
1611;1.1555e-14;-440;1585;24192;19613;1;594;-2.14748e+09;-2.31674e+06;-1;0;0;0;-1;0;430216148;438822279;32280783
1612;1.16616e-14;-453;1671;24706;19733;1;610;-2.14748e+09;-2.31207e+06;-1;0;0;0;-1;0;430307935;438928331;32313606
1612;1.1555e-14;-440;1585;24192;19613;1;594;-2.14748e+09;-2.31207e+06;-1;0;0;0;-1;0;430307935;438928331;32313606
1613;1.16616e-14;-453;1671;24706;19733;1;610;-2.14748e+09;-2.30742e+06;-1;0;0;0;-1;0;430399534;439034187;32346386
1613;1.1555e-14;-441;1585;24192;19613;1;594;-2.14748e+09;-2.30742e+06;0;0;0;0;0;0;430399534;439034187;32346386
1614;1.16616e-14;-453;1671;24706;19733;1;610;-2.14748e+09;-2.30277e+06;-1;0;0;0;-1;0;430490943;439139845;32379122
1614;1.1555e-14;-442;1585;24192;19613;1;594;-2.14748e+09;-2.30277e+06;0;0;0;0;0;0;430490943;439139845;32379122
1615;1.16616e-14;-454;1671;24706;19733;1;610;-2.14748e+09;-2.29814e+06;0;0;0;0;0;0;430582165;439245307;32411815
1615;1.1555e-14;-442;1585;24192;19613;1;594;-2.14748e+09;-2.29814e+06;-1;0;0;0;-1;0;430582165;439245307;32411815
1616;1.16616e-14;-455;1671;24706;19733;1;610;-2.14748e+09;-2.29362e+06;0;0;0;0;0;0;430673198;439350573;32444464
1616;1.1555e-14;-442;1585;24192;19613;1;594;-2.14748e+09;-2.29362e+06;-1;0;0;0;-1;0;430673198;439350573;32444464
1617;1.16616e-14;-455;1671;24706;19733;1;610;-2.14748e+09;-2.28891e+06;-1;0;0;0;-1;0;430764044;439455643;32477070
1617;1.1555e-14;-443;1585;24192;19613;1;594;-2.14748e+09;-2.28891e+06;0;0;0;0;0;0;430764044;439455643;32477070
1618;1.16616e-14;-456;1671;24706;19733;1;610;-2.14748e+09;-2.28431e+06;0;0;0;0;0;0;430854702;439560517;32509633
1618;1.1555e-14;-444;1585;24192;19613;1;594;-2.14748e+09;-2.28431e+06;0;0;0;0;0;0;430854702;439560517;32509633
1619;1.16616e-14;-456;1671;24706;19733;1;610;-2.14748e+09;-2.27972e+06;-1;0;0;0;-1;0;430945174;439665197;32542152
1619;1.1555e-14;-445;1585;24192;19613;1;594;-2.14748e+09;-2.27972e+06;0;0;0;0;0;0;430945174;439665197;32542152
1620;1.16616e-14;-456;1671;24706;19733;1;610;-2.14748e+09;-2.27514e+06;-1;0;0;0;-1;0;431035460;439769682;32574627
1620;1.1555e-14;-445;1585;24192;19613;1;594;-2.14748e+09;-2.27514e+06;-1;0;0;0;-1;0;431035460;439769682;32574627
1621;1.16616e-14;-456;1671;24706;19733;1;610;-2.14748e+09;-2.27057e+06;-1;0;0;0;-1;0;431125560;439873973;32607059
1621;1.1555e-14;-446;1585;24192;19613;1;594;-2.14748e+09;-2.27057e+06;0;0;0;0;0;0;431125560;439873973;32607059
1622;1.16616e-14;-456;1671;24706;19733;1;610;-2.14748e+09;-2.26601e+06;-1;0;0;0;-1;0;431215475;439978071;32639448
1622;1.1555e-14;-446;1585;24192;19613;1;594;-2.14748e+09;-2.26601e+06;-1;0;0;0;-1;0;431215475;439978071;32639448
1623;1.16616e-14;-457;1671;24706;19733;1;610;-2.14748e+09;-2.26146e+06;0;0;0;0;0;0;431305204;440081974;32671794
1623;1.1555e-14;-447;1585;24192;19613;1;594;-2.14748e+09;-2.26146e+06;0;0;0;0;0;0;431305204;440081974;32671794
1624;1.16616e-14;-458;1671;24706;19733;1;610;-2.14748e+09;-2.25692e+06;0;0;0;0;0;0;431394749;440185685;32704096
1624;1.1555e-14;-447;1585;24192;19613;1;594;-2.14748e+09;-2.25692e+06;-1;0;0;0;-1;0;431394749;440185685;32704096
1625;1.16616e-14;-458;1671;24706;19733;1;610;-2.14748e+09;-2.2524e+06;-1;0;0;0;-1;0;431484110;440289204;32736355
1625;1.1555e-14;-448;1585;24192;19613;1;594;-2.14748e+09;-2.2524e+06;0;0;0;0;0;0;431484110;440289204;32736355
1626;1.16616e-14;-459;1671;24706;19733;1;610;-2.14748e+09;-2.24788e+06;0;0;0;0;0;0;431573288;440392530;32768570
1626;1.1555e-14;-448;1585;24192;19613;1;594;-2.14748e+09;-2.24788e+06;-1;0;0;0;-1;0;431573288;440392530;32768570
1627;1.16616e-14;-460;1671;24706;19733;1;610;-2.14748e+09;-2.24347e+06;0;0;0;0;0;0;431662282;440495664;32800743
1627;1.1555e-14;-449;1585;24192;19613;1;594;-2.14748e+09;-2.24347e+06;0;0;0;0;0;0;431662282;440495664;32800743
1628;1.16616e-14;-460;1671;24706;19733;1;610;-2.14748e+09;-2.23888e+06;-1;0;0;0;-1;0;431751093;440598607;32832872
1628;1.1555e-14;-450;1585;24192;19613;1;594;-2.14748e+09;-2.23888e+06;0;0;0;0;0;0;431751093;440598607;32832872
1629;1.16616e-14;-460;1671;24706;19733;1;610;-2.14748e+09;-2.23439e+06;-1;0;0;0;-1;0;431839722;440701359;32864958
1629;1.1555e-14;-451;1585;24192;19613;1;594;-2.14748e+09;-2.23439e+06;0;0;0;0;0;0;431839722;440701359;32864958
1630;1.16616e-14;-461;1671;24706;19733;1;610;-2.14748e+09;-2.22992e+06;0;0;0;0;0;0;431928169;440803920;32897000
1630;1.1555e-14;-452;1585;24192;19613;1;594;-2.14748e+09;-2.22992e+06;0;0;0;0;0;0;431928169;440803920;32897000
1631;1.16616e-14;-462;1671;24706;19733;1;610;-2.14748e+09;-2.22545e+06;0;0;0;0;0;0;432016434;440906292;32929000
1631;1.1555e-14;-453;1585;24192;19613;1;594;-2.14748e+09;-2.22545e+06;0;0;0;0;0;0;432016434;440906292;32929000
1632;1.16616e-14;-462;1671;24706;19733;1;610;-2.14748e+09;-2.2211e+06;-1;0;0;0;-1;0;432104518;441008473;32960956
1632;1.1555e-14;-454;1585;24192;19613;1;594;-2.14748e+09;-2.2211e+06;0;0;0;0;0;0;432104518;441008473;32960956
1633;1.16616e-14;-462;1671;24706;19733;1;610;-2.14748e+09;-2.21655e+06;-1;0;0;0;-1;0;432192422;441110465;32992869
1633;1.1555e-14;-454;1585;24192;19613;1;594;-2.14748e+09;-2.21655e+06;-1;0;0;0;-1;0;432192422;441110465;32992869
1634;1.16616e-14;-463;1671;24706;19733;1;610;-2.14748e+09;-2.21212e+06;0;0;0;0;0;0;432280145;441212268;33024740
1634;1.1555e-14;-455;1585;24192;19613;1;594;-2.14748e+09;-2.21212e+06;0;0;0;0;0;0;432280145;441212268;33024740
1635;1.16616e-14;-464;1671;24706;19733;1;610;-2.14748e+09;-2.2077e+06;0;0;0;0;0;0;432367688;441313882;33056567
1635;1.1555e-14;-456;1585;24192;19613;1;594;-2.14748e+09;-2.2077e+06;0;0;0;0;0;0;432367688;441313882;33056567
1636;1.16616e-14;-464;1671;24706;19733;1;610;-2.14748e+09;-2.20328e+06;-1;0;0;0;-1;0;432455052;441415307;33088351
1636;1.1555e-14;-457;1585;24192;19613;1;594;-2.14748e+09;-2.20328e+06;0;0;0;0;0;0;432455052;441415307;33088351
1637;1.16616e-14;-464;1671;24706;19733;1;610;-2.14748e+09;-2.19898e+06;-1;0;0;0;-1;0;432542236;441516545;33120091
1637;1.1555e-14;-457;1585;24192;19613;1;594;-2.14748e+09;-2.19888e+06;-1;0;0;0;-1;0;432542236;441516545;33120091
1638;1.16616e-14;-464;1671;24706;19733;1;610;-2.14748e+09;-2.19448e+06;-1;0;0;0;-1;0;432629242;441617595;33151789
1638;1.1555e-14;-457;1585;24192;19613;1;594;-2.14748e+09;-2.19448e+06;-1;0;0;0;-1;0;432629242;441617595;33151789
1639;1.16616e-14;-465;1671;24706;19733;1;610;-2.14748e+09;-2.1901e+06;0;0;0;0;0;0;432716070;441718458;33183444
1639;1.1555e-14;-457;1585;24192;19613;1;594;-2.14748e+09;-2.1901e+06;-1;0;0;0;-1;0;432716070;441718458;33183444
1640;1.16616e-14;-466;1671;24706;19733;1;610;-2.14748e+09;-2.18572e+06;0;0;0;0;0;0;432802720;441819135;33215056
1640;1.1555e-14;-457;1585;24192;19613;1;594;-2.14748e+09;-2.18572e+06;-1;0;0;0;-1;0;432802720;441819135;33215056
1641;1.16616e-14;-467;1671;24706;19733;1;610;-2.14748e+09;-2.18136e+06;0;0;0;0;0;0;432889192;441919625;33246625
1641;1.1555e-14;-457;1585;24192;19613;1;594;-2.14748e+09;-2.18136e+06;-1;0;0;0;-1;0;432889192;441919625;33246625
1642;1.16616e-14;-468;1671;24706;19733;1;610;-2.14748e+09;-2.17701e+06;0;0;0;0;0;0;432975488;442019928;33278151
1642;1.1555e-14;-457;1585;24192;19613;1;594;-2.14748e+09;-2.17701e+06;-1;0;0;0;-1;0;432975488;442019928;33278151
1643;1.16616e-14;-469;1671;24706;19733;1;610;-2.14748e+09;-2.17266e+06;0;0;0;0;0;0;433061607;442120047;33309634
1643;1.1555e-14;-458;1585;24192;19613;1;594;-2.14748e+09;-2.17266e+06;0;0;0;0;0;0;433061607;442120047;33309634
1644;1.16616e-14;-469;1671;24706;19733;1;610;-2.14748e+09;-2.16833e+06;-1;0;0;0;-1;0;433147549;442219979;33341075
1644;1.1555e-14;-458;1585;24192;19613;1;594;-2.14748e+09;-2.16833e+06;-1;0;0;0;-1;0;433147549;442219979;33341075
1645;1.16616e-14;-469;1671;24706;19733;1;610;-2.14748e+09;-2.164e+06;-1;0;0;0;-1;0;433233316;442319727;33372472
1645;1.1555e-14;-458;1585;24192;19613;1;594;-2.14748e+09;-2.164e+06;-1;0;0;0;-1;0;433233316;442319727;33372472
1646;1.16616e-14;-470;1671;24706;19733;1;610;-2.14748e+09;-2.15969e+06;0;0;0;0;0;0;433318907;442419291;33403827
1646;1.1555e-14;-458;1585;24192;19613;1;594;-2.14748e+09;-2.15969e+06;-1;0;0;0;-1;0;433318907;442419291;33403827
1647;1.16616e-14;-471;1671;24706;19733;1;610;-2.14748e+09;-2.15538e+06;0;0;0;0;0;0;433404324;442518670;33435139
1647;1.1555e-14;-458;1585;24192;19613;1;594;-2.14748e+09;-2.15538e+06;-1;0;0;0;-1;0;433404324;442518670;33435139
1648;1.16616e-14;-472;1671;24706;19733;1;610;-2.14748e+09;-2.15109e+06;0;0;0;0;0;0;433489565;442617865;33466408
1648;1.1555e-14;-458;1585;24192;19613;1;594;-2.14748e+09;-2.15109e+06;-1;0;0;0;-1;0;433489565;442617865;33466408
1649;1.16616e-14;-472;1671;24706;19733;1;610;-2.14748e+09;-2.1468e+06;-1;0;0;0;-1;0;433574633;442716877;33497634
1649;1.1555e-14;-458;1585;24192;19613;1;594;-2.14748e+09;-2.1468e+06;-1;0;0;0;-1;0;433574633;442716877;33497634
1650;1.16616e-14;-472;1671;24706;19733;1;610;-2.14748e+09;-2.14253e+06;-1;0;0;0;-1;0;433659527;442815706;33528818
1650;1.1555e-14;-458;1585;24192;19613;1;594;-2.14748e+09;-2.14253e+06;-1;0;0;0;-1;0;433659527;442815706;33528818
1651;1.16616e-14;-473;1671;24706;19733;1;610;-2.14748e+09;-2.13826e+06;0;0;0;0;0;0;433744247;442914352;33559959
1651;1.1555e-14;-459;1585;24192;19613;1;594;-2.14748e+09;-2.13826e+06;0;0;0;0;0;0;433744247;442914352;33559959
1652;1.16616e-14;-473;1671;24706;19733;1;610;-2.14748e+09;-2.13401e+06;-1;0;0;0;-1;0;433828794;443012816;33591057
1652;1.1555e-14;-460;1585;24192;19613;1;594;-2.14748e+09;-2.13401e+06;0;0;0;0;0;0;433828794;443012816;33591057
1653;1.16616e-14;-474;1671;24706;19733;1;610;-2.14748e+09;-2.12976e+06;0;0;0;0;0;0;433913168;443111098;33622112
1653;1.1555e-14;-461;1585;24192;19613;1;594;-2.14748e+09;-2.12976e+06;0;0;0;0;0;0;433913168;443111098;33622112
1654;1.16616e-14;-474;1671;24706;19733;1;610;-2.14748e+09;-2.12552e+06;-1;0;0;0;-1;0;433997371;443209198;33653125
1654;1.1555e-14;-462;1585;24192;19613;1;594;-2.14748e+09;-2.12552e+06;0;0;0;0;0;0;433997371;443209198;33653125
1655;1.16616e-14;-474;1671;24706;19733;1;610;-2.14748e+09;-2.1213e+06;-1;0;0;0;-1;0;434081401;443307117;33684096
1655;1.1555e-14;-463;1585;24192;19613;1;594;-2.14748e+09;-2.1213e+06;0;0;0;0;0;0;434081401;443307117;33684096
1656;1.16616e-14;-474;1671;24706;19733;1;610;-2.14748e+09;-2.11708e+06;-1;0;0;0;-1;0;434165260;443404855;33715023
1656;1.1555e-14;-463;1585;24192;19613;1;594;-2.14748e+09;-2.11708e+06;-1;0;0;0;-1;0;434165260;443404855;33715023
1657;1.16616e-14;-474;1671;24706;19733;1;610;-2.14748e+09;-2.11287e+06;-1;0;0;0;-1;0;434248948;443502413;33745909
1657;1.1555e-14;-464;1585;24192;19613;1;594;-2.14748e+09;-2.11287e+06;0;0;0;0;0;0;434248948;443502413;33745909
1658;1.16616e-14;-474;1671;24706;19733;1;610;-2.14748e+09;-2.10867e+06;-1;0;0;0;-1;0;434332466;443599791;33776751
1658;1.1555e-14;-465;1585;24192;19613;1;594;-2.14748e+09;-2.10867e+06;0;0;0;0;0;0;434332466;443599791;33776751
1659;1.16616e-14;-474;1671;24706;19733;1;610;-2.14748e+09;-2.10448e+06;-1;0;0;0;-1;0;434415813;443696988;33807552
1659;1.1555e-14;-465;1585;24192;19613;1;594;-2.14748e+09;-2.10448e+06;-1;0;0;0;-1;0;434415813;443696988;33807552
1660;1.16616e-14;-475;1671;24706;19733;1;610;-2.14748e+09;-2.1003e+06;0;0;0;0;0;0;434498990;443794007;33838309
1660;1.1555e-14;-465;1585;24192;19613;1;594;-2.14748e+09;-2.1003e+06;-1;0;0;0;-1;0;434498990;443794007;33838309
1661;1.16616e-14;-476;1671;24706;19733;1;610;-2.14748e+09;-2.09623e+06;0;0;0;0;0;0;434581997;443890846;33869025
1661;1.1555e-14;-465;1585;24192;19613;1;594;-2.14748e+09;-2.09623e+06;-1;0;0;0;-1;0;434581997;443890846;33869025
1662;1.16616e-14;-477;1671;24706;19733;1;610;-2.14748e+09;-2.09197e+06;0;0;0;0;0;0;434664835;443987506;33899698
1662;1.1555e-14;-465;1585;24192;19613;1;594;-2.14748e+09;-2.09197e+06;-1;0;0;0;-1;0;434664835;443987506;33899698
1663;1.16616e-14;-477;1671;24706;19733;1;610;-2.14748e+09;-2.08782e+06;-1;0;0;0;-1;0;434747505;444083988;33930328
1663;1.1555e-14;-465;1585;24192;19613;1;594;-2.14748e+09;-2.08782e+06;-1;0;0;0;-1;0;434747505;444083988;33930328
1664;1.16616e-14;-477;1671;24706;19733;1;610;-2.14748e+09;-2.08367e+06;-1;0;0;0;-1;0;434830006;444180292;33960916
1664;1.1555e-14;-465;1585;24192;19613;1;594;-2.14748e+09;-2.08367e+06;-1;0;0;0;-1;0;434830006;444180292;33960916
1665;1.16616e-14;-477;1671;24706;19733;1;610;-2.14748e+09;-2.07954e+06;-1;0;0;0;-1;0;434912340;444276419;33991462
1665;1.1555e-14;-465;1585;24192;19613;1;594;-2.14748e+09;-2.07954e+06;-1;0;0;0;-1;0;434912340;444276419;33991462
1666;1.16616e-14;-478;1671;24706;19733;1;610;-2.14748e+09;-2.07542e+06;0;0;0;0;0;0;434994505;444372368;34021966
1666;1.1555e-14;-466;1585;24192;19613;1;594;-2.14748e+09;-2.07542e+06;0;0;0;0;0;0;434994505;444372368;34021966
1667;1.16616e-14;-478;1671;24706;19733;1;610;-2.14748e+09;-2.0713e+06;-1;0;0;0;-1;0;435076504;444468140;34052427
1667;1.1555e-14;-466;1585;24192;19613;1;594;-2.14748e+09;-2.0713e+06;-1;0;0;0;-1;0;435076504;444468140;34052427
1668;1.16616e-14;-479;1671;24706;19733;1;610;-2.14748e+09;-2.06719e+06;0;0;0;0;0;0;435158335;444563736;34082846
1668;1.1555e-14;-466;1585;24192;19613;1;594;-2.14748e+09;-2.0672e+06;-1;0;0;0;-1;0;435158335;444563736;34082846
1669;1.16616e-14;-480;1671;24706;19733;1;610;-2.14748e+09;-2.0631e+06;0;0;0;0;0;0;435240000;444659155;34113223
1669;1.1555e-14;-467;1585;24192;19613;1;594;-2.14748e+09;-2.0631e+06;0;0;0;0;0;0;435240000;444659155;34113223
1670;1.16616e-14;-480;1671;24706;19733;1;610;-2.14748e+09;-2.05901e+06;-1;0;0;0;-1;0;435321499;444754399;34143558
1670;1.1555e-14;-468;1585;24192;19613;1;594;-2.14748e+09;-2.05901e+06;0;0;0;0;0;0;435321499;444754399;34143558
1671;1.16616e-14;-481;1671;24706;19733;1;610;-2.14748e+09;-2.05493e+06;0;0;0;0;0;0;435402833;444849467;34173850
1671;1.1555e-14;-468;1585;24192;19613;1;594;-2.14748e+09;-2.05493e+06;-1;0;0;0;-1;0;435402833;444849467;34173850
1672;1.16616e-14;-482;1671;24706;19733;1;610;-2.14748e+09;-2.05087e+06;0;0;0;0;0;0;435484001;444944359;34204101
1672;1.1555e-14;-469;1585;24192;19613;1;594;-2.14748e+09;-2.05086e+06;0;0;0;0;0;0;435484001;444944359;34204101
1673;1.16616e-14;-482;1671;24706;19733;1;610;-2.14748e+09;-2.0468e+06;-1;0;0;0;-1;0;435565004;445039077;34234309
1673;1.1555e-14;-470;1585;24192;19613;1;594;-2.14748e+09;-2.0468e+06;0;0;0;0;0;0;435565004;445039077;34234309
1674;1.16616e-14;-482;1671;24706;19733;1;610;-2.14748e+09;-2.04275e+06;-1;0;0;0;-1;0;435645842;445133621;34264475
1674;1.1555e-14;-471;1585;24192;19613;1;594;-2.14748e+09;-2.04275e+06;0;0;0;0;0;0;435645842;445133621;34264475
1675;1.16616e-14;-483;1671;24706;19733;1;610;-2.14748e+09;-2.03881e+06;0;0;0;0;0;0;435726516;445227990;34294599
1675;1.1555e-14;-471;1585;24192;19613;1;594;-2.14748e+09;-2.03881e+06;-1;0;0;0;-1;0;435726516;445227990;34294599
1676;1.16616e-14;-483;1671;24706;19733;1;610;-2.14748e+09;-2.03468e+06;-1;0;0;0;-1;0;435807027;445322185;34324681
1676;1.1555e-14;-472;1585;24192;19613;1;594;-2.14748e+09;-2.03468e+06;0;0;0;0;0;0;435807027;445322185;34324681
1677;1.16616e-14;-483;1671;24706;19733;1;610;-2.14748e+09;-2.03075e+06;-1;0;0;0;-1;0;435887373;445416207;34354721
1677;1.1555e-14;-472;1585;24192;19613;1;594;-2.14748e+09;-2.03076e+06;-1;0;0;0;-1;0;435887373;445416207;34354721
1678;1.16616e-14;-483;1671;24706;19733;1;610;-2.14748e+09;-2.02664e+06;-1;0;0;0;-1;0;435967557;445510056;34384720
1678;1.1555e-14;-472;1585;24192;19613;1;594;-2.14748e+09;-2.02664e+06;-1;0;0;0;-1;0;435967557;445510056;34384720
1679;1.16616e-14;-483;1671;24706;19733;1;610;-2.14748e+09;-2.02263e+06;-1;0;0;0;-1;0;436047578;445603732;34414676
1679;1.1555e-14;-473;1585;24192;19613;1;594;-2.14748e+09;-2.02263e+06;0;0;0;0;0;0;436047578;445603732;34414676
1680;1.16616e-14;-484;1671;24706;19733;1;610;-2.14748e+09;-2.01864e+06;0;0;0;0;0;0;436127436;445697236;34444590
1680;1.1555e-14;-474;1585;24192;19613;1;594;-2.14748e+09;-2.01864e+06;0;0;0;0;0;0;436127436;445697236;34444590
1681;1.16616e-14;-484;1671;24706;19733;1;610;-2.14748e+09;-2.01465e+06;-1;0;0;0;-1;0;436207133;445790568;34474463
1681;1.1555e-14;-474;1585;24192;19613;1;594;-2.14748e+09;-2.01465e+06;-1;0;0;0;-1;0;436207133;445790568;34474463
1682;1.16616e-14;-485;1671;24706;19733;1;610;-2.14748e+09;-2.01067e+06;0;0;0;0;0;0;436286668;445883728;34504293
1682;1.1555e-14;-474;1585;24192;19613;1;594;-2.14748e+09;-2.01067e+06;-1;0;0;0;-1;0;436286668;445883728;34504293
1683;1.16616e-14;-485;1671;24706;19733;1;610;-2.14748e+09;-2.0067e+06;-1;0;0;0;-1;0;436366041;445976716;34534082
1683;1.1555e-14;-474;1585;24192;19613;1;594;-2.14748e+09;-2.0067e+06;-1;0;0;0;-1;0;436366041;445976716;34534082
1684;1.16616e-14;-485;1671;24706;19733;1;610;-2.14748e+09;-2.00274e+06;-1;0;0;0;-1;0;436445254;446069533;34563829
1684;1.1555e-14;-474;1585;24192;19613;1;594;-2.14748e+09;-2.00274e+06;-1;0;0;0;-1;0;436445254;446069533;34563829
1685;1.16616e-14;-485;1671;24706;19733;1;610;-2.14748e+09;-1.99878e+06;-1;0;0;0;-1;0;436524306;446162180;34593535
1685;1.1555e-14;-475;1585;24192;19613;1;594;-2.14748e+09;-1.99878e+06;0;0;0;0;0;0;436524306;446162180;34593535
1686;1.16616e-14;-485;1671;24706;19733;1;610;-2.14748e+09;-1.99484e+06;-1;0;0;0;-1;0;436603198;446254656;34623198
1686;1.1555e-14;-475;1585;24192;19613;1;594;-2.14748e+09;-1.99484e+06;-1;0;0;0;-1;0;436603198;446254656;34623198
1687;1.16616e-14;-486;1671;24706;19733;1;610;-2.14748e+09;-1.9909e+06;0;0;0;0;0;0;436681930;446346962;34652820
1687;1.1555e-14;-475;1585;24192;19613;1;594;-2.14748e+09;-1.9909e+06;-1;0;0;0;-1;0;436681930;446346962;34652820
1688;1.16616e-14;-486;1671;24706;19733;1;610;-2.14748e+09;-1.98698e+06;-1;0;0;0;-1;0;436760502;446439099;34682400
1688;1.1555e-14;-476;1585;24192;19613;1;594;-2.14748e+09;-1.98698e+06;0;0;0;0;0;0;436760502;446439099;34682400
1689;1.16616e-14;-486;1671;24706;19733;1;610;-2.14748e+09;-1.98306e+06;-1;0;0;0;-1;0;436838916;446531066;34711939
1689;1.1555e-14;-476;1585;24192;19613;1;594;-2.14748e+09;-1.98306e+06;-1;0;0;0;-1;0;436838916;446531066;34711939
1690;1.16616e-14;-487;1671;24706;19733;1;610;-2.14748e+09;-1.97915e+06;0;0;0;0;0;0;436917170;446622864;34741436
1690;1.1555e-14;-476;1585;24192;19613;1;594;-2.14748e+09;-1.97915e+06;-1;0;0;0;-1;0;436917170;446622864;34741436
1691;1.16616e-14;-487;1671;24706;19733;1;610;-2.14748e+09;-1.97525e+06;-1;0;0;0;-1;0;436995267;446714493;34770892
1691;1.1555e-14;-476;1585;24192;19613;1;594;-2.14748e+09;-1.97525e+06;-1;0;0;0;-1;0;436995267;446714493;34770892
1692;1.16616e-14;-487;1671;24706;19733;1;610;-2.14748e+09;-1.97136e+06;-1;0;0;0;-1;0;437073205;446805954;34800305
1692;1.1555e-14;-477;1585;24192;19613;1;594;-2.14748e+09;-1.97136e+06;0;0;0;0;0;0;437073205;446805954;34800305
1693;1.16616e-14;-487;1671;24706;19733;1;610;-2.14748e+09;-1.96747e+06;-1;0;0;0;-1;0;437150985;446897247;34829678
1693;1.1555e-14;-478;1585;24192;19613;1;594;-2.14748e+09;-1.96747e+06;0;0;0;0;0;0;437150985;446897247;34829678
1694;1.16616e-14;-487;1671;24706;19733;1;610;-2.14748e+09;-1.9636e+06;-1;0;0;0;-1;0;437228608;446988372;34859009
1694;1.1555e-14;-479;1585;24192;19613;1;594;-2.14748e+09;-1.9636e+06;0;0;0;0;0;0;437228608;446988372;34859009
1695;1.16616e-14;-488;1671;24706;19733;1;610;-2.14748e+09;-1.95983e+06;0;0;0;0;0;0;437306074;447079330;34888298
1695;1.1555e-14;-479;1585;24192;19613;1;594;-2.14748e+09;-1.95983e+06;-1;0;0;0;-1;0;437306074;447079330;34888298
1696;1.16616e-14;-488;1671;24706;19733;1;610;-2.14748e+09;-1.95598e+06;-1;0;0;0;-1;0;437383383;447170120;34917547
1696;1.1555e-14;-480;1585;24192;19613;1;594;-2.14748e+09;-1.95598e+06;0;0;0;0;0;0;437383383;447170120;34917547
1697;1.16616e-14;-489;1671;24706;19733;1;610;-2.14748e+09;-1.95203e+06;0;0;0;0;0;0;437460536;447260744;34946753
1697;1.1555e-14;-481;1585;24192;19613;1;594;-2.14748e+09;-1.95203e+06;0;0;0;0;0;0;437460536;447260744;34946753
1698;1.16616e-14;-489;1671;24706;19733;1;610;-2.14748e+09;-1.94818e+06;-1;0;0;0;-1;0;437537534;447351202;34975919
1698;1.1555e-14;-482;1585;24192;19613;1;594;-2.14748e+09;-1.94819e+06;0;0;0;0;0;0;437537534;447351202;34975919
1699;1.16616e-14;-490;1671;24706;19733;1;610;-2.14748e+09;-1.94445e+06;0;0;0;0;0;0;437614375;447441493;35005043
1699;1.1555e-14;-483;1585;24192;19613;1;594;-2.14748e+09;-1.94445e+06;0;0;0;0;0;0;437614375;447441493;35005043
1700;1.16616e-14;-490;1671;24706;19733;1;610;-2.14748e+09;-1.94053e+06;-1;0;0;0;-1;0;437691061;447531619;35034126
1700;1.1555e-14;-483;1585;24192;19613;1;594;-2.14748e+09;-1.94053e+06;-1;0;0;0;-1;0;437691061;447531619;35034126
1701;1.16616e-14;-491;1671;24706;19733;1;610;-2.14748e+09;-1.93671e+06;0;0;0;0;0;0;437767593;447621579;35063167
1701;1.1555e-14;-484;1585;24192;19613;1;594;-2.14748e+09;-1.93671e+06;0;0;0;0;0;0;437767593;447621579;35063167
1702;1.16616e-14;-491;1671;24706;19733;1;610;-2.14748e+09;-1.9329e+06;-1;0;0;0;-1;0;437843969;447711374;35092167
1702;1.1555e-14;-485;1585;24192;19613;1;594;-2.14748e+09;-1.9329e+06;0;0;0;0;0;0;437843969;447711374;35092167
1703;1.16616e-14;-491;1671;24706;19733;1;610;-2.14748e+09;-1.92911e+06;-1;0;0;0;-1;0;437920192;447801005;35121127
1703;1.1555e-14;-485;1585;24192;19613;1;594;-2.14748e+09;-1.92911e+06;-1;0;0;0;-1;0;437920192;447801005;35121127
1704;1.16616e-14;-491;1671;24706;19733;1;610;-2.14748e+09;-1.92532e+06;-1;0;0;0;-1;0;437996261;447890470;35150045
1704;1.1555e-14;-485;1585;24192;19613;1;594;-2.14748e+09;-1.92532e+06;-1;0;0;0;-1;0;437996261;447890470;35150045
1705;1.16616e-14;-492;1671;24706;19733;1;610;-2.14748e+09;-1.92153e+06;0;0;0;0;0;0;438072176;447979772;35178921
1705;1.1555e-14;-485;1585;24192;19613;1;594;-2.14748e+09;-1.92153e+06;-1;0;0;0;-1;0;438072176;447979772;35178921
1706;1.16616e-14;-492;1671;24706;19733;1;610;-2.14748e+09;-1.91776e+06;-1;0;0;0;-1;0;438147938;448068910;35207757
1706;1.1555e-14;-486;1585;24192;19613;1;594;-2.14748e+09;-1.91776e+06;0;0;0;0;0;0;438147938;448068910;35207757
1707;1.16616e-14;-492;1671;24706;19733;1;610;-2.14748e+09;-1.91409e+06;-1;0;0;0;-1;0;438223547;448157884;35236552
1707;1.1555e-14;-487;1585;24192;19613;1;594;-2.14748e+09;-1.91409e+06;0;0;0;0;0;0;438223547;448157884;35236552
1708;1.16616e-14;-492;1671;24706;19733;1;610;-2.14748e+09;-1.91024e+06;-1;0;0;0;-1;0;438299003;448246696;35265306
1708;1.1555e-14;-487;1585;24192;19613;1;594;-2.14748e+09;-1.91024e+06;-1;0;0;0;-1;0;438299003;448246696;35265306
1709;1.16616e-14;-493;1671;24706;19733;1;610;-2.14748e+09;-1.90649e+06;0;0;0;0;0;0;438374308;448335344;35294018
1709;1.1555e-14;-488;1585;24192;19613;1;594;-2.14748e+09;-1.90649e+06;0;0;0;0;0;0;438374308;448335344;35294018
1710;1.16616e-14;-494;1671;24706;19733;1;610;-2.14748e+09;-1.90274e+06;0;0;0;0;0;0;438449460;448423830;35322690
1710;1.1555e-14;-488;1585;24192;19613;1;594;-2.14748e+09;-1.90274e+06;-1;0;0;0;-1;0;438449460;448423830;35322690
1711;1.16616e-14;-494;1671;24706;19733;1;610;-2.14748e+09;-1.89901e+06;-1;0;0;0;-1;0;438524461;448512153;35351321
1711;1.1555e-14;-489;1585;24192;19613;1;594;-2.14748e+09;-1.89901e+06;0;0;0;0;0;0;438524461;448512153;35351321
1712;1.16616e-14;-494;1671;24706;19733;1;610;-2.14748e+09;-1.89529e+06;-1;0;0;0;-1;0;438599311;448600315;35379911
1712;1.1555e-14;-489;1585;24192;19613;1;594;-2.14748e+09;-1.89529e+06;-1;0;0;0;-1;0;438599311;448600315;35379911
1713;1.16616e-14;-495;1671;24706;19733;1;610;-2.14748e+09;-1.89157e+06;0;0;0;0;0;0;438674010;448688315;35408460
1713;1.1555e-14;-489;1585;24192;19613;1;594;-2.14748e+09;-1.89157e+06;-1;0;0;0;-1;0;438674010;448688315;35408460
1714;1.16616e-14;-495;1671;24706;19733;1;610;-2.14748e+09;-1.88786e+06;-1;0;0;0;-1;0;438748559;448776154;35436968
1714;1.1555e-14;-489;1585;24192;19613;1;594;-2.14748e+09;-1.88786e+06;-1;0;0;0;-1;0;438748559;448776154;35436968
1715;1.16616e-14;-496;1671;24706;19733;1;610;-2.14748e+09;-1.88416e+06;0;0;0;0;0;0;438822957;448863832;35465436
1715;1.1555e-14;-490;1585;24192;19613;1;594;-2.14748e+09;-1.88416e+06;0;0;0;0;0;0;438822957;448863832;35465436
1716;1.16616e-14;-497;1671;24706;19733;1;610;-2.14748e+09;-1.88047e+06;0;0;0;0;0;0;438897206;448951349;35493863
1716;1.1555e-14;-490;1585;24192;19613;1;594;-2.14748e+09;-1.88047e+06;-1;0;0;0;-1;0;438897206;448951349;35493863
1717;1.16616e-14;-497;1671;24706;19733;1;610;-2.14748e+09;-1.87678e+06;-1;0;0;0;-1;0;438971305;449038706;35522249
1717;1.1555e-14;-490;1585;24192;19613;1;594;-2.14748e+09;-1.87678e+06;-1;0;0;0;-1;0;438971305;449038706;35522249
1718;1.16616e-14;-498;1671;24706;19733;1;610;-2.14748e+09;-1.87311e+06;0;0;0;0;0;0;439045255;449125903;35550594
1718;1.1555e-14;-491;1585;24192;19613;1;594;-2.14748e+09;-1.87311e+06;0;0;0;0;0;0;439045255;449125903;35550594
1719;1.16616e-14;-499;1671;24706;19733;1;610;-2.14748e+09;-1.86944e+06;0;0;0;0;0;0;439119056;449212940;35578899
1719;1.1555e-14;-491;1585;24192;19613;1;594;-2.14748e+09;-1.86944e+06;-1;0;0;0;-1;0;439119056;449212940;35578899
1720;1.16616e-14;-500;1671;24706;19733;1;610;-2.14748e+09;-1.86578e+06;0;0;0;0;0;0;439192709;449299818;35607163
1720;1.1555e-14;-492;1585;24192;19613;1;594;-2.14748e+09;-1.86578e+06;0;0;0;0;0;0;439192709;449299818;35607163
1721;1.16616e-14;-500;1671;24706;19733;1;610;-2.14748e+09;-1.86213e+06;-1;0;0;0;-1;0;439266213;449386536;35635386
1721;1.1555e-14;-493;1585;24192;19613;1;594;-2.14748e+09;-1.86213e+06;0;0;0;0;0;0;439266213;449386536;35635386
1722;1.16616e-14;-501;1671;24706;19733;1;610;-2.14748e+09;-1.85848e+06;0;0;0;0;0;0;439339570;449473096;35663569
1722;1.1555e-14;-494;1585;24192;19613;1;594;-2.14748e+09;-1.85848e+06;0;0;0;0;0;0;439339570;449473096;35663569
1723;1.16616e-14;-501;1671;24706;19733;1;610;-2.14748e+09;-1.85495e+06;-1;0;0;0;-1;0;439412779;449559498;35691711
1723;1.1555e-14;-494;1585;24192;19613;1;594;-2.14748e+09;-1.85495e+06;-1;0;0;0;-1;0;439412779;449559498;35691711
1724;1.16616e-14;-502;1671;24706;19733;1;610;-2.14748e+09;-1.85122e+06;0;0;0;0;0;0;439485841;449645741;35719813
1724;1.1555e-14;-495;1585;24192;19613;1;594;-2.14748e+09;-1.85122e+06;0;0;0;0;0;0;439485841;449645741;35719813
1725;1.16616e-14;-503;1671;24706;19733;1;610;-2.14748e+09;-1.8476e+06;0;0;0;0;0;0;439558756;449731826;35747875
1725;1.1555e-14;-495;1585;24192;19613;1;594;-2.14748e+09;-1.8476e+06;-1;0;0;0;-1;0;439558756;449731826;35747875
1726;1.16616e-14;-504;1671;24706;19733;1;610;-2.14748e+09;-1.84399e+06;0;0;0;0;0;0;439631524;449817754;35775896
1726;1.1555e-14;-496;1585;24192;19613;1;594;-2.14748e+09;-1.84398e+06;0;0;0;0;0;0;439631524;449817754;35775896
1727;1.16616e-14;-504;1671;24706;19733;1;610;-2.14748e+09;-1.84038e+06;-1;0;0;0;-1;0;439704146;449903525;35803876
1727;1.1555e-14;-496;1585;24192;19613;1;594;-2.14748e+09;-1.84038e+06;-1;0;0;0;-1;0;439704146;449903525;35803876
1728;1.16616e-14;-504;1671;24706;19733;1;610;-2.14748e+09;-1.83678e+06;-1;0;0;0;-1;0;439776623;449989138;35831817
1728;1.1555e-14;-496;1585;24192;19613;1;594;-2.14748e+09;-1.83678e+06;-1;0;0;0;-1;0;439776623;449989138;35831817
1729;1.16616e-14;-504;1671;24706;19733;1;610;-2.14748e+09;-1.83319e+06;-1;0;0;0;-1;0;439848954;450074595;35859717
1729;1.1555e-14;-497;1585;24192;19613;1;594;-2.14748e+09;-1.83319e+06;0;0;0;0;0;0;439848954;450074595;35859717
1730;1.16616e-14;-505;1671;24706;19733;1;610;-2.14748e+09;-1.82971e+06;0;0;0;0;0;0;439921139;450159896;35887576
1730;1.1555e-14;-498;1585;24192;19613;1;594;-2.14748e+09;-1.82971e+06;0;0;0;0;0;0;439921139;450159896;35887576
1731;1.16616e-14;-505;1671;24706;19733;1;610;-2.14748e+09;-1.82604e+06;-1;0;0;0;-1;0;439993180;450245041;35915396
1731;1.1555e-14;-499;1585;24192;19613;1;594;-2.14748e+09;-1.82604e+06;0;0;0;0;0;0;439993180;450245041;35915396
1732;1.16616e-14;-506;1671;24706;19733;1;610;-2.14748e+09;-1.82247e+06;0;0;0;0;0;0;440065076;450330030;35943175
1732;1.1555e-14;-499;1585;24192;19613;1;594;-2.14748e+09;-1.82247e+06;-1;0;0;0;-1;0;440065076;450330030;35943175
1733;1.16616e-14;-506;1671;24706;19733;1;610;-2.14748e+09;-1.81891e+06;-1;0;0;0;-1;0;440136828;450414863;35970914
1733;1.1555e-14;-499;1585;24192;19613;1;594;-2.14748e+09;-1.81891e+06;-1;0;0;0;-1;0;440136828;450414863;35970914
1734;1.16616e-14;-507;1671;24706;19733;1;610;-2.14748e+09;-1.81536e+06;0;0;0;0;0;0;440208435;450499542;35998613
1734;1.1555e-14;-500;1585;24192;19613;1;594;-2.14748e+09;-1.81536e+06;0;0;0;0;0;0;440208435;450499542;35998613
1735;1.16616e-14;-508;1671;24706;19733;1;610;-2.14748e+09;-1.81182e+06;0;0;0;0;0;0;440279899;450584065;36026272
1735;1.1555e-14;-501;1585;24192;19613;1;594;-2.14748e+09;-1.81182e+06;0;0;0;0;0;0;440279899;450584065;36026272
1736;1.16616e-14;-508;1671;24706;19733;1;610;-2.14748e+09;-1.80828e+06;-1;0;0;0;-1;0;440351220;450668434;36053891
1736;1.1555e-14;-502;1585;24192;19613;1;594;-2.14748e+09;-1.80828e+06;0;0;0;0;0;0;440351220;450668434;36053891
1737;1.16616e-14;-509;1671;24706;19733;1;610;-2.14748e+09;-1.80475e+06;0;0;0;0;0;0;440422398;450752649;36081469
1737;1.1555e-14;-503;1585;24192;19613;1;594;-2.14748e+09;-1.80476e+06;0;0;0;0;0;0;440422398;450752649;36081469
1738;1.16616e-14;-510;1671;24706;19733;1;610;-2.14748e+09;-1.80123e+06;0;0;0;0;0;0;440493433;450836710;36109008
1738;1.1555e-14;-504;1585;24192;19613;1;594;-2.14748e+09;-1.80123e+06;0;0;0;0;0;0;440493433;450836710;36109008
1739;1.16616e-14;-510;1671;24706;19733;1;610;-2.14748e+09;-1.79772e+06;-1;0;0;0;-1;0;440564326;450920617;36136507
1739;1.1555e-14;-504;1585;24192;19613;1;594;-2.14748e+09;-1.79772e+06;-1;0;0;0;-1;0;440564326;450920617;36136507
1740;1.16616e-14;-510;1671;24706;19733;1;610;-2.14748e+09;-1.79422e+06;-1;0;0;0;-1;0;440635076;451004371;36163966
1740;1.1555e-14;-504;1585;24192;19613;1;594;-2.14748e+09;-1.79422e+06;-1;0;0;0;-1;0;440635076;451004371;36163966
1741;1.16616e-14;-511;1671;24706;19733;1;610;-2.14748e+09;-1.79072e+06;0;0;0;0;0;0;440705685;451087972;36191385
1741;1.1555e-14;-504;1585;24192;19613;1;594;-2.14748e+09;-1.79072e+06;-1;0;0;0;-1;0;440705685;451087972;36191385
1742;1.16616e-14;-511;1671;24706;19733;1;610;-2.14748e+09;-1.78723e+06;-1;0;0;0;-1;0;440776152;451171421;36218764
1742;1.1555e-14;-504;1585;24192;19613;1;594;-2.14748e+09;-1.78723e+06;-1;0;0;0;-1;0;440776152;451171421;36218764
1743;1.16616e-14;-511;1671;24706;19733;1;610;-2.14748e+09;-1.78375e+06;-1;0;0;0;-1;0;440846479;451254716;36246103
1743;1.1555e-14;-505;1585;24192;19613;1;594;-2.14748e+09;-1.78375e+06;0;0;0;0;0;0;440846479;451254716;36246103
1744;1.16616e-14;-511;1671;24706;19733;1;610;-2.14748e+09;-1.78037e+06;-1;0;0;0;-1;0;440916664;451337860;36273402
1744;1.1555e-14;-505;1585;24192;19613;1;594;-2.14748e+09;-1.78037e+06;-1;0;0;0;-1;0;440916664;451337860;36273402
1745;1.16616e-14;-511;1671;24706;19733;1;610;-2.14748e+09;-1.7768e+06;-1;0;0;0;-1;0;440986709;451420852;36300662
1745;1.1555e-14;-506;1585;24192;19613;1;594;-2.14748e+09;-1.7768e+06;0;0;0;0;0;0;440986709;451420852;36300662
1746;1.16616e-14;-511;1671;24706;19733;1;610;-2.14748e+09;-1.77334e+06;-1;0;0;0;-1;0;441056613;451503692;36327882
1746;1.1555e-14;-506;1585;24192;19613;1;594;-2.14748e+09;-1.77334e+06;-1;0;0;0;-1;0;441056613;451503692;36327882
1747;1.16616e-14;-511;1671;24706;19733;1;610;-2.14748e+09;-1.76989e+06;-1;0;0;0;-1;0;441126378;451586381;36355063
1747;1.1555e-14;-507;1585;24192;19613;1;594;-2.14748e+09;-1.76989e+06;0;0;0;0;0;0;441126378;451586381;36355063
1748;1.16616e-14;-512;1671;24706;19733;1;610;-2.14748e+09;-1.76644e+06;0;0;0;0;0;0;441196003;451668919;36382203
1748;1.1555e-14;-508;1585;24192;19613;1;594;-2.14748e+09;-1.76644e+06;0;0;0;0;0;0;441196003;451668919;36382203
1749;1.16616e-14;-513;1671;24706;19733;1;610;-2.14748e+09;-1.76301e+06;0;0;0;0;0;0;441265489;451751306;36409304
1749;1.1555e-14;-509;1585;24192;19613;1;594;-2.14748e+09;-1.76301e+06;0;0;0;0;0;0;441265489;451751306;36409304
1750;1.16616e-14;-513;1671;24706;19733;1;610;-2.14748e+09;-1.75958e+06;-1;0;0;0;-1;0;441334836;451833543;36436366
1750;1.1555e-14;-510;1585;24192;19613;1;594;-2.14748e+09;-1.75958e+06;0;0;0;0;0;0;441334836;451833543;36436366
1751;1.16616e-14;-513;1671;24706;19733;1;610;-2.14748e+09;-1.75615e+06;-1;0;0;0;-1;0;441404044;451915629;36463388
1751;1.1555e-14;-511;1585;24192;19613;1;594;-2.14748e+09;-1.75615e+06;0;0;0;0;0;0;441404044;451915629;36463388
1752;1.16616e-14;-513;1671;24706;19733;1;610;-2.14748e+09;-1.75274e+06;-1;0;0;0;-1;0;441473114;451997566;36490371
1752;1.1555e-14;-511;1585;24192;19613;1;594;-2.14748e+09;-1.75274e+06;-1;0;0;0;-1;0;441473114;451997566;36490371
1753;1.16616e-14;-513;1671;24706;19733;1;610;-2.14748e+09;-1.74933e+06;-1;0;0;0;-1;0;441542045;452079354;36517314
1753;1.1555e-14;-511;1585;24192;19613;1;594;-2.14748e+09;-1.74933e+06;-1;0;0;0;-1;0;441542045;452079354;36517314
1754;1.16616e-14;-514;1671;24706;19733;1;610;-2.14748e+09;-1.74593e+06;0;0;0;0;0;0;441610839;452160992;36544217
1754;1.1555e-14;-511;1585;24192;19613;1;594;-2.14748e+09;-1.74593e+06;-1;0;0;0;-1;0;441610839;452160992;36544217
1755;1.16616e-14;-514;1671;24706;19733;1;610;-2.14748e+09;-1.74253e+06;-1;0;0;0;-1;0;441679496;452242481;36571082
1755;1.1555e-14;-511;1585;24192;19613;1;594;-2.14748e+09;-1.74253e+06;-1;0;0;0;-1;0;441679496;452242481;36571082
1756;1.16616e-14;-515;1671;24706;19733;1;610;-2.14748e+09;-1.73915e+06;0;0;0;0;0;0;441748015;452323821;36597907
1756;1.1555e-14;-512;1585;24192;19613;1;594;-2.14748e+09;-1.73914e+06;0;0;0;0;0;0;441748015;452323821;36597907
1757;1.16616e-14;-515;1671;24706;19733;1;610;-2.14748e+09;-1.73576e+06;-1;0;0;0;-1;0;441816397;452405014;36624692
1757;1.1555e-14;-512;1585;24192;19613;1;594;-2.14748e+09;-1.73577e+06;-1;0;0;0;-1;0;441816397;452405014;36624692
1758;1.16616e-14;-515;1671;24706;19733;1;610;-2.14748e+09;-1.73239e+06;-1;0;0;0;-1;0;441884643;452486058;36651439
1758;1.1555e-14;-513;1585;24192;19613;1;594;-2.14748e+09;-1.73239e+06;0;0;0;0;0;0;441884643;452486058;36651439
1759;1.16616e-14;-516;1671;24706;19733;1;610;-2.14748e+09;-1.72903e+06;0;0;0;0;0;0;441952752;452566954;36678146
1759;1.1555e-14;-513;1585;24192;19613;1;594;-2.14748e+09;-1.72903e+06;-1;0;0;0;-1;0;441952752;452566954;36678146
1760;1.16616e-14;-516;1671;24706;19733;1;610;-2.14748e+09;-1.72567e+06;-1;0;0;0;-1;0;442020726;452647702;36704814
1760;1.1555e-14;-513;1585;24192;19613;1;594;-2.14748e+09;-1.72567e+06;-1;0;0;0;-1;0;442020726;452647702;36704814
1761;1.16616e-14;-517;1671;24706;19733;1;610;-2.14748e+09;-1.72232e+06;0;0;0;0;0;0;442088564;452728304;36731442
1761;1.1555e-14;-514;1585;24192;19613;1;594;-2.14748e+09;-1.72232e+06;0;0;0;0;0;0;442088564;452728304;36731442
1762;1.16616e-14;-517;1671;24706;19733;1;610;-2.14748e+09;-1.71898e+06;-1;0;0;0;-1;0;442156266;452808758;36758032
1762;1.1555e-14;-514;1585;24192;19613;1;594;-2.14748e+09;-1.71898e+06;-1;0;0;0;-1;0;442156266;452808758;36758032
1763;1.16616e-14;-517;1671;24706;19733;1;610;-2.14748e+09;-1.71564e+06;-1;0;0;0;-1;0;442223833;452889066;36784583
1763;1.1555e-14;-515;1585;24192;19613;1;594;-2.14748e+09;-1.71564e+06;0;0;0;0;0;0;442223833;452889066;36784583
1764;1.16616e-14;-517;1671;24706;19733;1;610;-2.14748e+09;-1.71231e+06;-1;0;0;0;-1;0;442291266;452969227;36811094
1764;1.1555e-14;-516;1585;24192;19613;1;594;-2.14748e+09;-1.71231e+06;0;0;0;0;0;0;442291266;452969227;36811094
1765;1.16616e-14;-518;1671;24706;19733;1;610;-2.14748e+09;-1.70909e+06;0;0;0;0;0;0;442358564;453049243;36837567
1765;1.1555e-14;-517;1585;24192;19613;1;594;-2.14748e+09;-1.70909e+06;0;0;0;0;0;0;442358564;453049243;36837567
1766;1.16616e-14;-519;1671;24706;19733;1;610;-2.14748e+09;-1.70567e+06;0;0;0;0;0;0;442425728;453129112;36864000
1766;1.1555e-14;-518;1585;24192;19613;1;594;-2.14748e+09;-1.70567e+06;0;0;0;0;0;0;442425728;453129112;36864000
1767;1.16616e-14;-520;1671;24706;19733;1;610;-2.14748e+09;-1.70246e+06;0;0;0;0;0;0;442492758;453208836;36890395
1767;1.1555e-14;-519;1585;24192;19613;1;594;-2.14748e+09;-1.70246e+06;0;0;0;0;0;0;442492758;453208836;36890395
1768;1.16616e-14;-521;1671;24706;19733;1;610;-2.14748e+09;-1.69906e+06;0;0;0;0;0;0;442559654;453288414;36916750
1768;1.1555e-14;-520;1585;24192;19613;1;594;-2.14748e+09;-1.69906e+06;0;0;0;0;0;0;442559654;453288414;36916750
1769;1.16616e-14;-522;1671;24706;19733;1;610;-2.14748e+09;-1.69587e+06;0;0;0;0;0;0;442626417;453367848;36943067
1769;1.1555e-14;-521;1585;24192;19613;1;594;-2.14748e+09;-1.69577e+06;0;0;0;0;0;0;442626417;453367848;36943067
1770;1.16616e-14;-523;1671;24706;19733;1;610;-2.14748e+09;-1.69248e+06;0;0;0;0;0;0;442693046;453447137;36969345
1770;1.1555e-14;-521;1585;24192;19613;1;594;-2.14748e+09;-1.69248e+06;-1;0;0;0;-1;0;442693046;453447137;36969345
1771;1.16616e-14;-523;1671;24706;19733;1;610;-2.14748e+09;-1.6892e+06;-1;0;0;0;-1;0;442759543;453526281;36995584
1771;1.1555e-14;-522;1585;24192;19613;1;594;-2.14748e+09;-1.6892e+06;0;0;0;0;0;0;442759543;453526281;36995584
1772;1.16616e-14;-524;1671;24706;19733;1;610;-2.14748e+09;-1.68592e+06;0;0;0;0;0;0;442825908;453605281;37021785
1772;1.1555e-14;-522;1585;24192;19613;1;594;-2.14748e+09;-1.68592e+06;-1;0;0;0;-1;0;442825908;453605281;37021785
1773;1.16616e-14;-525;1671;24706;19733;1;610;-2.14748e+09;-1.68266e+06;0;0;0;0;0;0;442892140;453684138;37047947
1773;1.1555e-14;-523;1585;24192;19613;1;594;-2.14748e+09;-1.68266e+06;0;0;0;0;0;0;442892140;453684138;37047947
1774;1.16616e-14;-526;1671;24706;19733;1;610;-2.14748e+09;-1.6795e+06;0;0;0;0;0;0;442958241;453762850;37074070
1774;1.1555e-14;-524;1585;24192;19613;1;594;-2.14748e+09;-1.6795e+06;0;0;0;0;0;0;442958241;453762850;37074070
1775;1.16616e-14;-527;1671;24706;19733;1;610;-2.14748e+09;-1.67625e+06;0;0;0;0;0;0;443024210;453841420;37100154
1775;1.1555e-14;-524;1585;24192;19613;1;594;-2.14748e+09;-1.67625e+06;-1;0;0;0;-1;0;443024210;453841420;37100154
1776;1.16616e-14;-528;1671;24706;19733;1;610;-2.14748e+09;-1.6729e+06;0;0;0;0;0;0;443090047;453919846;37126200
1776;1.1555e-14;-524;1585;24192;19613;1;594;-2.14748e+09;-1.6729e+06;-1;0;0;0;-1;0;443090047;453919846;37126200
1777;1.16616e-14;-529;1671;24706;19733;1;610;-2.14748e+09;-1.66976e+06;0;0;0;0;0;0;443155754;453998129;37152207
1777;1.1555e-14;-524;1585;24192;19613;1;594;-2.14748e+09;-1.66976e+06;-1;0;0;0;-1;0;443155754;453998129;37152207
1778;1.16616e-14;-530;1671;24706;19733;1;610;-2.14748e+09;-1.66643e+06;0;0;0;0;0;0;443221330;454076270;37178176
1778;1.1555e-14;-525;1585;24192;19613;1;594;-2.14748e+09;-1.66643e+06;0;0;0;0;0;0;443221330;454076270;37178176
1779;1.16616e-14;-530;1671;24706;19733;1;610;-2.14748e+09;-1.6633e+06;-1;0;0;0;-1;0;443286775;454154269;37204106
1779;1.1555e-14;-525;1585;24192;19613;1;594;-2.14748e+09;-1.6633e+06;-1;0;0;0;-1;0;443286775;454154269;37204106
1780;1.16616e-14;-530;1671;24706;19733;1;610;-2.14748e+09;-1.66009e+06;-1;0;0;0;-1;0;443352090;454232125;37229998
1780;1.1555e-14;-525;1585;24192;19613;1;594;-2.14748e+09;-1.66009e+06;-1;0;0;0;-1;0;443352090;454232125;37229998
1781;1.16616e-14;-530;1671;24706;19733;1;610;-2.14748e+09;-1.65677e+06;-1;0;0;0;-1;0;443417275;454309840;37255851
1781;1.1555e-14;-525;1585;24192;19613;1;594;-2.14748e+09;-1.65677e+06;-1;0;0;0;-1;0;443417275;454309840;37255851
1782;1.16616e-14;-531;1671;24706;19733;1;610;-2.14748e+09;-1.65357e+06;0;0;0;0;0;0;443482331;454387414;37281666
1782;1.1555e-14;-526;1585;24192;19613;1;594;-2.14748e+09;-1.65357e+06;0;0;0;0;0;0;443482331;454387414;37281666
1783;1.16616e-14;-531;1671;24706;19733;1;610;-2.14748e+09;-1.65037e+06;-1;0;0;0;-1;0;443547257;454464846;37307443
1783;1.1555e-14;-526;1585;24192;19613;1;594;-2.14748e+09;-1.65037e+06;-1;0;0;0;-1;0;443547257;454464846;37307443
1784;1.16616e-14;-531;1671;24706;19733;1;610;-2.14748e+09;-1.64718e+06;-1;0;0;0;-1;0;443612054;454542137;37333182
1784;1.1555e-14;-527;1585;24192;19613;1;594;-2.14748e+09;-1.64718e+06;0;0;0;0;0;0;443612054;454542137;37333182
1785;1.16616e-14;-531;1671;24706;19733;1;610;-2.14748e+09;-1.644e+06;-1;0;0;0;-1;0;443676723;454619288;37358882
1785;1.1555e-14;-527;1585;24192;19613;1;594;-2.14748e+09;-1.644e+06;-1;0;0;0;-1;0;443676723;454619288;37358882
1786;1.16616e-14;-532;1671;24706;19733;1;610;-2.14748e+09;-1.64082e+06;0;0;0;0;0;0;443741263;454696298;37384544
1786;1.1555e-14;-527;1585;24192;19613;1;594;-2.14748e+09;-1.64082e+06;-1;0;0;0;-1;0;443741263;454696298;37384544
1787;1.16616e-14;-533;1671;24706;19733;1;610;-2.14748e+09;-1.63765e+06;0;0;0;0;0;0;443805674;454773168;37410167
1787;1.1555e-14;-527;1585;24192;19613;1;594;-2.14748e+09;-1.63765e+06;-1;0;0;0;-1;0;443805674;454773168;37410167
1788;1.16616e-14;-534;1671;24706;19733;1;610;-2.14748e+09;-1.63448e+06;0;0;0;0;0;0;443869958;454849899;37435753
1788;1.1555e-14;-528;1585;24192;19613;1;594;-2.14748e+09;-1.63448e+06;0;0;0;0;0;0;443869958;454849899;37435753
1789;1.16616e-14;-535;1671;24706;19733;1;610;-2.14748e+09;-1.63132e+06;0;0;0;0;0;0;443934114;454926490;37461301
1789;1.1555e-14;-528;1585;24192;19613;1;594;-2.14748e+09;-1.63132e+06;-1;0;0;0;-1;0;443934114;454926490;37461301
1790;1.16616e-14;-536;1671;24706;19733;1;610;-2.14748e+09;-1.62817e+06;0;0;0;0;0;0;443998142;455002941;37486810
1790;1.1555e-14;-528;1585;24192;19613;1;594;-2.14748e+09;-1.62817e+06;-1;0;0;0;-1;0;443998142;455002941;37486810
1791;1.16616e-14;-536;1671;24706;19733;1;610;-2.14748e+09;-1.62503e+06;-1;0;0;0;-1;0;444062044;455079253;37512282
1791;1.1555e-14;-528;1585;24192;19613;1;594;-2.14748e+09;-1.62503e+06;-1;0;0;0;-1;0;444062044;455079253;37512282
1792;1.16616e-14;-537;1671;24706;19733;1;610;-2.14748e+09;-1.62189e+06;0;0;0;0;0;0;444125819;455155427;37537715
1792;1.1555e-14;-529;1585;24192;19613;1;594;-2.14748e+09;-1.62189e+06;0;0;0;0;0;0;444125819;455155427;37537715
1793;1.16616e-14;-537;1671;24706;19733;1;610;-2.14748e+09;-1.61876e+06;-1;0;0;0;-1;0;444189467;455231462;37563111
1793;1.1555e-14;-530;1585;24192;19613;1;594;-2.14748e+09;-1.61876e+06;0;0;0;0;0;0;444189467;455231462;37563111
1794;1.16616e-14;-538;1671;24706;19733;1;610;-2.14748e+09;-1.61563e+06;0;0;0;0;0;0;444252988;455307359;37588468
1794;1.1555e-14;-531;1585;24192;19613;1;594;-2.14748e+09;-1.61563e+06;0;0;0;0;0;0;444252988;455307359;37588468
1795;1.16616e-14;-538;1671;24706;19733;1;610;-2.14748e+09;-1.61252e+06;-1;0;0;0;-1;0;444316384;455383118;37613788
1795;1.1555e-14;-531;1585;24192;19613;1;594;-2.14748e+09;-1.61252e+06;-1;0;0;0;-1;0;444316384;455383118;37613788
1796;1.16616e-14;-539;1671;24706;19733;1;610;-2.14748e+09;-1.6094e+06;0;0;0;0;0;0;444379654;455458739;37639070
1796;1.1555e-14;-532;1585;24192;19613;1;594;-2.14748e+09;-1.6094e+06;0;0;0;0;0;0;444379654;455458739;37639070
1797;1.16616e-14;-540;1671;24706;19733;1;610;-2.14748e+09;-1.6063e+06;0;0;0;0;0;0;444442799;455534223;37664314
1797;1.1555e-14;-532;1585;24192;19613;1;594;-2.14748e+09;-1.6063e+06;-1;0;0;0;-1;0;444442799;455534223;37664314
1798;1.16616e-14;-541;1671;24706;19733;1;610;-2.14748e+09;-1.6032e+06;0;0;0;0;0;0;444505818;455609569;37689520
1798;1.1555e-14;-532;1585;24192;19613;1;594;-2.14748e+09;-1.6032e+06;-1;0;0;0;-1;0;444505818;455609569;37689520
1799;1.16616e-14;-542;1671;24706;19733;1;610;-2.14748e+09;-1.60011e+06;0;0;0;0;0;0;444568712;455684779;37714689
1799;1.1555e-14;-532;1585;24192;19613;1;594;-2.14748e+09;-1.60011e+06;-1;0;0;0;-1;0;444568712;455684779;37714689
1800;1.16616e-14;-542;1671;24706;19733;1;610;-2.14748e+09;-1.59702e+06;-1;0;0;0;-1;0;444631482;455759852;37739820
1800;1.1555e-14;-532;1585;24192;19613;1;594;-2.14748e+09;-1.59702e+06;-1;0;0;0;-1;0;444631482;455759852;37739820
1801;1.16616e-14;-542;1671;24706;19733;1;610;-2.14748e+09;-1.59394e+06;-1;0;0;0;-1;0;444694127;455834788;37764913
1801;1.1555e-14;-532;1585;24192;19613;1;594;-2.14748e+09;-1.59394e+06;-1;0;0;0;-1;0;444694127;455834788;37764913
1802;1.16616e-14;-542;1671;24706;19733;1;610;-2.14748e+09;-1.59097e+06;-1;0;0;0;-1;0;444756648;455909588;37789969
1802;1.1555e-14;-532;1585;24192;19613;1;594;-2.14748e+09;-1.59087e+06;-1;0;0;0;-1;0;444756648;455909588;37789969
1803;1.16616e-14;-542;1671;24706;19733;1;610;-2.14748e+09;-1.5879e+06;-1;0;0;0;-1;0;444819045;455984253;37814987
1803;1.1555e-14;-533;1585;24192;19613;1;594;-2.14748e+09;-1.5879e+06;0;0;0;0;0;0;444819045;455984253;37814987
1804;1.16616e-14;-542;1671;24706;19733;1;610;-2.14748e+09;-1.58474e+06;-1;0;0;0;-1;0;444881319;456058781;37839968
1804;1.1555e-14;-533;1585;24192;19613;1;594;-2.14748e+09;-1.58474e+06;-1;0;0;0;-1;0;444881319;456058781;37839968
1805;1.16616e-14;-543;1671;24706;19733;1;610;-2.14748e+09;-1.58169e+06;0;0;0;0;0;0;444943469;456133174;37864911
1805;1.1555e-14;-534;1585;24192;19613;1;594;-2.14748e+09;-1.58169e+06;0;0;0;0;0;0;444943469;456133174;37864911
1806;1.16616e-14;-544;1671;24706;19733;1;610;-2.14748e+09;-1.57864e+06;0;0;0;0;0;0;445005496;456207433;37889817
1806;1.1555e-14;-535;1585;24192;19613;1;594;-2.14748e+09;-1.57864e+06;0;0;0;0;0;0;445005496;456207433;37889817
1807;1.16616e-14;-545;1671;24706;19733;1;610;-2.14748e+09;-1.5756e+06;0;0;0;0;0;0;445067400;456281556;37914685
1807;1.1555e-14;-535;1585;24192;19613;1;594;-2.14748e+09;-1.5756e+06;-1;0;0;0;-1;0;445067400;456281556;37914685
1808;1.16616e-14;-546;1671;24706;19733;1;610;-2.14748e+09;-1.57257e+06;0;0;0;0;0;0;445129182;456355544;37939516
1808;1.1555e-14;-536;1585;24192;19613;1;594;-2.14748e+09;-1.57257e+06;0;0;0;0;0;0;445129182;456355544;37939516
1809;1.16616e-14;-546;1671;24706;19733;1;610;-2.14748e+09;-1.56954e+06;-1;0;0;0;-1;0;445190842;456429399;37964310
1809;1.1555e-14;-536;1585;24192;19613;1;594;-2.14748e+09;-1.56954e+06;-1;0;0;0;-1;0;445190842;456429399;37964310
1810;1.16616e-14;-547;1671;24706;19733;1;610;-2.14748e+09;-1.56652e+06;0;0;0;0;0;0;445252379;456503119;37989067
1810;1.1555e-14;-536;1585;24192;19613;1;594;-2.14748e+09;-1.56652e+06;-1;0;0;0;-1;0;445252379;456503119;37989067
1811;1.16616e-14;-547;1671;24706;19733;1;610;-2.14748e+09;-1.5635e+06;-1;0;0;0;-1;0;445313795;456576705;38013786
1811;1.1555e-14;-537;1585;24192;19613;1;594;-2.14748e+09;-1.5635e+06;0;0;0;0;0;0;445313795;456576705;38013786
1812;1.16616e-14;-547;1671;24706;19733;1;610;-2.14748e+09;-1.56049e+06;-1;0;0;0;-1;0;445375089;456650158;38038468
1812;1.1555e-14;-538;1585;24192;19613;1;594;-2.14748e+09;-1.56049e+06;0;0;0;0;0;0;445375089;456650158;38038468
1813;1.16616e-14;-547;1671;24706;19733;1;610;-2.14748e+09;-1.55749e+06;-1;0;0;0;-1;0;445436262;456723477;38063113
1813;1.1555e-14;-539;1585;24192;19613;1;594;-2.14748e+09;-1.55749e+06;0;0;0;0;0;0;445436262;456723477;38063113
1814;1.16616e-14;-547;1671;24706;19733;1;610;-2.14748e+09;-1.55449e+06;-1;0;0;0;-1;0;445497314;456796663;38087720
1814;1.1555e-14;-539;1585;24192;19613;1;594;-2.14748e+09;-1.55449e+06;-1;0;0;0;-1;0;445497314;456796663;38087720
1815;1.16616e-14;-548;1671;24706;19733;1;610;-2.14748e+09;-1.5515e+06;0;0;0;0;0;0;445558245;456869716;38112291
1815;1.1555e-14;-540;1585;24192;19613;1;594;-2.14748e+09;-1.5515e+06;0;0;0;0;0;0;445558245;456869716;38112291
1816;1.16616e-14;-548;1671;24706;19733;1;610;-2.14748e+09;-1.54852e+06;-1;0;0;0;-1;0;445619056;456942637;38136825
1816;1.1555e-14;-540;1585;24192;19613;1;594;-2.14748e+09;-1.54852e+06;-1;0;0;0;-1;0;445619056;456942637;38136825
1817;1.16616e-14;-549;1671;24706;19733;1;610;-2.14748e+09;-1.54554e+06;0;0;0;0;0;0;445679747;457015425;38161321
1817;1.1555e-14;-540;1585;24192;19613;1;594;-2.14748e+09;-1.54554e+06;-1;0;0;0;-1;0;445679747;457015425;38161321
1818;1.16616e-14;-550;1671;24706;19733;1;610;-2.14748e+09;-1.54257e+06;0;0;0;0;0;0;445740318;457088081;38185781
1818;1.1555e-14;-540;1585;24192;19613;1;594;-2.14748e+09;-1.54257e+06;-1;0;0;0;-1;0;445740318;457088081;38185781
1819;1.16616e-14;-550;1671;24706;19733;1;610;-2.14748e+09;-1.5396e+06;-1;0;0;0;-1;0;445800768;457160605;38210203
1819;1.1555e-14;-541;1585;24192;19613;1;594;-2.14748e+09;-1.5396e+06;0;0;0;0;0;0;445800768;457160605;38210203
1820;1.16616e-14;-551;1671;24706;19733;1;610;-2.14748e+09;-1.53664e+06;0;0;0;0;0;0;445861100;457232998;38234589
1820;1.1555e-14;-542;1585;24192;19613;1;594;-2.14748e+09;-1.53664e+06;0;0;0;0;0;0;445861100;457232998;38234589
1821;1.16616e-14;-551;1671;24706;19733;1;610;-2.14748e+09;-1.53379e+06;-1;0;0;0;-1;0;445921312;457305259;38258938
1821;1.1555e-14;-542;1585;24192;19613;1;594;-2.14748e+09;-1.53379e+06;-1;0;0;0;-1;0;445921312;457305259;38258938
1822;1.16616e-14;-551;1671;24706;19733;1;610;-2.14748e+09;-1.53074e+06;-1;0;0;0;-1;0;445981406;457377390;38283250
1822;1.1555e-14;-543;1585;24192;19613;1;594;-2.14748e+09;-1.53074e+06;0;0;0;0;0;0;445981406;457377390;38283250
1823;1.16616e-14;-551;1671;24706;19733;1;610;-2.14748e+09;-1.5278e+06;-1;0;0;0;-1;0;446041381;457449389;38307526
1823;1.1555e-14;-544;1585;24192;19613;1;594;-2.14748e+09;-1.5278e+06;0;0;0;0;0;0;446041381;457449389;38307526
1824;1.16616e-14;-552;1671;24706;19733;1;610;-2.14748e+09;-1.52497e+06;0;0;0;0;0;0;446101237;457521258;38331764
1824;1.1555e-14;-544;1585;24192;19613;1;594;-2.14748e+09;-1.52497e+06;-1;0;0;0;-1;0;446101237;457521258;38331764
1825;1.16616e-14;-553;1671;24706;19733;1;610;-2.14748e+09;-1.52194e+06;0;0;0;0;0;0;446160975;457592996;38355966
1825;1.1555e-14;-544;1585;24192;19613;1;594;-2.14748e+09;-1.52194e+06;-1;0;0;0;-1;0;446160975;457592996;38355966
1826;1.16616e-14;-554;1671;24706;19733;1;610;-2.14748e+09;-1.51902e+06;0;0;0;0;0;0;446220595;457664604;38380132
1826;1.1555e-14;-544;1585;24192;19613;1;594;-2.14748e+09;-1.51902e+06;-1;0;0;0;-1;0;446220595;457664604;38380132
1827;1.16616e-14;-555;1671;24706;19733;1;610;-2.14748e+09;-1.5161e+06;0;0;0;0;0;0;446280098;457736082;38404261
1827;1.1555e-14;-545;1585;24192;19613;1;594;-2.14748e+09;-1.5161e+06;0;0;0;0;0;0;446280098;457736082;38404261
1828;1.16616e-14;-556;1671;24706;19733;1;610;-2.14748e+09;-1.51319e+06;0;0;0;0;0;0;446339483;457807431;38428353
1828;1.1555e-14;-545;1585;24192;19613;1;594;-2.14748e+09;-1.51319e+06;-1;0;0;0;-1;0;446339483;457807431;38428353
1829;1.16616e-14;-557;1671;24706;19733;1;610;-2.14748e+09;-1.51028e+06;0;0;0;0;0;0;446398751;457878650;38452408
1829;1.1555e-14;-545;1585;24192;19613;1;594;-2.14748e+09;-1.51028e+06;-1;0;0;0;-1;0;446398751;457878650;38452408
1830;1.16616e-14;-557;1671;24706;19733;1;610;-2.14748e+09;-1.50738e+06;-1;0;0;0;-1;0;446457902;457949740;38476428
1830;1.1555e-14;-545;1585;24192;19613;1;594;-2.14748e+09;-1.50738e+06;-1;0;0;0;-1;0;446457902;457949740;38476428
1831;1.16616e-14;-558;1671;24706;19733;1;610;-2.14748e+09;-1.50449e+06;0;0;0;0;0;0;446516937;458020702;38500410
1831;1.1555e-14;-546;1585;24192;19613;1;594;-2.14748e+09;-1.50449e+06;0;0;0;0;0;0;446516937;458020702;38500410
1832;1.16616e-14;-559;1671;24706;19733;1;610;-2.14748e+09;-1.5016e+06;0;0;0;0;0;0;446575855;458091534;38524357
1832;1.1555e-14;-547;1585;24192;19613;1;594;-2.14748e+09;-1.5016e+06;0;0;0;0;0;0;446575855;458091534;38524357
1833;1.16616e-14;-559;1671;24706;19733;1;610;-2.14748e+09;-1.49872e+06;-1;0;0;0;-1;0;446634657;458162238;38548267
1833;1.1555e-14;-548;1585;24192;19613;1;594;-2.14748e+09;-1.49872e+06;0;0;0;0;0;0;446634657;458162238;38548267
1834;1.16616e-14;-560;1671;24706;19733;1;610;-2.14748e+09;-1.49585e+06;0;0;0;0;0;0;446693343;458232814;38572140
1834;1.1555e-14;-549;1585;24192;19613;1;594;-2.14748e+09;-1.49585e+06;0;0;0;0;0;0;446693343;458232814;38572140
1835;1.16616e-14;-561;1671;24706;19733;1;610;-2.14748e+09;-1.49298e+06;0;0;0;0;0;0;446751913;458303262;38595978
1835;1.1555e-14;-549;1585;24192;19613;1;594;-2.14748e+09;-1.49298e+06;-1;0;0;0;-1;0;446751913;458303262;38595978
1836;1.16616e-14;-562;1671;24706;19733;1;610;-2.14748e+09;-1.49012e+06;0;0;0;0;0;0;446810368;458373582;38619779
1836;1.1555e-14;-549;1585;24192;19613;1;594;-2.14748e+09;-1.49012e+06;-1;0;0;0;-1;0;446810368;458373582;38619779
1837;1.16616e-14;-562;1671;24706;19733;1;610;-2.14748e+09;-1.48726e+06;-1;0;0;0;-1;0;446868708;458443775;38643544
1837;1.1555e-14;-549;1585;24192;19613;1;594;-2.14748e+09;-1.48726e+06;-1;0;0;0;-1;0;446868708;458443775;38643544
1838;1.16616e-14;-563;1671;24706;19733;1;610;-2.14748e+09;-1.48441e+06;0;0;0;0;0;0;446926932;458513840;38667272
1838;1.1555e-14;-549;1585;24192;19613;1;594;-2.14748e+09;-1.48441e+06;-1;0;0;0;-1;0;446926932;458513840;38667272
1839;1.16616e-14;-563;1671;24706;19733;1;610;-2.14748e+09;-1.48156e+06;-1;0;0;0;-1;0;446985042;458583779;38690965
1839;1.1555e-14;-549;1585;24192;19613;1;594;-2.14748e+09;-1.48156e+06;-1;0;0;0;-1;0;446985042;458583779;38690965
1840;1.16616e-14;-563;1671;24706;19733;1;610;-2.14748e+09;-1.47872e+06;-1;0;0;0;-1;0;447043038;458653591;38714622
1840;1.1555e-14;-549;1585;24192;19613;1;594;-2.14748e+09;-1.47872e+06;-1;0;0;0;-1;0;447043038;458653591;38714622
1841;1.16616e-14;-564;1671;24706;19733;1;610;-2.14748e+09;-1.47589e+06;0;0;0;0;0;0;447100919;458723276;38738242
1841;1.1555e-14;-549;1585;24192;19613;1;594;-2.14748e+09;-1.47589e+06;-1;0;0;0;-1;0;447100919;458723276;38738242
1842;1.16616e-14;-564;1671;24706;19733;1;610;-2.14748e+09;-1.47306e+06;-1;0;0;0;-1;0;447158687;458792835;38761827
1842;1.1555e-14;-550;1585;24192;19613;1;594;-2.14748e+09;-1.47306e+06;0;0;0;0;0;0;447158687;458792835;38761827
1843;1.16616e-14;-564;1671;24706;19733;1;610;-2.14748e+09;-1.47024e+06;-1;0;0;0;-1;0;447216341;458862268;38785375
1843;1.1555e-14;-551;1585;24192;19613;1;594;-2.14748e+09;-1.47024e+06;0;0;0;0;0;0;447216341;458862268;38785375
1844;1.16616e-14;-565;1671;24706;19733;1;610;-2.14748e+09;-1.46752e+06;0;0;0;0;0;0;447273881;458931575;38808888
1844;1.1555e-14;-551;1585;24192;19613;1;594;-2.14748e+09;-1.46752e+06;-1;0;0;0;-1;0;447273881;458931575;38808888
1845;1.16616e-14;-566;1671;24706;19733;1;610;-2.14748e+09;-1.46462e+06;0;0;0;0;0;0;447331308;459000756;38832365
1845;1.1555e-14;-552;1585;24192;19613;1;594;-2.14748e+09;-1.46462e+06;0;0;0;0;0;0;447331308;459000756;38832365
1846;1.16616e-14;-567;1671;24706;19733;1;610;-2.14748e+09;-1.46191e+06;0;0;0;0;0;0;447388622;459069813;38855806
1846;1.1555e-14;-552;1585;24192;19613;1;594;-2.14748e+09;-1.46181e+06;-1;0;0;0;-1;0;447388622;459069813;38855806
1847;1.16616e-14;-567;1671;24706;19733;1;610;-2.14748e+09;-1.45911e+06;-1;0;0;0;-1;0;447445824;459138744;38879211
1847;1.1555e-14;-552;1585;24192;19613;1;594;-2.14748e+09;-1.45901e+06;-1;0;0;0;-1;0;447445823;459138744;38879211
1848;1.16616e-14;-567;1671;24706;19733;1;610;-2.14748e+09;-1.45622e+06;-1;0;0;0;-1;0;447502912;459207550;38902580
1848;1.1555e-14;-553;1585;24192;19613;1;594;-2.14748e+09;-1.45622e+06;0;0;0;0;0;0;447502912;459207550;38902580
1849;1.16616e-14;-568;1671;24706;19733;1;610;-2.14748e+09;-1.45353e+06;0;0;0;0;0;0;447559889;459276232;38925914
1849;1.1555e-14;-553;1584;24192;19613;1;594;-2.14748e+09;-1.45353e+06;0;0;0;0;0;0;447559889;459276232;38925914
1850;1.16616e-14;-568;1671;24706;19733;1;610;-2.14748e+09;-1.45075e+06;-1;0;0;0;-1;0;447616753;459344789;38949212
1850;1.1555e-14;-554;1584;24192;19613;1;594;-2.14748e+09;-1.45075e+06;0;0;0;0;0;0;447616753;459344789;38949212
1851;1.16616e-14;-568;1671;24706;19733;1;610;-2.14748e+09;-1.44787e+06;-1;0;0;0;-1;0;447673506;459413222;38972474
1851;1.1555e-14;-554;1584;24192;19613;1;594;-2.14748e+09;-1.44787e+06;-1;0;0;0;-1;0;447673506;459413222;38972474
1852;1.16616e-14;-568;1671;24706;19733;1;610;-2.14748e+09;-1.4451e+06;-1;0;0;0;-1;0;447730147;459481531;38995701
1852;1.1555e-14;-555;1584;24192;19613;1;594;-2.14748e+09;-1.4451e+06;0;0;0;0;0;0;447730147;459481531;38995701
1853;1.16616e-14;-569;1671;24706;19733;1;610;-2.14748e+09;-1.44234e+06;0;0;0;0;0;0;447786677;459549716;39018892
1853;1.1555e-14;-555;1584;24192;19613;1;594;-2.14748e+09;-1.44234e+06;-1;0;0;0;-1;0;447786677;459549716;39018892
1854;1.16616e-14;-570;1671;24706;19733;1;610;-2.14748e+09;-1.43958e+06;0;0;0;0;0;0;447843096;459617778;39042048
1854;1.1555e-14;-555;1584;24192;19613;1;594;-2.14748e+09;-1.43958e+06;-1;0;0;0;-1;0;447843096;459617778;39042048
1855;1.16616e-14;-570;1671;24706;19733;1;610;-2.14748e+09;-1.43683e+06;-1;0;0;0;-1;0;447899404;459685717;39065168
1855;1.1555e-14;-556;1584;24192;19613;1;594;-2.14748e+09;-1.43683e+06;0;0;0;0;0;0;447899404;459685717;39065168
1856;1.16616e-14;-570;1671;24706;19733;1;610;-2.14748e+09;-1.43408e+06;-1;0;0;0;-1;0;447955601;459753533;39088253
1856;1.1555e-14;-557;1584;24192;19613;1;594;-2.14748e+09;-1.43408e+06;0;0;0;0;0;0;447955601;459753533;39088253
1857;1.16616e-14;-570;1671;24706;19733;1;610;-2.14748e+09;-1.43144e+06;-1;0;0;0;-1;0;448011688;459821226;39111302
1857;1.1555e-14;-558;1584;24192;19613;1;594;-2.14748e+09;-1.43144e+06;0;0;0;0;0;0;448011688;459821226;39111302
1858;1.16616e-14;-570;1671;24706;19733;1;610;-2.14748e+09;-1.4287e+06;-1;0;0;0;-1;0;448067664;459888796;39134316
1858;1.1555e-14;-559;1584;24192;19613;1;594;-2.14748e+09;-1.4287e+06;0;0;0;0;0;0;448067664;459888796;39134316
1859;1.16616e-14;-570;1671;24706;19733;1;610;-2.14748e+09;-1.42587e+06;-1;0;0;0;-1;0;448123531;459956244;39157295
1859;1.1555e-14;-560;1584;24192;19613;1;594;-2.14748e+09;-1.42587e+06;0;0;0;0;0;0;448123531;459956244;39157295
1860;1.16616e-14;-570;1671;24706;19733;1;610;-2.14748e+09;-1.42315e+06;-1;0;0;0;-1;0;448179288;460023570;39180238
1860;1.1555e-14;-560;1584;24192;19613;1;594;-2.14748e+09;-1.42315e+06;-1;0;0;0;-1;0;448179288;460023570;39180238
1861;1.16616e-14;-571;1671;24706;19733;1;610;-2.14748e+09;-1.42043e+06;0;0;0;0;0;0;448234936;460090774;39203146
1861;1.1555e-14;-561;1584;24192;19613;1;594;-2.14748e+09;-1.42043e+06;0;0;0;0;0;0;448234936;460090774;39203146
1862;1.16616e-14;-572;1671;24706;19733;1;610;-2.14748e+09;-1.41771e+06;0;0;0;0;0;0;448290474;460157857;39226019
1862;1.1555e-14;-562;1584;24192;19613;1;594;-2.14748e+09;-1.41771e+06;0;0;0;0;0;0;448290474;460157857;39226019
1863;1.16616e-14;-573;1671;24706;19733;1;610;-2.14748e+09;-1.41501e+06;0;0;0;0;0;0;448345904;460224818;39248857
1863;1.1555e-14;-563;1584;24192;19613;1;594;-2.14748e+09;-1.41501e+06;0;0;0;0;0;0;448345904;460224818;39248857
1864;1.16616e-14;-574;1671;24706;19733;1;610;-2.14748e+09;-1.4123e+06;0;0;0;0;0;0;448401224;460291657;39271660
1864;1.1555e-14;-563;1584;24192;19613;1;594;-2.14748e+09;-1.4123e+06;-1;0;0;0;-1;0;448401224;460291657;39271660
1865;1.16616e-14;-574;1671;24706;19733;1;610;-2.14748e+09;-1.40961e+06;-1;0;0;0;-1;0;448456437;460358376;39294428
1865;1.1555e-14;-564;1584;24192;19613;1;594;-2.14748e+09;-1.40961e+06;0;0;0;0;0;0;448456437;460358376;39294428
1866;1.16616e-14;-574;1671;24706;19733;1;610;-2.14748e+09;-1.40691e+06;-1;0;0;0;-1;0;448511540;460424974;39317160
1866;1.1555e-14;-565;1584;24192;19613;1;594;-2.14748e+09;-1.40691e+06;0;0;0;0;0;0;448511540;460424974;39317160
1867;1.16616e-14;-574;1671;24706;19733;1;610;-2.14748e+09;-1.40423e+06;-1;0;0;0;-1;0;448566536;460491452;39339858
1867;1.1555e-14;-566;1584;24192;19613;1;594;-2.14748e+09;-1.40423e+06;0;0;0;0;0;0;448566536;460491452;39339858
1868;1.16616e-14;-575;1671;24706;19733;1;610;-2.14748e+09;-1.40165e+06;0;0;0;0;0;0;448621424;460557810;39362521
1868;1.1555e-14;-567;1584;24192;19613;1;594;-2.14748e+09;-1.40165e+06;0;0;0;0;0;0;448621424;460557810;39362521
1869;1.16616e-14;-575;1671;24706;19733;1;610;-2.14748e+09;-1.39887e+06;-1;0;0;0;-1;0;448676204;460624047;39385149
1869;1.1555e-14;-567;1584;24192;19613;1;594;-2.14748e+09;-1.39887e+06;-1;0;0;0;-1;0;448676204;460624047;39385149
1870;1.16616e-14;-576;1671;24706;19733;1;610;-2.14748e+09;-1.3962e+06;0;0;0;0;0;0;448730877;460690164;39407742
1870;1.1555e-14;-568;1584;24192;19613;1;594;-2.14748e+09;-1.3962e+06;0;0;0;0;0;0;448730877;460690164;39407742
1871;1.16616e-14;-576;1671;24706;19733;1;610;-2.14748e+09;-1.39354e+06;-1;0;0;0;-1;0;448785443;460756162;39430300
1871;1.1555e-14;-569;1584;24192;19613;1;594;-2.14748e+09;-1.39354e+06;0;0;0;0;0;0;448785443;460756162;39430300
1872;1.16616e-14;-576;1671;24706;19733;1;610;-2.14748e+09;-1.39098e+06;-1;0;0;0;-1;0;448839902;460822041;39452823
1872;1.1555e-14;-569;1584;24192;19613;1;594;-2.14748e+09;-1.39098e+06;-1;0;0;0;-1;0;448839902;460822041;39452823
1873;1.16616e-14;-577;1671;24706;19733;1;610;-2.14748e+09;-1.38823e+06;0;0;0;0;0;0;448894254;460887800;39475312
1873;1.1555e-14;-570;1584;24192;19613;1;594;-2.14748e+09;-1.38823e+06;0;0;0;0;0;0;448894254;460887800;39475312
1874;1.16616e-14;-577;1671;24706;19733;1;610;-2.14748e+09;-1.38558e+06;-1;0;0;0;-1;0;448948499;460953440;39497766
1874;1.1555e-14;-570;1584;24192;19613;1;594;-2.14748e+09;-1.38558e+06;-1;0;0;0;-1;0;448948499;460953440;39497766
1875;1.16616e-14;-578;1671;24706;19733;1;610;-2.14748e+09;-1.38294e+06;0;0;0;0;0;0;449002638;461018962;39520185
1875;1.1555e-14;-571;1584;24192;19613;1;594;-2.14748e+09;-1.38294e+06;0;0;0;0;0;0;449002638;461018962;39520185
1876;1.16616e-14;-579;1671;24706;19733;1;610;-2.14748e+09;-1.3803e+06;0;0;0;0;0;0;449056672;461084365;39542570
1876;1.1555e-14;-571;1584;24192;19613;1;594;-2.14748e+09;-1.3803e+06;-1;0;0;0;-1;0;449056672;461084365;39542570
1877;1.16616e-14;-579;1671;24706;19733;1;610;-2.14748e+09;-1.37767e+06;-1;0;0;0;-1;0;449110599;461149650;39564920
1877;1.1555e-14;-571;1584;24192;19613;1;594;-2.14748e+09;-1.37767e+06;-1;0;0;0;-1;0;449110599;461149650;39564920
1878;1.16616e-14;-579;1671;24706;19733;1;610;-2.14748e+09;-1.37514e+06;-1;0;0;0;-1;0;449164421;461214817;39587235
1878;1.1555e-14;-571;1584;24192;19613;1;594;-2.14748e+09;-1.37514e+06;-1;0;0;0;-1;0;449164421;461214817;39587235
1879;1.16616e-14;-580;1671;24706;19733;1;610;-2.14748e+09;-1.37242e+06;0;0;0;0;0;0;449218137;461279866;39609516
1879;1.1555e-14;-571;1584;24192;19613;1;594;-2.14748e+09;-1.37242e+06;-1;0;0;0;-1;0;449218137;461279866;39609516
1880;1.16616e-14;-581;1671;24706;19733;1;610;-2.14748e+09;-1.3698e+06;0;0;0;0;0;0;449271749;461344797;39631763
1880;1.1555e-14;-571;1584;24192;19613;1;594;-2.14748e+09;-1.3698e+06;-1;0;0;0;-1;0;449271749;461344797;39631763
1881;1.16616e-14;-581;1671;24706;19733;1;610;-2.14748e+09;-1.36729e+06;-1;0;0;0;-1;0;449325255;461409611;39653975
1881;1.1555e-14;-571;1584;24192;19613;1;594;-2.14748e+09;-1.36729e+06;-1;0;0;0;-1;0;449325255;461409611;39653975
1882;1.16616e-14;-581;1671;24706;19733;1;610;-2.14748e+09;-1.36469e+06;-1;0;0;0;-1;0;449378657;461474307;39676153
1882;1.1555e-14;-572;1584;24192;19613;1;594;-2.14748e+09;-1.36469e+06;0;0;0;0;0;0;449378657;461474307;39676153
1883;1.16616e-14;-582;1671;24706;19733;1;610;-2.14748e+09;-1.36209e+06;0;0;0;0;0;0;449431954;461538887;39698296
1883;1.1555e-14;-572;1584;24192;19613;1;594;-2.14748e+09;-1.36209e+06;-1;0;0;0;-1;0;449431954;461538887;39698296
1884;1.16616e-14;-583;1671;24706;19733;1;610;-2.14748e+09;-1.35939e+06;0;0;0;0;0;0;449485147;461603350;39720406
1884;1.1555e-14;-573;1584;24192;19613;1;594;-2.14748e+09;-1.35939e+06;0;0;0;0;0;0;449485147;461603350;39720406
1885;1.16616e-14;-584;1671;24706;19733;1;610;-2.14748e+09;-1.3569e+06;0;0;0;0;0;0;449538236;461667697;39742481
1885;1.1555e-14;-573;1584;24192;19613;1;594;-2.14748e+09;-1.3569e+06;-1;0;0;0;-1;0;449538236;461667697;39742481
1886;1.16616e-14;-584;1671;24706;19733;1;610;-2.14748e+09;-1.35422e+06;-1;0;0;0;-1;0;449591221;461731927;39764521
1886;1.1555e-14;-573;1584;24192;19613;1;594;-2.14748e+09;-1.35422e+06;-1;0;0;0;-1;0;449591221;461731927;39764521
1887;1.16616e-14;-584;1671;24706;19733;1;610;-2.14748e+09;-1.35164e+06;-1;0;0;0;-1;0;449644102;461796041;39786528
1887;1.1555e-14;-573;1584;24192;19613;1;594;-2.14748e+09;-1.35164e+06;-1;0;0;0;-1;0;449644102;461796041;39786528
1888;1.16616e-14;-584;1671;24706;19733;1;610;-2.14748e+09;-1.34917e+06;-1;0;0;0;-1;0;449696880;461860039;39808500
1888;1.1555e-14;-573;1584;24192;19613;1;594;-2.14748e+09;-1.34917e+06;-1;0;0;0;-1;0;449696880;461860039;39808500
1889;1.16616e-14;-584;1671;24706;19733;1;610;-2.14748e+09;-1.3466e+06;-1;0;0;0;-1;0;449749555;461923921;39830439
1889;1.1555e-14;-574;1584;24192;19613;1;594;-2.14748e+09;-1.3466e+06;0;0;0;0;0;0;449749555;461923921;39830439
1890;1.16616e-14;-585;1671;24706;19733;1;610;-2.14748e+09;-1.34393e+06;0;0;0;0;0;0;449802126;461987688;39852343
1890;1.1555e-14;-574;1584;24192;19613;1;594;-2.14748e+09;-1.34393e+06;-1;0;0;0;-1;0;449802126;461987688;39852343
1891;1.16616e-14;-586;1671;24706;19733;1;610;-2.14748e+09;-1.34138e+06;0;0;0;0;0;0;449854596;462051340;39874213
1891;1.1555e-14;-574;1584;24192;19613;1;594;-2.14748e+09;-1.34138e+06;-1;0;0;0;-1;0;449854596;462051340;39874213
1892;1.16616e-14;-587;1671;24706;19733;1;610;-2.14748e+09;-1.33882e+06;0;0;0;0;0;0;449906962;462114877;39896050
1892;1.1555e-14;-574;1584;24192;19613;1;594;-2.14748e+09;-1.33882e+06;-1;0;0;0;-1;0;449906962;462114877;39896050
1893;1.16616e-14;-587;1671;24706;19733;1;610;-2.14748e+09;-1.33628e+06;-1;0;0;0;-1;0;449959226;462178299;39917852
1893;1.1555e-14;-574;1584;24192;19613;1;594;-2.14748e+09;-1.33628e+06;-1;0;0;0;-1;0;449959226;462178299;39917852
1894;1.16616e-14;-588;1671;24706;19733;1;610;-2.14748e+09;-1.33373e+06;0;0;0;0;0;0;450011388;462241606;39939621
1894;1.1555e-14;-575;1584;24192;19613;1;594;-2.14748e+09;-1.33373e+06;0;0;0;0;0;0;450011388;462241606;39939621
1895;1.16616e-14;-589;1671;24706;19733;1;610;-2.14748e+09;-1.3313e+06;0;0;0;0;0;0;450063449;462304799;39961355
1895;1.1555e-14;-575;1584;24192;19613;1;594;-2.14748e+09;-1.3313e+06;-1;0;0;0;-1;0;450063449;462304799;39961355
1896;1.16616e-14;-590;1671;24706;19733;1;610;-2.14748e+09;-1.32866e+06;0;0;0;0;0;0;450115407;462367878;39983056
1896;1.1555e-14;-575;1584;24192;19613;1;594;-2.14748e+09;-1.32866e+06;-1;0;0;0;-1;0;450115407;462367878;39983056
1897;1.16616e-14;-591;1671;24706;19733;1;610;-2.14748e+09;-1.32614e+06;0;0;0;0;0;0;450167264;462430843;40004723
1897;1.1555e-14;-576;1584;24192;19613;1;594;-2.14748e+09;-1.32614e+06;0;0;0;0;0;0;450167264;462430843;40004723
1898;1.16616e-14;-591;1671;24706;19733;1;610;-2.14748e+09;-1.32361e+06;-1;0;0;0;-1;0;450219020;462493694;40026357
1898;1.1555e-14;-576;1584;24192;19613;1;594;-2.14748e+09;-1.32361e+06;-1;0;0;0;-1;0;450219020;462493694;40026357
1899;1.16616e-14;-591;1671;24706;19733;1;610;-2.14748e+09;-1.3211e+06;-1;0;0;0;-1;0;450270675;462556431;40047957
1899;1.1555e-14;-577;1584;24192;19613;1;594;-2.14748e+09;-1.3211e+06;0;0;0;0;0;0;450270675;462556431;40047957
1900;1.16616e-14;-592;1671;24706;19733;1;610;-2.14748e+09;-1.31858e+06;0;0;0;0;0;0;450322229;462619055;40069523
1900;1.1555e-14;-578;1584;24192;19613;1;594;-2.14748e+09;-1.31858e+06;0;0;0;0;0;0;450322229;462619055;40069523
1901;1.16616e-14;-592;1671;24706;19733;1;610;-2.14748e+09;-1.31608e+06;-1;0;0;0;-1;0;450373682;462681566;40091055
1901;1.1555e-14;-579;1584;24192;19613;1;594;-2.14748e+09;-1.31608e+06;0;0;0;0;0;0;450373682;462681566;40091055
1902;1.16616e-14;-592;1671;24706;19733;1;610;-2.14748e+09;-1.31358e+06;-1;0;0;0;-1;0;450425035;462743964;40112554
1902;1.1555e-14;-580;1584;24192;19613;1;594;-2.14748e+09;-1.31358e+06;0;0;0;0;0;0;450425035;462743964;40112554
1903;1.16616e-14;-593;1671;24706;19733;1;610;-2.14748e+09;-1.31108e+06;0;0;0;0;0;0;450476288;462806250;40134020
1903;1.1555e-14;-580;1584;24192;19613;1;594;-2.14748e+09;-1.31108e+06;-1;0;0;0;-1;0;450476288;462806250;40134020
1904;1.16616e-14;-594;1671;24706;19733;1;610;-2.14748e+09;-1.30869e+06;0;0;0;0;0;0;450527440;462868423;40155452
1904;1.1555e-14;-580;1584;24192;19613;1;594;-2.14748e+09;-1.30869e+06;-1;0;0;0;-1;0;450527440;462868423;40155452
1905;1.16616e-14;-594;1671;24706;19733;1;610;-2.14748e+09;-1.3061e+06;-1;0;0;0;-1;0;450578493;462930483;40176850
1905;1.1555e-14;-581;1584;24192;19613;1;594;-2.14748e+09;-1.3061e+06;0;0;0;0;0;0;450578493;462930483;40176850
1906;1.16616e-14;-594;1671;24706;19733;1;610;-2.14748e+09;-1.30362e+06;-1;0;0;0;-1;0;450629447;462992432;40198215
1906;1.1555e-14;-581;1584;24192;19613;1;594;-2.14748e+09;-1.30362e+06;-1;0;0;0;-1;0;450629447;462992432;40198215
1907;1.16616e-14;-595;1671;24706;19733;1;610;-2.14748e+09;-1.30114e+06;0;0;0;0;0;0;450680300;463054269;40219547
1907;1.1555e-14;-581;1584;24192;19613;1;594;-2.14748e+09;-1.30114e+06;-1;0;0;0;-1;0;450680300;463054269;40219547
1908;1.16616e-14;-595;1671;24706;19733;1;610;-2.14748e+09;-1.29867e+06;-1;0;0;0;-1;0;450731055;463115993;40240846
1908;1.1555e-14;-581;1584;24192;19613;1;594;-2.14748e+09;-1.29867e+06;-1;0;0;0;-1;0;450731055;463115993;40240846
1909;1.16616e-14;-596;1671;24706;19733;1;610;-2.14748e+09;-1.2962e+06;0;0;0;0;0;0;450781711;463177607;40262111
1909;1.1555e-14;-582;1584;24192;19613;1;594;-2.14748e+09;-1.2962e+06;0;0;0;0;0;0;450781711;463177607;40262111
1910;1.16616e-14;-596;1671;24706;19733;1;610;-2.14748e+09;-1.29374e+06;-1;0;0;0;-1;0;450832268;463239109;40283343
1910;1.1555e-14;-582;1584;24192;19613;1;594;-2.14748e+09;-1.29374e+06;-1;0;0;0;-1;0;450832268;463239109;40283343
1911;1.16616e-14;-597;1671;24706;19733;1;610;-2.14748e+09;-1.29129e+06;0;0;0;0;0;0;450882727;463300501;40304542
1911;1.1555e-14;-583;1584;24192;19613;1;594;-2.14748e+09;-1.29129e+06;0;0;0;0;0;0;450882727;463300501;40304542
1912;1.16616e-14;-598;1671;24706;19733;1;610;-2.14748e+09;-1.28894e+06;0;0;0;0;0;0;450933087;463361781;40325707
1912;1.1555e-14;-583;1584;24192;19613;1;594;-2.14748e+09;-1.28894e+06;-1;0;0;0;-1;0;450933087;463361781;40325707
1913;1.16616e-14;-598;1671;24706;19733;1;610;-2.14748e+09;-1.28639e+06;-1;0;0;0;-1;0;450983349;463422951;40346840
1913;1.1555e-14;-583;1584;24192;19613;1;594;-2.14748e+09;-1.28639e+06;-1;0;0;0;-1;0;450983349;463422951;40346840
1914;1.16616e-14;-598;1671;24706;19733;1;610;-2.14748e+09;-1.28395e+06;-1;0;0;0;-1;0;451033513;463484010;40367940
1914;1.1555e-14;-583;1584;24192;19613;1;594;-2.14748e+09;-1.28395e+06;-1;0;0;0;-1;0;451033513;463484010;40367940
1915;1.16616e-14;-599;1671;24706;19733;1;610;-2.14748e+09;-1.28151e+06;0;0;0;0;0;0;451083580;463544959;40389006
1915;1.1555e-14;-584;1584;24192;19613;1;594;-2.14748e+09;-1.28151e+06;0;0;0;0;0;0;451083580;463544959;40389006
1916;1.16616e-14;-600;1671;24706;19733;1;610;-2.14748e+09;-1.27918e+06;0;0;0;0;0;0;451133549;463605798;40410040
1916;1.1555e-14;-585;1584;24192;19613;1;594;-2.14748e+09;-1.27918e+06;0;0;0;0;0;0;451133549;463605798;40410040
1917;1.16616e-14;-601;1671;24706;19733;1;610;-2.14748e+09;-1.27665e+06;0;0;0;0;0;0;451183420;463666527;40431040
1917;1.1555e-14;-585;1584;24192;19613;1;594;-2.14748e+09;-1.27665e+06;-1;0;0;0;-1;0;451183420;463666527;40431040
1918;1.16616e-14;-601;1671;24706;19733;1;610;-2.14748e+09;-1.27423e+06;-1;0;0;0;-1;0;451233195;463727147;40452008
1918;1.1555e-14;-585;1584;24192;19613;1;594;-2.14748e+09;-1.27423e+06;-1;0;0;0;-1;0;451233195;463727147;40452008
1919;1.16616e-14;-601;1671;24706;19733;1;610;-2.14748e+09;-1.27181e+06;-1;0;0;0;-1;0;451282873;463787657;40472943
1919;1.1555e-14;-586;1584;24192;19613;1;594;-2.14748e+09;-1.27181e+06;0;0;0;0;0;0;451282873;463787657;40472943
1920;1.16616e-14;-602;1671;24706;19733;1;610;-2.14748e+09;-1.2694e+06;0;0;0;0;0;0;451332453;463848058;40493845
1920;1.1555e-14;-586;1584;24192;19613;1;594;-2.14748e+09;-1.2694e+06;-1;0;0;0;-1;0;451332453;463848058;40493845
1921;1.16616e-14;-603;1671;24706;19733;1;610;-2.14748e+09;-1.26699e+06;0;0;0;0;0;0;451381938;463908350;40514714
1921;1.1555e-14;-587;1584;24192;19613;1;594;-2.14748e+09;-1.26699e+06;0;0;0;0;0;0;451381938;463908350;40514714
1922;1.16616e-14;-603;1671;24706;19733;1;610;-2.14748e+09;-1.26459e+06;-1;0;0;0;-1;0;451431326;463968533;40535551
1922;1.1555e-14;-588;1584;24192;19613;1;594;-2.14748e+09;-1.26459e+06;0;0;0;0;0;0;451431326;463968533;40535551
1923;1.16616e-14;-604;1671;24706;19733;1;610;-2.14748e+09;-1.26219e+06;0;0;0;0;0;0;451480618;464028608;40556354
1923;1.1555e-14;-588;1584;24192;19613;1;594;-2.14748e+09;-1.26219e+06;-1;0;0;0;-1;0;451480618;464028608;40556354
1924;1.16616e-14;-604;1671;24706;19733;1;610;-2.14748e+09;-1.2598e+06;-1;0;0;0;-1;0;451529814;464088574;40577126
1924;1.1555e-14;-589;1584;24192;19613;1;594;-2.14748e+09;-1.2598e+06;0;0;0;0;0;0;451529814;464088574;40577126
1925;1.16616e-14;-605;1671;24706;19733;1;610;-2.14748e+09;-1.25741e+06;0;0;0;0;0;0;451578914;464148432;40597864
1925;1.1555e-14;-589;1584;24192;19613;1;594;-2.14748e+09;-1.25741e+06;-1;0;0;0;-1;0;451578914;464148432;40597864
1926;1.16616e-14;-606;1671;24706;19733;1;610;-2.14748e+09;-1.25502e+06;0;0;0;0;0;0;451627919;464208181;40618570
1926;1.1555e-14;-590;1584;24192;19613;1;594;-2.14748e+09;-1.25502e+06;0;0;0;0;0;0;451627919;464208181;40618570
1927;1.16616e-14;-606;1671;24706;19733;1;610;-2.14748e+09;-1.25265e+06;-1;0;0;0;-1;0;451676829;464267823;40639244
1927;1.1555e-14;-591;1584;24192;19613;1;594;-2.14748e+09;-1.25265e+06;0;0;0;0;0;0;451676829;464267823;40639244
1928;1.16616e-14;-606;1671;24706;19733;1;610;-2.14748e+09;-1.25027e+06;-1;0;0;0;-1;0;451725643;464327358;40659885
1928;1.1555e-14;-592;1584;24192;19613;1;594;-2.14748e+09;-1.25027e+06;0;0;0;0;0;0;451725643;464327358;40659885
1929;1.16616e-14;-607;1671;24706;19733;1;610;-2.14748e+09;-1.2479e+06;0;0;0;0;0;0;451774362;464386785;40680493
1929;1.1555e-14;-593;1584;24192;19613;1;594;-2.14748e+09;-1.2479e+06;0;0;0;0;0;0;451774362;464386785;40680493
1930;1.16616e-14;-607;1671;24706;19733;1;610;-2.14748e+09;-1.24554e+06;-1;0;0;0;-1;0;451822987;464446105;40701069
1930;1.1555e-14;-594;1584;24192;19613;1;594;-2.14748e+09;-1.24554e+06;0;0;0;0;0;0;451822987;464446105;40701069
1931;1.16616e-14;-607;1671;24706;19733;1;610;-2.14748e+09;-1.24318e+06;-1;0;0;0;-1;0;451871517;464505317;40721613
1931;1.1555e-14;-594;1584;24192;19613;1;594;-2.14748e+09;-1.24318e+06;-1;0;0;0;-1;0;451871517;464505317;40721613
1932;1.16616e-14;-608;1671;24706;19733;1;610;-2.14748e+09;-1.24082e+06;0;0;0;0;0;0;451919953;464564423;40742125
1932;1.1555e-14;-595;1584;24192;19613;1;594;-2.14748e+09;-1.24082e+06;0;0;0;0;0;0;451919953;464564423;40742125
1933;1.16616e-14;-608;1671;24706;19733;1;610;-2.14748e+09;-1.23847e+06;-1;0;0;0;-1;0;451968295;464623423;40762604
1933;1.1555e-14;-596;1584;24192;19613;1;594;-2.14748e+09;-1.23847e+06;0;0;0;0;0;0;451968295;464623423;40762604
1934;1.16616e-14;-608;1671;24706;19733;1;610;-2.14748e+09;-1.23623e+06;-1;0;0;0;-1;0;452016543;464682316;40783051
1934;1.1555e-14;-596;1584;24192;19613;1;594;-2.14748e+09;-1.23623e+06;-1;0;0;0;-1;0;452016543;464682316;40783051
1935;1.16616e-14;-608;1671;24706;19733;1;610;-2.14748e+09;-1.23378e+06;-1;0;0;0;-1;0;452064697;464741102;40803465
1935;1.1555e-14;-596;1584;24192;19613;1;594;-2.14748e+09;-1.23378e+06;-1;0;0;0;-1;0;452064697;464741102;40803465
1936;1.16616e-14;-609;1671;24706;19733;1;610;-2.14748e+09;-1.23145e+06;0;0;0;0;0;0;452112758;464799783;40823848
1936;1.1555e-14;-597;1584;24192;19613;1;594;-2.14748e+09;-1.23145e+06;0;0;0;0;0;0;452112758;464799783;40823848
1937;1.16616e-14;-609;1671;24706;19733;1;610;-2.14748e+09;-1.22912e+06;-1;0;0;0;-1;0;452160725;464858358;40844198
1937;1.1555e-14;-598;1584;24192;19613;1;594;-2.14748e+09;-1.22912e+06;0;0;0;0;0;0;452160725;464858358;40844198
1938;1.16616e-14;-610;1671;24706;19733;1;610;-2.14748e+09;-1.22679e+06;0;0;0;0;0;0;452208599;464916827;40864517
1938;1.1555e-14;-599;1584;24192;19613;1;594;-2.14748e+09;-1.22679e+06;0;0;0;0;0;0;452208599;464916827;40864517
1939;1.16616e-14;-611;1671;24706;19733;1;610;-2.14748e+09;-1.22447e+06;0;0;0;0;0;0;452256380;464975190;40884803
1939;1.1555e-14;-599;1584;24192;19613;1;594;-2.14748e+09;-1.22447e+06;-1;0;0;0;-1;0;452256380;464975190;40884803
1940;1.16616e-14;-612;1671;24706;19733;1;610;-2.14748e+09;-1.22215e+06;0;0;0;0;0;0;452304068;465033449;40905057
1940;1.1555e-14;-599;1584;24192;19613;1;594;-2.14748e+09;-1.22215e+06;-1;0;0;0;-1;0;452304068;465033449;40905057
1941;1.16616e-14;-612;1671;24706;19733;1;610;-2.14748e+09;-1.21984e+06;-1;0;0;0;-1;0;452351664;465091602;40925280
1941;1.1555e-14;-599;1584;24192;19613;1;594;-2.14748e+09;-1.21984e+06;-1;0;0;0;-1;0;452351664;465091602;40925280
1942;1.16616e-14;-612;1671;24706;19733;1;610;-2.14748e+09;-1.21763e+06;-1;0;0;0;-1;0;452399167;465149650;40945470
1942;1.1555e-14;-599;1584;24192;19613;1;594;-2.14748e+09;-1.21763e+06;-1;0;0;0;-1;0;452399167;465149650;40945470
1943;1.16616e-14;-613;1671;24706;19733;1;610;-2.14748e+09;-1.21522e+06;0;0;0;0;0;0;452446578;465207594;40965629
1943;1.1555e-14;-600;1584;24192;19613;1;594;-2.14748e+09;-1.21522e+06;0;0;0;0;0;0;452446578;465207594;40965629
1944;1.16616e-14;-614;1671;24706;19733;1;610;-2.14748e+09;-1.21293e+06;0;0;0;0;0;0;452493897;465265434;40985755
1944;1.1555e-14;-600;1584;24192;19613;1;594;-2.14748e+09;-1.21293e+06;-1;0;0;0;-1;0;452493897;465265434;40985755
1945;1.16616e-14;-614;1671;24706;19733;1;610;-2.14748e+09;-1.21063e+06;-1;0;0;0;-1;0;452541125;465323168;41005850
1945;1.1555e-14;-601;1584;24192;19613;1;594;-2.14748e+09;-1.21063e+06;0;0;0;0;0;0;452541125;465323168;41005850
1946;1.16616e-14;-615;1671;24706;19733;1;610;-2.14748e+09;-1.20834e+06;0;0;0;0;0;0;452588260;465380799;41025914
1946;1.1555e-14;-601;1584;24192;19613;1;594;-2.14748e+09;-1.20834e+06;-1;0;0;0;-1;0;452588260;465380799;41025914
1947;1.16616e-14;-616;1671;24706;19733;1;610;-2.14748e+09;-1.20606e+06;0;0;0;0;0;0;452635305;465438326;41045945
1947;1.1555e-14;-601;1584;24192;19613;1;594;-2.14748e+09;-1.20606e+06;-1;0;0;0;-1;0;452635305;465438326;41045945
1948;1.16616e-14;-617;1671;24706;19733;1;610;-2.14748e+09;-1.20377e+06;0;0;0;0;0;0;452682258;465495749;41065945
1948;1.1555e-14;-602;1584;24192;19613;1;594;-2.14748e+09;-1.20377e+06;0;0;0;0;0;0;452682258;465495749;41065945
1949;1.16616e-14;-618;1671;24706;19733;1;610;-2.14748e+09;-1.2015e+06;0;0;0;0;0;0;452729119;465553069;41085913
1949;1.1555e-14;-602;1584;24192;19613;1;594;-2.14748e+09;-1.2015e+06;-1;0;0;0;-1;0;452729119;465553069;41085913
1950;1.16616e-14;-619;1671;24706;19733;1;610;-2.14748e+09;-1.19923e+06;0;0;0;0;0;0;452775890;465610286;41105850
1950;1.1555e-14;-603;1584;24192;19613;1;594;-2.14748e+09;-1.19923e+06;0;0;0;0;0;0;452775890;465610286;41105850
1951;1.16616e-14;-619;1671;24706;19733;1;610;-2.14748e+09;-1.19696e+06;-1;0;0;0;-1;0;452822571;465667399;41125755
1951;1.1555e-14;-604;1584;24192;19613;1;594;-2.14748e+09;-1.19696e+06;0;0;0;0;0;0;452822571;465667399;41125755
1952;1.16616e-14;-620;1671;24706;19733;1;610;-2.14748e+09;-1.1947e+06;0;0;0;0;0;0;452869161;465724409;41145628
1952;1.1555e-14;-604;1584;24192;19613;1;594;-2.14748e+09;-1.1947e+06;-1;0;0;0;-1;0;452869161;465724409;41145628
1953;1.16616e-14;-621;1671;24706;19733;1;610;-2.14748e+09;-1.19244e+06;0;0;0;0;0;0;452915660;465781316;41165470
1953;1.1555e-14;-604;1584;24192;19613;1;594;-2.14748e+09;-1.19244e+06;-1;0;0;0;-1;0;452915660;465781316;41165470
1954;1.16616e-14;-621;1671;24706;19733;1;610;-2.14748e+09;-1.19018e+06;-1;0;0;0;-1;0;452962069;465838121;41185281
1954;1.1555e-14;-605;1584;24192;19613;1;594;-2.14748e+09;-1.19018e+06;0;0;0;0;0;0;452962069;465838121;41185281
1955;1.16616e-14;-622;1671;24706;19733;1;610;-2.14748e+09;-1.18793e+06;0;0;0;0;0;0;453008389;465894824;41205060
1955;1.1555e-14;-606;1584;24192;19613;1;594;-2.14748e+09;-1.18793e+06;0;0;0;0;0;0;453008389;465894824;41205060
1956;1.16616e-14;-623;1671;24706;19733;1;610;-2.14748e+09;-1.18569e+06;0;0;0;0;0;0;453054619;465951424;41224808
1956;1.1555e-14;-607;1584;24192;19613;1;594;-2.14748e+09;-1.18569e+06;0;0;0;0;0;0;453054619;465951424;41224808
1957;1.16616e-14;-623;1671;24706;19733;1;610;-2.14748e+09;-1.18345e+06;-1;0;0;0;-1;0;453100759;466007922;41244525
1957;1.1555e-14;-608;1584;24192;19613;1;594;-2.14748e+09;-1.18345e+06;0;0;0;0;0;0;453100759;466007922;41244525
1958;1.16616e-14;-624;1671;24706;19733;1;610;-2.14748e+09;-1.18121e+06;0;0;0;0;0;0;453146809;466064319;41264210
1958;1.1555e-14;-609;1584;24192;19613;1;594;-2.14748e+09;-1.18121e+06;0;0;0;0;0;0;453146809;466064319;41264210
1959;1.16616e-14;-624;1671;24706;19733;1;610;-2.14748e+09;-1.17898e+06;-1;0;0;0;-1;0;453192771;466120613;41283864
1959;1.1555e-14;-610;1584;24192;19613;1;594;-2.14748e+09;-1.17898e+06;0;0;0;0;0;0;453192771;466120613;41283864
1960;1.16616e-14;-624;1671;24706;19733;1;610;-2.14748e+09;-1.17675e+06;-1;0;0;0;-1;0;453238644;466176807;41303487
1960;1.1555e-14;-610;1584;24192;19613;1;594;-2.14748e+09;-1.17675e+06;-1;0;0;0;-1;0;453238644;466176807;41303487
1961;1.16616e-14;-625;1671;24706;19733;1;610;-2.14748e+09;-1.17453e+06;0;0;0;0;0;0;453284427;466232899;41323079
1961;1.1555e-14;-611;1584;24192;19613;1;594;-2.14748e+09;-1.17453e+06;0;0;0;0;0;0;453284427;466232899;41323079
1962;1.16616e-14;-626;1671;24706;19733;1;610;-2.14748e+09;-1.17231e+06;0;0;0;0;0;0;453330122;466288889;41342639
1962;1.1555e-14;-611;1584;24192;19613;1;594;-2.14748e+09;-1.17231e+06;-1;0;0;0;-1;0;453330122;466288889;41342639
1963;1.16616e-14;-627;1671;24706;19733;1;610;-2.14748e+09;-1.1701e+06;0;0;0;0;0;0;453375729;466344779;41362169
1963;1.1555e-14;-612;1584;24192;19613;1;594;-2.14748e+09;-1.1701e+06;0;0;0;0;0;0;453375729;466344779;41362169
1964;1.16616e-14;-627;1671;24706;19733;1;610;-2.14748e+09;-1.16789e+06;-1;0;0;0;-1;0;453421247;466400569;41381668
1964;1.1555e-14;-613;1584;24192;19613;1;594;-2.14748e+09;-1.16789e+06;0;0;0;0;0;0;453421247;466400569;41381668
1965;1.16616e-14;-627;1671;24706;19733;1;610;-2.14748e+09;-1.16568e+06;-1;0;0;0;-1;0;453466677;466456258;41401135
1965;1.1555e-14;-614;1584;24192;19613;1;594;-2.14748e+09;-1.16568e+06;0;0;0;0;0;0;453466677;466456258;41401135
1966;1.16616e-14;-628;1671;24706;19733;1;610;-2.14748e+09;-1.16348e+06;0;0;0;0;0;0;453512020;466511846;41420572
1966;1.1555e-14;-615;1584;24192;19613;1;594;-2.14748e+09;-1.16348e+06;0;0;0;0;0;0;453512020;466511846;41420572
1967;1.16616e-14;-629;1671;24706;19733;1;610;-2.14748e+09;-1.16129e+06;0;0;0;0;0;0;453557274;466567334;41439978
1967;1.1555e-14;-616;1584;24192;19613;1;594;-2.14748e+09;-1.16129e+06;0;0;0;0;0;0;453557274;466567334;41439978
1968;1.16616e-14;-629;1671;24706;19733;1;610;-2.14748e+09;-1.1591e+06;-1;0;0;0;-1;0;453602441;466622722;41459353
1968;1.1555e-14;-616;1584;24192;19613;1;594;-2.14748e+09;-1.1591e+06;-1;0;0;0;-1;0;453602441;466622722;41459353
1969;1.16616e-14;-630;1671;24706;19733;1;610;-2.14748e+09;-1.15691e+06;0;0;0;0;0;0;453647521;466678011;41478697
1969;1.1555e-14;-616;1584;24192;19613;1;594;-2.14748e+09;-1.15691e+06;-1;0;0;0;-1;0;453647521;466678011;41478697
1970;1.16616e-14;-630;1671;24706;19733;1;610;-2.14748e+09;-1.15472e+06;-1;0;0;0;-1;0;453692513;466733200;41498010
1970;1.1555e-14;-617;1584;24192;19613;1;594;-2.14748e+09;-1.15472e+06;0;0;0;0;0;0;453692513;466733200;41498010
1971;1.16616e-14;-630;1671;24706;19733;1;610;-2.14748e+09;-1.15255e+06;-1;0;0;0;-1;0;453737418;466788289;41517292
1971;1.1555e-14;-618;1584;24192;19613;1;594;-2.14748e+09;-1.15255e+06;0;0;0;0;0;0;453737418;466788289;41517292
1972;1.16616e-14;-630;1671;24706;19733;1;610;-2.14748e+09;-1.15047e+06;-1;0;0;0;-1;0;453782237;466843279;41536544
1972;1.1555e-14;-619;1584;24192;19613;1;594;-2.14748e+09;-1.15047e+06;0;0;0;0;0;0;453782237;466843279;41536544
1973;1.16616e-14;-630;1671;24706;19733;1;610;-2.14748e+09;-1.1482e+06;-1;0;0;0;-1;0;453826968;466898170;41555766
1973;1.1555e-14;-620;1584;24192;19613;1;594;-2.14748e+09;-1.1482e+06;0;0;0;0;0;0;453826968;466898170;41555766
1974;1.16616e-14;-630;1671;24706;19733;1;610;-2.14748e+09;-1.14604e+06;-1;0;0;0;-1;0;453871614;466952962;41574956
1974;1.1555e-14;-621;1584;24192;19613;1;594;-2.14748e+09;-1.14604e+06;0;0;0;0;0;0;453871614;466952962;41574956
1975;1.16616e-14;-630;1671;24706;19733;1;610;-2.14748e+09;-1.14387e+06;-1;0;0;0;-1;0;453916173;467007656;41594116
1975;1.1555e-14;-622;1584;24192;19613;1;594;-2.14748e+09;-1.14387e+06;0;0;0;0;0;0;453916173;467007656;41594116
1976;1.16616e-14;-630;1671;24706;19733;1;610;-2.14748e+09;-1.14172e+06;-1;0;0;0;-1;0;453960646;467062251;41613246
1976;1.1555e-14;-622;1584;24192;19613;1;594;-2.14748e+09;-1.14172e+06;-1;0;0;0;-1;0;453960646;467062251;41613246
1977;1.16616e-14;-630;1671;24706;19733;1;610;-2.14748e+09;-1.13956e+06;-1;0;0;0;-1;0;454005033;467116747;41632345
1977;1.1555e-14;-622;1584;24192;19613;1;594;-2.14748e+09;-1.13956e+06;-1;0;0;0;-1;0;454005033;467116747;41632345
1978;1.16616e-14;-631;1671;24706;19733;1;610;-2.14748e+09;-1.13751e+06;0;0;0;0;0;0;454049334;467171146;41651413
1978;1.1555e-14;-622;1584;24192;19613;1;594;-2.14748e+09;-1.13751e+06;-1;0;0;0;-1;0;454049334;467171146;41651413
1979;1.16616e-14;-631;1671;24706;19733;1;610;-2.14748e+09;-1.13527e+06;-1;0;0;0;-1;0;454093549;467225446;41670451
1979;1.1555e-14;-622;1584;24192;19613;1;594;-2.14748e+09;-1.13527e+06;-1;0;0;0;-1;0;454093549;467225446;41670451
1980;1.16616e-14;-631;1671;24706;19733;1;610;-2.14748e+09;-1.13323e+06;-1;0;0;0;-1;0;454137679;467279649;41689459
1980;1.1555e-14;-623;1584;24192;19613;1;594;-2.14748e+09;-1.13323e+06;0;0;0;0;0;0;454137679;467279649;41689459
1981;1.16616e-14;-632;1671;24706;19733;1;610;-2.14748e+09;-1.13099e+06;0;0;0;0;0;0;454181724;467333754;41708436
1981;1.1555e-14;-624;1584;24192;19613;1;594;-2.14748e+09;-1.13099e+06;0;0;0;0;0;0;454181724;467333754;41708436
1982;1.16616e-14;-632;1671;24706;19733;1;610;-2.14748e+09;-1.12886e+06;-1;0;0;0;-1;0;454225684;467387761;41727384
1982;1.1555e-14;-624;1584;24192;19613;1;594;-2.14748e+09;-1.12886e+06;-1;0;0;0;-1;0;454225684;467387761;41727384
1983;1.16616e-14;-633;1671;24706;19733;1;610;-2.14748e+09;-1.12673e+06;0;0;0;0;0;0;454269559;467441672;41746300
1983;1.1555e-14;-625;1584;24192;19613;1;594;-2.14748e+09;-1.12673e+06;0;0;0;0;0;0;454269559;467441672;41746300
1984;1.16616e-14;-634;1671;24706;19733;1;610;-2.14748e+09;-1.12461e+06;0;0;0;0;0;0;454313349;467495485;41765187
1984;1.1555e-14;-625;1584;24192;19613;1;594;-2.14748e+09;-1.12461e+06;-1;0;0;0;-1;0;454313349;467495485;41765187
1985;1.16616e-14;-635;1671;24706;19733;1;610;-2.14748e+09;-1.12249e+06;0;0;0;0;0;0;454357054;467549201;41784044
1985;1.1555e-14;-625;1584;24192;19613;1;594;-2.14748e+09;-1.12249e+06;-1;0;0;0;-1;0;454357054;467549201;41784044
1986;1.16616e-14;-636;1671;24706;19733;1;610;-2.14748e+09;-1.12037e+06;0;0;0;0;0;0;454400675;467602821;41802870
1986;1.1555e-14;-626;1584;24192;19613;1;594;-2.14748e+09;-1.12037e+06;0;0;0;0;0;0;454400675;467602821;41802870
1987;1.16616e-14;-637;1671;24706;19733;1;610;-2.14748e+09;-1.11826e+06;0;0;0;0;0;0;454444212;467656343;41821666
1987;1.1555e-14;-627;1584;24192;19613;1;594;-2.14748e+09;-1.11826e+06;0;0;0;0;0;0;454444212;467656343;41821666
1988;1.16616e-14;-637;1671;24706;19733;1;610;-2.14748e+09;-1.11616e+06;-1;0;0;0;-1;0;454487665;467709770;41840432
1988;1.1555e-14;-628;1584;24192;19613;1;594;-2.14748e+09;-1.11616e+06;0;0;0;0;0;0;454487665;467709770;41840432
1989;1.16616e-14;-637;1671;24706;19733;1;610;-2.14748e+09;-1.11405e+06;-1;0;0;0;-1;0;454531034;467763100;41859169
1989;1.1555e-14;-629;1584;24192;19613;1;594;-2.14748e+09;-1.11405e+06;0;0;0;0;0;0;454531034;467763100;41859169
1990;1.16616e-14;-637;1671;24706;19733;1;610;-2.14748e+09;-1.11196e+06;-1;0;0;0;-1;0;454574320;467816335;41877875
1990;1.1555e-14;-630;1584;24192;19613;1;594;-2.14748e+09;-1.11196e+06;0;0;0;0;0;0;454574320;467816335;41877875
1991;1.16616e-14;-638;1671;24706;19733;1;610;-2.14748e+09;-1.10986e+06;0;0;0;0;0;0;454617521;467869473;41896551
1991;1.1555e-14;-631;1584;24192;19613;1;594;-2.14748e+09;-1.10986e+06;0;0;0;0;0;0;454617521;467869473;41896551
1992;1.16616e-14;-639;1671;24706;19733;1;610;-2.14748e+09;-1.10777e+06;0;0;0;0;0;0;454660640;467922516;41915197
1992;1.1555e-14;-632;1584;24192;19613;1;594;-2.14748e+09;-1.10777e+06;0;0;0;0;0;0;454660640;467922516;41915197
1993;1.16616e-14;-639;1671;24706;19733;1;610;-2.14748e+09;-1.10568e+06;-1;0;0;0;-1;0;454703675;467975463;41933814
1993;1.1555e-14;-632;1584;24192;19613;1;594;-2.14748e+09;-1.10568e+06;-1;0;0;0;-1;0;454703675;467975463;41933814
1994;1.16616e-14;-640;1671;24706;19733;1;610;-2.14748e+09;-1.1036e+06;0;0;0;0;0;0;454746627;468028315;41952401
1994;1.1555e-14;-633;1584;24192;19613;1;594;-2.14748e+09;-1.1036e+06;0;0;0;0;0;0;454746627;468028315;41952401
1995;1.16616e-14;-640;1671;24706;19733;1;610;-2.14748e+09;-1.10162e+06;-1;0;0;0;-1;0;454789497;468081072;41970957
1995;1.1555e-14;-633;1584;24192;19613;1;594;-2.14748e+09;-1.10152e+06;-1;0;0;0;-1;0;454789497;468081072;41970957
1996;1.16616e-14;-640;1671;24706;19733;1;610;-2.14748e+09;-1.09945e+06;-1;0;0;0;-1;0;454832283;468133734;41989485
1996;1.1555e-14;-633;1584;24192;19613;1;594;-2.14748e+09;-1.09945e+06;-1;0;0;0;-1;0;454832283;468133734;41989485
1997;1.16616e-14;-641;1671;24706;19733;1;610;-2.14748e+09;-1.09738e+06;0;0;0;0;0;0;454874988;468186300;42007982
1997;1.1555e-14;-633;1584;24192;19613;1;594;-2.14748e+09;-1.09738e+06;-1;0;0;0;-1;0;454874988;468186300;42007982
1998;1.16616e-14;-642;1671;24706;19733;1;610;-2.14748e+09;-1.09532e+06;0;0;0;0;0;0;454917609;468238773;42026450
1998;1.1555e-14;-633;1584;24192;19613;1;594;-2.14748e+09;-1.09532e+06;-1;0;0;0;-1;0;454917609;468238773;42026450
1999;1.16616e-14;-643;1671;24706;19733;1;610;-2.14748e+09;-1.09325e+06;0;0;0;0;0;0;454960149;468291151;42044888
1999;1.1555e-14;-634;1584;24192;19613;1;594;-2.14748e+09;-1.09325e+06;0;0;0;0;0;0;454960149;468291151;42044888
